ID;RegioS;Perioden;BevolkingAanHetBeginVanDePeriode_1;LevendGeborenKinderen_2;Overledenen_3;TotaleVestiging_4;VestigingVanuitEenAndereGemeente_5;Immigratie_6;TotaalVertrekInclAdmCorrecties_7;VertrekNaarAndereGemeente_8;EmigratieInclusiefAdmCorrecties_9;OverigeCorrecties_10;Bevolkingsgroei_11;BevolkingsgroeiRelatief_12;BevolkingsgroeiSinds1Januari_13;BevolkingsgroeiSinds1JanuariRela_14;BevolkingAanHetEindeVanDePeriode_15
0;Nederland;2002 januari;16105285;17019;13469;66547;55181;11366;62482;55181;7301;;7615;0.05;7615;0.05;16112900
1;Nederland;2002 februari;16112900;15448;11735;55999;47049;8950;53659;47049;6610;;6053;0.04;13668;0.08;16118953
2;Nederland;2002 maart;16118953;16792;13281;58798;49290;9508;57137;49290;7847;;5172;0.03;18840;0.12;16124125
3;Nederland;2002 april;16124125;15995;11968;55730;46464;9266;53636;46464;7172;;6121;0.04;24961;0.15;16130246
4;Nederland;2002 mei;16130246;16800;11623;58679;49782;8897;57295;49782;7513;;6561;0.04;31522;0.2;16136807
5;Nederland;2002 juni;16136807;16116;11084;55795;46963;8832;55125;46963;8162;;5702;0.04;37224;0.23;16142509
6;Nederland;2002 juli;16142509;18011;11509;72075;60710;11365;70691;60710;9981;;7886;0.05;45110;0.28;16150395
7;Nederland;2002 augustus;16150395;17959;11134;76572;63110;13462;72610;63110;9500;;10787;0.07;55897;0.35;16161182
8;Nederland;2002 september;16161182;17586;10438;70322;57280;13042;66415;57280;9135;;11055;0.07;66952;0.42;16172237
9;Nederland;2002 oktober;16172237;17831;11530;66329;54735;11594;63842;54735;9107;;8788;0.05;75740;0.47;16181025
10;Nederland;2002 november;16181025;16011;11491;58655;50467;8188;57737;50467;7270;;5438;0.03;81178;0.5;16186463
11;Nederland;2002 december;16186463;16515;13093;54696;47916;6780;55236;47916;7320;3227.0;6109;0.04;87287;0.54;16192572
12;Nederland;2002;16105285;202083;142355;750197;628947;121250;725865;628947;96918;3227.0;87287;0.54;87287;0.54;16192572
13;Nederland;2003 januari;16192572;17153;13106;65511;56028;9483;64418;56028;8390;;5140;0.03;5140;0.03;16197712
14;Nederland;2003 februari;16197712;15579;11305;54034;45865;8169;53559;45865;7694;;4749;0.03;9889;0.06;16202461
15;Nederland;2003 maart;16202461;16755;13113;54752;46813;7939;54759;46813;7946;;3635;0.02;13524;0.08;16206096
16;Nederland;2003 april;16206096;16585;12203;52765;45402;7363;52842;45402;7440;;4305;0.03;17829;0.11;16210401
17;Nederland;2003 mei;16210401;16572;11309;52086;44926;7160;51544;44926;6618;;5805;0.04;23634;0.15;16216206
18;Nederland;2003 juni;16216206;16325;11088;55220;47625;7595;56197;47625;8572;;4260;0.03;27894;0.17;16220466
19;Nederland;2003 juli;16220466;17913;11234;67260;57864;9396;70070;57864;12206;;3869;0.02;31763;0.2;16224335
20;Nederland;2003 augustus;16224335;17572;11619;70019;58743;11276;68647;58743;9904;;7325;0.05;39088;0.24;16231660
21;Nederland;2003 september;16231660;17338;10942;70943;58502;12441;68059;58502;9557;;9280;0.06;48368;0.3;16240940
22;Nederland;2003 oktober;16240940;17087;11445;64896;54799;10097;64316;54799;9517;;6222;0.04;54590;0.34;16247162
23;Nederland;2003 november;16247162;15864;11291;54892;47695;7197;56193;47695;8498;;3272;0.02;57862;0.36;16250434
24;Nederland;2003 december;16250434;15554;13281;58326;51928;6398;60417;51928;8489;7416.0;7598;0.05;65460;0.4;16258032
25;Nederland;2003;16192572;200297;141936;720704;616190;104514;721021;616190;104831;7416.0;65460;0.4;65460;0.4;16258032
26;Nederland;2004 januari;16258032;16229;13726;58613;50923;7690;59771;50923;8848;;1345;0.01;1345;0.01;16259377
27;Nederland;2004 februari;16259377;15180;11300;52525;45869;6656;54505;45869;8636;;1900;0.01;3245;0.02;16261277
28;Nederland;2004 maart;16261277;16215;11983;58005;50781;7224;60757;50781;9976;;1480;0.01;4725;0.03;16262757
29;Nederland;2004 april;16262757;15801;11092;51160;45482;5678;54397;45482;8915;;1472;0.01;6197;0.04;16264229
30;Nederland;2004 mei;16264229;15751;11093;49065;42747;6318;49900;42747;7153;;3823;0.02;10020;0.06;16268052
31;Nederland;2004 juni;16268052;16477;10692;57992;50236;7756;59323;50236;9087;;4454;0.03;14474;0.09;16272506
32;Nederland;2004 juli;16272506;17324;10786;66558;58308;8250;69739;58308;11431;;3357;0.02;17831;0.11;16275863
33;Nederland;2004 augustus;16275863;16919;11166;72352;61574;10778;72712;61574;11138;;5393;0.03;23224;0.14;16281256
34;Nederland;2004 september;16281256;16438;10553;71636;59669;11967;69192;59669;9523;;8329;0.05;31553;0.19;16289585
35;Nederland;2004 oktober;16289585;16239;11103;59225;50669;8556;60209;50669;9540;;4152;0.03;35705;0.22;16293737
36;Nederland;2004 november;16293737;15613;10969;57451;50356;7095;58053;50356;7697;;4042;0.02;39747;0.24;16297779
37;Nederland;2004 december;16297779;15821;12090;57362;51311;6051;59602;51311;8291;6256.0;7747;0.05;47494;0.29;16305526
38;Nederland;2004;16258032;194007;136553;711944;617925;94019;728160;617925;110235;6256.0;47494;0.29;47494;0.29;16305526
39;Nederland;2005 januari;16305526;15678;12544;57966;51031;6935;59649;51031;8618;;1451;0.01;1451;0.01;16306977
40;Nederland;2005 februari;16306977;14671;12264;53372;46528;6844;54868;46528;8340;;911;0.01;2362;0.01;16307888
41;Nederland;2005 maart;16307888;15876;13783;56029;49182;6847;58528;49182;9346;;-406;0.0;1956;0.01;16307482
42;Nederland;2005 april;16307482;15563;11214;54394;48055;6339;57356;48055;9301;;1387;0.01;3343;0.02;16308869
43;Nederland;2005 mei;16308869;15711;11453;50186;44487;5699;52294;44487;7807;;2150;0.01;5493;0.03;16311019
44;Nederland;2005 juni;16311019;15583;10883;56352;49763;6589;59475;49763;9712;;1577;0.01;7070;0.04;16312596
45;Nederland;2005 juli;16312596;16405;10381;65928;58352;7576;69310;58352;10958;;2642;0.02;9712;0.06;16315238
46;Nederland;2005 augustus;16315238;16701;10348;77733;67470;10263;79813;67470;12343;;4273;0.03;13985;0.09;16319511
47;Nederland;2005 september;16319511;16194;10024;77931;64966;12965;76037;64966;11071;;8064;0.05;22049;0.14;16327575
48;Nederland;2005 oktober;16327575;16024;10805;64312;55855;8457;66288;55855;10433;;3243;0.02;25292;0.16;16330818
49;Nederland;2005 november;16330818;14728;10796;60430;52902;7528;63250;52902;10348;;1112;0.01;26404;0.16;16331930
50;Nederland;2005 december;16331930;14776;11907;59753;53498;6255;64946;53498;11448;4604.0;2280;0.01;28684;0.18;16334210
51;Nederland;2005;16305526;187910;136402;734386;642089;92297;761814;642089;119725;4604.0;28684;0.18;28684;0.18;16334210
52;Nederland;2006 januari;16334210;15399;12261;63736;56310;7426;66369;56310;10059;;505;0.0;505;0.0;16334715
53;Nederland;2006 februari;16334715;14286;11377;57353;49903;7450;59518;49903;9615;;744;0.0;1249;0.01;16335459
54;Nederland;2006 maart;16335459;15646;12689;62242;54485;7757;66568;54485;12083;;-1369;-0.01;-120;0.0;16334090
55;Nederland;2006 april;16334090;14543;11474;51317;44851;6466;54917;44851;10066;;-531;0.0;-651;0.0;16333559
56;Nederland;2006 mei;16333559;15673;10992;55795;48574;7221;59435;48574;10861;;1041;0.01;390;0.0;16334600
57;Nederland;2006 juni;16334600;15171;10764;57428;50090;7338;59759;50090;9669;;2076;0.01;2466;0.02;16336676
58;Nederland;2006 juli;16336676;15999;12164;66905;58291;8614;70163;58291;11872;;577;0.0;3043;0.02;16337253
59;Nederland;2006 augustus;16337253;16262;10409;80938;69244;11694;81711;69244;12467;;5080;0.03;8123;0.05;16342333
60;Nederland;2006 september;16342333;16123;10398;75602;61869;13733;74743;61869;12874;;6584;0.04;14707;0.09;16348917
61;Nederland;2006 oktober;16348917;16144;10349;65311;55680;9631;67345;55680;11665;;3761;0.02;18468;0.11;16352678
62;Nederland;2006 november;16352678;15005;10865;61830;54048;7782;65676;54048;11628;;294;0.0;18762;0.11;16352972
63;Nederland;2006 december;16352972;14806;11630;54995;48957;6038;58568;48957;9611;5417.0;5020;0.03;23782;0.15;16357992
64;Nederland;2006;16334210;185057;135372;753452;652302;101150;784772;652302;132470;5417.0;23782;0.15;23782;0.15;16357992
65;Nederland;2007 januari;16357992;15019;12221;66059;56746;9313;67716;56746;10970;;1141;0.01;1141;0.01;16359133
66;Nederland;2007 februari;16359133;13909;10884;57822;49174;8648;57042;49174;7868;;3805;0.02;4946;0.03;16362938
67;Nederland;2007 maart;16362938;15211;12019;60044;51787;8257;61109;51787;9322;;2127;0.01;7073;0.04;16365065
68;Nederland;2007 april;16365065;14385;11021;51375;44330;7045;52208;44330;7878;;2531;0.02;9604;0.06;16367596
69;Nederland;2007 mei;16367596;15144;10799;56682;48638;8044;57345;48638;8707;;3682;0.02;13286;0.08;16371278
70;Nederland;2007 juni;16371278;14659;10423;58774;50130;8644;59747;50130;9617;;3263;0.02;16549;0.1;16374541
71;Nederland;2007 juli;16374541;15989;10484;71638;60953;10685;74345;60953;13392;;2798;0.02;19347;0.12;16377339
72;Nederland;2007 augustus;16377339;16262;10450;81353;68083;13270;81229;68083;13146;;5936;0.04;25283;0.15;16383275
73;Nederland;2007 september;16383275;16021;9906;73505;58726;14779;69052;58726;10326;;10568;0.06;35851;0.22;16393843
74;Nederland;2007 oktober;16393843;15662;11049;69594;57720;11874;68911;57720;11191;;5296;0.03;41147;0.25;16399139
75;Nederland;2007 november;16399139;14531;11281;62625;53265;9360;64005;53265;10740;;1870;0.01;43017;0.26;16401009
76;Nederland;2007 december;16401009;14544;12485;53912;47012;6900;56431;47012;9419;4850.0;4390;0.03;47407;0.29;16405399
77;Nederland;2007;16357992;181336;133022;763383;646564;116819;769140;646564;122576;4850.0;47407;0.29;47407;0.29;16405399
78;Nederland;2008 januari;16405399;15071;12849;70643;59407;11236;69158;59407;9751;;3707;0.02;3707;0.02;16409106
79;Nederland;2008 februari;16409106;14236;11380;61808;50854;10954;59463;50854;8609;;5201;0.03;8908;0.05;16414307
80;Nederland;2008 maart;16414307;14771;12079;57780;48200;9580;56724;48200;8524;;3748;0.02;12656;0.08;16418055
81;Nederland;2008 april;16418055;14804;11366;60020;49683;10337;58176;49683;8493;;5282;0.03;17938;0.11;16423337
82;Nederland;2008 mei;16423337;15597;11328;54248;45287;8961;53168;45287;7881;;5349;0.03;23287;0.14;16428686
83;Nederland;2008 juni;16428686;15418;10444;60108;49736;10372;58833;49736;9097;;6249;0.04;29536;0.18;16434935
84;Nederland;2008 juli;16434935;16903;10854;74799;62017;12782;75331;62017;13314;;5517;0.03;35053;0.21;16440452
85;Nederland;2008 augustus;16440452;16350;10434;79388;64269;15119;76664;64269;12395;;8640;0.05;43693;0.27;16449092
86;Nederland;2008 september;16449092;16393;10137;83121;63181;19940;73610;63181;10429;;15767;0.1;59460;0.36;16464859
87;Nederland;2008 oktober;16464859;15685;10992;70757;56800;13957;66600;56800;9800;;8850;0.05;68310;0.42;16473709
88;Nederland;2008 november;16473709;14556;10906;58956;48107;10849;57024;48107;8917;;5582;0.03;73892;0.45;16479291
89;Nederland;2008 december;16479291;14850;12367;61141;51712;9429;62281;51712;10569;5153.0;6496;0.04;80388;0.49;16485787
90;Nederland;2008;16405399;184634;135136;792769;649253;143516;767032;649253;117779;5153.0;80388;0.49;80388;0.49;16485787
91;Nederland;2009 januari;16485787;15391;14371;63781;51965;11816;61546;51965;9581;;3255;0.02;3255;0.02;16489042
92;Nederland;2009 februari;16489042;13704;11695;58315;46986;11329;54135;46986;7149;;6189;0.04;9444;0.06;16495231
93;Nederland;2009 maart;16495231;15409;11546;60099;48765;11334;57510;48765;8745;;6452;0.04;15896;0.1;16501683
94;Nederland;2009 april;16501683;15098;10922;52952;43054;9898;52029;43054;8975;;5099;0.03;20995;0.13;16506782
95;Nederland;2009 mei;16506782;15254;10670;50330;41369;8961;48081;41369;6712;;6833;0.04;27828;0.17;16513615
96;Nederland;2009 juni;16513615;15522;10254;56279;45496;10783;54501;45496;9005;;7046;0.04;34874;0.21;16520661
97;Nederland;2009 juli;16520661;16669;10573;70181;57032;13149;68538;57032;11506;;7739;0.05;42613;0.26;16528400
98;Nederland;2009 augustus;16528400;16238;10239;75015;58771;16244;70872;58771;12101;;10142;0.06;52755;0.32;16538542
99;Nederland;2009 september;16538542;16246;10253;79272;59205;20067;69211;59205;10006;;16054;0.1;68809;0.42;16554596
100;Nederland;2009 oktober;16554596;15424;11176;64313;50712;13601;60840;50712;10128;;7721;0.05;76530;0.46;16562317
101;Nederland;2009 november;16562317;14952;10719;57104;46531;10573;55155;46531;8624;;6182;0.04;82712;0.5;16568499
102;Nederland;2009 december;16568499;15008;11817;56237;47614;8623;56979;47614;9365;4041.0;6490;0.04;89202;0.54;16574989
103;Nederland;2009;16485787;184915;134235;743878;597500;146378;709397;597500;111897;4041.0;89202;0.54;89202;0.54;16574989
104;Nederland;2010 januari;16574989;14929;12487;60282;49320;10962;59109;49320;9789;;3615;0.02;3615;0.02;16578604
105;Nederland;2010 februari;16578604;13905;11519;58725;46814;11911;54548;46814;7734;;6563;0.04;10178;0.06;16585167
106;Nederland;2010 maart;16585167;14994;12025;61000;49323;11677;60189;49323;10866;;3780;0.02;13958;0.08;16588947
107;Nederland;2010 april;16588947;14753;10976;52235;42556;9679;50986;42556;8430;;5026;0.03;18984;0.11;16593973
108;Nederland;2010 mei;16593973;15031;11276;50313;41197;9116;48708;41197;7511;;5360;0.03;24344;0.15;16599333
109;Nederland;2010 juni;16599333;15386;10657;56704;45310;11394;54631;45310;9321;;6802;0.04;31146;0.19;16606135
110;Nederland;2010 juli;16606135;16160;11141;67367;54127;13240;66846;54127;12719;;5540;0.03;36686;0.22;16611675
111;Nederland;2010 augustus;16611675;16116;10423;80299;61316;18983;73452;61316;12136;;12540;0.08;49226;0.3;16624215
112;Nederland;2010 september;16624215;16219;10640;79497;57952;21545;70486;57952;12534;;14590;0.09;63816;0.39;16638805
113;Nederland;2010 oktober;16638805;16064;11426;62759;48399;14360;57934;48399;9535;;9463;0.06;73279;0.44;16648268
114;Nederland;2010 november;16648268;15436;10948;58599;46760;11839;57236;46760;10476;;5851;0.04;79130;0.48;16654119
115;Nederland;2010 december;16654119;15404;12540;56522;46796;9726;57096;46796;10300;-610.0;1680;0.01;80810;0.49;16655799
116;Nederland;2010;16574989;184397;136058;744302;589870;154432;711221;589870;121351;-610.0;80810;0.49;80810;0.49;16655799
117;Nederland;2011 januari;16655799;15112;12200;62007;49660;12347;59576;49660;9916;;5343;0.03;5343;0.03;16661142
118;Nederland;2011 februari;16661142;14119;10644;59195;46571;12624;54800;46571;8229;;7870;0.05;13213;0.08;16669012
119;Nederland;2011 maart;16669012;14775;12044;59653;47735;11918;57465;47735;9730;;4919;0.03;18132;0.11;16673931
120;Nederland;2011 april;16673931;14289;11338;52333;42305;10028;52310;42305;10005;;2974;0.02;21106;0.13;16676905
121;Nederland;2011 mei;16676905;15121;11292;53666;43438;10228;52887;43438;9449;;4608;0.03;25714;0.15;16681513
122;Nederland;2011 juni;16681513;15371;10612;53842;42816;11026;53564;42816;10748;;5037;0.03;30751;0.18;16686550
123;Nederland;2011 juli;16686550;15782;10995;67411;53533;13878;68168;53533;14635;;4030;0.02;34781;0.21;16690580
124;Nederland;2011 augustus;16690580;16104;10686;86303;64138;22165;78829;64138;14691;;12892;0.08;47673;0.29;16703472
125;Nederland;2011 september;16703472;15674;10635;82694;59161;23533;72127;59161;12966;;15606;0.09;63279;0.38;16719078
126;Nederland;2011 oktober;16719078;15105;11285;61781;48336;13445;59351;48336;11015;;6250;0.04;69529;0.42;16725328
127;Nederland;2011 november;16725328;14223;11475;60662;48498;12164;59064;48498;10566;;4346;0.03;73875;0.44;16729674
128;Nederland;2011 december;16729674;14385;12535;57136;47530;9606;58774;47530;11244;462.0;674;0.0;74549;0.45;16730348
129;Nederland;2011;16655799;180060;135741;756683;593721;162962;726915;593721;133194;462.0;74549;0.45;74549;0.45;16730348
130;Nederland;2012 januari;16730348;14558;12490;66039;53862;12177;67175;53862;13313;;932;0.01;932;0.01;16731280
131;Nederland;2012 februari;16731280;13804;12511;61777;48635;13142;58660;48635;10025;;4410;0.03;5342;0.03;16735690
132;Nederland;2012 maart;16735690;14672;12799;59766;48556;11210;59698;48556;11142;;1941;0.01;7283;0.04;16737631
133;Nederland;2012 april;16737631;14244;11876;51112;41627;9485;51347;41627;9720;;2133;0.01;9416;0.06;16739764
134;Nederland;2012 mei;16739764;15089;11602;54077;43995;10082;54498;43995;10503;;3066;0.02;12482;0.07;16742830
135;Nederland;2012 juni;16742830;14580;11062;60272;49592;10680;61924;49592;12332;;1866;0.01;14348;0.09;16744696
136;Nederland;2012 juli;16744696;15218;11055;70166;56587;13579;72467;56587;15880;;1862;0.01;16210;0.1;16746558
137;Nederland;2012 augustus;16746558;15696;10855;87218;65509;21709;80450;65509;14941;;11609;0.07;27819;0.17;16758167
138;Nederland;2012 september;16758167;15129;10704;78297;56092;22205;68279;56092;12187;;14443;0.09;42262;0.25;16772610
139;Nederland;2012 oktober;16772610;15110;11510;66537;51850;14687;64021;51850;12171;;6116;0.04;48378;0.29;16778726
140;Nederland;2012 november;16778726;14204;11663;58626;47404;11222;58516;47404;11112;;2651;0.02;51029;0.31;16781377
141;Nederland;2012 december;16781377;13655;12686;54346;46150;8196;57315;46150;11165;198.0;-1802;-0.01;49227;0.29;16779575
142;Nederland;2012;16730348;175959;140813;768233;609859;158374;754350;609859;144491;198.0;49227;0.29;49227;0.29;16779575
143;Nederland;2013 januari;16779575;14534;13516;66843;54049;12794;66069;54049;12020;;1792;0.01;1792;0.01;16781367
144;Nederland;2013 februari;16781367;12746;12539;60817;48190;12627;58521;48190;10331;;2503;0.01;4295;0.03;16783870
145;Nederland;2013 maart;16783870;14074;13811;58449;47369;11080;57596;47369;10227;;1116;0.01;5411;0.03;16784986
146;Nederland;2013 april;16784986;13699;12354;53159;42734;10425;53707;42734;10973;;797;0.0;6208;0.04;16785783
147;Nederland;2013 mei;16785783;14184;11441;54605;43740;10865;54139;43740;10399;;3209;0.02;9417;0.06;16788992
148;Nederland;2013 juni;16788992;14110;10814;53033;42262;10771;53199;42262;10937;;3130;0.02;12547;0.07;16792122
149;Nederland;2013 juli;16792122;15820;11261;71728;56957;14771;73120;56957;16163;;3167;0.02;15714;0.09;16795289
150;Nederland;2013 augustus;16795289;15362;10788;87456;66463;20993;81440;66463;14977;;10590;0.06;26304;0.16;16805879
151;Nederland;2013 september;16805879;14993;10326;85693;61811;23882;76163;61811;14352;;14197;0.08;40501;0.24;16820076
152;Nederland;2013 oktober;16820076;14437;11490;67964;53139;14825;65225;53139;12086;;5686;0.03;46187;0.28;16825762
153;Nederland;2013 november;16825762;13694;11029;60097;48449;11648;59272;48449;10823;;3490;0.02;49677;0.3;16829252
154;Nederland;2013 december;16829252;13688;11876;59078;48987;10091;61368;48987;12381;515.0;37;0.0;49714;0.3;16829289
155;Nederland;2013;16779575;171341;141245;778922;614150;164772;759819;614150;145669;515.0;49714;0.3;49714;0.3;16829289
156;Nederland;2014 januari;16829289;14366;12198;71211;56235;14976;68749;56235;12514;;4630;0.03;4630;0.03;16833919
157;Nederland;2014 februari;16833919;13267;11142;65677;51205;14472;61422;51205;10217;;6380;0.04;11010;0.07;16840299
158;Nederland;2014 maart;16840299;14409;12008;61134;48880;12254;58854;48880;9974;;4681;0.03;15691;0.09;16844980
159;Nederland;2014 april;16844980;14031;11258;59287;47030;12257;57567;47030;10537;;4493;0.03;20184;0.12;16849473
160;Nederland;2014 mei;16849473;14584;11367;55594;44827;10767;54547;44827;9720;;4264;0.03;24448;0.15;16853737
161;Nederland;2014 juni;16853737;14626;10596;59107;46832;12275;59063;46832;12231;;4074;0.02;28522;0.17;16857811
162;Nederland;2014 juli;16857811;15669;11721;75623;60778;14845;77523;60778;16745;;2048;0.01;30570;0.18;16859859
163;Nederland;2014 augustus;16859859;15460;11199;91148;69209;21939;84417;69209;15208;;10992;0.07;41562;0.25;16870851
164;Nederland;2014 september;16870851;15552;10972;92748;66008;26740;80724;66008;14716;;16604;0.1;58166;0.35;16887455
165;Nederland;2014 oktober;16887455;15220;11635;73475;56501;16974;69495;56501;12994;;7565;0.04;65731;0.39;16895020
166;Nederland;2014 november;16895020;13907;11725;62512;49556;12956;59556;49556;10000;;5138;0.03;70869;0.42;16900158
167;Nederland;2014 december;16900158;14090;13402;69900;57406;12494;70412;57406;13006;392.0;568;0.0;71437;0.42;16900726
168;Nederland;2014;16829289;175181;139223;837416;654467;182949;802329;654467;147862;392.0;71437;0.42;71437;0.42;16900726
169;Nederland;2015 januari;16900726;14176;14955;73697;57673;16024;70889;57673;13216;;2029;0.01;2029;0.01;16902755
170;Nederland;2015 februari;16902755;12523;13183;69454;54148;15306;64289;54148;10141;;4505;0.03;6534;0.04;16907260
171;Nederland;2015 maart;16907260;13597;13673;69269;55280;13989;66518;55280;11238;;2675;0.02;9209;0.05;16909935
172;Nederland;2015 april;16909935;13241;12195;61902;49110;12792;59657;49110;10547;;3291;0.02;12500;0.07;16913226
173;Nederland;2015 mei;16913226;14345;11811;58106;47409;10697;56992;47409;9583;;3648;0.02;16148;0.1;16916874
174;Nederland;2015 juni;16916874;14273;11138;66753;52496;14257;65848;52496;13352;;4040;0.02;20188;0.12;16920914
175;Nederland;2015 juli;16920914;15308;11590;84267;67016;17251;84796;67016;17780;;3189;0.02;23377;0.14;16924103
176;Nederland;2015 augustus;16924103;15353;11174;98648;72853;25795;88819;72853;15966;;14008;0.08;37385;0.22;16938111
177;Nederland;2015 september;16938111;15330;11250;96189;67173;29016;80909;67173;13736;;19360;0.11;56745;0.34;16957471
178;Nederland;2015 oktober;16957471;14610;12235;78805;59837;18968;71607;59837;11770;;9573;0.06;66318;0.39;16967044
179;Nederland;2015 november;16967044;13852;11612;70656;54647;16009;64475;54647;9828;;8421;0.05;74739;0.44;16975465
180;Nederland;2015 december;16975465;13902;12318;74474;59963;14511;72315;59963;12352;-88.0;3655;0.02;78394;0.46;16979120
181;Nederland;2015;16900726;170510;147134;902220;697605;204615;847114;697605;149509;-88.0;78394;0.46;78394;0.46;16979120
182;Nederland;2016 januari;16979120;13990;13769;76417;59002;17415;72078;59002;13076;;4560;0.03;4560;0.03;16983680
183;Nederland;2016 februari;16983680;13342;12927;80400;60805;19595;72485;60805;11680;;8330;0.05;12890;0.08;16992010
184;Nederland;2016 maart;16992010;14107;13697;75406;58899;16507;69909;58899;11010;;5907;0.03;18797;0.11;16997917
185;Nederland;2016 april;16997917;13823;12228;71488;56971;14517;67469;56971;10498;;5614;0.03;24411;0.14;17003531
186;Nederland;2016 mei;17003531;14513;12223;70015;54968;15047;64545;54968;9577;;7760;0.05;32171;0.19;17011291
187;Nederland;2016 juni;17011291;14539;11237;75194;58532;16662;71737;58532;13205;;6759;0.04;38930;0.23;17018050
188;Nederland;2016 juli;17018050;15683;11707;88722;71360;17362;88074;71360;16714;;4624;0.03;43554;0.26;17022674
189;Nederland;2016 augustus;17022674;15603;11407;111554;80102;31452;95882;80102;15780;;19868;0.12;63422;0.37;17042542
190;Nederland;2016 september;17042542;15163;11270;103693;73608;30085;87639;73608;14031;;19947;0.12;83369;0.49;17062489
191;Nederland;2016 oktober;17062489;14539;12398;83772;64283;19489;76358;64283;12075;;9555;0.06;92924;0.55;17072044
192;Nederland;2016 november;17072044;13529;12333;80415;62658;17757;73868;62658;11210;;7743;0.05;100667;0.59;17079787
193;Nederland;2016 december;17079787;13689;13801;81151;66300;14851;78989;66300;12689;-330.0;1720;0.01;102387;0.6;17081507
194;Nederland;2016;16979120;172520;148997;998227;767488;230739;919033;767488;151545;-330.0;102387;0.6;102387;0.6;17081507
195;Nederland;2017 januari;17081507;14100;15814;85121;67736;17385;81131;67736;13395;;2276;0.01;2276;0.01;17083783
196;Nederland;2017 februari;17083783;12575;13642;84016;64304;19712;75276;64304;10972;;7673;0.04;9949;0.06;17091456
197;Nederland;2017 maart;17091456;13696;13037;84860;67554;17306;78140;67554;10586;;7379;0.04;17328;0.1;17098835
198;Nederland;2017 april;17098835;13413;11799;69826;56033;13793;65315;56033;9282;;6125;0.04;23453;0.14;17104960
199;Nederland;2017 mei;17104960;14367;12331;76520;60782;15738;71927;60782;11145;;6629;0.04;30082;0.18;17111589
200;Nederland;2017 juni;17111589;14012;11398;77064;60830;16234;74399;60830;13569;;5279;0.03;35361;0.21;17116868
201;Nederland;2017 juli;17116868;15043;11535;91654;73384;18270;91195;73384;17811;;3967;0.02;39328;0.23;17120835
202;Nederland;2017 augustus;17120835;15459;11396;112842;80584;32258;96879;80584;16295;;20026;0.12;59354;0.35;17140861
203;Nederland;2017 september;17140861;14825;11387;106073;73911;32162;88061;73911;14150;;21450;0.13;80804;0.47;17162311
204;Nederland;2017 oktober;17162311;14635;11888;87280;66414;20866;79435;66414;13021;;10592;0.06;91396;0.54;17172903
205;Nederland;2017 november;17172903;13998;12247;79620;62131;17489;73584;62131;11453;;7787;0.05;99183;0.58;17180690
206;Nederland;2017 december;17180690;13713;13740;76690;62946;13744;75559;62946;12613;-710.0;394;0.0;99577;0.58;17181084
207;Nederland;2017;17081507;169836;150214;1031566;796609;234957;950901;796609;154292;-710.0;99577;0.58;99577;0.58;17181084
208;Nederland;2018 januari;17181084;14111;14857;84102;65655;18447;78963;65655;13308;;4393;0.03;4393;0.03;17185477
209;Nederland;2018 februari;17185477;12269;14454;79595;59766;19829;70581;59766;10815;;6829;0.04;11222;0.07;17192306
210;Nederland;2018 maart;17192306;13415;16332;79383;63698;15685;75670;63698;11972;;796;0.0;12018;0.07;17193102
211;Nederland;2018 april;17193102;13417;12155;70369;55363;15006;65833;55363;10470;;5798;0.03;17816;0.1;17198900
212;Nederland;2018 mei;17198900;14619;11812;72959;56689;16270;66686;56689;9997;;9080;0.05;26896;0.16;17207980
213;Nederland;2018 juni;17207980;14192;11248;74424;58362;16062;72234;58362;13872;;5134;0.03;32030;0.19;17213114
214;Nederland;2018 juli;17213114;15297;12014;88887;68881;20006;87686;68881;18805;;4484;0.03;36514;0.21;17217598
215;Nederland;2018 augustus;17217598;15132;11755;112570;77928;34642;95315;77928;17387;;20632;0.12;57146;0.33;17238230
216;Nederland;2018 september;17238230;14955;11236;98278;66604;31674;80430;66604;13826;;21567;0.13;78713;0.46;17259797
217;Nederland;2018 oktober;17259797;14424;12189;88373;65829;22544;79174;65829;13345;;11434;0.07;90147;0.52;17271231
218;Nederland;2018 november;17271231;13581;12139;80166;61009;19157;72259;61009;11250;;9349;0.05;99496;0.58;17280580
219;Nederland;2018 december;17280580;13113;13172;72916;58501;14415;70820;58501;12319;-454.0;1583;0.01;101079;0.59;17282163
220;Nederland;2018;17181084;168525;153363;1002022;758285;243737;915651;758285;157366;-454.0;101079;0.59;101079;0.59;17282163
221;Nederland;2019 januari;17282163;14192;13998;86124;64581;21543;78461;64581;13880;;7857;0.05;7857;0.05;17290020
222;Nederland;2019 februari;17290020;12149;12758;80683;59088;21595;70751;59088;11663;;9323;0.05;17180;0.1;17299343
223;Nederland;2019 maart;17299343;13549;13757;78475;60215;18260;71911;60215;11696;;6356;0.04;23536;0.14;17305699
224;Nederland;2019 april;17305699;13717;12593;76518;58982;17536;69950;58982;10968;;7692;0.04;31228;0.18;17313391
225;Nederland;2019 mei;17313391;14349;12426;76657;59234;17423;69981;59234;10747;;8599;0.05;39827;0.23;17321990
226;Nederland;2019 juni;17321990;14233;11683;70747;53692;17055;67302;53692;13610;;5995;0.03;45822;0.27;17327985
227;Nederland;2019 juli;17327985;15476;12314;95461;72418;23043;91457;72418;19039;;7166;0.04;52988;0.31;17335151
228;Nederland;2019 augustus;17335151;15442;11773;112525;75260;37265;91993;75260;16733;;24201;0.14;77189;0.45;17359352
229;Nederland;2019 september;17359352;15132;11267;104718;67964;36754;82558;67964;14594;;26025;0.15;103214;0.6;17385377
230;Nederland;2019 oktober;17385377;14709;12571;89201;64355;24846;77352;64355;12997;;13987;0.08;117201;0.68;17399364
231;Nederland;2019 november;17399364;13686;13017;79244;60689;18555;72115;60689;11426;;7798;0.04;124999;0.72;17407162
232;Nederland;2019 december;17407162;13046;13728;76233;61044;15189;74720;61044;13676;-408.0;423;0.0;125422;0.73;17407585
233;Nederland;2019;17282163;169680;151885;1026586;757522;269064;918551;757522;161029;-408.0;125422;0.73;125422;0.73;17407585
234;Nederland;2020 januari;17407585;14085;14111;89538;67318;22220;83126;67318;15808;;6386;0.04;6386;0.04;17413971
235;Nederland;2020 februari;17413971;12905;12895;83523;61828;21695;73641;61828;11813;;9892;0.06;16278;0.09;17423863
236;Nederland;2020 maart;17423863;13556;16237;77114;61504;15610;74039;61504;12535;;394;0.0;16672;0.1;17424257
237;Nederland;2020 april;17424257;13375;18876;65780;56415;9365;64884;56415;8469;;-4605;-0.03;12067;0.07;17419652
238;Nederland;2020 mei;17419652;13791;12641;68250;59184;9066;67247;59184;8063;;2153;0.01;14220;0.08;17421805
239;Nederland;2020 juni;17421805;13928;11478;74237;61497;12740;72694;61497;11197;;3993;0.02;18213;0.1;17425798
240;Nederland;2020 juli;17425798;15625;11627;93268;75226;18042;92144;75226;16918;;5122;0.03;23335;0.13;17430920
241;Nederland;2020 augustus;17430920;15110;12568;104014;77267;26747;92652;77267;15385;;13904;0.08;37239;0.21;17444824
242;Nederland;2020 september;17444824;14966;11905;102202;71794;30408;84791;71794;12997;;20472;0.12;57711;0.33;17465296
243;Nederland;2020 oktober;17465296;14508;14613;92808;71947;20861;85559;71947;13612;;7144;0.04;64855;0.37;17472440
244;Nederland;2020 november;17472440;13555;14925;81445;63662;17783;76033;63662;12371;;4042;0.02;68897;0.4;17476482
245;Nederland;2020 december;17476482;13277;16802;82067;65751;16316;79077;65751;13326;-532.0;-1067;-0.01;67830;0.39;17475415
246;Nederland;2020;17407585;168681;168678;1014246;793393;220853;945887;793393;152494;-532.0;67830;0.39;67830;0.39;17475415
247;Nederland;2021 januari;17475415;13953;17307;88225;72449;15776;84231;72449;11782;0.0;640;0.0;640;0.0;17476055
248;Nederland;2021 februari;17476055;13480;13942;80761;64516;16245;73990;64516;9474;0.0;6309;0.04;6949;0.04;17482364
249;Nederland;2021 maart;17482364;14905;13797;89549;73083;16466;84352;73083;11269;0.0;6305;0.04;13254;0.08;17488669
250;Nederland;2021 april;17488669;14517;13533;81070;66243;14827;76010;66243;9767;0.0;6044;0.03;19298;0.11;17494713
251;Nederland;2021 mei;17494713;14806;13124;74867;60940;13927;70298;60940;9358;0.0;6251;0.04;25549;0.15;17500964
252;Nederland;2021 juni;17500964;14833;12205;78040;61638;16402;73730;61638;12092;0.0;6938;0.04;32487;0.19;17507902
253;Nederland;2021 juli;17507902;16108;12607;91993;72004;19989;87520;72004;15516;0.0;7974;0.05;40461;0.23;17515876
254;Nederland;2021 augustus;17515876;15958;12769;109494;74859;34635;90777;74859;15918;0.0;21906;0.13;62367;0.36;17537782
255;Nederland;2021 september;17537782;16225;12709;107295;67186;40109;80304;67186;13118;0.0;30507;0.17;92874;0.53;17568289
256;Nederland;2021 oktober;17568289;15713;14150;88739;63866;24873;75926;63866;12060;0.0;14376;0.08;107250;0.61;17582665
257;Nederland;2021 november;17582665;14676;16782;83080;61434;21646;72594;61434;11160;0.0;8380;0.05;115630;0.66;17591045
258;Nederland;2021 december;17591045;14267;18047;81925;64292;17633;78108;64292;13816;-410.0;-373;0.0;115257;0.66;17590672
259;Nederland;2021;17475415;179441;170972;1055038;802510;252528;947840;802510;145330;-410.0;115257;0.66;115257;0.66;17590672
260;Nederland;2022 januari;17590672;14054;14429;83062;63484;19578;76221;63484;12737;;6466;0.04;6466;0.04;17597138
261;Nederland;2022 februari;17597138;12764;13245;81983;58874;23109;70129;58874;11255;;11373;0.06;17839;0.1;17608511
262;Nederland;2022 maart;17608511;13585;15449;109176;62635;46541;74581;62635;11946;;32731;0.19;50570;0.29;17641242
263;Nederland;2022 april;17641242;12890;14570;108178;61890;46288;72781;61890;10891;;33717;0.19;84287;0.48;17674959
264;Nederland;2022 mei;17674959;14022;13484;93447;60770;32677;73177;60770;12407;;20808;0.12;105095;0.6;17695767
265;Nederland;2022 juni;17695767;14098;13048;89847;60679;29168;76785;60679;16106;;14112;0.08;119207;0.68;17709879
266;Nederland;2022 juli;17709879;14894;13655;99753;70346;29407;91166;70346;20820;;9826;0.06;129033;0.73;17719705
267;Nederland;2022 augustus;17719705;15257;13378;124540;76093;48447;96652;76093;20559;;29767;0.17;158800;0.9;17749472
268;Nederland;2022 september;17749472;15231;12759;120115;73034;47081;90594;73034;17560;;31993;0.18;190793;1.08;17781465
269;Nederland;2022 oktober;17781465;14481;14676;97725;67403;30322;82629;67403;15226;;14901;0.08;205694;1.17;17796366
270;Nederland;2022 november;17796366;13223;14043;93177;64715;28462;78828;64715;14113;;13529;0.08;219223;1.25;17809895
271;Nederland;2022 december;17809895;13005;17376;88992;66964;22028;82654;66964;15690;-571.0;1396;0.01;220619;1.25;17811291
272;Nederland;2022;17590672;167504;170112;1189995;786887;403108;966197;786887;179310;-571.0;220619;1.25;220619;1.25;17811291
273;Nederland;2023 januari;17811291;13231;16590;95101;69119;25982;85858;69119;16739;0.0;5884;0.03;5884;0.03;17817175
274;Nederland;2023 februari;17817175;12206;13990;90814;61993;28821;76905;61993;14912;0.0;12125;0.07;18009;0.1;17829300
275;Nederland;2023 maart;17829300;13725;16096;93892;67488;26404;82826;67488;15338;0.0;8695;0.05;26704;0.15;17837995
276;Nederland;2023 april;17837995;12876;13357;79936;59113;20823;72239;59113;13126;0.0;7216;0.04;33920;0.19;17845211
277;Nederland;2023 mei;17845211;14307;13142;85064;61826;23238;75554;61826;13728;0.0;10675;0.06;44595;0.25;17855886
278;Nederland;2023 juni;17855886;13958;13103;91073;67047;24026;83933;67047;16886;0.0;7995;0.04;52590;0.3;17863881
279;Nederland;2023 juli;17863881;14897;12648;102804;77210;25594;99529;77210;22319;0.0;5524;0.03;58114;0.33;17869405
280;Nederland;2023 augustus;17869405;14810;12685;126617;82550;44067;103798;82550;21248;0.0;24944;0.14;83058;0.47;17894349
281;Nederland;2023 september;17894349;13933;12850;116401;74486;41915;91688;74486;17202;0.0;25796;0.14;108854;0.61;17920145
282;Nederland;2023 oktober;17920145;14108;14138;98515;68263;30252;83964;68263;15701;0.0;14521;0.08;123375;0.69;17934666
283;Nederland;2023 november;17934666;13431;14823;89469;64364;25105;78912;64364;14548;0.0;9165;0.05;132540;0.74;17943831
284;Nederland;2023 december;17943831;13005;16099;84465;65024;19441;81579;65024;16555;-681.0;-889;0.0;131651;0.74;17942942
285;Nederland;2023;17811291;164487;169521;1154151;818483;335668;1016785;818483;198302;-681.0;131651;0.74;131651;0.74;17942942
286;Nederland;2024 januari;17942942;13582;16825;93019;68204;24815;86162;68204;17958;;3614;0.02;3614;0.02;17946556
287;Nederland;2024 februari;17946556;12893;15195;90617;63507;27110;79128;63507;15621;;9187;0.05;12801;0.07;17955743
288;Nederland;2024 maart;17955743;13527;15220;87739;64889;22850;79026;64889;14137;;7020;0.04;19821;0.11;17962763
289;Nederland;2024 april;17962763;13171;14272;83225;61388;21837;74843;61388;13455;;7281;0.04;27102;0.15;17970044
290;Nederland;2024 mei;17970044;14254;13844;82059;61408;20651;74837;61408;13429;;7632;0.04;34734;0.19;17977676
291;Nederland;2024 juni;17977676;13831;13073;80236;59758;20478;76737;59758;16979;;4257;0.02;38991;0.22;17981933
292;Nederland;2024 juli;17981933;14536;13402;99528;73609;25919;97227;73609;23618;;3435;0.02;42426;0.24;17985368
293;Nederland;2024 augustus;17985368;14828;13333;116017;76758;39259;97738;76758;20980;;19774;0.11;62200;0.35;18005142
294;Nederland;2024 september;18005142;14327;13215;111180;70986;40194;89223;70986;18237;;23069;0.13;85269;0.48;18028211
295;Nederland;2024 oktober;18028211;14018;14465;97718;69417;28301;86756;69417;17339;;10515;0.06;95784;0.53;18038726
296;Nederland;2024 november;18038726;13322;14081;88463;65324;23139;80747;65324;15423;;6957;0.04;102741;0.57;18045683
297;Nederland;2024 december;18045683;13115;15020;86435;66916;19519;84681;66916;17765;0.0;-151;0.0;102590;0.57;18045532
298;Nederland;2024;17942942;165404;171945;1116236;802164;314072;1007105;802164;204941;0.0;102590;0.57;102590;0.57;18045532
299;Nederland;2025 januari;18045532;13690;17283;100488;72846;27642;90571;72846;17725;;6324;0.04;6324;0.04;18051856
300;Nederland;2025 februari;18051856;12148;15932;94718;66619;28099;82345;66619;15726;;8589;0.05;14913;0.08;18060445
301;Noord-Nederland (LD);2002 januari;1685463;1690;1533;7533;6098;1435;6976;6391;585;;714;0.04;714;0.04;1686177
302;Noord-Nederland (LD);2002 februari;1686177;1610;1242;6294;5288;1006;6166;5694;472;;496;0.03;1210;0.07;1686673
303;Noord-Nederland (LD);2002 maart;1686673;1711;1475;6312;5358;954;6386;5714;672;;162;0.01;1372;0.08;1686835
304;Noord-Nederland (LD);2002 april;1686835;1583;1404;6202;5189;1013;6167;5538;629;;214;0.01;1586;0.09;1687049
305;Noord-Nederland (LD);2002 mei;1687049;1671;1339;6613;5749;864;6414;5963;451;;531;0.03;2117;0.13;1687580
306;Noord-Nederland (LD);2002 juni;1687580;1538;1256;6416;5469;947;6183;5587;596;;515;0.03;2632;0.16;1688095
307;Noord-Nederland (LD);2002 juli;1688095;1809;1309;8426;7348;1078;7798;7131;667;;1128;0.07;3760;0.22;1689223
308;Noord-Nederland (LD);2002 augustus;1689223;1839;1241;9303;8179;1124;8224;7584;640;;1677;0.1;5437;0.32;1690900
309;Noord-Nederland (LD);2002 september;1690900;1734;1181;8181;6877;1304;7531;6919;612;;1203;0.07;6640;0.39;1692103
310;Noord-Nederland (LD);2002 oktober;1692103;1825;1350;7431;6262;1169;7023;6369;654;;883;0.05;7523;0.45;1692986
311;Noord-Nederland (LD);2002 november;1692986;1618;1312;6609;5671;938;6435;5854;581;;480;0.03;8003;0.47;1693466
312;Noord-Nederland (LD);2002 december;1693466;1645;1445;6247;5494;753;5844;5319;525;-31.0;572;0.03;8575;0.51;1694038
313;Noord-Nederland (LD);2002;1685463;20273;16087;85567;72982;12585;81147;74063;7084;-31.0;8575;0.51;8575;0.51;1694038
314;Noord-Nederland (LD);2003 januari;1694038;1702;1572;7381;6599;782;7301;6639;662;;210;0.01;210;0.01;1694248
315;Noord-Nederland (LD);2003 februari;1694248;1515;1231;6281;5547;734;6238;5662;576;;327;0.02;537;0.03;1694575
316;Noord-Nederland (LD);2003 maart;1694575;1720;1445;6112;5448;664;6423;5721;702;;-36;0.0;501;0.03;1694539
317;Noord-Nederland (LD);2003 april;1694539;1699;1372;6113;5442;671;6399;5507;892;;41;0.0;542;0.03;1694580
318;Noord-Nederland (LD);2003 mei;1694580;1636;1288;5846;5219;627;6111;5437;674;;83;0.0;625;0.04;1694663
319;Noord-Nederland (LD);2003 juni;1694663;1638;1228;6135;5525;610;6254;5610;644;;291;0.02;916;0.05;1694954
320;Noord-Nederland (LD);2003 juli;1694954;1775;1251;7599;6847;752;7414;6586;828;;709;0.04;1625;0.1;1695663
321;Noord-Nederland (LD);2003 augustus;1695663;1731;1329;8482;7741;741;8121;7376;745;;763;0.04;2388;0.14;1696426
322;Noord-Nederland (LD);2003 september;1696426;1712;1196;8030;6987;1043;7763;7175;588;;783;0.05;3171;0.19;1697209
323;Noord-Nederland (LD);2003 oktober;1697209;1672;1278;6970;6193;777;6783;6104;679;;581;0.03;3752;0.22;1697790
324;Noord-Nederland (LD);2003 november;1697790;1512;1217;5776;5190;586;5701;5235;466;;370;0.02;4122;0.24;1698160
325;Noord-Nederland (LD);2003 december;1698160;1574;1433;6069;5600;469;6048;5451;597;543.0;705;0.04;4827;0.28;1698865
326;Noord-Nederland (LD);2003;1694038;19886;15840;80794;72338;8456;80556;72503;8053;543.0;4827;0.28;4827;0.28;1698865
327;Noord-Nederland (LD);2004 januari;1698865;1642;1555;6271;5723;548;6429;5785;644;;-71;0.0;-71;0.0;1698794
328;Noord-Nederland (LD);2004 februari;1698794;1536;1229;5637;5103;534;5985;5361;624;;-41;0.0;-112;-0.01;1698753
329;Noord-Nederland (LD);2004 maart;1698753;1637;1307;6270;5646;624;6790;5959;831;;-190;-0.01;-302;-0.02;1698563
330;Noord-Nederland (LD);2004 april;1698563;1569;1249;5586;5144;442;6074;5377;697;;-168;-0.01;-470;-0.03;1698395
331;Noord-Nederland (LD);2004 mei;1698395;1434;1252;5513;4967;546;5643;5148;495;;52;0.0;-418;-0.02;1698447
332;Noord-Nederland (LD);2004 juni;1698447;1578;1230;5995;5434;561;6266;5705;561;;77;0.0;-341;-0.02;1698524
333;Noord-Nederland (LD);2004 juli;1698524;1684;1258;7439;6886;553;7621;6838;783;;244;0.01;-97;-0.01;1698768
334;Noord-Nederland (LD);2004 augustus;1698768;1609;1198;8496;7692;804;7950;7275;675;;957;0.06;860;0.05;1699725
335;Noord-Nederland (LD);2004 september;1699725;1646;1224;8148;7028;1120;7953;7165;788;;617;0.04;1477;0.09;1700342
336;Noord-Nederland (LD);2004 oktober;1700342;1558;1183;6646;6021;625;6620;5883;737;;401;0.02;1878;0.11;1700743
337;Noord-Nederland (LD);2004 november;1700743;1550;1274;6227;5727;500;6170;5690;480;;333;0.02;2211;0.13;1701076
338;Noord-Nederland (LD);2004 december;1701076;1569;1397;6082;5660;422;6279;5603;676;367.0;342;0.02;2553;0.15;1701418
339;Noord-Nederland (LD);2004;1698865;19012;15356;78310;71031;7279;79780;71789;7991;367.0;2553;0.15;2553;0.15;1701418
340;Noord-Nederland (LD);2005 januari;1701418;1548;1395;6146;5688;458;6441;5896;545;;-142;-0.01;-142;-0.01;1701276
341;Noord-Nederland (LD);2005 februari;1701276;1386;1284;6013;5353;660;6043;5492;551;;72;0.0;-70;0.0;1701348
342;Noord-Nederland (LD);2005 maart;1701348;1546;1541;5768;5326;442;6498;5511;987;;-725;-0.04;-795;-0.05;1700623
343;Noord-Nederland (LD);2005 april;1700623;1493;1256;5852;5462;390;6429;5565;864;;-340;-0.02;-1135;-0.07;1700283
344;Noord-Nederland (LD);2005 mei;1700283;1566;1268;5608;5256;352;6034;5336;698;;-128;-0.01;-1263;-0.07;1700155
345;Noord-Nederland (LD);2005 juni;1700155;1478;1213;5999;5519;480;6256;5615;641;;8;0.0;-1255;-0.07;1700163
346;Noord-Nederland (LD);2005 juli;1700163;1610;1172;7467;6924;543;7812;6891;921;;93;0.01;-1162;-0.07;1700256
347;Noord-Nederland (LD);2005 augustus;1700256;1669;1151;8782;8138;644;8819;8075;744;;481;0.03;-681;-0.04;1700737
348;Noord-Nederland (LD);2005 september;1700737;1598;1081;9472;8217;1255;9158;8447;711;;831;0.05;150;0.01;1701568
349;Noord-Nederland (LD);2005 oktober;1701568;1572;1260;7101;6541;560;7541;6633;908;;-128;-0.01;22;0.0;1701440
350;Noord-Nederland (LD);2005 november;1701440;1521;1242;6680;6180;500;7417;6288;1129;;-458;-0.03;-436;-0.03;1700982
351;Noord-Nederland (LD);2005 december;1700982;1432;1308;6238;5877;361;6837;5933;904;246.0;-229;-0.01;-665;-0.04;1700753
352;Noord-Nederland (LD);2005;1701418;18419;15171;81126;74481;6645;85285;75682;9603;246.0;-665;-0.04;-665;-0.04;1700753
353;Noord-Nederland (LD);2006 januari;1700753;1532;1429;6676;6255;421;7267;6380;887;;-488;-0.03;-488;-0.03;1700265
354;Noord-Nederland (LD);2006 februari;1700265;1382;1287;6214;5719;495;6509;5764;745;;-200;-0.01;-688;-0.04;1700065
355;Noord-Nederland (LD);2006 maart;1700065;1581;1482;6514;6050;464;7055;6166;889;;-442;-0.03;-1130;-0.07;1699623
356;Noord-Nederland (LD);2006 april;1699623;1473;1348;5289;4932;357;5532;4958;574;;-118;-0.01;-1248;-0.07;1699505
357;Noord-Nederland (LD);2006 mei;1699505;1490;1272;5927;5457;470;6008;5480;528;;137;0.01;-1111;-0.07;1699642
358;Noord-Nederland (LD);2006 juni;1699642;1457;1269;6049;5620;429;6441;5778;663;;-204;-0.01;-1315;-0.08;1699438
359;Noord-Nederland (LD);2006 juli;1699438;1549;1297;7494;6871;623;7521;6668;853;;225;0.01;-1090;-0.06;1699663
360;Noord-Nederland (LD);2006 augustus;1699663;1588;1208;9474;8644;830;8990;8134;856;;864;0.05;-226;-0.01;1700527
361;Noord-Nederland (LD);2006 september;1700527;1533;1174;8982;7786;1196;8585;7801;784;;756;0.04;530;0.03;1701283
362;Noord-Nederland (LD);2006 oktober;1701283;1540;1267;7238;6563;675;7325;6561;764;;186;0.01;716;0.04;1701469
363;Noord-Nederland (LD);2006 november;1701469;1532;1232;6542;6047;495;6731;6070;661;;111;0.01;827;0.05;1701580
364;Noord-Nederland (LD);2006 december;1701580;1427;1262;6047;5669;378;6170;5414;756;398.0;440;0.03;1267;0.07;1702020
365;Noord-Nederland (LD);2006;1700753;18084;15527;82446;75613;6833;84134;75174;8960;398.0;1267;0.07;1267;0.07;1702020
366;Noord-Nederland (LD);2007 januari;1702020;1475;1353;6870;6308;562;7167;6394;773;;-175;-0.01;-175;-0.01;1701845
367;Noord-Nederland (LD);2007 februari;1701845;1378;1234;6298;5701;597;6472;5794;678;;-30;0.0;-205;-0.01;1701815
368;Noord-Nederland (LD);2007 maart;1701815;1470;1412;6340;5778;562;6506;5943;563;;-108;-0.01;-313;-0.02;1701707
369;Noord-Nederland (LD);2007 april;1701707;1373;1190;5336;4895;441;5478;5067;411;;41;0.0;-272;-0.02;1701748
370;Noord-Nederland (LD);2007 mei;1701748;1485;1255;6058;5555;503;6295;5709;586;;-7;0.0;-279;-0.02;1701741
371;Noord-Nederland (LD);2007 juni;1701741;1360;1173;6158;5603;555;6105;5567;538;;240;0.01;-39;0.0;1701981
372;Noord-Nederland (LD);2007 juli;1701981;1559;1182;8111;7436;675;8244;7263;981;;244;0.01;205;0.01;1702225
373;Noord-Nederland (LD);2007 augustus;1702225;1587;1174;9753;8776;977;9068;8302;766;;1098;0.06;1303;0.08;1703323
374;Noord-Nederland (LD);2007 september;1703323;1581;1101;8452;7189;1263;7684;7110;574;;1248;0.07;2551;0.15;1704571
375;Noord-Nederland (LD);2007 oktober;1704571;1467;1189;7669;6812;857;7477;6879;598;;470;0.03;3021;0.18;1705041
376;Noord-Nederland (LD);2007 november;1705041;1463;1232;6465;5859;606;6929;6135;794;;-233;-0.01;2788;0.16;1704808
377;Noord-Nederland (LD);2007 december;1704808;1396;1365;5806;5345;461;6188;5475;713;326.0;-25;0.0;2763;0.16;1704783
378;Noord-Nederland (LD);2007;1702020;17594;14860;83316;75257;8059;83613;75638;7975;326.0;2763;0.16;2763;0.16;1704783
379;Noord-Nederland (LD);2008 januari;1704783;1565;1424;7537;6846;691;7791;7015;776;;-113;-0.01;-113;-0.01;1704670
380;Noord-Nederland (LD);2008 februari;1704670;1350;1274;6443;5786;657;6796;6256;540;;-277;-0.02;-390;-0.02;1704393
381;Noord-Nederland (LD);2008 maart;1704393;1396;1367;5943;5290;653;6146;5621;525;;-174;-0.01;-564;-0.03;1704219
382;Noord-Nederland (LD);2008 april;1704219;1447;1285;5975;5324;651;6103;5607;496;;34;0.0;-530;-0.03;1704253
383;Noord-Nederland (LD);2008 mei;1704253;1519;1299;5682;5122;560;5885;5347;538;;17;0.0;-513;-0.03;1704270
384;Noord-Nederland (LD);2008 juni;1704270;1489;1224;6123;5488;635;6184;5592;592;;204;0.01;-309;-0.02;1704474
385;Noord-Nederland (LD);2008 juli;1704474;1648;1262;8275;7467;808;8239;7298;941;;422;0.02;113;0.01;1704896
386;Noord-Nederland (LD);2008 augustus;1704896;1585;1172;9202;8083;1119;8523;7748;775;;1092;0.06;1205;0.07;1705988
387;Noord-Nederland (LD);2008 september;1705988;1568;1158;9718;7764;1954;8206;7567;639;;1922;0.11;3127;0.18;1707910
388;Noord-Nederland (LD);2008 oktober;1707910;1502;1276;7497;6450;1047;7377;6444;933;;346;0.02;3473;0.2;1708256
389;Noord-Nederland (LD);2008 november;1708256;1432;1252;6260;5533;727;6215;5573;642;;225;0.01;3698;0.22;1708481
390;Noord-Nederland (LD);2008 december;1708481;1347;1372;6390;5686;704;6391;5751;640;366.0;340;0.02;4038;0.24;1708821
391;Noord-Nederland (LD);2008;1704783;17848;15365;85045;74839;10206;83856;75819;8037;366.0;4038;0.24;4038;0.24;1708821
392;Noord-Nederland (LD);2009 januari;1708821;1511;1658;6452;5715;737;6650;5981;669;;-345;-0.02;-345;-0.02;1708476
393;Noord-Nederland (LD);2009 februari;1708476;1292;1372;6287;5365;922;6159;5621;538;;48;0.0;-297;-0.02;1708524
394;Noord-Nederland (LD);2009 maart;1708524;1544;1397;6141;5220;921;6174;5521;653;;114;0.01;-183;-0.01;1708638
395;Noord-Nederland (LD);2009 april;1708638;1441;1213;5667;4858;809;5514;4994;520;;381;0.02;198;0.01;1709019
396;Noord-Nederland (LD);2009 mei;1709019;1464;1205;5096;4460;636;4919;4567;352;;436;0.03;634;0.04;1709455
397;Noord-Nederland (LD);2009 juni;1709455;1556;1160;5818;5056;762;5885;5246;639;;329;0.02;963;0.06;1709784
398;Noord-Nederland (LD);2009 juli;1709784;1727;1212;7784;6900;884;7867;6873;994;;432;0.03;1395;0.08;1710216
399;Noord-Nederland (LD);2009 augustus;1710216;1499;1191;8671;7502;1169;7703;7056;647;;1276;0.07;2671;0.16;1711492
400;Noord-Nederland (LD);2009 september;1711492;1554;1142;9041;7171;1870;7654;6955;699;;1799;0.11;4470;0.26;1713291
401;Noord-Nederland (LD);2009 oktober;1713291;1534;1290;6636;5551;1085;6179;5712;467;;701;0.04;5171;0.3;1713992
402;Noord-Nederland (LD);2009 november;1713992;1392;1172;5711;4977;734;6150;5219;931;;-219;-0.01;4952;0.29;1713773
403;Noord-Nederland (LD);2009 december;1713773;1527;1367;5518;4816;702;5617;5128;489;120.0;181;0.01;5133;0.3;1713954
404;Noord-Nederland (LD);2009;1708821;18041;15379;78822;67591;11231;76471;68873;7598;120.0;5133;0.3;5133;0.3;1713954
405;Noord-Nederland (LD);2010 januari;1713954;1422;1336;6040;5243;797;6112;5400;712;;14;0.0;14;0.0;1713968
406;Noord-Nederland (LD);2010 februari;1713968;1347;1323;6037;5064;973;5772;5293;479;;289;0.02;303;0.02;1714257
407;Noord-Nederland (LD);2010 maart;1714257;1394;1384;6172;5331;841;6386;5577;809;;-204;-0.01;99;0.01;1714053
408;Noord-Nederland (LD);2010 april;1714053;1351;1248;5270;4507;763;5109;4669;440;;264;0.02;363;0.02;1714317
409;Noord-Nederland (LD);2010 mei;1714317;1377;1305;5013;4367;646;4828;4443;385;;257;0.01;620;0.04;1714574
410;Noord-Nederland (LD);2010 juni;1714574;1439;1242;5698;4812;886;5682;5022;660;;213;0.01;833;0.05;1714787
411;Noord-Nederland (LD);2010 juli;1714787;1569;1324;7336;6335;1001;7485;6555;930;;96;0.01;929;0.05;1714883
412;Noord-Nederland (LD);2010 augustus;1714883;1583;1188;8572;7314;1258;8013;7219;794;;954;0.06;1883;0.11;1715837
413;Noord-Nederland (LD);2010 september;1715837;1529;1163;9041;6856;2185;7722;7008;714;;1685;0.1;3568;0.21;1717522
414;Noord-Nederland (LD);2010 oktober;1717522;1538;1295;6303;5218;1085;6077;5468;609;;469;0.03;4037;0.24;1717991
415;Noord-Nederland (LD);2010 november;1717991;1417;1255;5916;5087;829;6150;5309;841;;-72;0.0;3965;0.23;1717919
416;Noord-Nederland (LD);2010 december;1717919;1528;1472;5725;5078;647;5966;5261;705;-5.0;-190;-0.01;3775;0.22;1717729
417;Noord-Nederland (LD);2010;1713954;17494;15535;77123;65212;11911;75302;67224;8078;-5.0;3775;0.22;3775;0.22;1717729
418;Noord-Nederland (LD);2011 januari;1717729;1432;1363;6104;5351;753;6377;5614;763;;-204;-0.01;-204;-0.01;1717525
419;Noord-Nederland (LD);2011 februari;1717525;1345;1230;6341;5348;993;6360;5634;726;;96;0.01;-108;-0.01;1717621
420;Noord-Nederland (LD);2011 maart;1717621;1442;1390;6041;5280;761;6246;5543;703;;-153;-0.01;-261;-0.02;1717468
421;Noord-Nederland (LD);2011 april;1717468;1359;1264;5236;4573;663;5248;4719;529;;83;0.0;-178;-0.01;1717551
422;Noord-Nederland (LD);2011 mei;1717551;1425;1278;5245;4629;616;5339;4792;547;;53;0.0;-125;-0.01;1717604
423;Noord-Nederland (LD);2011 juni;1717604;1481;1248;5283;4646;637;5731;4884;847;;-215;-0.01;-340;-0.02;1717389
424;Noord-Nederland (LD);2011 juli;1717389;1473;1291;6910;6044;866;7330;6177;1153;;-238;-0.01;-578;-0.03;1717151
425;Noord-Nederland (LD);2011 augustus;1717151;1607;1173;9132;7686;1446;8605;7676;929;;961;0.06;383;0.02;1718112
426;Noord-Nederland (LD);2011 september;1718112;1524;1254;9971;7237;2734;8070;7249;821;;2171;0.13;2554;0.15;1720283
427;Noord-Nederland (LD);2011 oktober;1720283;1379;1255;6258;5332;926;6391;5536;855;;-9;0.0;2545;0.15;1720274
428;Noord-Nederland (LD);2011 november;1720274;1307;1321;5889;5185;704;6534;5487;1047;;-659;-0.04;1886;0.11;1719615
429;Noord-Nederland (LD);2011 december;1719615;1350;1455;5521;4937;584;6098;5207;891;-37.0;-719;-0.04;1167;0.07;1718896
430;Noord-Nederland (LD);2011;1717729;17124;15522;77931;66248;11683;78329;68518;9811;-37.0;1167;0.07;1167;0.07;1718896
431;Noord-Nederland (LD);2012 januari;1718896;1411;1401;6461;5684;777;6820;5945;875;;-349;-0.02;-349;-0.02;1718547
432;Noord-Nederland (LD);2012 februari;1718547;1257;1381;6486;5376;1110;6619;5762;857;;-257;-0.01;-606;-0.04;1718290
433;Noord-Nederland (LD);2012 maart;1718290;1398;1471;5780;5084;696;6225;5495;730;;-518;-0.03;-1124;-0.07;1717772
434;Noord-Nederland (LD);2012 april;1717772;1255;1364;5023;4481;542;5305;4753;552;;-391;-0.02;-1515;-0.09;1717381
435;Noord-Nederland (LD);2012 mei;1717381;1435;1314;5277;4709;568;5474;4920;554;;-76;0.0;-1591;-0.09;1717305
436;Noord-Nederland (LD);2012 juni;1717305;1352;1297;6100;5477;623;6430;5573;857;;-275;-0.02;-1866;-0.11;1717030
437;Noord-Nederland (LD);2012 juli;1717030;1433;1273;7251;6431;820;7567;6468;1099;;-156;-0.01;-2022;-0.12;1716874
438;Noord-Nederland (LD);2012 augustus;1716874;1455;1302;9856;7964;1892;8716;7815;901;;1293;0.08;-729;-0.04;1718167
439;Noord-Nederland (LD);2012 september;1718167;1406;1230;9167;6969;2198;7899;6956;943;;1444;0.08;715;0.04;1719611
440;Noord-Nederland (LD);2012 oktober;1719611;1483;1344;6481;5554;927;6839;5869;970;;-219;-0.01;496;0.03;1719392
441;Noord-Nederland (LD);2012 november;1719392;1325;1374;5761;4992;769;6099;5245;854;;-387;-0.02;109;0.01;1719005
442;Noord-Nederland (LD);2012 december;1719005;1302;1431;5293;4829;464;5696;4997;699;12.0;-520;-0.03;-411;-0.02;1718485
443;Noord-Nederland (LD);2012;1718896;16512;16182;78936;67550;11386;79689;69798;9891;12.0;-411;-0.02;-411;-0.02;1718485
444;Noord-Nederland (LD);2013 januari;1718485;1370;1586;6608;5744;864;6866;6012;854;;-474;-0.03;-474;-0.03;1718011
445;Noord-Nederland (LD);2013 februari;1718011;1192;1551;6240;5339;901;6566;5727;839;;-685;-0.04;-1159;-0.07;1717326
446;Noord-Nederland (LD);2013 maart;1717326;1280;1595;5620;4997;623;5837;5316;521;;-532;-0.03;-1691;-0.1;1716794
447;Noord-Nederland (LD);2013 april;1716794;1232;1384;5368;4619;749;5475;4923;552;;-259;-0.02;-1950;-0.11;1716535
448;Noord-Nederland (LD);2013 mei;1716535;1295;1300;5543;4813;730;5606;4909;697;;-68;0.0;-2018;-0.12;1716467
449;Noord-Nederland (LD);2013 juni;1716467;1343;1183;5185;4482;703;5555;4769;786;;-210;-0.01;-2228;-0.13;1716257
450;Noord-Nederland (LD);2013 juli;1716257;1464;1208;7536;6564;972;7904;6793;1111;;-112;-0.01;-2340;-0.14;1716145
451;Noord-Nederland (LD);2013 augustus;1716145;1372;1221;9825;8324;1501;9334;8232;1102;;642;0.04;-1698;-0.1;1716787
452;Noord-Nederland (LD);2013 september;1716787;1379;1166;9881;7280;2601;8326;7480;846;;1768;0.1;70;0.0;1718555
453;Noord-Nederland (LD);2013 oktober;1718555;1275;1333;6565;5662;903;6656;5869;787;;-149;-0.01;-79;0.0;1718406
454;Noord-Nederland (LD);2013 november;1718406;1312;1230;5954;5194;760;5997;5418;579;;39;0.0;-40;0.0;1718445
455;Noord-Nederland (LD);2013 december;1718445;1249;1356;5726;5109;617;6083;5399;684;52.0;-412;-0.02;-452;-0.03;1718033
456;Noord-Nederland (LD);2013;1718485;15763;16113;80051;68127;11924;80205;70847;9358;52.0;-452;-0.03;-452;-0.03;1718033
457;Noord-Nederland (LD);2014 januari;1718033;1340;1311;6933;5789;1144;6931;6083;848;;31;0.0;31;0.0;1718064
458;Noord-Nederland (LD);2014 februari;1718064;1249;1267;6517;5465;1052;6702;5868;834;;-203;-0.01;-172;-0.01;1717861
459;Noord-Nederland (LD);2014 maart;1717861;1266;1387;5932;5176;756;6173;5401;772;;-362;-0.02;-534;-0.03;1717499
460;Noord-Nederland (LD);2014 april;1717499;1375;1258;5604;4795;809;5791;5122;669;;-70;0.0;-604;-0.04;1717429
461;Noord-Nederland (LD);2014 mei;1717429;1375;1241;5442;4704;738;5613;4935;678;;-37;0.0;-641;-0.04;1717392
462;Noord-Nederland (LD);2014 juni;1717392;1318;1207;5694;4974;720;6325;5361;964;;-520;-0.03;-1161;-0.07;1716872
463;Noord-Nederland (LD);2014 juli;1716872;1427;1342;8012;6978;1034;8486;7259;1227;;-389;-0.02;-1550;-0.09;1716483
464;Noord-Nederland (LD);2014 augustus;1716483;1406;1312;10451;8498;1953;9519;8444;1075;;1026;0.06;-524;-0.03;1717509
465;Noord-Nederland (LD);2014 september;1717509;1418;1189;10208;7455;2753;8724;7739;985;;1713;0.1;1189;0.07;1719222
466;Noord-Nederland (LD);2014 oktober;1719222;1345;1315;7535;5926;1609;7322;6455;867;;243;0.01;1432;0.08;1719465
467;Noord-Nederland (LD);2014 november;1719465;1232;1307;6313;5118;1195;6432;5766;666;;-194;-0.01;1238;0.07;1719271
468;Noord-Nederland (LD);2014 december;1719271;1275;1589;7110;5954;1156;7269;6400;869;-23.0;-496;-0.03;742;0.04;1718775
469;Noord-Nederland (LD);2014;1718033;16026;15725;85751;70832;14919;85287;74833;10454;-23.0;742;0.04;742;0.04;1718775
470;Noord-Nederland (LD);2015 januari;1718775;1351;1649;7686;6164;1522;7796;6823;973;;-408;-0.02;-408;-0.02;1718367
471;Noord-Nederland (LD);2015 februari;1718367;1138;1398;7535;6015;1520;7431;6677;754;;-156;-0.01;-564;-0.03;1718211
472;Noord-Nederland (LD);2015 maart;1718211;1228;1520;6916;5717;1199;7119;6408;711;;-495;-0.03;-1059;-0.06;1717716
473;Noord-Nederland (LD);2015 april;1717716;1199;1396;6158;5108;1050;6425;5754;671;;-464;-0.03;-1523;-0.09;1717252
474;Noord-Nederland (LD);2015 mei;1717252;1286;1319;5788;4967;821;5904;5439;465;;-149;-0.01;-1672;-0.1;1717103
475;Noord-Nederland (LD);2015 juni;1717103;1262;1285;6533;5366;1167;6809;5880;929;;-299;-0.02;-1971;-0.11;1716804
476;Noord-Nederland (LD);2015 juli;1716804;1350;1323;8684;7290;1394;9114;7944;1170;;-403;-0.02;-2374;-0.14;1716401
477;Noord-Nederland (LD);2015 augustus;1716401;1298;1291;11297;8582;2715;10010;9055;955;;1294;0.08;-1080;-0.06;1717695
478;Noord-Nederland (LD);2015 september;1717695;1383;1295;9924;7366;2558;9246;8129;1117;;766;0.04;-314;-0.02;1718461
479;Noord-Nederland (LD);2015 oktober;1718461;1302;1308;8093;6273;1820;7843;7040;803;;244;0.01;-70;0.0;1718705
480;Noord-Nederland (LD);2015 november;1718705;1287;1377;7204;5406;1798;7014;6387;627;;100;0.01;30;0.0;1718805
481;Noord-Nederland (LD);2015 december;1718805;1285;1354;7583;6163;1420;7944;7155;789;15.0;-415;-0.02;-385;-0.02;1718390
482;Noord-Nederland (LD);2015;1718775;15369;16515;93401;74417;18984;92655;82691;9964;15.0;-385;-0.02;-385;-0.02;1718390
483;Noord-Nederland (LD);2016 januari;1718390;1234;1607;8109;6143;1966;8065;7023;1042;;-329;-0.02;-329;-0.02;1718061
484;Noord-Nederland (LD);2016 februari;1718061;1284;1468;8511;6481;2030;8546;7535;1011;;-219;-0.01;-548;-0.03;1717842
485;Noord-Nederland (LD);2016 maart;1717842;1289;1544;7343;5949;1394;7687;6929;758;;-599;-0.03;-1147;-0.07;1717243
486;Noord-Nederland (LD);2016 april;1717243;1188;1405;7348;6187;1161;7406;6694;712;;-275;-0.02;-1422;-0.08;1716968
487;Noord-Nederland (LD);2016 mei;1716968;1336;1425;7455;5827;1628;7125;6527;598;;241;0.01;-1181;-0.07;1717209
488;Noord-Nederland (LD);2016 juni;1717209;1239;1280;8144;6301;1843;8079;7047;1032;;24;0.0;-1157;-0.07;1717233
489;Noord-Nederland (LD);2016 juli;1717233;1424;1329;9804;7998;1806;10004;8899;1105;;-105;-0.01;-1262;-0.07;1717128
490;Noord-Nederland (LD);2016 augustus;1717128;1472;1285;12611;9251;3360;11067;10104;963;;1731;0.1;469;0.03;1718859
491;Noord-Nederland (LD);2016 september;1718859;1404;1303;12469;8833;3636;10241;9393;848;;2329;0.14;2798;0.16;1721188
492;Noord-Nederland (LD);2016 oktober;1721188;1358;1399;9715;6851;2864;8837;8088;749;;837;0.05;3635;0.21;1722025
493;Noord-Nederland (LD);2016 november;1722025;1217;1443;9917;6612;3305;9284;8561;723;;407;0.02;4042;0.24;1722432
494;Noord-Nederland (LD);2016 december;1722432;1186;1465;10115;7073;3042;10003;9271;732;-18.0;-185;-0.01;3857;0.22;1722247
495;Noord-Nederland (LD);2016;1718390;15631;16953;111541;83506;28035;106344;96071;10273;-18.0;3857;0.22;3857;0.22;1722247
496;Noord-Nederland (LD);2017 januari;1722247;1240;1784;9375;7107;2268;9953;9071;882;;-1122;-0.07;-1122;-0.07;1721125
497;Noord-Nederland (LD);2017 februari;1721125;1113;1549;10833;7083;3750;10071;9235;836;;326;0.02;-796;-0.05;1721451
498;Noord-Nederland (LD);2017 maart;1721451;1270;1536;10237;7159;3078;10474;9721;753;;-503;-0.03;-1299;-0.08;1720948
499;Noord-Nederland (LD);2017 april;1720948;1213;1353;8488;5809;2679;8398;7778;620;;-50;0.0;-1349;-0.08;1720898
500;Noord-Nederland (LD);2017 mei;1720898;1297;1397;9208;6606;2602;9192;8530;662;;-84;0.0;-1433;-0.08;1720814
501;Noord-Nederland (LD);2017 juni;1720814;1260;1321;8233;6319;1914;9088;7902;1186;;-916;-0.05;-2349;-0.14;1719898
502;Noord-Nederland (LD);2017 juli;1719898;1345;1344;9791;7897;1894;10811;9387;1424;;-1019;-0.06;-3368;-0.2;1718879
503;Noord-Nederland (LD);2017 augustus;1718879;1384;1299;12898;9144;3754;11421;10402;1019;;1562;0.09;-1806;-0.1;1720441
504;Noord-Nederland (LD);2017 september;1720441;1280;1223;12247;8819;3428;10469;9606;863;;1835;0.11;29;0.0;1722276
505;Noord-Nederland (LD);2017 oktober;1722276;1318;1345;9541;7161;2380;9376;8500;876;;138;0.01;167;0.01;1722414
506;Noord-Nederland (LD);2017 november;1722414;1297;1435;8627;6584;2043;8559;7799;760;;-70;0.0;97;0.01;1722344
507;Noord-Nederland (LD);2017 december;1722344;1233;1544;8728;6804;1924;8394;7769;625;-55.0;-32;0.0;65;0.0;1722312
508;Noord-Nederland (LD);2017;1722247;15250;17130;118206;86492;31714;116206;105700;10506;-55.0;65;0.0;65;0.0;1722312
509;Noord-Nederland (LD);2018 januari;1722312;1245;1695;8412;6724;1688;8620;7754;866;;-658;-0.04;-658;-0.04;1721654
510;Noord-Nederland (LD);2018 februari;1721654;1116;1672;8526;6368;2158;8132;7322;810;;-162;-0.01;-820;-0.05;1721492
511;Noord-Nederland (LD);2018 maart;1721492;1144;1878;8450;6614;1836;8351;7690;661;;-635;-0.04;-1455;-0.08;1720857
512;Noord-Nederland (LD);2018 april;1720857;1200;1399;7196;5593;1603;7103;6491;612;;-106;-0.01;-1561;-0.09;1720751
513;Noord-Nederland (LD);2018 mei;1720751;1273;1344;7638;5867;1771;7327;6742;585;;240;0.01;-1321;-0.08;1720991
514;Noord-Nederland (LD);2018 juni;1720991;1167;1253;7509;6064;1445;8313;7181;1132;;-890;-0.05;-2211;-0.13;1720101
515;Noord-Nederland (LD);2018 juli;1720101;1322;1417;9348;7435;1913;9895;8476;1419;;-642;-0.04;-2853;-0.17;1719459
516;Noord-Nederland (LD);2018 augustus;1719459;1316;1302;12719;9017;3702;10509;9563;946;;2224;0.13;-629;-0.04;1721683
517;Noord-Nederland (LD);2018 september;1721683;1317;1263;10737;7854;2883;9084;8184;900;;1707;0.1;1078;0.06;1723390
518;Noord-Nederland (LD);2018 oktober;1723390;1272;1387;8840;7030;1810;8252;7434;818;;473;0.03;1551;0.09;1723863
519;Noord-Nederland (LD);2018 november;1723863;1198;1338;7967;6411;1556;7713;7021;692;;114;0.01;1665;0.1;1723977
520;Noord-Nederland (LD);2018 december;1723977;1134;1468;7234;6000;1234;7044;6419;625;-4.0;-148;-0.01;1517;0.09;1723829
521;Noord-Nederland (LD);2018;1722312;14704;17416;104576;80977;23599;100343;90277;10066;-4.0;1517;0.09;1517;0.09;1723829
522;Noord-Nederland (LD);2019 januari;1723829;1243;1527;8107;6539;1568;8252;7185;1067;;-429;-0.02;-429;-0.02;1723400
523;Noord-Nederland (LD);2019 februari;1723400;1102;1349;8176;6115;2061;7539;6613;926;;390;0.02;-39;0.0;1723790
524;Noord-Nederland (LD);2019 maart;1723790;1207;1576;7633;6203;1430;7305;6621;684;;-41;0.0;-80;0.0;1723749
525;Noord-Nederland (LD);2019 april;1723749;1198;1408;7031;5733;1298;6882;6255;627;;-61;0.0;-141;-0.01;1723688
526;Noord-Nederland (LD);2019 mei;1723688;1264;1374;7055;5837;1218;6956;6347;609;;-11;0.0;-152;-0.01;1723677
527;Noord-Nederland (LD);2019 juni;1723677;1266;1357;7122;5461;1661;6938;5882;1056;;93;0.01;-59;0.0;1723770
528;Noord-Nederland (LD);2019 juli;1723770;1362;1396;9739;7624;2115;9760;8227;1533;;-55;0.0;-114;-0.01;1723715
529;Noord-Nederland (LD);2019 augustus;1723715;1432;1372;12171;8269;3902;9780;8717;1063;;2451;0.14;2337;0.14;1726166
530;Noord-Nederland (LD);2019 september;1726166;1350;1236;10997;7460;3537;8686;7815;871;;2425;0.14;4762;0.28;1728591
531;Noord-Nederland (LD);2019 oktober;1728591;1324;1360;8621;6561;2060;7772;7099;673;;813;0.05;5575;0.32;1729404
532;Noord-Nederland (LD);2019 november;1729404;1217;1473;7788;6250;1538;7336;6599;737;;196;0.01;5771;0.33;1729600
533;Noord-Nederland (LD);2019 december;1729600;1144;1471;7588;6115;1473;7328;6592;736;-28.0;-95;-0.01;5676;0.33;1729505
534;Noord-Nederland (LD);2019;1723829;15109;16899;102028;78167;23861;94534;83952;10582;-28.0;5676;0.33;5676;0.33;1729505
535;Noord-Nederland (LD);2020 januari;1729505;1263;1635;8775;6910;1865;8662;7602;1060;;-259;-0.01;-259;-0.01;1729246
536;Noord-Nederland (LD);2020 februari;1729246;1112;1400;8895;6582;2313;8094;7249;845;;513;0.03;254;0.01;1729759
537;Noord-Nederland (LD);2020 maart;1729759;1170;1571;7144;6067;1077;7268;6359;909;;-525;-0.03;-271;-0.02;1729234
538;Noord-Nederland (LD);2020 april;1729234;1237;1581;5920;5460;460;6158;5632;526;;-582;-0.03;-853;-0.05;1728652
539;Noord-Nederland (LD);2020 mei;1728652;1175;1339;6506;6033;473;6641;6023;618;;-299;-0.02;-1152;-0.07;1728353
540;Noord-Nederland (LD);2020 juni;1728353;1221;1348;7023;6066;957;7061;6174;887;;-165;-0.01;-1317;-0.08;1728188
541;Noord-Nederland (LD);2020 juli;1728188;1333;1312;9008;7656;1352;9256;7790;1466;;-227;-0.01;-1544;-0.09;1727961
542;Noord-Nederland (LD);2020 augustus;1727961;1296;1400;10474;7826;2648;8688;7793;895;;1682;0.1;138;0.01;1729643
543;Noord-Nederland (LD);2020 september;1729643;1380;1382;9708;7041;2667;7849;7052;797;;1857;0.11;1995;0.12;1731500
544;Noord-Nederland (LD);2020 oktober;1731500;1315;1521;9309;7385;1924;8230;7378;852;;873;0.05;2868;0.17;1732373
545;Noord-Nederland (LD);2020 november;1732373;1242;1515;8200;6257;1943;7385;6700;685;;542;0.03;3410;0.2;1732915
546;Noord-Nederland (LD);2020 december;1732915;1188;1716;8646;6879;1767;7873;7193;680;-17.0;228;0.01;3638;0.21;1733143
547;Noord-Nederland (LD);2020;1729505;14932;17720;99608;80162;19446;93165;82945;10220;-17.0;3638;0.21;3638;0.21;1733143
548;Noord-Nederland (LD);2021 januari;1733143;1281;1993;8210;6964;1246;7961;7241;720;0.0;-463;-0.03;-463;-0.03;1732680
549;Noord-Nederland (LD);2021 februari;1732680;1204;1658;7869;6467;1402;7464;6798;666;0.0;-49;0.0;-512;-0.03;1732631
550;Noord-Nederland (LD);2021 maart;1732631;1317;1583;9379;7555;1824;8489;7703;786;0.0;624;0.04;112;0.01;1733255
551;Noord-Nederland (LD);2021 april;1733255;1340;1476;8639;6825;1814;7504;6969;535;0.0;999;0.06;1111;0.06;1734254
552;Noord-Nederland (LD);2021 mei;1734254;1347;1455;7894;6226;1668;7145;6523;622;0.0;641;0.04;1752;0.1;1734895
553;Noord-Nederland (LD);2021 juni;1734895;1295;1434;8098;6375;1723;7548;6731;817;0.0;411;0.02;2163;0.12;1735306
554;Noord-Nederland (LD);2021 juli;1735306;1452;1340;9852;7340;2512;9000;7767;1233;0.0;964;0.06;3127;0.18;1736270
555;Noord-Nederland (LD);2021 augustus;1736270;1380;1366;11333;7633;3700;9518;8420;1098;0.0;1829;0.11;4956;0.29;1738099
556;Noord-Nederland (LD);2021 september;1738099;1431;1422;12241;7117;5124;8810;7976;834;0.0;3440;0.2;8396;0.48;1741539
557;Noord-Nederland (LD);2021 oktober;1741539;1416;1602;9525;6842;2683;8221;7406;815;0.0;1118;0.06;9514;0.55;1742657
558;Noord-Nederland (LD);2021 november;1742657;1369;1811;8657;6359;2298;8297;7517;780;0.0;-82;0.0;9432;0.54;1742575
559;Noord-Nederland (LD);2021 december;1742575;1236;2006;8062;6267;1795;7945;7134;811;10.0;-643;-0.04;8789;0.51;1741932
560;Noord-Nederland (LD);2021;1733143;16068;19146;109759;81970;27789;97902;88185;9717;10.0;8789;0.51;8789;0.51;1741932
561;Noord-Nederland (LD);2022 januari;1741932;1255;1624;8378;6405;1973;7815;6968;847;;194;0.01;194;0.01;1742126
562;Noord-Nederland (LD);2022 februari;1742126;1147;1455;8533;5730;2803;7478;6633;845;;747;0.04;941;0.05;1742873
563;Noord-Nederland (LD);2022 maart;1742873;1170;1746;11336;6180;5156;8092;7427;665;;2668;0.15;3609;0.21;1745541
564;Noord-Nederland (LD);2022 april;1745541;1202;1677;11410;6447;4963;7880;7258;622;;3055;0.18;6664;0.38;1748596
565;Noord-Nederland (LD);2022 mei;1748596;1169;1580;9386;6081;3305;7685;6911;774;;1290;0.07;7954;0.46;1749886
566;Noord-Nederland (LD);2022 juni;1749886;1211;1482;9477;5836;3641;8112;6898;1214;;1094;0.06;9048;0.52;1750980
567;Noord-Nederland (LD);2022 juli;1750980;1380;1578;10735;7067;3668;9296;7689;1607;;1241;0.07;10289;0.59;1752221
568;Noord-Nederland (LD);2022 augustus;1752221;1268;1547;12971;7517;5454;10067;8567;1500;;2625;0.15;12914;0.74;1754846
569;Noord-Nederland (LD);2022 september;1754846;1402;1431;12255;7440;4815;9806;8492;1314;;2420;0.14;15334;0.88;1757266
570;Noord-Nederland (LD);2022 oktober;1757266;1312;1626;9371;6755;2616;8486;7502;984;;571;0.03;15905;0.91;1757837
571;Noord-Nederland (LD);2022 november;1757837;1169;1618;8939;6450;2489;8230;7177;1053;;260;0.01;16165;0.93;1758097
572;Noord-Nederland (LD);2022 december;1758097;1146;1956;8556;6712;1844;8138;7185;953;-28.0;-420;-0.02;15745;0.9;1757677
573;Noord-Nederland (LD);2022;1741932;14831;19320;121347;78620;42727;101085;88707;12378;-28.0;15745;0.9;15745;0.9;1757677
574;Noord-Nederland (LD);2023 januari;1757677;1197;1830;9295;6919;2376;8895;7534;1361;0.0;-233;-0.01;-233;-0.01;1757444
575;Noord-Nederland (LD);2023 februari;1757444;1086;1548;9439;6334;3105;8407;7010;1397;0.0;570;0.03;337;0.02;1758014
576;Noord-Nederland (LD);2023 maart;1758014;1204;1753;9555;6654;2901;8395;7299;1096;0.0;611;0.03;948;0.05;1758625
577;Noord-Nederland (LD);2023 april;1758625;1164;1506;8037;5851;2186;7320;6438;882;0.0;375;0.02;1323;0.08;1759000
578;Noord-Nederland (LD);2023 mei;1759000;1249;1456;8684;6292;2392;8079;7132;947;0.0;398;0.02;1721;0.1;1759398
579;Noord-Nederland (LD);2023 juni;1759398;1215;1510;9547;7027;2520;8749;7544;1205;0.0;503;0.03;2224;0.13;1759901
580;Noord-Nederland (LD);2023 juli;1759901;1331;1473;11167;8234;2933;10837;8930;1907;0.0;188;0.01;2412;0.14;1760089
581;Noord-Nederland (LD);2023 augustus;1760089;1255;1362;14302;9132;5170;11005;9564;1441;0.0;3190;0.18;5602;0.32;1763279
582;Noord-Nederland (LD);2023 september;1763279;1243;1443;13108;8144;4964;9544;8417;1127;0.0;3364;0.19;8966;0.51;1766643
583;Noord-Nederland (LD);2023 oktober;1766643;1216;1643;9808;6655;3153;8864;7821;1043;0.0;517;0.03;9483;0.54;1767160
584;Noord-Nederland (LD);2023 november;1767160;1221;1634;9410;6367;3043;8610;7528;1082;0.0;387;0.02;9870;0.56;1767547
585;Noord-Nederland (LD);2023 december;1767547;1201;1849;8661;6314;2347;8185;7136;1049;5.0;-167;-0.01;9703;0.55;1767380
586;Noord-Nederland (LD);2023;1757677;14582;19007;121013;83923;37090;106890;92353;14537;5.0;9703;0.55;9703;0.55;1767380
587;Noord-Nederland (LD);2024 januari;1767380;1169;1953;9365;6651;2714;9098;7622;1476;;-517;-0.03;-517;-0.03;1766863
588;Noord-Nederland (LD);2024 februari;1766863;1097;1665;9685;6315;3370;8640;7380;1260;;477;0.03;-40;0.0;1767340
589;Noord-Nederland (LD);2024 maart;1767340;1096;1656;9087;6408;2679;8457;7416;1041;;70;0.0;30;0.0;1767410
590;Noord-Nederland (LD);2024 april;1767410;1160;1620;8712;5980;2732;8176;7215;961;;76;0.0;106;0.01;1767486
591;Noord-Nederland (LD);2024 mei;1767486;1261;1598;8272;5777;2495;7830;7080;750;;105;0.01;211;0.01;1767591
592;Noord-Nederland (LD);2024 juni;1767591;1217;1577;8657;5955;2702;8284;6999;1285;;13;0.0;224;0.01;1767604
593;Noord-Nederland (LD);2024 juli;1767604;1300;1584;10681;7432;3249;10571;8601;1970;;-174;-0.01;50;0.0;1767430
594;Noord-Nederland (LD);2024 augustus;1767430;1248;1534;13297;8196;5101;10095;8692;1403;;2916;0.16;2966;0.17;1770346
595;Noord-Nederland (LD);2024 september;1770346;1286;1505;13153;7984;5169;9848;8617;1231;;3086;0.17;6052;0.34;1773432
596;Noord-Nederland (LD);2024 oktober;1773432;1205;1597;10079;6800;3279;9014;7846;1168;;673;0.04;6725;0.38;1774105
597;Noord-Nederland (LD);2024 november;1774105;1210;1548;9260;6592;2668;8623;7660;963;;299;0.02;7024;0.4;1774404
598;Noord-Nederland (LD);2024 december;1774404;1211;1635;8577;6351;2226;8455;7539;916;0.0;-302;-0.02;6722;0.38;1774102
599;Noord-Nederland (LD);2024;1767380;14460;19472;118825;80441;38384;107091;92667;14424;0.0;6722;0.38;6722;0.38;1774102
600;Noord-Nederland (LD);2025 januari;1774102;1209;1932;9887;6876;3011;9688;8249;1439;;-524;-0.03;-524;-0.03;1773578
601;Noord-Nederland (LD);2025 februari;1773578;1100;1860;9806;6490;3316;8753;7479;1274;;293;0.02;-231;-0.01;1773871
602;Oost-Nederland (LD);2002 januari;3384986;3798;2664;12974;11086;1888;11244;10109;1135;;2864;0.08;2864;0.08;3387850
603;Oost-Nederland (LD);2002 februari;3387850;3356;2350;11026;9604;1422;10155;8996;1159;;1877;0.06;4741;0.14;3389727
604;Oost-Nederland (LD);2002 maart;3389727;3727;2606;11637;9963;1674;10753;9498;1255;;2005;0.06;6746;0.2;3391732
605;Oost-Nederland (LD);2002 april;3391732;3613;2541;11005;9292;1713;9960;8844;1116;;2117;0.06;8863;0.26;3393849
606;Oost-Nederland (LD);2002 mei;3393849;3691;2409;11371;9899;1472;10435;9270;1165;;2218;0.07;11081;0.33;3396067
607;Oost-Nederland (LD);2002 juni;3396067;3549;2302;11257;9601;1656;10296;9084;1212;;2208;0.07;13289;0.39;3398275
608;Oost-Nederland (LD);2002 juli;3398275;3894;2337;14386;12730;1656;13950;12392;1558;;1993;0.06;15282;0.45;3400268
609;Oost-Nederland (LD);2002 augustus;3400268;3954;2270;15664;13310;2354;14387;12945;1442;;2961;0.09;18243;0.54;3403229
610;Oost-Nederland (LD);2002 september;3403229;3893;2161;14347;11861;2486;13153;11669;1484;;2926;0.09;21169;0.63;3406155
611;Oost-Nederland (LD);2002 oktober;3406155;3963;2374;13295;11127;2168;12292;10680;1612;;2592;0.08;23761;0.7;3408747
612;Oost-Nederland (LD);2002 november;3408747;3650;2347;11459;10110;1349;11158;9736;1422;;1604;0.05;25365;0.75;3410351
613;Oost-Nederland (LD);2002 december;3410351;3748;2690;10704;9598;1106;10186;8863;1323;852.0;2428;0.07;27793;0.82;3412779
614;Oost-Nederland (LD);2002;3384986;44836;29051;149125;128181;20944;137969;122086;15883;852.0;27793;0.82;27793;0.82;3412779
615;Oost-Nederland (LD);2003 januari;3412779;3852;2717;12637;11322;1315;12238;10887;1351;;1534;0.04;1534;0.04;3414313
616;Oost-Nederland (LD);2003 februari;3414313;3518;2329;10587;9259;1328;10069;8887;1182;;1707;0.05;3241;0.09;3416020
617;Oost-Nederland (LD);2003 maart;3416020;3796;2663;10859;9586;1273;10609;9219;1390;;1383;0.04;4624;0.14;3417403
618;Oost-Nederland (LD);2003 april;3417403;3608;2524;10191;9064;1127;9984;8631;1353;;1291;0.04;5915;0.17;3418694
619;Oost-Nederland (LD);2003 mei;3418694;3654;2346;10316;9180;1136;10108;8623;1485;;1516;0.04;7431;0.22;3420210
620;Oost-Nederland (LD);2003 juni;3420210;3512;2330;11263;10094;1169;10925;9521;1404;;1520;0.04;8951;0.26;3421730
621;Oost-Nederland (LD);2003 juli;3421730;3937;2290;14003;12657;1346;13397;11675;1722;;2253;0.07;11204;0.33;3423983
622;Oost-Nederland (LD);2003 augustus;3423983;3892;2411;14513;12541;1972;13956;12463;1493;;2038;0.06;13242;0.39;3426021
623;Oost-Nederland (LD);2003 september;3426021;3872;2305;14329;12201;2128;14015;12304;1711;;1881;0.05;15123;0.44;3427902
624;Oost-Nederland (LD);2003 oktober;3427902;3886;2296;12835;11202;1633;12661;11171;1490;;1764;0.05;16887;0.49;3429666
625;Oost-Nederland (LD);2003 november;3429666;3659;2359;10865;9713;1152;10689;9397;1292;;1476;0.04;18363;0.54;3431142
626;Oost-Nederland (LD);2003 december;3431142;3394;2812;11672;10614;1058;11690;10074;1616;639.0;1203;0.04;19566;0.57;3432345
627;Oost-Nederland (LD);2003;3412779;44580;29382;144070;127433;16637;140341;122852;17489;639.0;19566;0.57;19566;0.57;3432345
628;Oost-Nederland (LD);2004 januari;3432345;3578;2749;11318;10304;1014;11305;9807;1498;;842;0.02;842;0.02;3433187
629;Oost-Nederland (LD);2004 februari;3433187;3274;2351;10194;9282;912;10823;9034;1789;;294;0.01;1136;0.03;3433481
630;Oost-Nederland (LD);2004 maart;3433481;3606;2507;11347;10276;1071;11523;9889;1634;;923;0.03;2059;0.06;3434404
631;Oost-Nederland (LD);2004 april;3434404;3519;2260;10006;9100;906;10064;8802;1262;;1201;0.03;3260;0.09;3435605
632;Oost-Nederland (LD);2004 mei;3435605;3394;2191;9564;8581;983;9275;8190;1085;;1492;0.04;4752;0.14;3437097
633;Oost-Nederland (LD);2004 juni;3437097;3655;2164;11473;10262;1211;11286;9864;1422;;1678;0.05;6430;0.19;3438775
634;Oost-Nederland (LD);2004 juli;3438775;3739;2162;13678;12482;1196;13499;11802;1697;;1756;0.05;8186;0.24;3440531
635;Oost-Nederland (LD);2004 augustus;3440531;3781;2292;14691;12928;1763;14758;12960;1798;;1422;0.04;9608;0.28;3441953
636;Oost-Nederland (LD);2004 september;3441953;3521;2108;14184;12309;1875;14166;12526;1640;;1431;0.04;11039;0.32;3443384
637;Oost-Nederland (LD);2004 oktober;3443384;3665;2299;11793;10365;1428;12116;10223;1893;;1043;0.03;12082;0.35;3444427
638;Oost-Nederland (LD);2004 november;3444427;3472;2234;11192;10164;1028;11569;9960;1609;;861;0.02;12943;0.38;3445288
639;Oost-Nederland (LD);2004 december;3445288;3431;2493;11053;10173;880;11049;9689;1360;1071.0;2013;0.06;14956;0.44;3447301
640;Oost-Nederland (LD);2004;3432345;42635;27810;140493;126226;14267;141433;122746;18687;1071.0;14956;0.44;14956;0.44;3447301
641;Oost-Nederland (LD);2005 januari;3447301;3423;2603;11655;10554;1101;11400;9856;1544;;1075;0.03;1075;0.03;3448376
642;Oost-Nederland (LD);2005 februari;3448376;3297;2503;10273;9292;981;10097;8905;1192;;970;0.03;2045;0.06;3449346
643;Oost-Nederland (LD);2005 maart;3449346;3505;2851;11151;10116;1035;10976;9618;1358;;829;0.02;2874;0.08;3450175
644;Oost-Nederland (LD);2005 april;3450175;3423;2265;10618;9637;981;10865;9264;1601;;911;0.03;3785;0.11;3451086
645;Oost-Nederland (LD);2005 mei;3451086;3449;2391;9910;9075;835;9595;8602;993;;1373;0.04;5158;0.15;3452459
646;Oost-Nederland (LD);2005 juni;3452459;3436;2213;10766;9753;1013;10997;9582;1415;;992;0.03;6150;0.18;3453451
647;Oost-Nederland (LD);2005 juli;3453451;3589;2165;13258;12038;1220;13419;11566;1853;;1263;0.04;7413;0.22;3454714
648;Oost-Nederland (LD);2005 augustus;3454714;3681;2125;15764;13891;1873;15833;13947;1886;;1487;0.04;8900;0.26;3456201
649;Oost-Nederland (LD);2005 september;3456201;3522;2047;15288;13258;2030;15318;13493;1825;;1445;0.04;10345;0.3;3457646
650;Oost-Nederland (LD);2005 oktober;3457646;3621;2190;12592;11259;1333;12716;11187;1529;;1307;0.04;11652;0.34;3458953
651;Oost-Nederland (LD);2005 november;3458953;3242;2204;11471;10380;1091;12151;10336;1815;;358;0.01;12010;0.35;3459311
652;Oost-Nederland (LD);2005 december;3459311;3246;2484;11196;10383;813;11909;10000;1909;529.0;578;0.02;12588;0.37;3459889
653;Oost-Nederland (LD);2005;3447301;41434;28041;143942;129636;14306;145276;126356;18920;529.0;12588;0.37;12588;0.37;3459889
654;Oost-Nederland (LD);2006 januari;3459889;3459;2475;12519;11365;1154;12489;10989;1500;;1014;0.03;1014;0.03;3460903
655;Oost-Nederland (LD);2006 februari;3460903;3167;2333;10896;9931;965;11318;9830;1488;;412;0.01;1426;0.04;3461315
656;Oost-Nederland (LD);2006 maart;3461315;3489;2598;11691;10644;1047;12315;10598;1717;;267;0.01;1693;0.05;3461582
657;Oost-Nederland (LD);2006 april;3461582;3185;2369;10100;9115;985;10415;8982;1433;;501;0.01;2194;0.06;3462083
658;Oost-Nederland (LD);2006 mei;3462083;3488;2261;10689;9672;1017;11155;9556;1599;;761;0.02;2955;0.09;3462844
659;Oost-Nederland (LD);2006 juni;3462844;3344;2183;10874;9804;1070;11314;9751;1563;;721;0.02;3676;0.11;3463565
660;Oost-Nederland (LD);2006 juli;3463565;3543;2543;13819;12472;1347;13800;11853;1947;;1019;0.03;4695;0.14;3464584
661;Oost-Nederland (LD);2006 augustus;3464584;3599;2143;16316;14445;1871;16639;14599;2040;;1133;0.03;5828;0.17;3465717
662;Oost-Nederland (LD);2006 september;3465717;3618;2149;15141;12833;2308;15027;13062;1965;;1583;0.05;7411;0.21;3467300
663;Oost-Nederland (LD);2006 oktober;3467300;3575;2091;12119;10782;1337;12730;10958;1772;;873;0.03;8284;0.24;3468173
664;Oost-Nederland (LD);2006 november;3468173;3355;2239;11776;10695;1081;12552;10871;1681;;340;0.01;8624;0.25;3468513
665;Oost-Nederland (LD);2006 december;3468513;3237;2390;10502;9637;865;10821;9353;1468;816.0;1344;0.04;9968;0.29;3469857
666;Oost-Nederland (LD);2006;3459889;41059;27774;146442;131395;15047;150575;130402;20173;816.0;9968;0.29;9968;0.29;3469857
667;Oost-Nederland (LD);2007 januari;3469857;3375;2463;12574;11188;1386;12862;10896;1966;;624;0.02;624;0.02;3470481
668;Oost-Nederland (LD);2007 februari;3470481;3039;2289;10756;9532;1224;10687;9600;1087;;819;0.02;1443;0.04;3471300
669;Oost-Nederland (LD);2007 maart;3471300;3373;2406;11212;10067;1145;11329;9987;1342;;850;0.02;2293;0.07;3472150
670;Oost-Nederland (LD);2007 april;3472150;3086;2272;9500;8552;948;9788;8406;1382;;526;0.02;2819;0.08;3472676
671;Oost-Nederland (LD);2007 mei;3472676;3287;2255;10723;9603;1120;10583;9266;1317;;1172;0.03;3991;0.12;3473848
672;Oost-Nederland (LD);2007 juni;3473848;3204;2110;11366;10136;1230;11647;10114;1533;;813;0.02;4804;0.14;3474661
673;Oost-Nederland (LD);2007 juli;3474661;3536;2119;14199;12647;1552;14447;12647;1800;;1169;0.03;5973;0.17;3475830
674;Oost-Nederland (LD);2007 augustus;3475830;3576;2070;16805;14525;2280;16485;14611;1874;;1826;0.05;7799;0.22;3477656
675;Oost-Nederland (LD);2007 september;3477656;3519;1998;14396;12163;2233;13901;12322;1579;;2016;0.06;9815;0.28;3479672
676;Oost-Nederland (LD);2007 oktober;3479672;3402;2254;12911;11335;1576;13091;11286;1805;;968;0.03;10783;0.31;3480640
677;Oost-Nederland (LD);2007 november;3480640;3178;2263;11867;10671;1196;12157;10532;1625;;625;0.02;11408;0.33;3481265
678;Oost-Nederland (LD);2007 december;3481265;3203;2538;10256;9302;954;10367;8964;1403;732.0;1286;0.04;12694;0.37;3482551
679;Oost-Nederland (LD);2007;3469857;39778;27037;146565;129721;16844;147344;128631;18713;732.0;12694;0.37;12694;0.37;3482551
680;Oost-Nederland (LD);2008 januari;3482551;3184;2633;13310;11728;1582;12986;11545;1441;;875;0.03;875;0.03;3483426
681;Oost-Nederland (LD);2008 februari;3483426;3178;2322;11603;10079;1524;10948;9729;1219;;1511;0.04;2386;0.07;3484937
682;Oost-Nederland (LD);2008 maart;3484937;3248;2411;10797;9426;1371;10544;9283;1261;;1090;0.03;3476;0.1;3486027
683;Oost-Nederland (LD);2008 april;3486027;3255;2331;11451;9987;1464;11247;9750;1497;;1128;0.03;4604;0.13;3487155
684;Oost-Nederland (LD);2008 mei;3487155;3369;2331;10181;8857;1324;9902;8712;1190;;1317;0.04;5921;0.17;3488472
685;Oost-Nederland (LD);2008 juni;3488472;3413;2107;11501;10076;1425;11445;9969;1476;;1362;0.04;7283;0.21;3489834
686;Oost-Nederland (LD);2008 juli;3489834;3686;2220;14746;12848;1898;14594;12437;2157;;1618;0.05;8901;0.26;3491452
687;Oost-Nederland (LD);2008 augustus;3491452;3527;2080;16125;13780;2345;15544;13665;1879;;2028;0.06;10929;0.31;3493480
688;Oost-Nederland (LD);2008 september;3493480;3537;2068;15561;12653;2908;14698;13159;1539;;2332;0.07;13261;0.38;3495812
689;Oost-Nederland (LD);2008 oktober;3495812;3463;2264;13142;11172;1970;13004;11435;1569;;1337;0.04;14598;0.42;3497149
690;Oost-Nederland (LD);2008 november;3497149;3149;2210;10821;9278;1543;10668;9492;1176;;1092;0.03;15690;0.45;3498241
691;Oost-Nederland (LD);2008 december;3498241;3198;2454;11550;10197;1353;11411;10022;1389;822.0;1705;0.05;17395;0.5;3499946
692;Oost-Nederland (LD);2008;3482551;40207;27431;150788;130081;20707;146991;129198;17793;822.0;17395;0.5;17395;0.5;3499946
693;Oost-Nederland (LD);2009 januari;3499946;3327;3044;11900;10133;1767;11319;9939;1380;;864;0.02;864;0.02;3500810
694;Oost-Nederland (LD);2009 februari;3500810;3009;2409;11036;9341;1695;10486;9247;1239;;1150;0.03;2014;0.06;3501960
695;Oost-Nederland (LD);2009 maart;3501960;3428;2302;11302;9672;1630;11070;9567;1503;;1358;0.04;3372;0.1;3503318
696;Oost-Nederland (LD);2009 april;3503318;3331;2330;9675;8287;1388;9336;8330;1006;;1340;0.04;4712;0.13;3504658
697;Oost-Nederland (LD);2009 mei;3504658;3189;2163;9440;8058;1382;8915;7973;942;;1551;0.04;6263;0.18;3506209
698;Oost-Nederland (LD);2009 juni;3506209;3366;2103;10735;9121;1614;10275;8908;1367;;1723;0.05;7986;0.23;3507932
699;Oost-Nederland (LD);2009 juli;3507932;3577;2144;13918;11801;2117;13379;11552;1827;;1972;0.06;9958;0.28;3509904
700;Oost-Nederland (LD);2009 augustus;3509904;3508;2081;14359;11725;2634;14154;12501;1653;;1632;0.05;11590;0.33;3511536
701;Oost-Nederland (LD);2009 september;3511536;3528;2104;14563;11773;2790;13900;12496;1404;;2087;0.06;13677;0.39;3513623
702;Oost-Nederland (LD);2009 oktober;3513623;3269;2324;11990;9838;2152;11722;10108;1614;;1213;0.03;14890;0.43;3514836
703;Oost-Nederland (LD);2009 november;3514836;3238;2229;10587;8901;1686;10502;9056;1446;;1094;0.03;15984;0.46;3515930
704;Oost-Nederland (LD);2009 december;3515930;3132;2443;10611;9346;1265;10593;9250;1343;525.0;1232;0.04;17216;0.49;3517162
705;Oost-Nederland (LD);2009;3499946;39902;27676;140116;117996;22120;135651;118927;16724;525.0;17216;0.49;17216;0.49;3517162
706;Oost-Nederland (LD);2010 januari;3517162;3236;2439;11482;9901;1581;11549;9850;1699;;730;0.02;730;0.02;3517892
707;Oost-Nederland (LD);2010 februari;3517892;3024;2421;10868;9186;1682;10587;9406;1181;;884;0.03;1614;0.05;3518776
708;Oost-Nederland (LD);2010 maart;3518776;3341;2496;11132;9518;1614;11131;9610;1521;;846;0.02;2460;0.07;3519622
709;Oost-Nederland (LD);2010 april;3519622;3164;2263;9718;8261;1457;9974;8390;1584;;645;0.02;3105;0.09;3520267
710;Oost-Nederland (LD);2010 mei;3520267;3239;2447;9543;8105;1438;8913;7850;1063;;1422;0.04;4527;0.13;3521689
711;Oost-Nederland (LD);2010 juni;3521689;3271;2242;10593;8789;1804;10053;8786;1267;;1569;0.04;6096;0.17;3523258
712;Oost-Nederland (LD);2010 juli;3523258;3437;2293;13129;11005;2124;13130;11147;1983;;1143;0.03;7239;0.21;3524401
713;Oost-Nederland (LD);2010 augustus;3524401;3445;2204;15387;12272;3115;14678;12965;1713;;1950;0.06;9189;0.26;3526351
714;Oost-Nederland (LD);2010 september;3526351;3372;2170;14841;11718;3123;15111;12112;2999;;932;0.03;10121;0.29;3527283
715;Oost-Nederland (LD);2010 oktober;3527283;3502;2332;11635;9461;2174;10971;9521;1450;;1834;0.05;11955;0.34;3529117
716;Oost-Nederland (LD);2010 november;3529117;3340;2238;10984;9343;1641;10868;9492;1376;;1218;0.03;13173;0.37;3530335
717;Oost-Nederland (LD);2010 december;3530335;3261;2570;10939;9486;1453;10697;9241;1456;-165.0;768;0.02;13941;0.4;3531103
718;Oost-Nederland (LD);2010;3517162;39632;28115;140251;117045;23206;137662;118370;19292;-165.0;13941;0.4;13941;0.4;3531103
719;Oost-Nederland (LD);2011 januari;3531103;3195;2517;11723;9881;1842;11425;9811;1614;;976;0.03;976;0.03;3532079
720;Oost-Nederland (LD);2011 februari;3532079;3042;2229;10958;9171;1787;10437;9108;1329;;1334;0.04;2310;0.07;3533413
721;Oost-Nederland (LD);2011 maart;3533413;3173;2419;11068;9293;1775;10707;9129;1578;;1115;0.03;3425;0.1;3534528
722;Oost-Nederland (LD);2011 april;3534528;2902;2333;9667;8174;1493;9741;8291;1450;;495;0.01;3920;0.11;3535023
723;Oost-Nederland (LD);2011 mei;3535023;3189;2333;9807;8279;1528;9800;8373;1427;;863;0.02;4783;0.14;3535886
724;Oost-Nederland (LD);2011 juni;3535886;3322;2154;10310;8655;1655;10024;8559;1465;;1454;0.04;6237;0.18;3537340
725;Oost-Nederland (LD);2011 juli;3537340;3272;2283;12887;10896;1991;12861;10697;2164;;1015;0.03;7252;0.21;3538355
726;Oost-Nederland (LD);2011 augustus;3538355;3468;2218;16363;12867;3496;15485;13492;1993;;2128;0.06;9380;0.27;3540483
727;Oost-Nederland (LD);2011 september;3540483;3216;2172;15119;12156;2963;14286;12526;1760;;1877;0.05;11257;0.32;3542360
728;Oost-Nederland (LD);2011 oktober;3542360;3287;2334;11493;9384;2109;11492;9747;1745;;954;0.03;12211;0.35;3543314
729;Oost-Nederland (LD);2011 november;3543314;3122;2424;11028;9306;1722;11665;9694;1971;;61;0.0;12272;0.35;3543375
730;Oost-Nederland (LD);2011 december;3543375;3110;2566;10668;9202;1466;10694;9130;1564;45.0;563;0.02;12835;0.36;3543938
731;Oost-Nederland (LD);2011;3531103;38298;27982;141091;117264;23827;138617;118557;20060;45.0;12835;0.36;12835;0.36;3543938
732;Oost-Nederland (LD);2012 januari;3543938;3082;2524;12448;10691;1757;12452;10676;1776;;554;0.02;554;0.02;3544492
733;Oost-Nederland (LD);2012 februari;3544492;2944;2594;11793;9873;1920;11351;9874;1477;;792;0.02;1346;0.04;3545284
734;Oost-Nederland (LD);2012 maart;3545284;3101;2506;11044;9401;1643;11064;9549;1515;;575;0.02;1921;0.05;3545859
735;Oost-Nederland (LD);2012 april;3545859;3039;2469;9371;8171;1200;9591;8187;1404;;350;0.01;2271;0.06;3546209
736;Oost-Nederland (LD);2012 mei;3546209;3160;2454;9977;8629;1348;10039;8595;1444;;644;0.02;2915;0.08;3546853
737;Oost-Nederland (LD);2012 juni;3546853;3039;2284;11773;10197;1576;11634;9999;1635;;894;0.03;3809;0.11;3547747
738;Oost-Nederland (LD);2012 juli;3547747;3274;2357;13706;11711;1995;13996;11848;2148;;627;0.02;4436;0.13;3548374
739;Oost-Nederland (LD);2012 augustus;3548374;3356;2212;16721;13400;3321;16126;14143;1983;;1739;0.05;6175;0.17;3550113
740;Oost-Nederland (LD);2012 september;3550113;3157;2262;14300;11500;2800;13631;12050;1581;;1564;0.04;7739;0.22;3551677
741;Oost-Nederland (LD);2012 oktober;3551677;3203;2369;12565;10449;2116;12220;10489;1731;;1179;0.03;8918;0.25;3552856
742;Oost-Nederland (LD);2012 november;3552856;3007;2315;10906;9454;1452;10698;9487;1211;;900;0.03;9818;0.28;3553756
743;Oost-Nederland (LD);2012 december;3553756;2831;2623;10098;8896;1202;10560;9071;1489;80.0;-174;0.0;9644;0.27;3553582
744;Oost-Nederland (LD);2012;3543938;37193;28969;144702;122372;22330;143362;123968;19394;80.0;9644;0.27;9644;0.27;3553582
745;Oost-Nederland (LD);2013 januari;3553582;3071;2803;12510;10681;1829;12411;10651;1760;;367;0.01;367;0.01;3553949
746;Oost-Nederland (LD);2013 februari;3553949;2686;2550;11461;9600;1861;11278;9693;1585;;319;0.01;686;0.02;3554268
747;Oost-Nederland (LD);2013 maart;3554268;2974;2896;10846;9247;1599;10632;9422;1210;;292;0.01;978;0.03;3554560
748;Oost-Nederland (LD);2013 april;3554560;2981;2602;9552;8233;1319;10010;8542;1468;;-79;0.0;899;0.03;3554481
749;Oost-Nederland (LD);2013 mei;3554481;2989;2419;10006;8437;1569;10305;8763;1542;;271;0.01;1170;0.03;3554752
750;Oost-Nederland (LD);2013 juni;3554752;2912;2233;10046;8434;1612;9890;8319;1571;;835;0.02;2005;0.06;3555587
751;Oost-Nederland (LD);2013 juli;3555587;3460;2363;13835;11814;2021;14356;11955;2401;;576;0.02;2581;0.07;3556163
752;Oost-Nederland (LD);2013 augustus;3556163;3282;2213;16533;13511;3022;16540;14587;1953;;1062;0.03;3643;0.1;3557225
753;Oost-Nederland (LD);2013 september;3557225;3260;2201;15661;12357;3304;15249;13172;2077;;1471;0.04;5114;0.14;3558696
754;Oost-Nederland (LD);2013 oktober;3558696;3038;2350;12448;10287;2161;13299;10917;2382;;-163;0.0;4951;0.14;3558533
755;Oost-Nederland (LD);2013 november;3558533;2934;2275;11274;9505;1769;11398;9630;1768;;535;0.02;5486;0.15;3559068
756;Oost-Nederland (LD);2013 december;3559068;2934;2421;11105;9474;1631;11457;9586;1871;53.0;214;0.01;5700;0.16;3559282
757;Oost-Nederland (LD);2013;3553582;36521;29326;145277;121580;23697;146825;125237;21588;53.0;5700;0.16;5700;0.16;3559282
758;Oost-Nederland (LD);2014 januari;3559282;3063;2537;13010;10953;2057;12751;11087;1664;;785;0.02;785;0.02;3560067
759;Oost-Nederland (LD);2014 februari;3560067;2790;2306;12111;10009;2102;11927;10304;1623;;668;0.02;1453;0.04;3560735
760;Oost-Nederland (LD);2014 maart;3560735;3007;2377;11395;9662;1733;11293;9885;1408;;732;0.02;2185;0.06;3561467
761;Oost-Nederland (LD);2014 april;3561467;2952;2318;10700;9002;1698;10973;9205;1768;;361;0.01;2546;0.07;3561828
762;Oost-Nederland (LD);2014 mei;3561828;3075;2373;10445;8924;1521;10610;9145;1465;;537;0.02;3083;0.09;3562365
763;Oost-Nederland (LD);2014 juni;3562365;3040;2265;11288;9466;1822;10960;9268;1692;;1103;0.03;4186;0.12;3563468
764;Oost-Nederland (LD);2014 juli;3563468;3256;2368;14262;12154;2108;14848;12279;2569;;302;0.01;4488;0.13;3563770
765;Oost-Nederland (LD);2014 augustus;3563770;3203;2400;16965;13608;3357;16951;14746;2205;;817;0.02;5305;0.15;3564587
766;Oost-Nederland (LD);2014 september;3564587;3243;2314;16720;13071;3649;15788;13733;2055;;1861;0.05;7166;0.2;3566448
767;Oost-Nederland (LD);2014 oktober;3566448;3278;2407;13567;11105;2462;13352;11427;1925;;1086;0.03;8252;0.23;3567534
768;Oost-Nederland (LD);2014 november;3567534;2923;2399;11344;9512;1832;11021;9635;1386;;847;0.02;9099;0.26;3568381
769;Oost-Nederland (LD);2014 december;3568381;3035;2721;12958;11137;1821;12961;11198;1763;329.0;640;0.02;9739;0.27;3569021
770;Oost-Nederland (LD);2014;3559282;36865;28785;154765;128603;26162;153435;131912;21523;329.0;9739;0.27;9739;0.27;3569021
771;Oost-Nederland (LD);2015 januari;3569021;3012;3115;13282;11036;2246;12967;11154;1813;;212;0.01;212;0.01;3569233
772;Oost-Nederland (LD);2015 februari;3569233;2635;2779;13476;11016;2460;12417;10851;1566;;915;0.03;1127;0.03;3570148
773;Oost-Nederland (LD);2015 maart;3570148;2955;2684;12482;10372;2110;12162;10655;1507;;591;0.02;1718;0.05;3570739
774;Oost-Nederland (LD);2015 april;3570739;2834;2533;11429;9566;1863;10859;9266;1593;;871;0.02;2589;0.07;3571610
775;Oost-Nederland (LD);2015 mei;3571610;3045;2365;10859;9093;1766;10638;9193;1445;;901;0.03;3490;0.1;3572511
776;Oost-Nederland (LD);2015 juni;3572511;2998;2292;12529;10201;2328;12286;10338;1948;;949;0.03;4439;0.12;3573460
777;Oost-Nederland (LD);2015 juli;3573460;3133;2383;16104;13531;2573;16179;13500;2679;;675;0.02;5114;0.14;3574135
778;Oost-Nederland (LD);2015 augustus;3574135;3311;2338;18667;14643;4024;17374;15295;2079;;2266;0.06;7380;0.21;3576401
779;Oost-Nederland (LD);2015 september;3576401;3124;2251;16948;12978;3970;15408;13425;1983;;2413;0.07;9793;0.27;3578814
780;Oost-Nederland (LD);2015 oktober;3578814;3121;2517;14481;11454;3027;13401;11501;1900;;1684;0.05;11477;0.32;3580498
781;Oost-Nederland (LD);2015 november;3580498;2953;2358;13085;10677;2408;12083;10533;1550;;1597;0.04;13074;0.37;3582095
782;Oost-Nederland (LD);2015 december;3582095;2904;2520;14385;11859;2526;13220;11551;1669;55.0;1604;0.04;14678;0.41;3583699
783;Oost-Nederland (LD);2015;3569021;36025;30135;167727;136426;31301;158994;137262;21732;55.0;14678;0.41;14678;0.41;3583699
784;Oost-Nederland (LD);2016 januari;3583699;2868;2897;14375;11797;2578;13631;11641;1990;;715;0.02;715;0.02;3584414
785;Oost-Nederland (LD);2016 februari;3584414;2786;2594;15719;12297;3422;14187;12293;1894;;1724;0.05;2439;0.07;3586138
786;Oost-Nederland (LD);2016 maart;3586138;3017;2873;14595;11896;2699;13279;11782;1497;;1460;0.04;3899;0.11;3587598
787;Oost-Nederland (LD);2016 april;3587598;2935;2586;13784;11549;2235;12894;11430;1464;;1239;0.03;5138;0.14;3588837
788;Oost-Nederland (LD);2016 mei;3588837;2979;2537;13359;11089;2270;12267;10717;1550;;1534;0.04;6672;0.19;3590371
789;Oost-Nederland (LD);2016 juni;3590371;3037;2301;14019;11471;2548;13465;11430;2035;;1290;0.04;7962;0.22;3591661
790;Oost-Nederland (LD);2016 juli;3591661;3267;2427;17762;15078;2684;17316;14841;2475;;1286;0.04;9248;0.26;3592947
791;Oost-Nederland (LD);2016 augustus;3592947;3219;2274;21413;16366;5047;18474;16166;2308;;3884;0.11;13132;0.37;3596831
792;Oost-Nederland (LD);2016 september;3596831;3136;2346;18537;14478;4059;16779;14827;1952;;2548;0.07;15680;0.44;3599379
793;Oost-Nederland (LD);2016 oktober;3599379;2987;2481;14905;12659;2246;14125;12374;1751;;1286;0.04;16966;0.47;3600665
794;Oost-Nederland (LD);2016 november;3600665;2844;2509;14727;12617;2110;13530;12045;1485;;1532;0.04;18498;0.52;3602197
795;Oost-Nederland (LD);2016 december;3602197;2858;2810;15428;13510;1918;14200;12559;1641;-67.0;1209;0.03;19707;0.55;3603406
796;Oost-Nederland (LD);2016;3583699;35933;30635;188623;154807;33816;174147;152105;22042;-67.0;19707;0.55;19707;0.55;3603406
797;Oost-Nederland (LD);2017 januari;3603406;2999;3346;15527;13402;2125;14681;12769;1912;;499;0.01;499;0.01;3603905
798;Oost-Nederland (LD);2017 februari;3603905;2685;2826;15592;13058;2534;14221;12566;1655;;1230;0.03;1729;0.05;3605135
799;Oost-Nederland (LD);2017 maart;3605135;2819;2642;15850;13940;1910;14364;12843;1521;;1663;0.05;3392;0.09;3606798
800;Oost-Nederland (LD);2017 april;3606798;2719;2472;13031;11487;1544;12018;10687;1331;;1260;0.03;4652;0.13;3608058
801;Oost-Nederland (LD);2017 mei;3608058;3000;2545;14032;12248;1784;12882;11584;1298;;1605;0.04;6257;0.17;3609663
802;Oost-Nederland (LD);2017 juni;3609663;2925;2391;14358;12373;1985;13519;11809;1710;;1373;0.04;7630;0.21;3611036
803;Oost-Nederland (LD);2017 juli;3611036;3202;2377;17318;15036;2282;16831;14198;2633;;1312;0.04;8942;0.25;3612348
804;Oost-Nederland (LD);2017 augustus;3612348;3210;2355;20742;16908;3834;17940;15780;2160;;3657;0.1;12599;0.35;3616005
805;Oost-Nederland (LD);2017 september;3616005;3083;2406;20303;15597;4706;17152;15119;2033;;3828;0.11;16427;0.46;3619833
806;Oost-Nederland (LD);2017 oktober;3619833;3063;2433;15950;13360;2590;14648;12730;1918;;1932;0.05;18359;0.51;3621765
807;Oost-Nederland (LD);2017 november;3621765;2861;2550;14318;12412;1906;13655;11948;1707;;974;0.03;19333;0.54;3622739
808;Oost-Nederland (LD);2017 december;3622739;2878;2810;14601;12996;1605;14008;12253;1755;-126.0;535;0.01;19868;0.55;3623274
809;Oost-Nederland (LD);2017;3603406;35444;31153;191622;162817;28805;175919;154286;21633;-126.0;19868;0.55;19868;0.55;3623274
810;Oost-Nederland (LD);2018 januari;3623274;2994;3189;15150;13018;2132;14419;12567;1852;;536;0.01;536;0.01;3623810
811;Oost-Nederland (LD);2018 februari;3623810;2599;2939;14970;12064;2906;13441;11633;1808;;1189;0.03;1725;0.05;3624999
812;Oost-Nederland (LD);2018 maart;3624999;2873;3539;14740;12793;1947;13940;12287;1653;;134;0.0;1859;0.05;3625133
813;Oost-Nederland (LD);2018 april;3625133;2835;2568;13011;11068;1943;12215;10754;1461;;1063;0.03;2922;0.08;3626196
814;Oost-Nederland (LD);2018 mei;3626196;3073;2434;13354;11260;2094;12339;11008;1331;;1654;0.05;4576;0.13;3627850
815;Oost-Nederland (LD);2018 juni;3627850;3019;2313;14031;11823;2208;12800;11088;1712;;1937;0.05;6513;0.18;3629787
816;Oost-Nederland (LD);2018 juli;3629787;3191;2515;17407;14744;2663;15963;13450;2513;;2120;0.06;8633;0.24;3631907
817;Oost-Nederland (LD);2018 augustus;3631907;3080;2430;20964;16747;4217;17911;15717;2194;;3703;0.1;12336;0.34;3635610
818;Oost-Nederland (LD);2018 september;3635610;3078;2285;18451;13685;4766;14984;13190;1794;;4260;0.12;16596;0.46;3639870
819;Oost-Nederland (LD);2018 oktober;3639870;3006;2538;16593;13646;2947;15099;12993;2106;;1962;0.05;18558;0.51;3641832
820;Oost-Nederland (LD);2018 november;3641832;2807;2468;14697;12281;2416;13222;11626;1596;;1814;0.05;20372;0.56;3643646
821;Oost-Nederland (LD);2018 december;3643646;2763;2795;14189;12086;2103;12859;11378;1481;5.0;1303;0.04;21675;0.6;3644949
822;Oost-Nederland (LD);2018;3623274;35318;32013;187557;155215;32342;169192;147691;21501;5.0;21675;0.6;21675;0.6;3644949
823;Oost-Nederland (LD);2019 januari;3644949;2899;2890;15463;12769;2694;14253;12184;2069;;1219;0.03;1219;0.03;3646168
824;Oost-Nederland (LD);2019 februari;3646168;2582;2699;15034;11868;3166;13242;11275;1967;;1675;0.05;2894;0.08;3647843
825;Oost-Nederland (LD);2019 maart;3647843;2778;2855;14848;12271;2577;13667;11774;1893;;1104;0.03;3998;0.11;3648947
826;Oost-Nederland (LD);2019 april;3648947;2852;2681;14153;11769;2384;13096;11413;1683;;1228;0.03;5226;0.14;3650175
827;Oost-Nederland (LD);2019 mei;3650175;3050;2714;14259;11901;2358;13094;11482;1612;;1501;0.04;6727;0.18;3651676
828;Oost-Nederland (LD);2019 juni;3651676;2970;2436;13489;10974;2515;12023;10263;1760;;2000;0.05;8727;0.24;3653676
829;Oost-Nederland (LD);2019 juli;3653676;3291;2577;18748;15445;3303;16928;14276;2652;;2534;0.07;11261;0.31;3656210
830;Oost-Nederland (LD);2019 augustus;3656210;3211;2497;21412;16325;5087;17314;15191;2123;;4812;0.13;16073;0.44;3661022
831;Oost-Nederland (LD);2019 september;3661022;3132;2454;19374;14089;5285;15097;13210;1887;;4955;0.14;21028;0.58;3665977
832;Oost-Nederland (LD);2019 oktober;3665977;3131;2666;16548;13217;3331;14544;12513;2031;;2469;0.07;23497;0.64;3668446
833;Oost-Nederland (LD);2019 november;3668446;2835;2691;15075;12412;2663;13511;11791;1720;;1708;0.05;25205;0.69;3670154
834;Oost-Nederland (LD);2019 december;3670154;2812;2866;14676;12530;2146;13311;11509;1802;-86.0;1225;0.03;26430;0.73;3671379
835;Oost-Nederland (LD);2019;3644949;35543;32026;193079;155570;37509;170080;146881;23199;-86.0;26430;0.73;26430;0.73;3671379
836;Oost-Nederland (LD);2020 januari;3671379;3025;2895;16407;13507;2900;15177;12673;2504;;1360;0.04;1360;0.04;3672739
837;Oost-Nederland (LD);2020 februari;3672739;2792;2783;15799;12595;3204;13743;12084;1659;;2065;0.06;3425;0.09;3674804
838;Oost-Nederland (LD);2020 maart;3674804;2888;3410;14622;12255;2367;13465;11780;1685;;635;0.02;4060;0.11;3675439
839;Oost-Nederland (LD);2020 april;3675439;2784;3881;13032;11697;1335;11980;10795;1185;;-45;0.0;4015;0.11;3675394
840;Oost-Nederland (LD);2020 mei;3675394;2897;2573;13057;11772;1285;12199;11186;1013;;1182;0.03;5197;0.14;3676576
841;Oost-Nederland (LD);2020 juni;3676576;2904;2466;13988;12237;1751;13200;11675;1525;;1226;0.03;6423;0.17;3677802
842;Oost-Nederland (LD);2020 juli;3677802;3345;2420;18198;15577;2621;16463;14450;2013;;2660;0.07;9083;0.25;3680462
843;Oost-Nederland (LD);2020 augustus;3680462;3234;2577;19759;16050;3709;16959;14914;2045;;3457;0.09;12540;0.34;3683919
844;Oost-Nederland (LD);2020 september;3683919;3140;2557;18266;14218;4048;15515;13674;1841;;3334;0.09;15874;0.43;3687253
845;Oost-Nederland (LD);2020 oktober;3687253;3097;2999;17194;14365;2829;15463;13581;1882;;1829;0.05;17703;0.48;3689082
846;Oost-Nederland (LD);2020 november;3689082;2845;3083;15149;12851;2298;13535;11905;1630;;1376;0.04;19079;0.52;3690458
847;Oost-Nederland (LD);2020 december;3690458;2904;3601;15629;13408;2221;13964;12185;1779;-64.0;904;0.02;19983;0.54;3691362
848;Oost-Nederland (LD);2020;3671379;35855;35245;191100;160532;30568;171663;150902;20761;-64.0;19983;0.54;19983;0.54;3691362
849;Oost-Nederland (LD);2021 januari;3691362;2986;3686;16948;14813;2135;15251;13414;1837;0.0;997;0.03;997;0.03;3692359
850;Oost-Nederland (LD);2021 februari;3692359;2851;2799;15447;12901;2546;13259;11744;1515;0.0;2240;0.06;3237;0.09;3694599
851;Oost-Nederland (LD);2021 maart;3694599;3107;2820;16640;14411;2229;15181;13454;1727;0.0;1746;0.05;4983;0.13;3696345
852;Oost-Nederland (LD);2021 april;3696345;3021;2863;15216;13138;2078;13548;12146;1402;0.0;1826;0.05;6809;0.18;3698171
853;Oost-Nederland (LD);2021 mei;3698171;3036;2730;13902;12084;1818;12810;11356;1454;0.0;1398;0.04;8207;0.22;3699569
854;Oost-Nederland (LD);2021 juni;3699569;3057;2668;14751;12509;2242;13500;11737;1763;0.0;1640;0.04;9847;0.27;3701209
855;Oost-Nederland (LD);2021 juli;3701209;3382;2659;17738;15139;2599;15696;13544;2152;0.0;2765;0.07;12612;0.34;3703974
856;Oost-Nederland (LD);2021 augustus;3703974;3384;2649;19386;15048;4338;16137;14019;2118;0.0;3984;0.11;16596;0.45;3707958
857;Oost-Nederland (LD);2021 september;3707958;3336;2691;18460;13075;5385;14030;12270;1760;0.0;5075;0.14;21671;0.59;3713033
858;Oost-Nederland (LD);2021 oktober;3713033;3344;3025;15797;12973;2824;13735;11932;1803;0.0;2381;0.06;24052;0.65;3715414
859;Oost-Nederland (LD);2021 november;3715414;3030;3605;14991;12323;2668;12963;11253;1710;0.0;1453;0.04;25505;0.69;3716867
860;Oost-Nederland (LD);2021 december;3716867;3044;3725;14925;12818;2107;13902;11799;2103;-56.0;286;0.01;25791;0.7;3717153
861;Oost-Nederland (LD);2021;3691362;37578;35920;194201;161232;32969;170012;148668;21344;-56.0;25791;0.7;25791;0.7;3717153
862;Oost-Nederland (LD);2022 januari;3717153;2969;2935;15445;12941;2504;14170;12261;1909;;1309;0.04;1309;0.04;3718462
863;Oost-Nederland (LD);2022 februari;3718462;2802;2809;14958;11629;3329;12748;11048;1700;;2203;0.06;3512;0.09;3720665
864;Oost-Nederland (LD);2022 maart;3720665;2933;3221;20340;12633;7707;13648;11716;1932;;6404;0.17;9916;0.27;3727069
865;Oost-Nederland (LD);2022 april;3727069;2695;3141;21061;12539;8522;13053;11378;1675;;7562;0.2;17478;0.47;3734631
866;Oost-Nederland (LD);2022 mei;3734631;3104;2869;17674;12158;5516;13685;11299;2386;;4224;0.11;21702;0.58;3738855
867;Oost-Nederland (LD);2022 juni;3738855;2995;2756;17047;12137;4910;13502;11298;2204;;3784;0.1;25486;0.69;3742639
868;Oost-Nederland (LD);2022 juli;3742639;3180;2853;18848;14310;4538;16336;13104;3232;;2839;0.08;28325;0.76;3745478
869;Oost-Nederland (LD);2022 augustus;3745478;3330;2837;21735;15299;6436;16714;13745;2969;;5514;0.15;33839;0.91;3750992
870;Oost-Nederland (LD);2022 september;3750992;3248;2735;21730;14415;7315;16019;13350;2669;;6224;0.17;40063;1.08;3757216
871;Oost-Nederland (LD);2022 oktober;3757216;3091;3241;18162;13551;4611;15000;12503;2497;;3012;0.08;43075;1.16;3760228
872;Oost-Nederland (LD);2022 november;3760228;2792;2970;16661;12710;3951;14502;11991;2511;;1981;0.05;45056;1.21;3762209
873;Oost-Nederland (LD);2022 december;3762209;2824;3710;16638;13463;3175;15110;12505;2605;-109.0;533;0.01;45589;1.23;3762742
874;Oost-Nederland (LD);2022;3717153;35963;36077;220299;157785;62514;174487;146198;28289;-109.0;45589;1.23;45589;1.23;3762742
875;Oost-Nederland (LD);2023 januari;3762742;2760;3501;17715;14010;3705;15442;12924;2518;0.0;1532;0.04;1532;0.04;3764274
876;Oost-Nederland (LD);2023 februari;3764274;2617;2912;16362;12188;4174;13934;11460;2474;0.0;2133;0.06;3665;0.1;3766407
877;Oost-Nederland (LD);2023 maart;3766407;3018;3327;17140;13448;3692;15514;12909;2605;0.0;1317;0.03;4982;0.13;3767724
878;Oost-Nederland (LD);2023 april;3767724;2706;2728;15256;12247;3009;13561;11256;2305;0.0;1673;0.04;6655;0.18;3769397
879;Oost-Nederland (LD);2023 mei;3769397;2982;2821;15968;12483;3485;13799;11459;2340;0.0;2330;0.06;8985;0.24;3771727
880;Oost-Nederland (LD);2023 juni;3771727;3025;2696;17169;13748;3421;15288;12816;2472;0.0;2210;0.06;11195;0.3;3773937
881;Oost-Nederland (LD);2023 juli;3773937;3191;2625;19316;15670;3646;18128;14668;3460;0.0;1754;0.05;12949;0.34;3775691
882;Oost-Nederland (LD);2023 augustus;3775691;3258;2697;22692;16745;5947;19325;15911;3414;0.0;3928;0.1;16877;0.45;3779619
883;Oost-Nederland (LD);2023 september;3779619;3010;2649;20986;14732;6254;16922;14190;2732;0.0;4425;0.12;21302;0.57;3784044
884;Oost-Nederland (LD);2023 oktober;3784044;3091;2958;18003;13703;4300;15205;12531;2674;0.0;2931;0.08;24233;0.64;3786975
885;Oost-Nederland (LD);2023 november;3786975;2837;3129;16077;12750;3327;14177;11816;2361;0.0;1608;0.04;25841;0.69;3788583
886;Oost-Nederland (LD);2023 december;3788583;2803;3353;15639;13154;2485;14629;12083;2546;-113.0;347;0.01;26188;0.7;3788930
887;Oost-Nederland (LD);2023;3762742;35298;35396;212323;164878;47445;185924;154023;31901;-113.0;26188;0.7;26188;0.7;3788930
888;Oost-Nederland (LD);2024 januari;3788930;2905;3632;17055;13764;3291;15767;12862;2905;;561;0.01;561;0.01;3789491
889;Oost-Nederland (LD);2024 februari;3789491;2861;3248;16587;12761;3826;14535;11888;2647;;1665;0.04;2226;0.06;3791156
890;Oost-Nederland (LD);2024 maart;3791156;2897;3155;16017;13042;2975;14201;12112;2089;;1558;0.04;3784;0.1;3792714
891;Oost-Nederland (LD);2024 april;3792714;2789;3047;15303;12427;2876;13698;11425;2273;;1347;0.04;5131;0.14;3794061
892;Oost-Nederland (LD);2024 mei;3794061;2959;2894;15407;12678;2729;13245;11051;2194;;2227;0.06;7358;0.19;3796288
893;Oost-Nederland (LD);2024 juni;3796288;2932;2720;14559;11800;2759;13395;10909;2486;;1376;0.04;8734;0.23;3797664
894;Oost-Nederland (LD);2024 juli;3797664;3103;2883;18797;15404;3393;16813;13476;3337;;2204;0.06;10938;0.29;3799868
895;Oost-Nederland (LD);2024 augustus;3799868;3203;2707;20817;15875;4942;17437;14578;2859;;3876;0.1;14814;0.39;3803744
896;Oost-Nederland (LD);2024 september;3803744;3032;2766;19746;14266;5480;15500;12922;2578;;4512;0.12;19326;0.51;3808256
897;Oost-Nederland (LD);2024 oktober;3808256;2986;3052;17442;13897;3545;15051;12440;2611;;2325;0.06;21651;0.57;3810581
898;Oost-Nederland (LD);2024 november;3810581;2927;2984;16188;13151;3037;14507;11956;2551;;1624;0.04;23275;0.61;3812205
899;Oost-Nederland (LD);2024 december;3812205;2831;3170;16136;13579;2557;14376;11671;2705;0.0;1421;0.04;24696;0.65;3813626
900;Oost-Nederland (LD);2024;3788930;35425;36258;204054;162644;41410;178525;147290;31235;0.0;24696;0.65;24696;0.65;3813626
901;Oost-Nederland (LD);2025 januari;3813626;3043;3603;17821;14452;3369;15730;12962;2768;;1531;0.04;1531;0.04;3815157
902;Oost-Nederland (LD);2025 februari;3815157;2611;3189;17234;13530;3704;14011;11575;2436;;2645;0.07;4176;0.11;3817802
903;West-Nederland (LD);2002 januari;7500417;8115;6383;33225;27271;5954;31580;27895;3685;;3377;0.05;3377;0.05;7503794
904;West-Nederland (LD);2002 februari;7503794;7320;5476;28413;23511;4902;26964;23625;3339;;3293;0.04;6670;0.09;7507087
905;West-Nederland (LD);2002 maart;7507087;8002;6129;29486;24388;5098;28561;24619;3942;;2798;0.04;9468;0.13;7509885
906;West-Nederland (LD);2002 april;7509885;7624;5504;28148;23283;4865;27096;23512;3584;;3172;0.04;12640;0.17;7513057
907;West-Nederland (LD);2002 mei;7513057;7997;5403;29448;24635;4813;29027;25075;3952;;3015;0.04;15655;0.21;7516072
908;West-Nederland (LD);2002 juni;7516072;7742;5121;27635;22983;4652;27731;23540;4191;;2525;0.03;18180;0.24;7518597
909;West-Nederland (LD);2002 juli;7518597;8666;5397;35818;29175;6643;35189;29839;5350;;3898;0.05;22078;0.29;7522495
910;West-Nederland (LD);2002 augustus;7522495;8485;5295;37185;29562;7623;35533;30372;5161;;4842;0.06;26920;0.36;7527337
911;West-Nederland (LD);2002 september;7527337;8377;4893;34724;27621;7103;32117;27438;4679;;6091;0.08;33011;0.44;7533428
912;West-Nederland (LD);2002 oktober;7533428;8513;5257;33427;27162;6265;31878;27287;4591;;4805;0.06;37816;0.5;7538233
913;West-Nederland (LD);2002 november;7538233;7602;5389;29742;25233;4509;28792;25257;3535;;3163;0.04;40979;0.55;7541396
914;West-Nederland (LD);2002 december;7541396;7869;6202;27365;23619;3746;28020;24331;3689;1260.0;2272;0.03;43251;0.58;7543668
915;West-Nederland (LD);2002;7500417;96312;66449;374616;308443;66173;362488;312790;49698;1260.0;43251;0.58;43251;0.58;7543668
916;West-Nederland (LD);2003 januari;7543668;8081;6087;33013;27489;5524;32077;27620;4457;;2930;0.04;2930;0.04;7546598
917;West-Nederland (LD);2003 februari;7546598;7457;5331;26730;22137;4593;26217;22077;4140;;2639;0.03;5569;0.07;7549237
918;West-Nederland (LD);2003 maart;7549237;7860;6173;27843;23244;4599;27141;23079;4062;;2389;0.03;7958;0.11;7551626
919;West-Nederland (LD);2003 april;7551626;8096;5655;26434;22259;4175;25893;22370;3523;;2982;0.04;10940;0.15;7554608
920;West-Nederland (LD);2003 mei;7554608;7965;5286;26065;22021;4044;25169;22154;3015;;3575;0.05;14515;0.19;7558183
921;West-Nederland (LD);2003 juni;7558183;7814;5093;27160;22799;4361;28023;23406;4617;;1858;0.02;16373;0.22;7560041
922;West-Nederland (LD);2003 juli;7560041;8496;5207;32922;27396;5526;36043;28662;7381;;168;0.0;16541;0.22;7560209
923;West-Nederland (LD);2003 augustus;7560209;8479;5195;34009;27319;6690;32966;27644;5322;;4327;0.06;20868;0.28;7564536
924;West-Nederland (LD);2003 september;7564536;8292;5087;35116;27849;7267;32622;27393;5229;;5699;0.08;26567;0.35;7570235
925;West-Nederland (LD);2003 oktober;7570235;8240;5366;32904;26938;5966;31923;26879;5044;;3855;0.05;30422;0.4;7574090
926;West-Nederland (LD);2003 november;7574090;7650;5226;27610;23511;4099;28672;23751;4921;;1362;0.02;31784;0.42;7575452
927;West-Nederland (LD);2003 december;7575452;7431;6265;29772;25997;3775;30641;26451;4190;4744.0;5041;0.07;36825;0.49;7580493
928;West-Nederland (LD);2003;7543668;95861;65971;359578;298959;60619;357387;301486;55901;4744.0;36825;0.49;36825;0.49;7580493
929;West-Nederland (LD);2004 januari;7580493;7846;6482;29917;25143;4774;30004;25390;4614;;1277;0.02;1277;0.02;7581770
930;West-Nederland (LD);2004 februari;7581770;7361;5241;27121;23029;4092;27396;22995;4401;;1845;0.02;3122;0.04;7583615
931;West-Nederland (LD);2004 maart;7583615;7836;5523;29342;25216;4126;30493;25322;5171;;1162;0.02;4284;0.06;7584777
932;West-Nederland (LD);2004 april;7584777;7647;5194;25953;22703;3250;27717;22802;4915;;689;0.01;4973;0.07;7585466
933;West-Nederland (LD);2004 mei;7585466;7737;5190;24822;21171;3651;25542;21373;4169;;1827;0.02;6800;0.09;7587293
934;West-Nederland (LD);2004 juni;7587293;8049;4931;29449;24927;4522;30264;25088;5176;;2303;0.03;9103;0.12;7589596
935;West-Nederland (LD);2004 juli;7589596;8479;5076;32759;27824;4935;35060;28564;6496;;1102;0.01;10205;0.13;7590698
936;West-Nederland (LD);2004 augustus;7590698;8172;5249;35545;29189;6356;35601;29130;6471;;2867;0.04;13072;0.17;7593565
937;West-Nederland (LD);2004 september;7593565;7949;4939;35532;28639;6893;32882;27951;4931;;5660;0.07;18732;0.25;7599225
938;West-Nederland (LD);2004 oktober;7599225;7832;5097;30089;25052;5037;30037;24989;5048;;2787;0.04;21519;0.28;7602012
939;West-Nederland (LD);2004 november;7602012;7518;5147;28910;24922;3988;28847;25105;3742;;2434;0.03;23953;0.32;7604446
940;West-Nederland (LD);2004 december;7604446;7749;5581;29220;25665;3555;30490;26062;4428;3409.0;4307;0.06;28260;0.37;7608753
941;West-Nederland (LD);2004;7580493;94175;63650;358659;303480;55179;364333;304771;59562;3409.0;28260;0.37;28260;0.37;7608753
942;West-Nederland (LD);2005 januari;7608753;7666;5874;28670;24765;3905;29707;25199;4508;;755;0.01;755;0.01;7609508
943;West-Nederland (LD);2005 februari;7609508;7064;5468;27130;23163;3967;28287;23317;4970;;439;0.01;1194;0.02;7609947
944;West-Nederland (LD);2005 maart;7609947;7741;6328;28529;24576;3953;30093;24875;5218;;-151;0.0;1043;0.01;7609796
945;West-Nederland (LD);2005 april;7609796;7706;5280;27170;23515;3655;28888;23877;5011;;708;0.01;1751;0.02;7610504
946;West-Nederland (LD);2005 mei;7610504;7735;5320;25040;21763;3277;26615;22079;4536;;840;0.01;2591;0.03;7611344
947;West-Nederland (LD);2005 juni;7611344;7628;5083;28403;24732;3671;30398;24943;5455;;550;0.01;3141;0.04;7611894
948;West-Nederland (LD);2005 juli;7611894;7944;4789;32588;28217;4371;34805;28702;6103;;938;0.01;4079;0.05;7612832
949;West-Nederland (LD);2005 augustus;7612832;8082;4825;38241;32310;5931;39521;32395;7126;;1977;0.03;6056;0.08;7614809
950;West-Nederland (LD);2005 september;7614809;7892;4725;38756;31238;7518;36451;30202;6249;;5472;0.07;11528;0.15;7620281
951;West-Nederland (LD);2005 oktober;7620281;7738;5048;32892;27897;4995;33345;27409;5936;;2237;0.03;13765;0.18;7622518
952;West-Nederland (LD);2005 november;7622518;7211;5113;30865;26478;4387;31593;26233;5360;;1370;0.02;15135;0.2;7623888
953;West-Nederland (LD);2005 december;7623888;7298;5530;30845;27098;3747;33843;27298;6545;3026.0;1796;0.02;16931;0.22;7625684
954;West-Nederland (LD);2005;7608753;91705;63383;369129;315752;53377;383546;316529;67017;3026.0;16931;0.22;16931;0.22;7625684
955;West-Nederland (LD);2006 januari;7625684;7420;5675;32124;27798;4326;33379;27831;5548;;490;0.01;490;0.01;7626174
956;West-Nederland (LD);2006 februari;7626174;6997;5292;29793;25200;4593;30620;25041;5579;;878;0.01;1368;0.02;7627052
957;West-Nederland (LD);2006 maart;7627052;7561;5927;32051;27391;4660;34493;27255;7238;;-808;-0.01;560;0.01;7626244
958;West-Nederland (LD);2006 april;7626244;7084;5294;26268;22514;3754;28558;22394;6164;;-500;-0.01;60;0.0;7625744
959;West-Nederland (LD);2006 mei;7625744;7654;5063;28487;24210;4277;31160;24252;6908;;-82;0.0;-22;0.0;7625662
960;West-Nederland (LD);2006 juni;7625662;7417;4919;29545;25166;4379;30488;25081;5407;;1555;0.02;1533;0.02;7627217
961;West-Nederland (LD);2006 juli;7627217;7764;5580;32533;27596;4937;34971;28308;6663;;-254;0.0;1279;0.02;7626963
962;West-Nederland (LD);2006 augustus;7626963;7824;4753;38940;32256;6684;39353;32548;6805;;2658;0.03;3937;0.05;7629621
963;West-Nederland (LD);2006 september;7629621;7813;4756;37807;29679;8128;36553;28888;7665;;4311;0.06;8248;0.11;7633932
964;West-Nederland (LD);2006 oktober;7633932;7960;4753;33332;27595;5737;34065;27035;7030;;2474;0.03;10722;0.14;7636406
965;West-Nederland (LD);2006 november;7636406;7247;4984;31926;27344;4582;34087;26841;7246;;102;0.0;10824;0.14;7636508
966;West-Nederland (LD);2006 december;7636508;7309;5446;28074;24469;3605;30372;24894;5478;3195.0;2760;0.04;13584;0.18;7639268
967;West-Nederland (LD);2006;7625684;90050;62442;380880;321218;59662;398099;320368;77731;3195.0;13584;0.18;13584;0.18;7639268
968;West-Nederland (LD);2007 januari;7639268;7314;5736;33902;28196;5706;34326;28246;6080;;1154;0.02;1154;0.02;7640422
969;West-Nederland (LD);2007 februari;7640422;6860;4947;29968;24599;5369;28524;24290;4234;;3357;0.04;4511;0.06;7643779
970;West-Nederland (LD);2007 maart;7643779;7491;5507;30827;25914;4913;30997;25610;5387;;1814;0.02;6325;0.08;7645593
971;West-Nederland (LD);2007 april;7645593;7141;5140;26726;22365;4361;26846;22382;4464;;1881;0.02;8206;0.11;7647474
972;West-Nederland (LD);2007 mei;7647474;7508;4966;28908;24058;4850;29468;24424;5044;;1982;0.03;10188;0.13;7649456
973;West-Nederland (LD);2007 juni;7649456;7231;4860;29721;24630;5091;30410;24822;5588;;1682;0.02;11870;0.16;7651138
974;West-Nederland (LD);2007 juli;7651138;7771;4940;35458;29019;6439;37613;29466;8147;;676;0.01;12546;0.16;7651814
975;West-Nederland (LD);2007 augustus;7651814;7919;4891;39668;32072;7596;40017;32123;7894;;2679;0.04;15225;0.2;7654493
976;West-Nederland (LD);2007 september;7654493;7872;4612;37526;28652;8874;33863;27787;6076;;6923;0.09;22148;0.29;7661416
977;West-Nederland (LD);2007 oktober;7661416;7777;5143;36169;29098;7071;35354;28675;6679;;3449;0.05;25597;0.34;7664865
978;West-Nederland (LD);2007 november;7664865;7145;5269;32324;26592;5732;32359;26271;6088;;1841;0.02;27438;0.36;7666706
979;West-Nederland (LD);2007 december;7666706;7150;5842;27645;23543;4102;29034;23495;5539;2908.0;2827;0.04;30265;0.4;7669533
980;West-Nederland (LD);2007;7639268;89179;61853;388842;318738;70104;388811;317591;71220;2908.0;30265;0.4;30265;0.4;7669533
981;West-Nederland (LD);2008 januari;7669533;7377;6016;36047;29454;6593;34711;29183;5528;;2697;0.04;2697;0.04;7672230
982;West-Nederland (LD);2008 februari;7672230;6931;5158;32310;25440;6870;30272;25180;5092;;3811;0.05;6508;0.08;7676041
983;West-Nederland (LD);2008 maart;7676041;7344;5569;29725;24059;5666;28876;23915;4961;;2624;0.03;9132;0.12;7678665
984;West-Nederland (LD);2008 april;7678665;7273;5266;30773;24577;6196;29187;24467;4720;;3593;0.05;12725;0.17;7682258
985;West-Nederland (LD);2008 mei;7682258;7653;5175;27821;22488;5333;27161;22504;4657;;3138;0.04;15863;0.21;7685396
986;West-Nederland (LD);2008 juni;7685396;7488;4811;30965;24683;6282;29967;24773;5194;;3675;0.05;19538;0.25;7689071
987;West-Nederland (LD);2008 juli;7689071;8276;5019;37564;29757;7807;38135;30314;7821;;2686;0.03;22224;0.29;7691757
988;West-Nederland (LD);2008 augustus;7691757;8079;4815;38660;29964;8696;37696;30359;7337;;4228;0.05;26452;0.34;7695985
989;West-Nederland (LD);2008 september;7695985;8127;4705;42579;31012;11567;36132;29981;6151;;9869;0.13;36321;0.47;7705854
990;West-Nederland (LD);2008 oktober;7705854;7741;5063;36978;28667;8311;33196;27915;5281;;6460;0.08;42781;0.56;7712314
991;West-Nederland (LD);2008 november;7712314;7313;5002;30711;24213;6498;29175;23786;5389;;3847;0.05;46628;0.61;7716161
992;West-Nederland (LD);2008 december;7716161;7589;5717;31589;26113;5476;32926;26057;6869;3160.0;3695;0.05;50323;0.66;7719856
993;West-Nederland (LD);2008;7669533;91191;62316;405722;320427;85295;387434;318434;69000;3160.0;50323;0.66;50323;0.66;7719856
994;West-Nederland (LD);2009 januari;7719856;7592;6585;33269;26172;7097;31584;25981;5603;;2692;0.03;2692;0.03;7722548
995;West-Nederland (LD);2009 februari;7722548;6791;5257;29993;23413;6580;26945;23114;3831;;4582;0.06;7274;0.09;7727130
996;West-Nederland (LD);2009 maart;7727130;7536;5211;31302;24717;6585;28995;24158;4837;;4632;0.06;11906;0.15;7731762
997;West-Nederland (LD);2009 april;7731762;7467;4972;27312;21490;5822;26882;21147;5735;;2925;0.04;14831;0.19;7734687
998;West-Nederland (LD);2009 mei;7734687;7698;4898;26009;20840;5169;24770;20776;3994;;4039;0.05;18870;0.24;7738726
999;West-Nederland (LD);2009 juni;7738726;7577;4743;28990;22808;6182;27917;22724;5193;;3907;0.05;22777;0.3;7742633
1000;West-Nederland (LD);2009 juli;7742633;8118;4831;34753;27222;7531;34111;27631;6480;;3929;0.05;26706;0.35;7746562
1001;West-Nederland (LD);2009 augustus;7746562;8051;4689;38125;28402;9723;35447;27670;7777;;6040;0.08;32746;0.42;7752602
1002;West-Nederland (LD);2009 september;7752602;8062;4789;40399;28764;11635;33578;27528;6050;;10094;0.13;42840;0.55;7762696
1003;West-Nederland (LD);2009 oktober;7762696;7660;5041;33476;25883;7593;31125;24957;6168;;4970;0.06;47810;0.62;7767666
1004;West-Nederland (LD);2009 november;7767666;7511;4928;29996;23860;6136;27604;23078;4526;;4975;0.06;52785;0.68;7772641
1005;West-Nederland (LD);2009 december;7772641;7569;5486;29443;24362;5081;29946;24114;5832;2793.0;4373;0.06;57158;0.74;7777014
1006;West-Nederland (LD);2009;7719856;91632;61430;383067;297933;85134;358904;292878;66026;2793.0;57158;0.74;57158;0.74;7777014
1007;West-Nederland (LD);2010 januari;7777014;7460;5895;31109;24629;6480;29793;24143;5650;;2881;0.04;2881;0.04;7779895
1008;West-Nederland (LD);2010 februari;7779895;6868;5263;30722;23684;7038;27909;23152;4757;;4418;0.06;7299;0.09;7784313
1009;West-Nederland (LD);2010 maart;7784313;7481;5522;31965;25079;6886;31169;24604;6565;;2755;0.04;10054;0.13;7787068
1010;West-Nederland (LD);2010 april;7787068;7499;4989;27399;21632;5767;26034;21231;4803;;3875;0.05;13929;0.18;7790943
1011;West-Nederland (LD);2010 mei;7790943;7515;5023;25999;20739;5260;25336;20725;4611;;3155;0.04;17084;0.22;7794098
1012;West-Nederland (LD);2010 juni;7794098;7747;4856;29383;22935;6448;28512;22776;5736;;3762;0.05;20846;0.27;7797860
1013;West-Nederland (LD);2010 juli;7797860;8012;5050;33904;26329;7575;33769;26078;7691;;3097;0.04;23943;0.31;7800957
1014;West-Nederland (LD);2010 augustus;7800957;7943;4674;41504;29764;11740;36450;28868;7582;;8323;0.11;32266;0.41;7809280
1015;West-Nederland (LD);2010 september;7809280;8121;4927;40337;28237;12100;33577;26946;6631;;9954;0.13;42220;0.54;7819234
1016;West-Nederland (LD);2010 oktober;7819234;7987;5277;32332;24566;7766;29443;23748;5695;;5599;0.07;47819;0.61;7824833
1017;West-Nederland (LD);2010 november;7824833;7745;4982;30443;23496;6947;29118;22744;6374;;4088;0.05;51907;0.67;7828921
1018;West-Nederland (LD);2010 december;7828921;7728;5757;29262;23537;5725;29692;23323;6369;-337.0;1204;0.02;53111;0.68;7830125
1019;West-Nederland (LD);2010;7777014;92106;62215;384359;294627;89732;360802;288338;72464;-337.0;53111;0.68;53111;0.68;7830125
1020;West-Nederland (LD);2011 januari;7830125;7614;5618;31973;24511;7462;29773;24137;5636;;4196;0.05;4196;0.05;7834321
1021;West-Nederland (LD);2011 februari;7834321;7027;4827;30211;22967;7244;27252;22588;4664;;5159;0.07;9355;0.12;7839480
1022;West-Nederland (LD);2011 maart;7839480;7484;5539;31349;24190;7159;29534;23827;5707;;3760;0.05;13115;0.17;7843240
1023;West-Nederland (LD);2011 april;7843240;7319;5143;27216;21311;5905;26915;20944;5971;;2477;0.03;15592;0.2;7845717
1024;West-Nederland (LD);2011 mei;7845717;7600;5147;28020;21895;6125;27284;21627;5657;;3189;0.04;18781;0.24;7848906
1025;West-Nederland (LD);2011 juni;7848906;7679;4861;27828;21243;6585;27707;21238;6469;;2939;0.04;21720;0.28;7851845
1026;West-Nederland (LD);2011 juli;7851845;7902;5061;34232;25622;8610;34771;25930;8841;;2302;0.03;24022;0.31;7854147
1027;West-Nederland (LD);2011 augustus;7854147;7934;4890;43320;30552;12768;38863;29950;8913;;7501;0.1;31523;0.4;7861648
1028;West-Nederland (LD);2011 september;7861648;7864;4893;41188;28414;12774;35490;27559;7931;;8669;0.11;40192;0.51;7870317
1029;West-Nederland (LD);2011 oktober;7870317;7607;5242;32158;24291;7867;29955;23502;6453;;4568;0.06;44760;0.57;7874885
1030;West-Nederland (LD);2011 november;7874885;7101;5153;32270;24688;7582;29441;23771;5670;;4777;0.06;49537;0.63;7879662
1031;West-Nederland (LD);2011 december;7879662;7204;5646;29650;23991;5659;30498;23680;6818;381.0;1091;0.01;50628;0.65;7880753
1032;West-Nederland (LD);2011;7830125;90335;62020;389415;293675;95740;367483;288753;78730;381.0;50628;0.65;50628;0.65;7880753
1033;West-Nederland (LD);2012 januari;7880753;7374;5714;34165;26762;7403;34690;26488;8202;;1135;0.01;1135;0.01;7881888
1034;West-Nederland (LD);2012 februari;7881888;7004;5736;31840;24089;7751;29517;23474;6043;;3591;0.05;4726;0.06;7885479
1035;West-Nederland (LD);2012 maart;7885479;7423;5865;31264;24678;6586;30986;24119;6867;;1836;0.02;6562;0.08;7887315
1036;West-Nederland (LD);2012 april;7887315;7219;5438;26876;21004;5872;26309;20539;5770;;2348;0.03;8910;0.11;7889663
1037;West-Nederland (LD);2012 mei;7889663;7645;5256;27961;21832;6129;28403;21684;6719;;1947;0.02;10857;0.14;7891610
1038;West-Nederland (LD);2012 juni;7891610;7388;5032;30310;24026;6284;31896;24269;7627;;770;0.01;11627;0.15;7892380
1039;West-Nederland (LD);2012 juli;7892380;7656;5043;35176;27092;8084;36956;26928;10028;;833;0.01;12460;0.16;7893213
1040;West-Nederland (LD);2012 augustus;7893213;7820;4897;42946;30799;12147;39649;30049;9600;;6220;0.08;18680;0.24;7899433
1041;West-Nederland (LD);2012 september;7899433;7620;4866;39258;27074;12184;33198;25771;7427;;8814;0.11;27494;0.35;7908247
1042;West-Nederland (LD);2012 oktober;7908247;7647;5246;34893;25909;8984;32421;25059;7362;;4873;0.06;32367;0.41;7913120
1043;West-Nederland (LD);2012 november;7913120;7291;5325;30368;23483;6885;30189;22953;7236;;2145;0.03;34512;0.44;7915265
1044;West-Nederland (LD);2012 december;7915265;7031;5797;28163;23240;4923;30119;22867;7252;63.0;-659;-0.01;33853;0.43;7914606
1045;West-Nederland (LD);2012;7880753;89118;64215;393220;299988;93232;384333;294200;90133;63.0;33853;0.43;33853;0.43;7914606
1046;West-Nederland (LD);2013 januari;7914606;7384;6204;34194;26589;7605;33465;26305;7160;;1909;0.02;1909;0.02;7916515
1047;West-Nederland (LD);2013 februari;7916515;6517;5645;31392;23974;7418;29601;23276;6325;;2663;0.03;4572;0.06;7919178
1048;West-Nederland (LD);2013 maart;7919178;7217;6066;30164;23630;6534;29618;23103;6515;;1697;0.02;6269;0.08;7920875
1049;West-Nederland (LD);2013 april;7920875;6886;5637;27673;21502;6171;28115;20865;7250;;807;0.01;7076;0.09;7921682
1050;West-Nederland (LD);2013 mei;7921682;7135;5170;27969;21619;6350;27600;21316;6284;;2334;0.03;9410;0.12;7924016
1051;West-Nederland (LD);2013 juni;7924016;7140;4999;26997;20811;6186;27113;20630;6483;;2025;0.03;11435;0.14;7926041
1052;West-Nederland (LD);2013 juli;7926041;7791;5178;35878;27061;8817;36419;26773;9646;;2072;0.03;13507;0.17;7928113
1053;West-Nederland (LD);2013 augustus;7928113;7743;4929;43250;30955;12295;39011;29891;9120;;7053;0.09;20560;0.26;7935166
1054;West-Nederland (LD);2013 september;7935166;7488;4746;43271;30578;12693;37810;28719;9091;;8203;0.1;28763;0.36;7943369
1055;West-Nederland (LD);2013 oktober;7943369;7380;5225;36037;27083;8954;32407;25708;6699;;5785;0.07;34548;0.44;7949154
1056;West-Nederland (LD);2013 november;7949154;6908;5001;31070;24210;6860;29906;23562;6344;;3071;0.04;37619;0.48;7952225
1057;West-Nederland (LD);2013 december;7952225;6899;5402;30281;24379;5902;31663;24044;7619;354.0;469;0.01;38088;0.48;7952694
1058;West-Nederland (LD);2013;7914606;86488;64202;398176;302391;95785;382728;294192;88536;354.0;38088;0.48;38088;0.48;7952694
1059;West-Nederland (LD);2014 januari;7952694;7287;5627;36744;27900;8844;34871;27428;7443;;3533;0.04;3533;0.04;7956227
1060;West-Nederland (LD);2014 februari;7956227;6745;5019;33792;25417;8375;30407;24637;5770;;5111;0.06;8644;0.11;7961338
1061;West-Nederland (LD);2014 maart;7961338;7391;5517;31785;24621;7164;29993;24141;5852;;3666;0.05;12310;0.15;7965004
1062;West-Nederland (LD);2014 april;7965004;7063;5079;30935;23756;7179;29102;23073;6029;;3817;0.05;16127;0.2;7968821
1063;West-Nederland (LD);2014 mei;7968821;7399;5127;28982;22567;6415;27847;22138;5709;;3407;0.04;19534;0.25;7972228
1064;West-Nederland (LD);2014 juni;7972228;7417;4742;30429;23280;7149;30224;23066;7158;;2880;0.04;22414;0.28;7975108
1065;West-Nederland (LD);2014 juli;7975108;7966;5280;37719;29130;8589;38946;29027;9919;;1459;0.02;23873;0.3;7976567
1066;West-Nederland (LD);2014 augustus;7976567;7911;5011;45698;33163;12535;40848;31818;9030;;7750;0.1;31623;0.4;7984317
1067;West-Nederland (LD);2014 september;7984317;7947;5036;47330;32826;14504;40041;31167;8874;;10200;0.13;41823;0.53;7994517
1068;West-Nederland (LD);2014 oktober;7994517;7740;5222;38710;28856;9854;34961;27475;7486;;6267;0.08;48090;0.6;8000784
1069;West-Nederland (LD);2014 november;8000784;7191;5305;32663;25253;7410;30003;24154;5849;;4546;0.06;52636;0.66;8005330
1070;West-Nederland (LD);2014 december;8005330;7149;6002;35964;29032;6932;36323;28436;7887;120.0;908;0.01;53544;0.67;8006238
1071;West-Nederland (LD);2014;7952694;89206;62967;430751;325801;104950;403566;316560;87006;120.0;53544;0.67;53544;0.67;8006238
1072;West-Nederland (LD);2015 januari;8006238;7159;6772;37813;28793;9020;35778;27863;7915;;2422;0.03;2422;0.03;8008660
1073;West-Nederland (LD);2015 februari;8008660;6466;5843;34851;26678;8173;31846;25931;5915;;3628;0.05;6050;0.08;8012288
1074;West-Nederland (LD);2015 maart;8012288;6919;6228;35989;28441;7548;34144;27503;6641;;2536;0.03;8586;0.11;8014824
1075;West-Nederland (LD);2015 april;8014824;6716;5459;31940;24801;7139;30522;24313;6209;;2675;0.03;11261;0.14;8017499
1076;West-Nederland (LD);2015 mei;8017499;7258;5419;29770;24011;5759;29005;23406;5599;;2604;0.03;13865;0.17;8020103
1077;West-Nederland (LD);2015 juni;8020103;7309;5024;34256;26509;7747;33875;25947;7928;;2666;0.03;16531;0.21;8022769
1078;West-Nederland (LD);2015 juli;8022769;7819;5233;42553;32987;9566;43128;32426;10702;;2011;0.03;18542;0.23;8024780
1079;West-Nederland (LD);2015 augustus;8024780;7703;5002;49857;35153;14704;43768;33763;10005;;8790;0.11;27332;0.34;8033570
1080;West-Nederland (LD);2015 september;8033570;7860;5143;49461;33735;15726;39818;31960;7858;;12360;0.15;39692;0.5;8045930
1081;West-Nederland (LD);2015 oktober;8045930;7470;5629;41071;30599;10472;35668;29341;6327;;7244;0.09;46936;0.59;8053174
1082;West-Nederland (LD);2015 november;8053174;7034;5285;36578;27950;8628;32131;26642;5489;;6196;0.08;53132;0.66;8059370
1083;West-Nederland (LD);2015 december;8059370;7108;5695;38509;30649;7860;37110;29823;7287;-160.0;2652;0.03;55784;0.7;8062022
1084;West-Nederland (LD);2015;8006238;86821;66732;462648;350306;112342;426793;338918;87875;-160.0;55784;0.7;55784;0.7;8062022
1085;West-Nederland (LD);2016 januari;8062022;7195;6227;38949;29487;9462;35893;28409;7484;;4024;0.05;4024;0.05;8066046
1086;West-Nederland (LD);2016 februari;8066046;6756;5945;40332;30310;10022;35546;28908;6638;;5597;0.07;9621;0.12;8071643
1087;West-Nederland (LD);2016 maart;8071643;7176;6133;37723;29374;8349;34909;28481;6428;;3857;0.05;13478;0.17;8075500
1088;West-Nederland (LD);2016 april;8075500;7072;5415;35503;27898;7605;33180;27175;6005;;3980;0.05;17458;0.22;8079480
1089;West-Nederland (LD);2016 mei;8079480;7421;5446;34937;27149;7788;31839;26488;5351;;5073;0.06;22531;0.28;8084553
1090;West-Nederland (LD);2016 juni;8084553;7484;5143;37681;29176;8505;35923;28208;7715;;4099;0.05;26630;0.33;8088652
1091;West-Nederland (LD);2016 juli;8088652;7923;5286;43410;34290;9120;43449;33531;9918;;2598;0.03;29228;0.36;8091250
1092;West-Nederland (LD);2016 augustus;8091250;7819;5260;55814;38425;17389;46927;37518;9409;;11446;0.14;40674;0.5;8102696
1093;West-Nederland (LD);2016 september;8102696;7758;5044;50815;35849;14966;42955;34423;8532;;10574;0.13;51248;0.64;8113270
1094;West-Nederland (LD);2016 oktober;8113270;7405;5648;43078;32443;10635;38584;31188;7396;;6251;0.08;57499;0.71;8119521
1095;West-Nederland (LD);2016 november;8119521;6895;5554;40297;31042;9255;36580;29765;6815;;5058;0.06;62557;0.78;8124579
1096;West-Nederland (LD);2016 december;8124579;7051;6413;40054;32772;7282;39301;31622;7679;-193.0;1198;0.01;63755;0.79;8125777
1097;West-Nederland (LD);2016;8062022;87955;67514;498593;378215;120378;455086;365716;89370;-193.0;63755;0.79;63755;0.79;8125777
1098;West-Nederland (LD);2017 januari;8125777;7218;7175;43392;33651;9741;40433;32396;8037;;3002;0.04;3002;0.04;8128779
1099;West-Nederland (LD);2017 februari;8128779;6387;6033;41697;31739;9958;36502;30122;6380;;5549;0.07;8551;0.11;8134328
1100;West-Nederland (LD);2017 maart;8134328;6984;5782;42099;33321;8778;38240;31991;6249;;5061;0.06;13612;0.17;8139389
1101;West-Nederland (LD);2017 april;8139389;7022;5304;34367;27603;6764;31966;26595;5371;;4119;0.05;17731;0.22;8143508
1102;West-Nederland (LD);2017 mei;8143508;7357;5631;38022;29932;8090;35873;28878;6995;;3875;0.05;21606;0.27;8147383
1103;West-Nederland (LD);2017 juni;8147383;7209;5008;38992;29869;9123;37426;29159;8267;;3767;0.05;25373;0.31;8151150
1104;West-Nederland (LD);2017 juli;8151150;7621;5150;45617;35368;10249;45302;35126;10176;;2786;0.03;28159;0.35;8153936
1105;West-Nederland (LD);2017 augustus;8153936;7780;5162;56848;38199;18649;48217;38319;9898;;11249;0.14;39408;0.48;8165185
1106;West-Nederland (LD);2017 september;8165185;7518;5171;52044;35433;16611;43246;34714;8532;;11145;0.14;50553;0.62;8176330
1107;West-Nederland (LD);2017 oktober;8176330;7434;5353;44836;32910;11926;39904;32198;7706;;7013;0.09;57566;0.71;8183343
1108;West-Nederland (LD);2017 november;8183343;7197;5452;40848;30620;10228;36677;29967;6710;;5916;0.07;63482;0.78;8189259
1109;West-Nederland (LD);2017 december;8189259;7065;6163;38249;30444;7805;38022;30518;7504;-374.0;755;0.01;64237;0.79;8190014
1110;West-Nederland (LD);2017;8125777;86792;67384;517011;389089;127922;471808;379983;91825;-374.0;64237;0.79;64237;0.79;8190014
1111;West-Nederland (LD);2018 januari;8190014;7332;6695;43815;32721;11094;39996;32274;7722;;4456;0.05;4456;0.05;8194470
1112;West-Nederland (LD);2018 februari;8194470;6246;6375;40589;29658;10931;35309;29270;6039;;5151;0.06;9607;0.12;8199621
1113;West-Nederland (LD);2018 maart;8199621;6865;7101;40146;31571;8575;37989;30966;7023;;1921;0.02;11528;0.14;8201542
1114;West-Nederland (LD);2018 april;8201542;6802;5417;36395;27989;8406;33446;27390;6056;;4334;0.05;15862;0.19;8205876
1115;West-Nederland (LD);2018 mei;8205876;7437;5366;37232;28011;9221;33903;27783;6120;;5400;0.07;21262;0.26;8211276
1116;West-Nederland (LD);2018 juni;8211276;7279;5086;37728;28644;9084;37022;28784;8238;;2899;0.04;24161;0.3;8214175
1117;West-Nederland (LD);2018 juli;8214175;7854;5431;44219;32752;11467;44302;33466;10836;;2340;0.03;26501;0.32;8216515
1118;West-Nederland (LD);2018 augustus;8216515;7789;5391;56263;36476;19787;48579;37717;10862;;10082;0.12;36583;0.45;8226597
1119;West-Nederland (LD);2018 september;8226597;7626;5091;50025;32419;17606;40889;32518;8371;;11671;0.14;48254;0.59;8238268
1120;West-Nederland (LD);2018 oktober;8238268;7383;5504;45652;32392;13260;40154;32695;7459;;7377;0.09;55631;0.68;8245645
1121;West-Nederland (LD);2018 november;8245645;6932;5531;41235;29974;11261;36442;30186;6256;;6194;0.08;61825;0.75;8251839
1122;West-Nederland (LD);2018 december;8251839;6756;5880;37149;28840;8309;37035;29441;7594;-387.0;603;0.01;62428;0.76;8252442
1123;West-Nederland (LD);2018;8190014;86301;68868;510448;371447;139001;465066;372490;92576;-387.0;62428;0.76;62428;0.76;8252442
1124;West-Nederland (LD);2019 januari;8252442;7329;6344;44928;32120;12808;40199;32202;7997;;5714;0.07;5714;0.07;8258156
1125;West-Nederland (LD);2019 februari;8258156;6204;5728;41225;29278;11947;35898;29556;6342;;5803;0.07;11517;0.14;8263959
1126;West-Nederland (LD);2019 maart;8263959;6994;6099;40644;30128;10516;36898;30164;6734;;4641;0.06;16158;0.2;8268600
1127;West-Nederland (LD);2019 april;8268600;7079;5548;39701;29593;10108;35931;29568;6363;;5301;0.06;21459;0.26;8273901
1128;West-Nederland (LD);2019 mei;8273901;7333;5547;39808;29713;10095;36331;29922;6409;;5263;0.06;26722;0.32;8279164
1129;West-Nederland (LD);2019 juni;8279164;7315;5243;36301;26640;9661;35327;27077;8250;;3046;0.04;29768;0.36;8282210
1130;West-Nederland (LD);2019 juli;8282210;7865;5569;48333;35113;13220;47145;36144;11001;;3484;0.04;33252;0.4;8285694
1131;West-Nederland (LD);2019 augustus;8285694;7907;5256;57369;36039;21330;47501;37196;10305;;12519;0.15;45771;0.55;8298213
1132;West-Nederland (LD);2019 september;8298213;7741;5043;53623;33499;20124;42327;34015;8312;;13994;0.17;59765;0.72;8312207
1133;West-Nederland (LD);2019 oktober;8312207;7396;5670;46807;31977;14830;39235;32143;7092;;9298;0.11;69063;0.84;8321505
1134;West-Nederland (LD);2019 november;8321505;7002;5822;40597;29962;10635;36796;30306;6490;;4981;0.06;74044;0.9;8326486
1135;West-Nederland (LD);2019 december;8326486;6736;6198;39028;30426;8602;39290;31195;8095;-217.0;59;0.0;74103;0.9;8326545
1136;West-Nederland (LD);2019;8252442;86901;68067;528364;374488;153876;472878;379488;93390;-217.0;74103;0.9;74103;0.9;8326545
1137;West-Nederland (LD);2020 januari;8326545;7182;6357;46619;33587;13032;42919;33877;9042;;4525;0.05;4525;0.05;8331070
1138;West-Nederland (LD);2020 februari;8331070;6649;5690;42416;30584;11832;37621;30679;6942;;5754;0.07;10279;0.12;8336824
1139;West-Nederland (LD);2020 maart;8336824;6880;6631;39513;30846;8667;38826;31355;7471;;936;0.01;11215;0.13;8337760
1140;West-Nederland (LD);2020 april;8337760;6773;8230;33581;28180;5401;33823;28987;4836;;-1699;-0.02;9516;0.11;8336061
1141;West-Nederland (LD);2020 mei;8336061;7054;5736;34614;29633;4981;34897;30385;4512;;1035;0.01;10551;0.13;8337096
1142;West-Nederland (LD);2020 juni;8337096;7176;5132;37682;30739;6943;37731;31366;6365;;1995;0.02;12546;0.15;8339091
1143;West-Nederland (LD);2020 juli;8339091;7876;5304;46553;36632;9921;46918;37790;9128;;2207;0.03;14753;0.18;8341298
1144;West-Nederland (LD);2020 augustus;8341298;7648;5818;51852;37917;13935;48495;39249;9246;;5187;0.06;19940;0.24;8346485
1145;West-Nederland (LD);2020 september;8346485;7546;5407;53290;36274;17016;44239;36575;7664;;11190;0.13;31130;0.37;8357675
1146;West-Nederland (LD);2020 oktober;8357675;7366;6780;47506;35759;11747;44413;36571;7842;;3679;0.04;34809;0.42;8361354
1147;West-Nederland (LD);2020 november;8361354;6908;6926;41654;31942;9712;40175;32586;7589;;1461;0.02;36270;0.44;8362815
1148;West-Nederland (LD);2020 december;8362815;6771;7522;41503;32732;8771;42117;33804;8313;-361.0;-1726;-0.02;34544;0.41;8361089
1149;West-Nederland (LD);2020;8326545;85829;75533;516783;394825;121958;492174;403224;88950;-361.0;34544;0.41;34544;0.41;8361089
1150;West-Nederland (LD);2021 januari;8361089;7008;7593;44649;35871;8778;44180;37264;6916;0.0;-116;0.0;-116;0.0;8360973
1151;West-Nederland (LD);2021 februari;8360973;6790;6279;41017;32474;8543;38592;33223;5369;0.0;2936;0.04;2820;0.03;8363909
1152;West-Nederland (LD);2021 maart;8363909;7617;6310;45311;36718;8593;44119;37783;6336;0.0;2499;0.03;5319;0.06;8366408
1153;West-Nederland (LD);2021 april;8366408;7351;6058;40381;32956;7425;39505;34003;5502;0.0;2169;0.03;7488;0.09;8368577
1154;West-Nederland (LD);2021 mei;8368577;7498;5912;37301;30264;7037;36015;31038;4977;0.0;2872;0.03;10360;0.12;8371449
1155;West-Nederland (LD);2021 juni;8371449;7548;5343;38800;30495;8305;37648;30922;6726;0.0;3357;0.04;13717;0.16;8374806
1156;West-Nederland (LD);2021 juli;8374806;8075;5698;45261;34965;10296;45637;36832;8805;0.0;2001;0.02;15718;0.19;8376807
1157;West-Nederland (LD);2021 augustus;8376807;8058;5860;56213;37437;18776;47568;38253;9315;0.0;10843;0.13;26561;0.32;8387650
1158;West-Nederland (LD);2021 september;8387650;8287;5824;55486;33773;21713;41514;34037;7477;0.0;16435;0.2;42996;0.51;8404085
1159;West-Nederland (LD);2021 oktober;8404085;7898;6273;46521;31989;14532;38957;32447;6510;0.0;9189;0.11;52185;0.62;8413274
1160;West-Nederland (LD);2021 november;8413274;7482;7182;43302;31030;12272;37172;31033;6139;0.0;6430;0.08;58615;0.7;8419704
1161;West-Nederland (LD);2021 december;8419704;7206;7984;42837;32771;10066;41054;33401;7653;-298.0;707;0.01;59322;0.71;8420411
1162;West-Nederland (LD);2021;8361089;90818;76316;537079;400743;136336;491961;410236;81725;-298.0;59322;0.71;59322;0.71;8420411
1163;West-Nederland (LD);2022 januari;8420411;7050;6553;42520;31745;10775;39451;32172;7279;;3566;0.04;3566;0.04;8423977
1164;West-Nederland (LD);2022 februari;8423977;6364;5969;42483;29937;12546;36050;29796;6254;;6828;0.08;10394;0.12;8430805
1165;West-Nederland (LD);2022 maart;8430805;6823;6771;55103;31073;24030;37878;31451;6427;;17277;0.2;27671;0.33;8448082
1166;West-Nederland (LD);2022 april;8448082;6438;6498;55503;31132;24371;37835;31743;6092;;17608;0.21;45279;0.54;8465690
1167;West-Nederland (LD);2022 mei;8465690;7087;5920;47974;30979;16995;37566;30967;6599;;11575;0.14;56854;0.68;8477265
1168;West-Nederland (LD);2022 juni;8477265;7094;5894;44899;30783;14116;39960;30689;9271;;6139;0.07;62993;0.75;8483404
1169;West-Nederland (LD);2022 juli;8483404;7403;6143;49983;35271;14712;47943;36291;11652;;3300;0.04;66293;0.79;8486704
1170;West-Nederland (LD);2022 augustus;8486704;7614;5916;64334;38299;26035;51272;39164;12108;;14760;0.17;81053;0.96;8501464
1171;West-Nederland (LD);2022 september;8501464;7653;5756;61786;37037;24749;46592;36847;9745;;17091;0.2;98144;1.17;8518555
1172;West-Nederland (LD);2022 oktober;8518555;7172;6528;49925;34094;15831;42766;34265;8501;;7803;0.09;105947;1.26;8526358
1173;West-Nederland (LD);2022 november;8526358;6669;6267;48350;32915;15435;40072;32669;7403;;8680;0.1;114627;1.36;8535038
1174;West-Nederland (LD);2022 december;8535038;6604;7778;45402;33560;11842;42581;33951;8630;-390.0;1257;0.01;115884;1.38;8536295
1175;West-Nederland (LD);2022;8420411;83971;75993;608262;396825;211437;499966;400005;99961;-390.0;115884;1.38;115884;1.38;8536295
1176;West-Nederland (LD);2023 januari;8536295;6658;7399;48180;34514;13666;43957;34635;9322;0.0;3482;0.04;3482;0.04;8539777
1177;West-Nederland (LD);2023 februari;8539777;6069;6192;47269;31738;15531;39271;31059;8212;0.0;7875;0.09;11357;0.13;8547652
1178;West-Nederland (LD);2023 maart;8547652;6910;7112;47189;33933;13256;41532;33297;8235;0.0;5455;0.06;16812;0.2;8553107
1179;West-Nederland (LD);2023 april;8553107;6493;5927;40183;29445;10738;36700;29558;7142;0.0;4049;0.05;20861;0.24;8557156
1180;West-Nederland (LD);2023 mei;8557156;7183;5873;42966;31071;11895;38154;30924;7230;0.0;6122;0.07;26983;0.32;8563278
1181;West-Nederland (LD);2023 juni;8563278;7052;5805;45431;33102;12329;42544;33072;9472;0.0;4134;0.05;31117;0.36;8567412
1182;West-Nederland (LD);2023 juli;8567412;7385;5713;51478;38533;12945;50984;38802;12182;0.0;2166;0.03;33283;0.39;8569578
1183;West-Nederland (LD);2023 augustus;8569578;7436;5673;63450;41092;22358;53533;41191;12342;0.0;11680;0.14;44963;0.53;8581258
1184;West-Nederland (LD);2023 september;8581258;6869;5865;60347;38514;21833;47662;37716;9946;0.0;13689;0.16;58652;0.69;8594947
1185;West-Nederland (LD);2023 oktober;8594947;7030;6331;50841;35005;15836;42917;34348;8569;0.0;8623;0.1;67275;0.79;8603570
1186;West-Nederland (LD);2023 november;8603570;6832;6699;45697;32747;12950;40016;31969;8047;0.0;5814;0.07;73089;0.86;8609384
1187;West-Nederland (LD);2023 december;8609384;6484;7224;42637;32796;9841;42102;32776;9326;-541.0;-746;-0.01;72343;0.85;8608638
1188;West-Nederland (LD);2023;8536295;82401;75813;585668;412490;173178;519372;409347;110025;-541.0;72343;0.85;72343;0.85;8608638
1189;West-Nederland (LD);2024 januari;8608638;6859;7549;46282;33987;12295;43699;33584;10115;;1893;0.02;1893;0.02;8610531
1190;West-Nederland (LD);2024 februari;8610531;6433;6693;45280;31893;13387;39386;31144;8242;;5634;0.07;7527;0.09;8616165
1191;West-Nederland (LD);2024 maart;8616165;6942;6867;43121;32138;10983;39102;31587;7515;;4094;0.05;11621;0.13;8620259
1192;West-Nederland (LD);2024 april;8620259;6628;6324;41443;30764;10679;37122;30138;6984;;4625;0.05;16246;0.19;8624884
1193;West-Nederland (LD);2024 mei;8624884;7105;6111;40618;30862;9756;38123;30731;7392;;3489;0.04;19735;0.23;8628373
1194;West-Nederland (LD);2024 juni;8628373;6919;5874;39713;29807;9906;38787;29305;9482;;1971;0.02;21706;0.25;8630344
1195;West-Nederland (LD);2024 juli;8630344;7313;5919;48828;36107;12721;49579;36458;13121;;643;0.01;22349;0.26;8630987
1196;West-Nederland (LD);2024 augustus;8630987;7465;5926;56567;36879;19688;49899;37714;12185;;8207;0.1;30556;0.35;8639194
1197;West-Nederland (LD);2024 september;8639194;7186;5799;55618;35122;20496;46044;35526;10518;;10961;0.13;41517;0.48;8650155
1198;West-Nederland (LD);2024 oktober;8650155;7075;6441;49045;35337;13708;44658;34984;9674;;5021;0.06;46538;0.54;8655176
1199;West-Nederland (LD);2024 november;8655176;6630;6327;43723;32551;11172;40435;32144;8291;;3591;0.04;50129;0.58;8658767
1200;West-Nederland (LD);2024 december;8658767;6573;6730;42740;33391;9349;43416;33505;9911;0.0;-833;-0.01;49296;0.57;8657934
1201;West-Nederland (LD);2024;8608638;83128;76560;552978;398838;154140;510250;396820;113430;0.0;49296;0.57;49296;0.57;8657934
1202;West-Nederland (LD);2025 januari;8657934;6845;7734;51146;36780;14366;45660;36281;9379;;4597;0.05;4597;0.05;8662531
1203;West-Nederland (LD);2025 februari;8662531;6069;7089;47112;32943;14169;41592;33122;8470;;4500;0.05;9097;0.11;8667031
1204;Zuid-Nederland (LD);2002 januari;3534419;3416;2889;12815;10726;2089;12682;10786;1896;;660;0.02;660;0.02;3535079
1205;Zuid-Nederland (LD);2002 februari;3535079;3162;2667;10266;8646;1620;10374;8734;1640;;387;0.01;1047;0.03;3535466
1206;Zuid-Nederland (LD);2002 maart;3535466;3352;3071;11363;9581;1782;11437;9459;1978;;207;0.01;1254;0.04;3535673
1207;Zuid-Nederland (LD);2002 april;3535673;3175;2519;10375;8700;1675;10413;8570;1843;;618;0.02;1872;0.05;3536291
1208;Zuid-Nederland (LD);2002 mei;3536291;3441;2472;11247;9499;1748;11419;9474;1945;;797;0.02;2669;0.08;3537088
1209;Zuid-Nederland (LD);2002 juni;3537088;3287;2405;10487;8910;1577;10915;8752;2163;;454;0.01;3123;0.09;3537542
1210;Zuid-Nederland (LD);2002 juli;3537542;3642;2466;13445;11457;1988;13754;11348;2406;;867;0.02;3990;0.11;3538409
1211;Zuid-Nederland (LD);2002 augustus;3538409;3681;2328;14420;12059;2361;14466;12209;2257;;1307;0.04;5297;0.15;3539716
1212;Zuid-Nederland (LD);2002 september;3539716;3582;2203;13070;10921;2149;13614;11254;2360;;835;0.02;6132;0.17;3540551
1213;Zuid-Nederland (LD);2002 oktober;3540551;3530;2549;12176;10184;1992;12649;10399;2250;;508;0.01;6640;0.19;3541059
1214;Zuid-Nederland (LD);2002 november;3541059;3141;2443;10845;9453;1392;11352;9620;1732;;191;0.01;6831;0.19;3541250
1215;Zuid-Nederland (LD);2002 december;3541250;3253;2756;10380;9205;1175;11186;9403;1783;1146.0;837;0.02;7668;0.22;3542087
1216;Zuid-Nederland (LD);2002;3534419;40662;30768;140889;119341;21548;144261;120008;24253;1146.0;7668;0.22;7668;0.22;3542087
1217;Zuid-Nederland (LD);2003 januari;3542087;3518;2730;12480;10618;1862;12802;10882;1920;;466;0.01;466;0.01;3542553
1218;Zuid-Nederland (LD);2003 februari;3542553;3089;2414;10436;8922;1514;11035;9239;1796;;76;0.0;542;0.02;3542629
1219;Zuid-Nederland (LD);2003 maart;3542629;3379;2832;9938;8535;1403;10586;8794;1792;;-101;0.0;441;0.01;3542528
1220;Zuid-Nederland (LD);2003 april;3542528;3182;2652;10027;8637;1390;10566;8894;1672;;-9;0.0;432;0.01;3542519
1221;Zuid-Nederland (LD);2003 mei;3542519;3317;2389;9859;8506;1353;10156;8712;1444;;631;0.02;1063;0.03;3543150
1222;Zuid-Nederland (LD);2003 juni;3543150;3361;2437;10662;9207;1455;10995;9088;1907;;591;0.02;1654;0.05;3543741
1223;Zuid-Nederland (LD);2003 juli;3543741;3705;2486;12736;10964;1772;13216;10941;2275;;739;0.02;2393;0.07;3544480
1224;Zuid-Nederland (LD);2003 augustus;3544480;3470;2684;13015;11142;1873;13604;11260;2344;;197;0.01;2590;0.07;3544677
1225;Zuid-Nederland (LD);2003 september;3544677;3462;2354;13468;11465;2003;13659;11630;2029;;917;0.03;3507;0.1;3545594
1226;Zuid-Nederland (LD);2003 oktober;3545594;3289;2505;12187;10466;1721;12949;10645;2304;;22;0.0;3529;0.1;3545616
1227;Zuid-Nederland (LD);2003 november;3545616;3043;2489;10641;9281;1360;11131;9312;1819;;64;0.0;3593;0.1;3545680
1228;Zuid-Nederland (LD);2003 december;3545680;3155;2771;10813;9717;1096;12038;9952;2086;1490.0;649;0.02;4242;0.12;3546329
1229;Zuid-Nederland (LD);2003;3542087;39970;30743;136262;117460;18802;142737;119349;23388;1490.0;4242;0.12;4242;0.12;3546329
1230;Zuid-Nederland (LD);2004 januari;3546329;3163;2940;11107;9753;1354;12033;9941;2092;;-703;-0.02;-703;-0.02;3545626
1231;Zuid-Nederland (LD);2004 februari;3545626;3009;2479;9573;8455;1118;10301;8479;1822;;-198;-0.01;-901;-0.03;3545428
1232;Zuid-Nederland (LD);2004 maart;3545428;3136;2646;11046;9643;1403;11951;9611;2340;;-415;-0.01;-1316;-0.04;3545013
1233;Zuid-Nederland (LD);2004 april;3545013;3066;2389;9615;8535;1080;10542;8501;2041;;-250;-0.01;-1566;-0.04;3544763
1234;Zuid-Nederland (LD);2004 mei;3544763;3186;2460;9166;8028;1138;9440;8036;1404;;452;0.01;-1114;-0.03;3545215
1235;Zuid-Nederland (LD);2004 juni;3545215;3195;2367;11075;9613;1462;11507;9579;1928;;396;0.01;-718;-0.02;3545611
1236;Zuid-Nederland (LD);2004 juli;3545611;3422;2290;12682;11116;1566;13559;11104;2455;;255;0.01;-463;-0.01;3545866
1237;Zuid-Nederland (LD);2004 augustus;3545866;3357;2427;13620;11765;1855;14403;12209;2194;;147;0.0;-316;-0.01;3546013
1238;Zuid-Nederland (LD);2004 september;3546013;3322;2282;13772;11693;2079;14191;12027;2164;;621;0.02;305;0.01;3546634
1239;Zuid-Nederland (LD);2004 oktober;3546634;3184;2524;10697;9231;1466;11436;9574;1862;;-79;0.0;226;0.01;3546555
1240;Zuid-Nederland (LD);2004 november;3546555;3073;2314;11122;9543;1579;11467;9601;1866;;414;0.01;640;0.02;3546969
1241;Zuid-Nederland (LD);2004 december;3546969;3072;2619;11007;9813;1194;11784;9957;1827;1409.0;1085;0.03;1725;0.05;3548054
1242;Zuid-Nederland (LD);2004;3546329;38185;29737;134482;117188;17294;142614;118619;23995;1409.0;1725;0.05;1725;0.05;3548054
1243;Zuid-Nederland (LD);2005 januari;3548054;3041;2672;11495;10024;1471;12101;10080;2021;;-237;-0.01;-237;-0.01;3547817
1244;Zuid-Nederland (LD);2005 februari;3547817;2924;3009;9956;8720;1236;10441;8814;1627;;-570;-0.02;-807;-0.02;3547247
1245;Zuid-Nederland (LD);2005 maart;3547247;3084;3063;10581;9164;1417;10961;9178;1783;;-359;-0.01;-1166;-0.03;3546888
1246;Zuid-Nederland (LD);2005 april;3546888;2941;2413;10754;9441;1313;11174;9349;1825;;108;0.0;-1058;-0.03;3546996
1247;Zuid-Nederland (LD);2005 mei;3546996;2961;2474;9628;8393;1235;10050;8470;1580;;65;0.0;-993;-0.03;3547061
1248;Zuid-Nederland (LD);2005 juni;3547061;3041;2374;11184;9759;1425;11824;9623;2201;;27;0.0;-966;-0.03;3547088
1249;Zuid-Nederland (LD);2005 juli;3547088;3262;2255;12615;11173;1442;13274;11193;2081;;348;0.01;-618;-0.02;3547436
1250;Zuid-Nederland (LD);2005 augustus;3547436;3269;2247;14946;13131;1815;15640;13053;2587;;328;0.01;-290;-0.01;3547764
1251;Zuid-Nederland (LD);2005 september;3547764;3182;2171;14415;12253;2162;15110;12824;2286;;316;0.01;26;0.0;3548080
1252;Zuid-Nederland (LD);2005 oktober;3548080;3093;2307;11727;10158;1569;12686;10626;2060;;-173;0.0;-147;0.0;3547907
1253;Zuid-Nederland (LD);2005 november;3547907;2754;2237;11414;9864;1550;12089;10045;2044;;-158;0.0;-305;-0.01;3547749
1254;Zuid-Nederland (LD);2005 december;3547749;2800;2585;11474;10140;1334;12357;10267;2090;803.0;135;0.0;-170;0.0;3547884
1255;Zuid-Nederland (LD);2005;3548054;36352;29807;140189;122220;17969;147707;123522;24185;803.0;-170;0.0;-170;0.0;3547884
1256;Zuid-Nederland (LD);2006 januari;3547884;2988;2682;12417;10892;1525;13234;11110;2124;;-511;-0.01;-511;-0.01;3547373
1257;Zuid-Nederland (LD);2006 februari;3547373;2740;2465;10450;9053;1397;11071;9268;1803;;-346;-0.01;-857;-0.02;3547027
1258;Zuid-Nederland (LD);2006 maart;3547027;3015;2682;11986;10400;1586;12705;10466;2239;;-386;-0.01;-1243;-0.04;3546641
1259;Zuid-Nederland (LD);2006 april;3546641;2801;2463;9660;8290;1370;10412;8517;1895;;-414;-0.01;-1657;-0.05;3546227
1260;Zuid-Nederland (LD);2006 mei;3546227;3041;2396;10692;9235;1457;11112;9286;1826;;225;0.01;-1432;-0.04;3546452
1261;Zuid-Nederland (LD);2006 juni;3546452;2953;2393;10960;9500;1460;11516;9480;2036;;4;0.0;-1428;-0.04;3546456
1262;Zuid-Nederland (LD);2006 juli;3546456;3143;2744;13059;11352;1707;13871;11462;2409;;-413;-0.01;-1841;-0.05;3546043
1263;Zuid-Nederland (LD);2006 augustus;3546043;3251;2305;16208;13899;2309;16729;13963;2766;;425;0.01;-1416;-0.04;3546468
1264;Zuid-Nederland (LD);2006 september;3546468;3159;2319;13672;11571;2101;14578;12118;2460;;-66;0.0;-1482;-0.04;3546402
1265;Zuid-Nederland (LD);2006 oktober;3546402;3069;2238;12622;10740;1882;13225;11126;2099;;228;0.01;-1254;-0.04;3546630
1266;Zuid-Nederland (LD);2006 november;3546630;2871;2410;11586;9962;1624;12306;10266;2040;;-259;-0.01;-1513;-0.04;3546371
1267;Zuid-Nederland (LD);2006 december;3546371;2833;2532;10372;9182;1190;11205;9296;1909;1008.0;476;0.01;-1037;-0.03;3546847
1268;Zuid-Nederland (LD);2006;3547884;35864;29629;143684;124076;19608;151964;126358;25606;1008.0;-1037;-0.03;-1037;-0.03;3546847
1269;Zuid-Nederland (LD);2007 januari;3546847;2855;2669;12713;11054;1659;13361;11210;2151;;-462;-0.01;-462;-0.01;3546385
1270;Zuid-Nederland (LD);2007 februari;3546385;2632;2414;10800;9342;1458;11359;9490;1869;;-341;-0.01;-803;-0.02;3546044
1271;Zuid-Nederland (LD);2007 maart;3546044;2877;2694;11665;10028;1637;12277;10247;2030;;-429;-0.01;-1232;-0.03;3545615
1272;Zuid-Nederland (LD);2007 april;3545615;2785;2419;9813;8518;1295;10096;8475;1621;;83;0.0;-1149;-0.03;3545698
1273;Zuid-Nederland (LD);2007 mei;3545698;2864;2323;10993;9422;1571;10999;9239;1760;;535;0.02;-614;-0.02;3546233
1274;Zuid-Nederland (LD);2007 juni;3546233;2864;2280;11529;9761;1768;11585;9627;1958;;528;0.01;-86;0.0;3546761
1275;Zuid-Nederland (LD);2007 juli;3546761;3123;2243;13870;11851;2019;14041;11577;2464;;709;0.02;623;0.02;3547470
1276;Zuid-Nederland (LD);2007 augustus;3547470;3180;2315;15127;12710;2417;15659;13047;2612;;333;0.01;956;0.03;3547803
1277;Zuid-Nederland (LD);2007 september;3547803;3049;2195;13131;10722;2409;13604;11507;2097;;381;0.01;1337;0.04;3548184
1278;Zuid-Nederland (LD);2007 oktober;3548184;3016;2463;12845;10475;2370;12989;10880;2109;;409;0.01;1746;0.05;3548593
1279;Zuid-Nederland (LD);2007 november;3548593;2745;2517;11969;10143;1826;12560;10327;2233;;-363;-0.01;1383;0.04;3548230
1280;Zuid-Nederland (LD);2007 december;3548230;2795;2740;10205;8822;1383;10842;9078;1764;884.0;302;0.01;1685;0.05;3548532
1281;Zuid-Nederland (LD);2007;3546847;34785;29272;144660;122848;21812;149372;124704;24668;884.0;1685;0.05;1685;0.05;3548532
1282;Zuid-Nederland (LD);2008 januari;3548532;2945;2776;13749;11379;2370;13670;11664;2006;;248;0.01;248;0.01;3548780
1283;Zuid-Nederland (LD);2008 februari;3548780;2777;2626;11452;9549;1903;11447;9689;1758;;156;0.0;404;0.01;3548936
1284;Zuid-Nederland (LD);2008 maart;3548936;2783;2732;11315;9425;1890;11158;9381;1777;;208;0.01;612;0.02;3549144
1285;Zuid-Nederland (LD);2008 april;3549144;2829;2484;11821;9795;2026;11639;9859;1780;;527;0.01;1139;0.03;3549671
1286;Zuid-Nederland (LD);2008 mei;3549671;3056;2523;10564;8820;1744;10220;8724;1496;;877;0.02;2016;0.06;3550548
1287;Zuid-Nederland (LD);2008 juni;3550548;3028;2302;11519;9489;2030;11237;9402;1835;;1008;0.03;3024;0.09;3551556
1288;Zuid-Nederland (LD);2008 juli;3551556;3293;2353;14214;11945;2269;14363;11968;2395;;791;0.02;3815;0.11;3552347
1289;Zuid-Nederland (LD);2008 augustus;3552347;3159;2367;15401;12442;2959;14901;12497;2404;;1292;0.04;5107;0.14;3553639
1290;Zuid-Nederland (LD);2008 september;3553639;3161;2206;15263;11752;3511;14574;12474;2100;;1644;0.05;6751;0.19;3555283
1291;Zuid-Nederland (LD);2008 oktober;3555283;2979;2389;13140;10511;2629;13023;11006;2017;;707;0.02;7458;0.21;3555990
1292;Zuid-Nederland (LD);2008 november;3555990;2662;2442;11164;9083;2081;10966;9256;1710;;418;0.01;7876;0.22;3556408
1293;Zuid-Nederland (LD);2008 december;3556408;2716;2824;11612;9716;1896;11553;9882;1671;805.0;756;0.02;8632;0.24;3557164
1294;Zuid-Nederland (LD);2008;3548532;35388;30024;151214;123906;27308;148751;125802;22949;805.0;8632;0.24;8632;0.24;3557164
1295;Zuid-Nederland (LD);2009 januari;3557164;2961;3084;12160;9945;2215;11993;10064;1929;;44;0.0;44;0.0;3557208
1296;Zuid-Nederland (LD);2009 februari;3557208;2612;2657;10999;8867;2132;10545;9004;1541;;409;0.01;453;0.01;3557617
1297;Zuid-Nederland (LD);2009 maart;3557617;2901;2636;11354;9156;2198;11271;9519;1752;;348;0.01;801;0.02;3557965
1298;Zuid-Nederland (LD);2009 april;3557965;2859;2407;10298;8419;1879;10297;8583;1714;;453;0.01;1254;0.04;3558418
1299;Zuid-Nederland (LD);2009 mei;3558418;2903;2404;9785;8011;1774;9477;8053;1424;;807;0.02;2061;0.06;3559225
1300;Zuid-Nederland (LD);2009 juni;3559225;3023;2248;10736;8511;2225;10424;8618;1806;;1087;0.03;3148;0.09;3560312
1301;Zuid-Nederland (LD);2009 juli;3560312;3247;2386;13726;11109;2617;13181;10976;2205;;1406;0.04;4554;0.13;3561718
1302;Zuid-Nederland (LD);2009 augustus;3561718;3180;2278;13860;11142;2718;13568;11544;2024;;1194;0.03;5748;0.16;3562912
1303;Zuid-Nederland (LD);2009 september;3562912;3102;2218;15269;11497;3772;14079;12226;1853;;2074;0.06;7822;0.22;3564986
1304;Zuid-Nederland (LD);2009 oktober;3564986;2961;2521;12211;9440;2771;11814;9935;1879;;837;0.02;8659;0.24;3565823
1305;Zuid-Nederland (LD);2009 november;3565823;2811;2390;10810;8793;2017;10899;9178;1721;;332;0.01;8991;0.25;3566155
1306;Zuid-Nederland (LD);2009 december;3566155;2780;2521;10665;9090;1575;10823;9122;1701;603.0;704;0.02;9695;0.27;3566859
1307;Zuid-Nederland (LD);2009;3557164;35340;29750;141873;113980;27893;138371;116822;21549;603.0;9695;0.27;9695;0.27;3566859
1308;Zuid-Nederland (LD);2010 januari;3566859;2811;2817;11651;9547;2104;11655;9927;1728;;-10;0.0;-10;0.0;3566849
1309;Zuid-Nederland (LD);2010 februari;3566849;2666;2512;11098;8880;2218;10280;8963;1317;;972;0.03;962;0.03;3567821
1310;Zuid-Nederland (LD);2010 maart;3567821;2778;2623;11731;9395;2336;11503;9532;1971;;383;0.01;1345;0.04;3568204
1311;Zuid-Nederland (LD);2010 april;3568204;2739;2476;9848;8156;1692;9869;8266;1603;;242;0.01;1587;0.04;3568446
1312;Zuid-Nederland (LD);2010 mei;3568446;2900;2501;9758;7986;1772;9631;8179;1452;;526;0.01;2113;0.06;3568972
1313;Zuid-Nederland (LD);2010 juni;3568972;2929;2317;11030;8774;2256;10384;8726;1658;;1258;0.04;3371;0.09;3570230
1314;Zuid-Nederland (LD);2010 juli;3570230;3142;2474;12998;10458;2540;12462;10347;2115;;1204;0.03;4575;0.13;3571434
1315;Zuid-Nederland (LD);2010 augustus;3571434;3145;2357;14836;11966;2870;14311;12264;2047;;1313;0.04;5888;0.17;3572747
1316;Zuid-Nederland (LD);2010 september;3572747;3197;2380;15278;11141;4137;14076;11886;2190;;2019;0.06;7907;0.22;3574766
1317;Zuid-Nederland (LD);2010 oktober;3574766;3037;2522;12489;9154;3335;11443;9662;1781;;1561;0.04;9468;0.27;3576327
1318;Zuid-Nederland (LD);2010 november;3576327;2934;2473;11256;8834;2422;11100;9215;1885;;617;0.02;10085;0.28;3576944
1319;Zuid-Nederland (LD);2010 december;3576944;2887;2741;10596;8695;1901;10741;8971;1770;-103.0;-102;0.0;9983;0.28;3576842
1320;Zuid-Nederland (LD);2010;3566859;35165;30193;142569;112986;29583;137455;115938;21517;-103.0;9983;0.28;9983;0.28;3576842
1321;Zuid-Nederland (LD);2011 januari;3576842;2871;2702;12207;9917;2290;12001;10098;1903;;375;0.01;375;0.01;3577217
1322;Zuid-Nederland (LD);2011 februari;3577217;2705;2358;11685;9085;2600;10751;9241;1510;;1281;0.04;1656;0.05;3578498
1323;Zuid-Nederland (LD);2011 maart;3578498;2676;2696;11195;8972;2223;10978;9236;1742;;197;0.01;1853;0.05;3578695
1324;Zuid-Nederland (LD);2011 april;3578695;2709;2598;10214;8247;1967;10406;8351;2055;;-81;0.0;1772;0.05;3578614
1325;Zuid-Nederland (LD);2011 mei;3578614;2907;2534;10594;8635;1959;10464;8646;1818;;503;0.01;2275;0.06;3579117
1326;Zuid-Nederland (LD);2011 juni;3579117;2889;2349;10421;8272;2149;10102;8135;1967;;859;0.02;3134;0.09;3579976
1327;Zuid-Nederland (LD);2011 juli;3579976;3135;2360;13382;10971;2411;13206;10729;2477;;951;0.03;4085;0.11;3580927
1328;Zuid-Nederland (LD);2011 augustus;3580927;3095;2405;17488;13033;4455;15876;13020;2856;;2302;0.06;6387;0.18;3583229
1329;Zuid-Nederland (LD);2011 september;3583229;3070;2316;16416;11354;5062;14281;11827;2454;;2889;0.08;9276;0.26;3586118
1330;Zuid-Nederland (LD);2011 oktober;3586118;2832;2454;11872;9329;2543;11513;9551;1962;;737;0.02;10013;0.28;3586855
1331;Zuid-Nederland (LD);2011 november;3586855;2693;2577;11475;9319;2156;11424;9546;1878;;167;0.0;10180;0.28;3587022
1332;Zuid-Nederland (LD);2011 december;3587022;2721;2868;11297;9400;1897;11484;9513;1971;73.0;-261;-0.01;9919;0.28;3586761
1333;Zuid-Nederland (LD);2011;3576842;34303;30217;148246;116534;31712;142486;117893;24593;73.0;9919;0.28;9919;0.28;3586761
1334;Zuid-Nederland (LD);2012 januari;3586761;2691;2851;12965;10725;2240;13213;10753;2460;;-408;-0.01;-408;-0.01;3586353
1335;Zuid-Nederland (LD);2012 februari;3586353;2599;2800;11658;9297;2361;11173;9525;1648;;284;0.01;-124;0.0;3586637
1336;Zuid-Nederland (LD);2012 maart;3586637;2750;2957;11678;9393;2285;11423;9393;2030;;48;0.0;-76;0.0;3586685
1337;Zuid-Nederland (LD);2012 april;3586685;2731;2605;9842;7971;1871;10142;8148;1994;;-174;0.0;-250;-0.01;3586511
1338;Zuid-Nederland (LD);2012 mei;3586511;2849;2578;10862;8825;2037;10582;8796;1786;;551;0.02;301;0.01;3587062
1339;Zuid-Nederland (LD);2012 juni;3587062;2801;2449;12089;9892;2197;11964;9751;2213;;477;0.01;778;0.02;3587539
1340;Zuid-Nederland (LD);2012 juli;3587539;2855;2382;14033;11353;2680;13948;11343;2605;;558;0.02;1336;0.04;3588097
1341;Zuid-Nederland (LD);2012 augustus;3588097;3065;2444;17695;13346;4349;15959;13502;2457;;2357;0.07;3693;0.1;3590454
1342;Zuid-Nederland (LD);2012 september;3590454;2946;2346;15572;10549;5023;13551;11315;2236;;2621;0.07;6314;0.18;3593075
1343;Zuid-Nederland (LD);2012 oktober;3593075;2777;2551;12598;9938;2660;12541;10433;2108;;283;0.01;6597;0.18;3593358
1344;Zuid-Nederland (LD);2012 november;3593358;2581;2649;11591;9475;2116;11530;9719;1811;;-7;0.0;6590;0.18;3593351
1345;Zuid-Nederland (LD);2012 december;3593351;2491;2835;10792;9185;1607;10940;9215;1725;43.0;-449;-0.01;6141;0.17;3592902
1346;Zuid-Nederland (LD);2012;3586761;33136;31447;151375;119949;31426;146966;121893;25073;43.0;6141;0.17;6141;0.17;3592902
1347;Zuid-Nederland (LD);2013 januari;3592902;2709;2923;13531;11035;2496;13327;11081;2246;;-10;0.0;-10;0.0;3592892
1348;Zuid-Nederland (LD);2013 februari;3592892;2351;2793;11724;9277;2447;11076;9494;1582;;206;0.01;196;0.01;3593098
1349;Zuid-Nederland (LD);2013 maart;3593098;2603;3254;11819;9495;2324;11509;9528;1981;;-341;-0.01;-145;0.0;3592757
1350;Zuid-Nederland (LD);2013 april;3592757;2600;2731;10566;8380;2186;10107;8404;1703;;328;0.01;183;0.01;3593085
1351;Zuid-Nederland (LD);2013 mei;3593085;2765;2552;11087;8871;2216;10628;8752;1876;;672;0.02;855;0.02;3593757
1352;Zuid-Nederland (LD);2013 juni;3593757;2715;2399;10805;8535;2270;10641;8544;2097;;480;0.01;1335;0.04;3594237
1353;Zuid-Nederland (LD);2013 juli;3594237;3105;2512;14479;11518;2961;14441;11436;3005;;631;0.02;1966;0.05;3594868
1354;Zuid-Nederland (LD);2013 augustus;3594868;2965;2425;17848;13673;4175;16555;13753;2802;;1833;0.05;3799;0.11;3596701
1355;Zuid-Nederland (LD);2013 september;3596701;2866;2213;16880;11596;5284;14778;12440;2338;;2755;0.08;6554;0.18;3599456
1356;Zuid-Nederland (LD);2013 oktober;3599456;2744;2582;12914;10107;2807;12863;10645;2218;;213;0.01;6767;0.19;3599669
1357;Zuid-Nederland (LD);2013 november;3599669;2540;2523;11799;9540;2259;11971;9839;2132;;-155;0.0;6612;0.18;3599514
1358;Zuid-Nederland (LD);2013 december;3599514;2606;2697;11966;10025;1941;12165;9958;2207;56.0;-234;-0.01;6378;0.18;3599280
1359;Zuid-Nederland (LD);2013;3592902;32569;31604;155418;122052;33366;150061;123874;26187;56.0;6378;0.18;6378;0.18;3599280
1360;Zuid-Nederland (LD);2014 januari;3599280;2676;2723;14524;11593;2931;14196;11637;2559;;281;0.01;281;0.01;3599561
1361;Zuid-Nederland (LD);2014 februari;3599561;2483;2550;13257;10314;2943;12386;10396;1990;;804;0.02;1085;0.03;3600365
1362;Zuid-Nederland (LD);2014 maart;3600365;2745;2727;12022;9421;2601;11395;9453;1942;;645;0.02;1730;0.05;3601010
1363;Zuid-Nederland (LD);2014 april;3601010;2641;2603;12048;9477;2571;11701;9630;2071;;385;0.01;2115;0.06;3601395
1364;Zuid-Nederland (LD);2014 mei;3601395;2735;2626;10725;8632;2093;10477;8609;1868;;357;0.01;2472;0.07;3601752
1365;Zuid-Nederland (LD);2014 juni;3601752;2851;2382;11696;9112;2584;11554;9137;2417;;611;0.02;3083;0.09;3602363
1366;Zuid-Nederland (LD);2014 juli;3602363;3020;2731;15630;12516;3114;15243;12213;3030;;676;0.02;3759;0.1;3603039
1367;Zuid-Nederland (LD);2014 augustus;3603039;2940;2476;18034;13940;4094;17099;14201;2898;;1399;0.04;5158;0.14;3604438
1368;Zuid-Nederland (LD);2014 september;3604438;2944;2433;18490;12656;5834;16171;13369;2802;;2830;0.08;7988;0.22;3607268
1369;Zuid-Nederland (LD);2014 oktober;3607268;2857;2691;13663;10614;3049;13860;11144;2716;;-31;0.0;7957;0.22;3607237
1370;Zuid-Nederland (LD);2014 november;3607237;2561;2714;12192;9673;2519;12100;10001;2099;;-61;0.0;7896;0.22;3607176
1371;Zuid-Nederland (LD);2014 december;3607176;2631;3090;13868;11283;2585;13859;11372;2487;-34.0;-484;-0.01;7412;0.21;3606692
1372;Zuid-Nederland (LD);2014;3599280;33084;31746;166149;129231;36918;160041;131162;28879;-34.0;7412;0.21;7412;0.21;3606692
1373;Zuid-Nederland (LD);2015 januari;3606692;2654;3419;14916;11680;3236;14348;11833;2515;;-197;-0.01;-197;-0.01;3606495
1374;Zuid-Nederland (LD);2015 februari;3606495;2284;3163;13592;10439;3153;12595;10689;1906;;118;0.0;-79;0.0;3606613
1375;Zuid-Nederland (LD);2015 maart;3606613;2495;3241;13882;10750;3132;13093;10714;2379;;43;0.0;-36;0.0;3606656
1376;Zuid-Nederland (LD);2015 april;3606656;2492;2807;12375;9635;2740;11851;9777;2074;;209;0.01;173;0.0;3606865
1377;Zuid-Nederland (LD);2015 mei;3606865;2756;2708;11689;9338;2351;11445;9371;2074;;292;0.01;465;0.01;3607157
1378;Zuid-Nederland (LD);2015 juni;3607157;2704;2537;13435;10420;3015;12878;10331;2547;;724;0.02;1189;0.03;3607881
1379;Zuid-Nederland (LD);2015 juli;3607881;3006;2651;16926;13208;3718;16375;13146;3229;;906;0.03;2095;0.06;3608787
1380;Zuid-Nederland (LD);2015 augustus;3608787;3041;2543;18827;14475;4352;17667;14740;2927;;1658;0.05;3753;0.1;3610445
1381;Zuid-Nederland (LD);2015 september;3610445;2963;2561;19856;13094;6762;16437;13659;2778;;3821;0.11;7574;0.21;3614266
1382;Zuid-Nederland (LD);2015 oktober;3614266;2717;2781;15160;11511;3649;14695;11955;2740;;401;0.01;7975;0.22;3614667
1383;Zuid-Nederland (LD);2015 november;3614667;2578;2592;13789;10614;3175;13247;11085;2162;;528;0.01;8503;0.24;3615195
1384;Zuid-Nederland (LD);2015 december;3615195;2605;2749;13997;11292;2705;14041;11434;2607;2.0;-186;-0.01;8317;0.23;3615009
1385;Zuid-Nederland (LD);2015;3606692;32295;33752;178444;136456;41988;168672;138734;29938;2.0;8317;0.23;8317;0.23;3615009
1386;Zuid-Nederland (LD);2016 januari;3615009;2693;3038;14984;11575;3409;14489;11929;2560;;150;0.0;150;0.0;3615159
1387;Zuid-Nederland (LD);2016 februari;3615159;2516;2920;15838;11717;4121;14206;12069;2137;;1228;0.03;1378;0.04;3616387
1388;Zuid-Nederland (LD);2016 maart;3616387;2625;3147;15745;11680;4065;14034;11707;2327;;1189;0.03;2567;0.07;3617576
1389;Zuid-Nederland (LD);2016 april;3617576;2628;2822;14853;11337;3516;13989;11672;2317;;670;0.02;3237;0.09;3618246
1390;Zuid-Nederland (LD);2016 mei;3618246;2777;2815;14264;10903;3361;13314;11236;2078;;912;0.03;4149;0.11;3619158
1391;Zuid-Nederland (LD);2016 juni;3619158;2779;2513;15350;11584;3766;14270;11847;2423;;1346;0.04;5495;0.15;3620504
1392;Zuid-Nederland (LD);2016 juli;3620504;3069;2665;17746;13994;3752;17305;14089;3216;;845;0.02;6340;0.18;3621349
1393;Zuid-Nederland (LD);2016 augustus;3621349;3093;2588;21716;16060;5656;19414;16314;3100;;2807;0.08;9147;0.25;3624156
1394;Zuid-Nederland (LD);2016 september;3624156;2865;2577;21872;14448;7424;17664;14965;2699;;4496;0.12;13643;0.38;3628652
1395;Zuid-Nederland (LD);2016 oktober;3628652;2789;2870;16074;12330;3744;14812;12633;2179;;1181;0.03;14824;0.41;3629833
1396;Zuid-Nederland (LD);2016 november;3629833;2573;2827;15474;12387;3087;14474;12287;2187;;746;0.02;15570;0.43;3630579
1397;Zuid-Nederland (LD);2016 december;3630579;2594;3113;15554;12945;2609;15485;12848;2637;-52.0;-502;-0.01;15068;0.42;3630077
1398;Zuid-Nederland (LD);2016;3615009;33001;33895;199470;150960;48510;183456;153596;29860;-52.0;15068;0.42;15068;0.42;3630077
1399;Zuid-Nederland (LD);2017 januari;3630077;2643;3509;16827;13576;3251;16064;13500;2564;;-103;0.0;-103;0.0;3629974
1400;Zuid-Nederland (LD);2017 februari;3629974;2390;3234;15894;12424;3470;14482;12381;2101;;568;0.02;465;0.01;3630542
1401;Zuid-Nederland (LD);2017 maart;3630542;2623;3077;16674;13134;3540;15062;12999;2063;;1158;0.03;1623;0.04;3631700
1402;Zuid-Nederland (LD);2017 april;3631700;2459;2670;13940;11134;2806;12933;10973;1960;;796;0.02;2419;0.07;3632496
1403;Zuid-Nederland (LD);2017 mei;3632496;2713;2758;15258;11996;3262;13980;11790;2190;;1233;0.03;3652;0.1;3633729
1404;Zuid-Nederland (LD);2017 juni;3633729;2618;2678;15481;12269;3212;14366;11960;2406;;1055;0.03;4707;0.13;3634784
1405;Zuid-Nederland (LD);2017 juli;3634784;2875;2664;18928;15083;3845;18251;14673;3578;;888;0.02;5595;0.15;3635672
1406;Zuid-Nederland (LD);2017 augustus;3635672;3085;2580;22354;16333;6021;19301;16083;3218;;3558;0.1;9153;0.25;3639230
1407;Zuid-Nederland (LD);2017 september;3639230;2944;2587;21479;14062;7417;17194;14472;2722;;4642;0.13;13795;0.38;3643872
1408;Zuid-Nederland (LD);2017 oktober;3643872;2820;2757;16953;12983;3970;15507;12986;2521;;1509;0.04;15304;0.42;3645381
1409;Zuid-Nederland (LD);2017 november;3645381;2643;2810;15827;12515;3312;14693;12417;2276;;967;0.03;16271;0.45;3646348
1410;Zuid-Nederland (LD);2017 december;3646348;2537;3223;15112;12702;2410;15135;12406;2729;-155.0;-864;-0.02;15407;0.42;3645484
1411;Zuid-Nederland (LD);2017;3630077;32350;34547;204727;158211;46516;186968;156640;30328;-155.0;15407;0.42;15407;0.42;3645484
1412;Zuid-Nederland (LD);2018 januari;3645484;2540;3278;16725;13192;3533;15928;13060;2868;;59;0.0;59;0.0;3645543
1413;Zuid-Nederland (LD);2018 februari;3645543;2308;3468;15510;11676;3834;13699;11541;2158;;651;0.02;710;0.02;3646194
1414;Zuid-Nederland (LD);2018 maart;3646194;2533;3814;16047;12720;3327;15390;12755;2635;;-624;-0.02;86;0.0;3645570
1415;Zuid-Nederland (LD);2018 april;3645570;2580;2771;13767;10713;3054;13069;10728;2341;;507;0.01;593;0.02;3646077
1416;Zuid-Nederland (LD);2018 mei;3646077;2836;2668;14735;11551;3184;13117;11156;1961;;1786;0.05;2379;0.07;3647863
1417;Zuid-Nederland (LD);2018 juni;3647863;2727;2596;15156;11831;3325;14099;11309;2790;;1188;0.03;3567;0.1;3649051
1418;Zuid-Nederland (LD);2018 juli;3649051;2930;2651;17913;13950;3963;17526;13489;4037;;666;0.02;4233;0.12;3649717
1419;Zuid-Nederland (LD);2018 augustus;3649717;2947;2632;22624;15688;6936;18316;14931;3385;;4623;0.13;8856;0.24;3654340
1420;Zuid-Nederland (LD);2018 september;3654340;2934;2597;19065;12646;6419;15473;12712;2761;;3929;0.11;12785;0.35;3658269
1421;Zuid-Nederland (LD);2018 oktober;3658269;2763;2760;17288;12761;4527;15669;12707;2962;;1622;0.04;14407;0.4;3659891
1422;Zuid-Nederland (LD);2018 november;3659891;2644;2802;16267;12343;3924;14882;12176;2706;;1227;0.03;15634;0.43;3661118
1423;Zuid-Nederland (LD);2018 december;3661118;2460;3029;14344;11575;2769;13882;11263;2619;-68.0;-175;0.0;15459;0.42;3660943
1424;Zuid-Nederland (LD);2018;3645484;32202;35066;199441;150646;48795;181050;147827;33223;-68.0;15459;0.42;15459;0.42;3660943
1425;Zuid-Nederland (LD);2019 januari;3660943;2721;3237;17626;13153;4473;15757;13010;2747;;1353;0.04;1353;0.04;3662296
1426;Zuid-Nederland (LD);2019 februari;3662296;2261;2982;16248;11827;4421;14072;11644;2428;;1455;0.04;2808;0.08;3663751
1427;Zuid-Nederland (LD);2019 maart;3663751;2570;3227;15350;11613;3737;14041;11656;2385;;652;0.02;3460;0.09;3664403
1428;Zuid-Nederland (LD);2019 april;3664403;2588;2956;15633;11887;3746;14041;11746;2295;;1224;0.03;4684;0.13;3665627
1429;Zuid-Nederland (LD);2019 mei;3665627;2702;2791;15535;11783;3752;13600;11483;2117;;1846;0.05;6530;0.18;3667473
1430;Zuid-Nederland (LD);2019 juni;3667473;2682;2647;13835;10617;3218;13014;10470;2544;;856;0.02;7386;0.2;3668329
1431;Zuid-Nederland (LD);2019 juli;3668329;2958;2772;18641;14236;4405;17624;13771;3853;;1203;0.03;8589;0.23;3669532
1432;Zuid-Nederland (LD);2019 augustus;3669532;2892;2648;21573;14627;6946;17398;14156;3242;;4419;0.12;13008;0.36;3673951
1433;Zuid-Nederland (LD);2019 september;3673951;2909;2534;20724;12916;7808;16448;12924;3524;;4651;0.13;17659;0.48;3678602
1434;Zuid-Nederland (LD);2019 oktober;3678602;2858;2875;17225;12600;4625;15801;12600;3201;;1407;0.04;19066;0.52;3680009
1435;Zuid-Nederland (LD);2019 november;3680009;2632;3031;15784;12065;3719;14472;11993;2479;;913;0.02;19979;0.55;3680922
1436;Zuid-Nederland (LD);2019 december;3680922;2354;3193;14941;11973;2968;14791;11748;3043;-77.0;-766;-0.02;19213;0.52;3680156
1437;Zuid-Nederland (LD);2019;3660943;32127;34893;203115;149297;53818;181059;147201;33858;-77.0;19213;0.52;19213;0.52;3680156
1438;Zuid-Nederland (LD);2020 januari;3680156;2615;3224;17737;13314;4423;16368;13166;3202;;760;0.02;760;0.02;3680916
1439;Zuid-Nederland (LD);2020 februari;3680916;2352;3022;16413;12067;4346;14183;11816;2367;;1560;0.04;2320;0.06;3682476
1440;Zuid-Nederland (LD);2020 maart;3682476;2618;4625;15835;12336;3499;14480;12010;2470;;-652;-0.02;1668;0.05;3681824
1441;Zuid-Nederland (LD);2020 april;3681824;2581;5184;13247;11078;2169;12923;11001;1922;;-2279;-0.06;-611;-0.02;3679545
1442;Zuid-Nederland (LD);2020 mei;3679545;2665;2993;14073;11746;2327;13510;11590;1920;;235;0.01;-376;-0.01;3679780
1443;Zuid-Nederland (LD);2020 juni;3679780;2627;2532;15544;12455;3089;14702;12282;2420;;937;0.03;561;0.02;3680717
1444;Zuid-Nederland (LD);2020 juli;3680717;3071;2591;19509;15361;4148;19507;15196;4311;;482;0.01;1043;0.03;3681199
1445;Zuid-Nederland (LD);2020 augustus;3681199;2932;2773;21929;15474;6455;18510;15311;3199;;3578;0.1;4621;0.13;3684777
1446;Zuid-Nederland (LD);2020 september;3684777;2900;2559;20938;14261;6677;17188;14493;2695;;4091;0.11;8712;0.24;3688868
1447;Zuid-Nederland (LD);2020 oktober;3688868;2730;3313;18799;14438;4361;17453;14417;3036;;763;0.02;9475;0.26;3689631
1448;Zuid-Nederland (LD);2020 november;3689631;2560;3401;16442;12612;3830;14938;12471;2467;;663;0.02;10138;0.28;3690294
1449;Zuid-Nederland (LD);2020 december;3690294;2414;3963;16289;12732;3557;15123;12569;2554;-90.0;-473;-0.01;9665;0.26;3689821
1450;Zuid-Nederland (LD);2020;3680156;32065;40180;206755;157874;48881;188885;156322;32563;-90.0;9665;0.26;9665;0.26;3689821
1451;Zuid-Nederland (LD);2021 januari;3689821;2678;4035;18418;14801;3617;16839;14530;2309;0.0;222;0.01;222;0.01;3690043
1452;Zuid-Nederland (LD);2021 februari;3690043;2635;3206;16428;12674;3754;14675;12751;1924;0.0;1182;0.03;1404;0.04;3691225
1453;Zuid-Nederland (LD);2021 maart;3691225;2864;3084;18219;14399;3820;16563;14143;2420;0.0;1436;0.04;2840;0.08;3692661
1454;Zuid-Nederland (LD);2021 april;3692661;2805;3136;16834;13324;3510;15453;13125;2328;0.0;1050;0.03;3890;0.11;3693711
1455;Zuid-Nederland (LD);2021 mei;3693711;2925;3027;15770;12366;3404;14328;12023;2305;0.0;1340;0.04;5230;0.14;3695051
1456;Zuid-Nederland (LD);2021 juni;3695051;2933;2760;16391;12259;4132;15034;12248;2786;0.0;1530;0.04;6760;0.18;3696581
1457;Zuid-Nederland (LD);2021 juli;3696581;3199;2910;19142;14560;4582;17187;13861;3326;0.0;2244;0.06;9004;0.24;3698825
1458;Zuid-Nederland (LD);2021 augustus;3698825;3136;2894;22562;14741;7821;17554;14167;3387;0.0;5250;0.14;14254;0.39;3704075
1459;Zuid-Nederland (LD);2021 september;3704075;3171;2772;21108;13221;7887;15950;12903;3047;0.0;5557;0.15;19811;0.54;3709632
1460;Zuid-Nederland (LD);2021 oktober;3709632;3055;3250;16896;12062;4834;15013;12081;2932;0.0;1688;0.05;21499;0.58;3711320
1461;Zuid-Nederland (LD);2021 november;3711320;2795;4184;16130;11722;4408;14162;11631;2531;0.0;579;0.02;22078;0.6;3711899
1462;Zuid-Nederland (LD);2021 december;3711899;2781;4332;16101;12436;3665;15207;11958;3249;-66.0;-723;-0.02;21355;0.58;3711176
1463;Zuid-Nederland (LD);2021;3689821;34977;39590;213999;158565;55434;187965;155421;32544;-66.0;21355;0.58;21355;0.58;3711176
1464;Zuid-Nederland (LD);2022 januari;3711176;2780;3317;16719;12393;4326;14785;12083;2702;;1397;0.04;1397;0.04;3712573
1465;Zuid-Nederland (LD);2022 februari;3712573;2451;3012;16009;11578;4431;13853;11397;2456;;1595;0.04;2992;0.08;3714168
1466;Zuid-Nederland (LD);2022 maart;3714168;2659;3711;22397;12749;9648;14963;12041;2922;;6382;0.17;9374;0.25;3720550
1467;Zuid-Nederland (LD);2022 april;3720550;2555;3254;20204;11772;8432;14013;11511;2502;;5492;0.15;14866;0.4;3726042
1468;Zuid-Nederland (LD);2022 mei;3726042;2662;3115;18413;11552;6861;14241;11593;2648;;3719;0.1;18585;0.5;3729761
1469;Zuid-Nederland (LD);2022 juni;3729761;2798;2916;18424;11923;6501;15211;11794;3417;;3095;0.08;21680;0.58;3732856
1470;Zuid-Nederland (LD);2022 juli;3732856;2931;3081;20187;13698;6489;17591;13262;4329;;2446;0.07;24126;0.65;3735302
1471;Zuid-Nederland (LD);2022 augustus;3735302;3045;3078;25500;14978;10522;18599;14617;3982;;6868;0.18;30994;0.84;3742170
1472;Zuid-Nederland (LD);2022 september;3742170;2928;2837;24344;14142;10202;18177;14345;3832;;6258;0.17;37252;1.0;3748428
1473;Zuid-Nederland (LD);2022 oktober;3748428;2906;3281;20267;13003;7264;16377;13133;3244;;3515;0.09;40767;1.1;3751943
1474;Zuid-Nederland (LD);2022 november;3751943;2593;3188;19227;12640;6587;16024;12878;3146;;2608;0.07;43375;1.17;3754551
1475;Zuid-Nederland (LD);2022 december;3754551;2431;3932;18396;13229;5167;16825;13323;3502;-44.0;26;0.0;43401;1.17;3754577
1476;Zuid-Nederland (LD);2022;3711176;32739;38722;240087;153657;86430;190659;151977;38682;-44.0;43401;1.17;43401;1.17;3754577
1477;Zuid-Nederland (LD);2023 januari;3754577;2616;3860;19911;13676;6235;17564;14026;3538;0.0;1103;0.03;1103;0.03;3755680
1478;Zuid-Nederland (LD);2023 februari;3755680;2434;3338;17744;11733;6011;15293;12464;2829;0.0;1547;0.04;2650;0.07;3757227
1479;Zuid-Nederland (LD);2023 maart;3757227;2593;3904;20008;13453;6555;17385;13983;3402;0.0;1312;0.03;3962;0.11;3758539
1480;Zuid-Nederland (LD);2023 april;3758539;2513;3196;16460;11570;4890;14658;11861;2797;0.0;1119;0.03;5081;0.14;3759658
1481;Zuid-Nederland (LD);2023 mei;3759658;2893;2992;17446;11980;5466;15522;12311;3211;0.0;1825;0.05;6906;0.18;3761483
1482;Zuid-Nederland (LD);2023 juni;3761483;2666;3092;18926;13170;5756;17352;13615;3737;0.0;1148;0.03;8054;0.21;3762631
1483;Zuid-Nederland (LD);2023 juli;3762631;2990;2837;20843;14773;6070;19580;14810;4770;0.0;1416;0.04;9470;0.25;3764047
1484;Zuid-Nederland (LD);2023 augustus;3764047;2861;2953;26173;15581;10592;19935;15884;4051;0.0;6146;0.16;15616;0.42;3770193
1485;Zuid-Nederland (LD);2023 september;3770193;2811;2893;21960;13096;8864;17560;14163;3397;0.0;4318;0.11;19934;0.53;3774511
1486;Zuid-Nederland (LD);2023 oktober;3774511;2771;3206;19863;12900;6963;16978;13563;3415;0.0;2450;0.06;22384;0.6;3776961
1487;Zuid-Nederland (LD);2023 november;3776961;2541;3361;18285;12500;5785;16109;13051;3058;0.0;1356;0.04;23740;0.63;3778317
1488;Zuid-Nederland (LD);2023 december;3778317;2517;3673;17528;12760;4768;16663;13029;3634;-32.0;-323;-0.01;23417;0.62;3777994
1489;Zuid-Nederland (LD);2023;3754577;32206;39305;235147;157192;77955;204599;162760;41839;-32.0;23417;0.62;23417;0.62;3777994
1490;Zuid-Nederland (LD);2024 januari;3777994;2649;3691;20317;13802;6515;17598;14136;3462;;1677;0.04;1677;0.04;3779671
1491;Zuid-Nederland (LD);2024 februari;3779671;2502;3589;19065;12538;6527;16567;13095;3472;;1411;0.04;3088;0.08;3781082
1492;Zuid-Nederland (LD);2024 maart;3781082;2592;3542;19514;13301;6213;17266;13774;3492;;1298;0.03;4386;0.12;3782380
1493;Zuid-Nederland (LD);2024 april;3782380;2594;3281;17767;12217;5550;15847;12610;3237;;1233;0.03;5619;0.15;3783613
1494;Zuid-Nederland (LD);2024 mei;3783613;2929;3241;17762;12091;5671;15639;12546;3093;;1811;0.05;7430;0.2;3785424
1495;Zuid-Nederland (LD);2024 juni;3785424;2763;2902;17307;12196;5111;16271;12545;3726;;897;0.02;8327;0.22;3786321
1496;Zuid-Nederland (LD);2024 juli;3786321;2820;3016;21222;14666;6556;20264;15074;5190;;762;0.02;9089;0.24;3787083
1497;Zuid-Nederland (LD);2024 augustus;3787083;2912;3166;25336;15808;9528;20307;15774;4533;;4775;0.13;13864;0.37;3791858
1498;Zuid-Nederland (LD);2024 september;3791858;2823;3145;22663;13614;9049;17831;13921;3910;;4510;0.12;18374;0.49;3796368
1499;Zuid-Nederland (LD);2024 oktober;3796368;2752;3375;21152;13383;7769;18033;14147;3886;;2496;0.07;20870;0.55;3798864
1500;Zuid-Nederland (LD);2024 november;3798864;2555;3222;19292;13030;6262;17182;13564;3618;;1443;0.04;22313;0.59;3800307
1501;Zuid-Nederland (LD);2024 december;3800307;2500;3485;18982;13595;5387;18434;14201;4233;0.0;-437;-0.01;21876;0.58;3799870
1502;Zuid-Nederland (LD);2024;3777994;32391;39655;240379;160241;80138;211239;165387;45852;0.0;21876;0.58;21876;0.58;3799870
1503;Zuid-Nederland (LD);2025 januari;3799870;2593;4014;21634;14738;6896;19493;15354;4139;;720;0.02;720;0.02;3800590
1504;Zuid-Nederland (LD);2025 februari;3800590;2368;3794;20566;13656;6910;17989;14443;3546;;1151;0.03;1871;0.05;3801741
1505;Groningen (PV);2002 januari;570480;527;549;2747;2177;570;2717;2436;281;;8;0.0;8;0.0;570488
1506;Groningen (PV);2002 februari;570488;536;408;2324;1959;365;2430;2202;228;;22;0.0;30;0.01;570510
1507;Groningen (PV);2002 maart;570510;571;521;2332;1972;360;2434;2125;309;;-52;-0.01;-22;0.0;570458
1508;Groningen (PV);2002 april;570458;501;508;2384;1959;425;2470;2211;259;;-93;-0.02;-115;-0.02;570365
1509;Groningen (PV);2002 mei;570365;540;460;2458;2125;333;2381;2235;146;;157;0.03;42;0.01;570522
1510;Groningen (PV);2002 juni;570522;495;446;2474;2052;422;2493;2209;284;;30;0.01;72;0.01;570552
1511;Groningen (PV);2002 juli;570552;560;422;3111;2642;469;3056;2776;280;;193;0.03;265;0.05;570745
1512;Groningen (PV);2002 augustus;570745;612;424;3891;3406;485;3137;2952;185;;942;0.17;1207;0.21;571687
1513;Groningen (PV);2002 september;571687;547;396;3662;3016;646;2924;2661;263;;889;0.16;2096;0.37;572576
1514;Groningen (PV);2002 oktober;572576;585;448;3024;2519;505;2856;2542;314;;305;0.05;2401;0.42;572881
1515;Groningen (PV);2002 november;572881;517;435;2707;2323;384;2611;2348;263;;178;0.03;2579;0.45;573059
1516;Groningen (PV);2002 december;573059;532;533;2244;2006;238;2377;2146;231;72.0;-62;-0.01;2517;0.44;572997
1517;Groningen (PV);2002;570480;6523;5550;33358;28156;5202;31886;28843;3043;72.0;2517;0.44;2517;0.44;572997
1518;Groningen (PV);2003 januari;572997;521;538;2867;2554;313;2793;2530;263;;57;0.01;57;0.01;573054
1519;Groningen (PV);2003 februari;573054;485;431;2433;2139;294;2433;2240;193;;54;0.01;111;0.02;573108
1520;Groningen (PV);2003 maart;573108;569;497;2237;1992;245;2415;2138;277;;-106;-0.02;5;0.0;573002
1521;Groningen (PV);2003 april;573002;554;492;2325;2099;226;2534;2183;351;;-147;-0.03;-142;-0.02;572855
1522;Groningen (PV);2003 mei;572855;544;469;2190;1953;237;2508;2167;341;;-243;-0.04;-385;-0.07;572612
1523;Groningen (PV);2003 juni;572612;479;443;2322;2066;256;2391;2102;289;;-33;-0.01;-418;-0.07;572579
1524;Groningen (PV);2003 juli;572579;599;453;2879;2520;359;2883;2540;343;;142;0.02;-276;-0.05;572721
1525;Groningen (PV);2003 augustus;572721;602;491;3634;3265;369;3034;2801;233;;711;0.12;435;0.08;573432
1526;Groningen (PV);2003 september;573432;565;405;3684;3163;521;3011;2804;207;;833;0.15;1268;0.22;574265
1527;Groningen (PV);2003 oktober;574265;526;429;2761;2467;294;2867;2508;359;;-9;0.0;1259;0.22;574256
1528;Groningen (PV);2003 november;574256;494;429;2270;2052;218;2261;2061;200;;74;0.01;1333;0.23;574330
1529;Groningen (PV);2003 december;574330;500;475;2236;2053;183;2420;2082;338;213.0;54;0.01;1387;0.24;574384
1530;Groningen (PV);2003;572997;6438;5552;31838;28323;3515;31550;28156;3394;213.0;1387;0.24;1387;0.24;574384
1531;Groningen (PV);2004 januari;574384;514;548;2451;2218;233;2591;2235;356;;-174;-0.03;-174;-0.03;574210
1532;Groningen (PV);2004 februari;574210;511;431;2306;2066;240;2292;2021;271;;94;0.02;-80;-0.01;574304
1533;Groningen (PV);2004 maart;574304;525;423;2388;2116;272;2677;2254;423;;-187;-0.03;-267;-0.05;574117
1534;Groningen (PV);2004 april;574117;525;435;2051;1814;237;2358;2055;303;;-217;-0.04;-484;-0.08;573900
1535;Groningen (PV);2004 mei;573900;464;441;2036;1811;225;2114;1878;236;;-55;-0.01;-539;-0.09;573845
1536;Groningen (PV);2004 juni;573845;487;440;2187;1925;262;2547;2237;310;;-313;-0.05;-852;-0.15;573532
1537;Groningen (PV);2004 juli;573532;513;425;2723;2494;229;3012;2715;297;;-201;-0.04;-1053;-0.18;573331
1538;Groningen (PV);2004 augustus;573331;543;433;3788;3397;391;3116;2844;272;;782;0.14;-271;-0.05;574113
1539;Groningen (PV);2004 september;574113;520;409;3744;3075;669;3209;2836;373;;646;0.11;375;0.07;574759
1540;Groningen (PV);2004 oktober;574759;501;394;2595;2317;278;2595;2232;363;;107;0.02;482;0.08;574866
1541;Groningen (PV);2004 november;574866;491;411;2411;2184;227;2345;2130;215;;146;0.03;628;0.11;575012
1542;Groningen (PV);2004 december;575012;547;521;2406;2166;240;2551;2252;299;179.0;60;0.01;688;0.12;575072
1543;Groningen (PV);2004;574384;6141;5311;31086;27583;3503;31407;27689;3718;179.0;688;0.12;688;0.12;575072
1544;Groningen (PV);2005 januari;575072;473;481;2499;2285;214;2762;2471;291;;-271;-0.05;-271;-0.05;574801
1545;Groningen (PV);2005 februari;574801;459;416;2438;2072;366;2409;2168;241;;72;0.01;-199;-0.03;574873
1546;Groningen (PV);2005 maart;574873;511;492;2249;2049;200;2455;2146;309;;-187;-0.03;-386;-0.07;574686
1547;Groningen (PV);2005 april;574686;470;471;2125;1950;175;2701;2155;546;;-577;-0.1;-963;-0.17;574109
1548;Groningen (PV);2005 mei;574109;489;456;2090;1926;164;2430;2074;356;;-307;-0.05;-1270;-0.22;573802
1549;Groningen (PV);2005 juni;573802;440;428;2197;1966;231;2412;2110;302;;-203;-0.04;-1473;-0.26;573599
1550;Groningen (PV);2005 juli;573599;528;409;2819;2570;249;3252;2721;531;;-314;-0.05;-1787;-0.31;573285
1551;Groningen (PV);2005 augustus;573285;518;393;3698;3394;304;3541;3182;359;;282;0.05;-1505;-0.26;573567
1552;Groningen (PV);2005 september;573567;555;386;4340;3571;769;3622;3239;383;;887;0.15;-618;-0.11;574454
1553;Groningen (PV);2005 oktober;574454;546;413;2926;2671;255;3081;2729;352;;-22;0.0;-640;-0.11;574432
1554;Groningen (PV);2005 november;574432;495;400;2529;2318;211;2699;2359;340;;-75;-0.01;-715;-0.12;574357
1555;Groningen (PV);2005 december;574357;459;471;2378;2207;171;2755;2371;384;74.0;-315;-0.05;-1030;-0.18;574042
1556;Groningen (PV);2005;575072;5943;5216;32288;28979;3309;34119;29725;4394;74.0;-1030;-0.18;-1030;-0.18;574042
1557;Groningen (PV);2006 januari;574042;480;506;2581;2414;167;2878;2555;323;;-323;-0.06;-323;-0.06;573719
1558;Groningen (PV);2006 februari;573719;460;448;2650;2388;262;2647;2425;222;;15;0.0;-308;-0.05;573734
1559;Groningen (PV);2006 maart;573734;523;514;2529;2340;189;3026;2613;413;;-488;-0.09;-796;-0.14;573246
1560;Groningen (PV);2006 april;573246;470;438;1991;1849;142;2202;1905;297;;-179;-0.03;-975;-0.17;573067
1561;Groningen (PV);2006 mei;573067;478;447;2168;2003;165;2449;2148;301;;-250;-0.04;-1225;-0.21;572817
1562;Groningen (PV);2006 juni;572817;437;443;2374;2204;170;2778;2443;335;;-410;-0.07;-1635;-0.28;572407
1563;Groningen (PV);2006 juli;572407;471;432;2787;2541;246;2997;2655;342;;-171;-0.03;-1806;-0.31;572236
1564;Groningen (PV);2006 augustus;572236;546;429;4050;3669;381;3661;3250;411;;506;0.09;-1300;-0.23;572742
1565;Groningen (PV);2006 september;572742;533;376;4121;3449;672;3542;3116;426;;736;0.13;-564;-0.1;573478
1566;Groningen (PV);2006 oktober;573478;490;390;3013;2684;329;2955;2566;389;;158;0.03;-406;-0.07;573636
1567;Groningen (PV);2006 november;573636;504;426;2571;2357;214;2717;2416;301;;-68;-0.01;-474;-0.08;573568
1568;Groningen (PV);2006 december;573568;446;409;2230;2075;155;2399;2095;304;178.0;46;0.01;-428;-0.07;573614
1569;Groningen (PV);2006;574042;5838;5258;33065;29973;3092;34251;30187;4064;178.0;-428;-0.07;-428;-0.07;573614
1570;Groningen (PV);2007 januari;573614;453;476;2710;2446;264;2937;2588;349;;-250;-0.04;-250;-0.04;573364
1571;Groningen (PV);2007 februari;573364;419;418;2448;2161;287;2663;2336;327;;-214;-0.04;-464;-0.08;573150
1572;Groningen (PV);2007 maart;573150;469;462;2420;2225;195;2751;2471;280;;-324;-0.06;-788;-0.14;572826
1573;Groningen (PV);2007 april;572826;460;415;2150;1997;153;2304;2098;206;;-109;-0.02;-897;-0.16;572717
1574;Groningen (PV);2007 mei;572717;512;416;2270;2055;215;2581;2326;255;;-215;-0.04;-1112;-0.19;572502
1575;Groningen (PV);2007 juni;572502;438;396;2376;2161;215;2505;2274;231;;-87;-0.02;-1199;-0.21;572415
1576;Groningen (PV);2007 juli;572415;512;410;3176;2919;257;3448;2974;474;;-170;-0.03;-1369;-0.24;572245
1577;Groningen (PV);2007 augustus;572245;513;412;4439;4004;435;3826;3422;404;;714;0.12;-655;-0.11;572959
1578;Groningen (PV);2007 september;572959;508;368;4034;3372;662;3177;2891;286;;997;0.17;342;0.06;573956
1579;Groningen (PV);2007 oktober;573956;471;390;3030;2631;399;3045;2686;359;;66;0.01;408;0.07;574022
1580;Groningen (PV);2007 november;574022;473;404;2618;2338;280;2893;2503;390;;-206;-0.04;202;0.04;573816
1581;Groningen (PV);2007 december;573816;449;453;2114;1946;168;2654;2193;461;187.0;-357;-0.06;-155;-0.03;573459
1582;Groningen (PV);2007;573614;5677;5020;33785;30255;3530;34784;30762;4022;187.0;-155;-0.03;-155;-0.03;573459
1583;Groningen (PV);2008 januari;573459;532;489;2903;2588;315;3259;2814;445;;-313;-0.05;-313;-0.05;573146
1584;Groningen (PV);2008 februari;573146;441;425;2633;2356;277;2896;2676;220;;-247;-0.04;-560;-0.1;572899
1585;Groningen (PV);2008 maart;572899;476;505;2394;2093;301;2527;2326;201;;-162;-0.03;-722;-0.13;572737
1586;Groningen (PV);2008 april;572737;471;445;2290;2045;245;2556;2359;197;;-240;-0.04;-962;-0.17;572497
1587;Groningen (PV);2008 mei;572497;488;439;2221;1972;249;2413;2201;212;;-143;-0.02;-1105;-0.19;572354
1588;Groningen (PV);2008 juni;572354;483;428;2324;2068;256;2489;2237;252;;-110;-0.02;-1215;-0.21;572244
1589;Groningen (PV);2008 juli;572244;528;428;3193;2851;342;3409;3016;393;;-116;-0.02;-1331;-0.23;572128
1590;Groningen (PV);2008 augustus;572128;539;423;4095;3616;479;3470;3125;345;;741;0.13;-590;-0.1;572869
1591;Groningen (PV);2008 september;572869;514;403;4680;3578;1102;3482;3130;352;;1309;0.23;719;0.13;574178
1592;Groningen (PV);2008 oktober;574178;486;453;2973;2507;466;2917;2521;396;;89;0.02;808;0.14;574267
1593;Groningen (PV);2008 november;574267;470;413;2541;2243;298;2686;2355;331;;-88;-0.02;720;0.13;574179
1594;Groningen (PV);2008 december;574179;480;427;2413;2187;226;2722;2404;318;169.0;-87;-0.02;633;0.11;574092
1595;Groningen (PV);2008;573459;5908;5278;34660;30104;4556;34826;31164;3662;169.0;633;0.11;633;0.11;574092
1596;Groningen (PV);2009 januari;574092;490;585;2575;2295;280;2760;2486;274;;-280;-0.05;-280;-0.05;573812
1597;Groningen (PV);2009 februari;573812;428;482;2567;2148;419;2509;2278;231;;4;0.0;-276;-0.05;573816
1598;Groningen (PV);2009 maart;573816;503;493;2485;2016;469;2678;2315;363;;-183;-0.03;-459;-0.08;573633
1599;Groningen (PV);2009 april;573633;470;380;2133;1841;292;2093;1891;202;;130;0.02;-329;-0.06;573763
1600;Groningen (PV);2009 mei;573763;481;443;2071;1781;290;2041;1845;196;;68;0.01;-261;-0.05;573831
1601;Groningen (PV);2009 juni;573831;533;419;2316;2045;271;2430;2088;342;;0;0.0;-261;-0.05;573831
1602;Groningen (PV);2009 juli;573831;579;399;3090;2750;340;3146;2712;434;;124;0.02;-137;-0.02;573955
1603;Groningen (PV);2009 augustus;573955;510;411;4039;3491;548;3104;2796;308;;1034;0.18;897;0.16;574989
1604;Groningen (PV);2009 september;574989;516;365;4648;3384;1264;3166;2761;405;;1633;0.28;2530;0.44;576622
1605;Groningen (PV);2009 oktober;576622;474;420;2852;2327;525;2541;2331;210;;365;0.06;2895;0.5;576987
1606;Groningen (PV);2009 november;576987;449;387;2339;2004;335;2757;2127;630;;-356;-0.06;2539;0.44;576631
1607;Groningen (PV);2009 december;576631;477;447;2226;1928;298;2305;2063;242;86.0;37;0.01;2576;0.45;576668
1608;Groningen (PV);2009;574092;5910;5231;33341;28010;5331;31530;27693;3837;86.0;2576;0.45;2576;0.45;576668
1609;Groningen (PV);2010 januari;576668;493;462;2448;2074;374;2430;2164;266;;49;0.01;49;0.01;576717
1610;Groningen (PV);2010 februari;576717;439;476;2611;2055;556;2356;2112;244;;218;0.04;267;0.05;576935
1611;Groningen (PV);2010 maart;576935;439;490;2493;2131;362;2694;2252;442;;-252;-0.04;15;0.0;576683
1612;Groningen (PV);2010 april;576683;456;438;2057;1692;365;2040;1797;243;;35;0.01;50;0.01;576718
1613;Groningen (PV);2010 mei;576718;448;431;1947;1665;282;1874;1709;165;;90;0.02;140;0.02;576808
1614;Groningen (PV);2010 juni;576808;449;441;2214;1811;403;2319;1984;335;;-97;-0.02;43;0.01;576711
1615;Groningen (PV);2010 juli;576711;510;455;2866;2471;395;3129;2680;449;;-208;-0.04;-165;-0.03;576503
1616;Groningen (PV);2010 augustus;576503;533;405;3838;3227;611;3207;2825;382;;759;0.13;594;0.1;577262
1617;Groningen (PV);2010 september;577262;478;395;4609;3276;1333;3248;2855;393;;1444;0.25;2038;0.35;578706
1618;Groningen (PV);2010 oktober;578706;506;402;2872;2178;694;2439;2182;257;;537;0.09;2575;0.45;579243
1619;Groningen (PV);2010 november;579243;481;446;2366;1947;419;2433;1965;468;;-32;-0.01;2543;0.44;579211
1620;Groningen (PV);2010 december;579211;500;490;2276;2015;261;2460;2008;452;-1.0;-175;-0.03;2368;0.41;579036
1621;Groningen (PV);2010;576668;5732;5331;32597;26542;6055;30629;26533;4096;-1.0;2368;0.41;2368;0.41;579036
1622;Groningen (PV);2011 januari;579036;481;449;2522;2200;322;2647;2248;399;;-93;-0.02;-93;-0.02;578943
1623;Groningen (PV);2011 februari;578943;442;411;2860;2293;567;2713;2365;348;;178;0.03;85;0.01;579121
1624;Groningen (PV);2011 maart;579121;479;493;2475;2113;362;2627;2274;353;;-166;-0.03;-81;-0.01;578955
1625;Groningen (PV);2011 april;578955;460;412;2072;1766;306;2102;1847;255;;18;0.0;-63;-0.01;578973
1626;Groningen (PV);2011 mei;578973;496;400;2044;1748;296;2138;1826;312;;2;0.0;-61;-0.01;578975
1627;Groningen (PV);2011 juni;578975;526;475;2046;1781;265;2396;1934;462;;-299;-0.05;-360;-0.06;578676
1628;Groningen (PV);2011 juli;578676;494;440;2739;2392;347;3084;2524;560;;-291;-0.05;-651;-0.11;578385
1629;Groningen (PV);2011 augustus;578385;562;382;4187;3455;732;3578;3070;508;;789;0.14;138;0.02;579174
1630;Groningen (PV);2011 september;579174;548;418;5522;3575;1947;3352;2947;405;;2300;0.4;2438;0.42;581474
1631;Groningen (PV);2011 oktober;581474;452;433;2771;2325;446;2701;2272;429;;89;0.02;2527;0.44;581563
1632;Groningen (PV);2011 november;581563;447;439;2545;2227;318;2820;2206;614;;-267;-0.05;2260;0.39;581296
1633;Groningen (PV);2011 december;581296;466;497;2308;2053;255;2701;2173;528;3.0;-421;-0.07;1839;0.32;580875
1634;Groningen (PV);2011;579036;5853;5249;34091;27928;6163;32859;27686;5173;3.0;1839;0.32;1839;0.32;580875
1635;Groningen (PV);2012 januari;580875;463;472;2646;2331;315;2879;2487;392;;-242;-0.04;-242;-0.04;580633
1636;Groningen (PV);2012 februari;580633;440;474;2912;2237;675;2975;2415;560;;-97;-0.02;-339;-0.06;580536
1637;Groningen (PV);2012 maart;580536;484;481;2437;2107;330;2558;2216;342;;-118;-0.02;-457;-0.08;580418
1638;Groningen (PV);2012 april;580418;450;453;2039;1794;245;2230;1948;282;;-194;-0.03;-651;-0.11;580224
1639;Groningen (PV);2012 mei;580224;475;464;2009;1768;241;2258;1955;303;;-238;-0.04;-889;-0.15;579986
1640;Groningen (PV);2012 juni;579986;433;434;2418;2157;261;2740;2263;477;;-323;-0.06;-1212;-0.21;579663
1641;Groningen (PV);2012 juli;579663;512;465;3011;2649;362;3391;2722;669;;-333;-0.06;-1545;-0.27;579330
1642;Groningen (PV);2012 augustus;579330;486;437;4813;3717;1096;3664;3164;500;;1198;0.21;-347;-0.06;580528
1643;Groningen (PV);2012 september;580528;475;380;5158;3480;1678;3392;2892;500;;1861;0.32;1514;0.26;582389
1644;Groningen (PV);2012 oktober;582389;485;430;2710;2234;476;2901;2391;510;;-136;-0.02;1378;0.24;582253
1645;Groningen (PV);2012 november;582253;437;490;2357;2030;327;2613;2060;553;;-309;-0.05;1069;0.18;581944
1646;Groningen (PV);2012 december;581944;464;480;2211;1970;241;2439;2069;370;5.0;-239;-0.04;830;0.14;581705
1647;Groningen (PV);2012;580875;5604;5460;34721;28474;6247;34040;28582;5458;5.0;830;0.14;830;0.14;581705
1648;Groningen (PV);2013 januari;581705;484;505;2632;2225;407;2858;2371;487;;-247;-0.04;-247;-0.04;581458
1649;Groningen (PV);2013 februari;581458;421;513;2764;2231;533;2872;2417;455;;-200;-0.03;-447;-0.08;581258
1650;Groningen (PV);2013 maart;581258;405;533;2274;2009;265;2417;2174;243;;-271;-0.05;-718;-0.12;580987
1651;Groningen (PV);2013 april;580987;398;473;2130;1757;373;2188;1935;253;;-133;-0.02;-851;-0.15;580854
1652;Groningen (PV);2013 mei;580854;427;424;2211;1852;359;2483;1987;496;;-269;-0.05;-1120;-0.19;580585
1653;Groningen (PV);2013 juni;580585;481;389;2043;1742;301;2435;1981;454;;-300;-0.05;-1420;-0.24;580285
1654;Groningen (PV);2013 juli;580285;473;413;3098;2726;372;3526;2856;670;;-368;-0.06;-1788;-0.31;579917
1655;Groningen (PV);2013 augustus;579917;457;408;4869;4122;747;3850;3280;570;;1068;0.18;-720;-0.12;580985
1656;Groningen (PV);2013 september;580985;462;383;5533;3497;2036;3640;3143;497;;1972;0.34;1252;0.22;582957
1657;Groningen (PV);2013 oktober;582957;419;464;2751;2245;506;2779;2352;427;;-73;-0.01;1179;0.2;582884
1658;Groningen (PV);2013 november;582884;454;437;2462;2050;412;2398;2100;298;;81;0.01;1260;0.22;582965
1659;Groningen (PV);2013 december;582965;445;445;2353;2070;283;2596;2249;347;6.0;-237;-0.04;1023;0.18;582728
1660;Groningen (PV);2013;581705;5326;5387;35120;28526;6594;34042;28845;5197;6.0;1023;0.18;1023;0.18;582728
1661;Groningen (PV);2014 januari;582728;450;458;2774;2208;566;2932;2462;470;;-166;-0.03;-166;-0.03;582562
1662;Groningen (PV);2014 februari;582562;456;433;2920;2256;664;3025;2519;506;;-82;-0.01;-248;-0.04;582480
1663;Groningen (PV);2014 maart;582480;428;457;2466;2081;385;2815;2293;522;;-378;-0.06;-626;-0.11;582102
1664;Groningen (PV);2014 april;582102;465;427;2316;1930;386;2541;2124;417;;-187;-0.03;-813;-0.14;581915
1665;Groningen (PV);2014 mei;581915;474;422;2218;1808;410;2434;2027;407;;-164;-0.03;-977;-0.17;581751
1666;Groningen (PV);2014 juni;581751;435;401;2213;1904;309;2716;2143;573;;-469;-0.08;-1446;-0.25;581282
1667;Groningen (PV);2014 juli;581282;460;441;3373;2906;467;3902;3097;805;;-510;-0.09;-1956;-0.34;580772
1668;Groningen (PV);2014 augustus;580772;491;417;5377;4240;1137;4156;3500;656;;1295;0.22;-661;-0.11;582067
1669;Groningen (PV);2014 september;582067;492;432;5640;3525;2115;3780;3252;528;;1920;0.33;1259;0.22;583987
1670;Groningen (PV);2014 oktober;583987;467;424;3435;2370;1065;3142;2799;343;;336;0.06;1595;0.27;584323
1671;Groningen (PV);2014 november;584323;385;462;2898;2122;776;2910;2575;335;;-89;-0.02;1506;0.26;584234
1672;Groningen (PV);2014 december;584234;411;551;3093;2396;697;3239;2866;373;-6.0;-292;-0.05;1214;0.21;583942
1673;Groningen (PV);2014;582728;5414;5325;38723;29746;8977;37592;31657;5935;-6.0;1214;0.21;1214;0.21;583942
1674;Groningen (PV);2015 januari;583942;449;565;3452;2510;942;3507;2956;551;;-171;-0.03;-171;-0.03;583771
1675;Groningen (PV);2015 februari;583771;389;451;3619;2555;1064;3575;3075;500;;-18;0.0;-189;-0.03;583753
1676;Groningen (PV);2015 maart;583753;413;522;3032;2308;724;3334;2892;442;;-411;-0.07;-600;-0.1;583342
1677;Groningen (PV);2015 april;583342;444;421;2715;2125;590;2985;2598;387;;-247;-0.04;-847;-0.15;583095
1678;Groningen (PV);2015 mei;583095;437;445;2243;1921;322;2705;2436;269;;-470;-0.08;-1317;-0.23;582625
1679;Groningen (PV);2015 juni;582625;420;420;2729;2160;569;3067;2524;543;;-338;-0.06;-1655;-0.28;582287
1680;Groningen (PV);2015 juli;582287;490;435;3516;2864;652;4255;3567;688;;-684;-0.12;-2339;-0.4;581603
1681;Groningen (PV);2015 augustus;581603;427;433;5547;3964;1583;4464;3937;527;;1077;0.19;-1262;-0.22;582680
1682;Groningen (PV);2015 september;582680;484;412;5081;3289;1792;4206;3509;697;;947;0.16;-315;-0.05;583627
1683;Groningen (PV);2015 oktober;583627;474;446;3782;2501;1281;3448;2997;451;;362;0.06;47;0.01;583989
1684;Groningen (PV);2015 november;583989;441;488;3386;2166;1220;3188;2863;325;;151;0.03;198;0.03;584140
1685;Groningen (PV);2015 december;584140;461;443;3261;2389;872;3720;3282;438;22.0;-419;-0.07;-221;-0.04;583721
1686;Groningen (PV);2015;583942;5329;5481;42363;30752;11611;42454;36636;5818;22.0;-221;-0.04;-221;-0.04;583721
1687;Groningen (PV);2016 januari;583721;433;533;3636;2372;1264;3642;3031;611;;-106;-0.02;-106;-0.02;583615
1688;Groningen (PV);2016 februari;583615;484;504;3876;2628;1248;4122;3445;677;;-266;-0.05;-372;-0.06;583349
1689;Groningen (PV);2016 maart;583349;443;512;3199;2439;760;3723;3298;425;;-593;-0.1;-965;-0.17;582756
1690;Groningen (PV);2016 april;582756;414;429;3106;2444;662;3435;3000;435;;-344;-0.06;-1309;-0.22;582412
1691;Groningen (PV);2016 mei;582412;458;464;3115;2289;826;3294;2970;324;;-185;-0.03;-1494;-0.26;582227
1692;Groningen (PV);2016 juni;582227;422;443;3346;2443;903;3660;3084;576;;-335;-0.06;-1829;-0.31;581892
1693;Groningen (PV);2016 juli;581892;461;448;4042;3262;780;4692;4013;679;;-637;-0.11;-2466;-0.42;581255
1694;Groningen (PV);2016 augustus;581255;508;412;5896;4072;1824;4800;4260;540;;1192;0.21;-1274;-0.22;582447
1695;Groningen (PV);2016 september;582447;480;447;6050;3966;2084;4391;3884;507;;1692;0.29;418;0.07;584139
1696;Groningen (PV);2016 oktober;584139;465;454;3413;2628;785;3431;2983;448;;-7;0.0;411;0.07;584132
1697;Groningen (PV);2016 november;584132;449;466;3215;2624;591;3314;2927;387;;-116;-0.02;295;0.05;584016
1698;Groningen (PV);2016 december;584016;389;471;3016;2587;429;3351;2985;366;-18.0;-435;-0.07;-140;-0.02;583581
1699;Groningen (PV);2016;583721;5406;5583;45910;33754;12156;45855;39880;5975;-18.0;-140;-0.02;-140;-0.02;583581
1700;Groningen (PV);2017 januari;583581;401;561;3093;2651;442;3501;3042;459;;-568;-0.1;-568;-0.1;583013
1701;Groningen (PV);2017 februari;583013;391;522;3869;2943;926;3635;3098;537;;103;0.02;-465;-0.08;583116
1702;Groningen (PV);2017 maart;583116;399;497;3374;2874;500;3482;3017;465;;-206;-0.04;-671;-0.11;582910
1703;Groningen (PV);2017 april;582910;432;482;2795;2327;468;2876;2508;368;;-131;-0.02;-802;-0.14;582779
1704;Groningen (PV);2017 mei;582779;435;461;2901;2457;444;3085;2734;351;;-210;-0.04;-1012;-0.17;582569
1705;Groningen (PV);2017 juni;582569;423;423;2732;2346;386;3382;2633;749;;-650;-0.11;-1662;-0.28;581919
1706;Groningen (PV);2017 juli;581919;431;453;3336;2867;469;4467;3549;918;;-1153;-0.2;-2815;-0.48;580766
1707;Groningen (PV);2017 augustus;580766;466;428;5576;3741;1835;4583;3994;589;;1031;0.18;-1784;-0.31;581797
1708;Groningen (PV);2017 september;581797;428;363;5579;3798;1781;4211;3698;513;;1433;0.25;-351;-0.06;583230
1709;Groningen (PV);2017 oktober;583230;425;463;3725;2832;893;3620;3155;465;;67;0.01;-284;-0.05;583297
1710;Groningen (PV);2017 november;583297;409;485;3086;2547;539;3187;2763;424;;-177;-0.03;-461;-0.08;583120
1711;Groningen (PV);2017 december;583120;452;526;2911;2551;360;2993;2680;313;-20.0;-176;-0.03;-637;-0.11;582944
1712;Groningen (PV);2017;583581;5092;5664;42977;33934;9043;43022;36871;6151;-20.0;-637;-0.11;-637;-0.11;582944
1713;Groningen (PV);2018 januari;582944;420;554;3671;2534;1137;3359;2963;396;;178;0.03;178;0.03;583122
1714;Groningen (PV);2018 februari;583122;373;561;4239;2487;1752;3818;3329;489;;233;0.04;411;0.07;583355
1715;Groningen (PV);2018 maart;583355;371;593;4070;2681;1389;4012;3630;382;;-164;-0.03;247;0.04;583191
1716;Groningen (PV);2018 april;583191;402;458;3324;2141;1183;3406;3071;335;;-138;-0.02;109;0.02;583053
1717;Groningen (PV);2018 mei;583053;417;418;3559;2217;1342;3563;3261;302;;-5;0.0;104;0.02;583048
1718;Groningen (PV);2018 juni;583048;405;406;3215;2214;1001;4197;3525;672;;-983;-0.17;-879;-0.15;582065
1719;Groningen (PV);2018 juli;582065;436;468;4029;2711;1318;4786;3925;861;;-789;-0.14;-1668;-0.29;581276
1720;Groningen (PV);2018 augustus;581276;430;397;6050;3505;2545;4935;4376;559;;1148;0.2;-520;-0.09;582424
1721;Groningen (PV);2018 september;582424;444;413;5703;3492;2211;4213;3734;479;;1521;0.26;1001;0.17;583945
1722;Groningen (PV);2018 oktober;583945;426;428;3918;2667;1251;3799;3405;394;;117;0.02;1118;0.19;584062
1723;Groningen (PV);2018 november;584062;417;454;3601;2480;1121;3557;3141;416;;7;0.0;1125;0.19;584069
1724;Groningen (PV);2018 december;584069;392;500;3112;2264;848;3102;2778;324;19.0;-79;-0.01;1046;0.18;583990
1725;Groningen (PV);2018;582944;4933;5650;48491;31393;17098;46747;41138;5609;19.0;1046;0.18;1046;0.18;583990
1726;Groningen (PV);2019 januari;583990;427;490;3262;2326;936;3731;3035;696;;-532;-0.09;-532;-0.09;583458
1727;Groningen (PV);2019 februari;583458;373;453;3912;2379;1533;3495;2931;564;;337;0.06;-195;-0.03;583795
1728;Groningen (PV);2019 maart;583795;408;526;3347;2389;958;3182;2791;391;;47;0.01;-148;-0.03;583842
1729;Groningen (PV);2019 april;583842;398;478;2899;2109;790;3154;2787;367;;-335;-0.06;-483;-0.08;583507
1730;Groningen (PV);2019 mei;583507;413;457;2941;2123;818;3087;2738;349;;-190;-0.03;-673;-0.12;583317
1731;Groningen (PV);2019 juni;583317;424;437;3090;1901;1189;3323;2653;670;;-246;-0.04;-919;-0.16;583071
1732;Groningen (PV);2019 juli;583071;441;453;4009;2579;1430;4736;3790;946;;-739;-0.13;-1658;-0.28;582332
1733;Groningen (PV);2019 augustus;582332;459;444;5946;3235;2711;4678;4063;615;;1283;0.22;-375;-0.06;583615
1734;Groningen (PV);2019 september;583615;442;405;5743;3073;2670;3973;3466;507;;1807;0.31;1432;0.25;585422
1735;Groningen (PV);2019 oktober;585422;464;454;3792;2294;1498;3329;3012;317;;473;0.08;1905;0.33;585895
1736;Groningen (PV);2019 november;585895;420;436;3461;2390;1071;3277;2897;380;;168;0.03;2073;0.35;586063
1737;Groningen (PV);2019 december;586063;373;467;3261;2201;1060;3385;2948;437;21.0;-197;-0.03;1876;0.32;585866
1738;Groningen (PV);2019;583990;5042;5500;45663;28999;16664;43350;37111;6239;21.0;1876;0.32;1876;0.32;585866
1739;Groningen (PV);2020 januari;585866;437;528;3877;2577;1300;3895;3332;563;;-109;-0.02;-109;-0.02;585757
1740;Groningen (PV);2020 februari;585757;393;458;4449;2627;1822;3869;3324;545;;515;0.09;406;0.07;586272
1741;Groningen (PV);2020 maart;586272;404;541;2973;2305;668;3385;2818;567;;-549;-0.09;-143;-0.02;585723
1742;Groningen (PV);2020 april;585723;406;474;2060;1866;194;2661;2283;378;;-669;-0.11;-812;-0.14;585054
1743;Groningen (PV);2020 mei;585054;393;419;2461;2224;237;2848;2422;426;;-413;-0.07;-1225;-0.21;584641
1744;Groningen (PV);2020 juni;584641;406;456;2877;2284;593;3017;2494;523;;-190;-0.03;-1415;-0.24;584451
1745;Groningen (PV);2020 juli;584451;460;411;3589;2737;852;4216;3252;964;;-578;-0.1;-1993;-0.34;583873
1746;Groningen (PV);2020 augustus;583873;414;472;4977;3054;1923;3854;3288;566;;1065;0.18;-928;-0.16;584938
1747;Groningen (PV);2020 september;584938;453;436;4772;2879;1893;3519;3020;499;;1270;0.22;342;0.06;586208
1748;Groningen (PV);2020 oktober;586208;434;462;4332;2798;1534;3621;3101;520;;683;0.12;1025;0.17;586891
1749;Groningen (PV);2020 november;586891;389;447;3828;2202;1626;3489;3053;436;;281;0.05;1306;0.22;587172
1750;Groningen (PV);2020 december;587172;367;612;3760;2359;1401;3778;3359;419;28.0;-235;-0.04;1071;0.18;586937
1751;Groningen (PV);2020;585866;4956;5716;43955;29912;14043;42152;35746;6406;28.0;1071;0.18;1071;0.18;586937
1752;Groningen (PV);2021 januari;586937;420;673;3328;2413;915;3501;3130;371;0.0;-426;-0.07;-426;-0.07;586511
1753;Groningen (PV);2021 februari;586511;411;551;3401;2314;1087;3449;3081;368;0.0;-188;-0.03;-614;-0.1;586323
1754;Groningen (PV);2021 maart;586323;421;517;4093;2584;1509;4058;3563;495;0.0;-61;-0.01;-675;-0.12;586262
1755;Groningen (PV);2021 april;586262;404;462;3981;2446;1535;3554;3267;287;0.0;369;0.06;-306;-0.05;586631
1756;Groningen (PV);2021 mei;586631;464;486;3549;2196;1353;3542;3120;422;0.0;-15;0.0;-321;-0.05;586616
1757;Groningen (PV);2021 juni;586616;448;456;3503;2185;1318;3676;3227;449;0.0;-181;-0.03;-502;-0.09;586435
1758;Groningen (PV);2021 juli;586435;475;430;4435;2450;1985;4341;3601;740;0.0;139;0.02;-363;-0.06;586574
1759;Groningen (PV);2021 augustus;586574;475;452;5475;2713;2762;4743;4101;642;0.0;755;0.13;392;0.07;587329
1760;Groningen (PV);2021 september;587329;450;446;7284;2865;4419;4464;3929;535;0.0;2824;0.48;3216;0.55;590153
1761;Groningen (PV);2021 oktober;590153;465;526;4647;2394;2253;4089;3651;438;0.0;497;0.08;3713;0.63;590650
1762;Groningen (PV);2021 november;590650;462;589;4254;2322;1932;4219;3733;486;0.0;-92;-0.02;3621;0.62;590558
1763;Groningen (PV);2021 december;590558;411;613;3690;2183;1507;3945;3513;432;69.0;-388;-0.07;3233;0.55;590170
1764;Groningen (PV);2021;586937;5306;6201;51640;29065;22575;47581;41916;5665;69.0;3233;0.55;3233;0.55;590170
1765;Groningen (PV);2022 januari;590170;454;506;3824;2284;1540;3829;3344;485;;-57;-0.01;-57;-0.01;590113
1766;Groningen (PV);2022 februari;590113;372;477;4278;1993;2285;3911;3377;534;;262;0.04;205;0.03;590375
1767;Groningen (PV);2022 maart;590375;393;565;5291;2216;3075;4210;3821;389;;909;0.15;1114;0.19;591284
1768;Groningen (PV);2022 april;591284;395;544;4894;2255;2639;3892;3561;331;;853;0.14;1967;0.33;592137
1769;Groningen (PV);2022 mei;592137;388;512;4199;2075;2124;3685;3349;336;;390;0.07;2357;0.4;592527
1770;Groningen (PV);2022 juni;592527;416;482;4686;2129;2557;4093;3487;606;;527;0.09;2884;0.49;593054
1771;Groningen (PV);2022 juli;593054;472;501;4986;2494;2492;4636;3722;914;;321;0.05;3205;0.54;593375
1772;Groningen (PV);2022 augustus;593375;441;492;6711;2785;3926;5139;4268;871;;1521;0.26;4726;0.8;594896
1773;Groningen (PV);2022 september;594896;458;469;6370;2918;3452;4998;4306;692;;1361;0.23;6087;1.03;596257
1774;Groningen (PV);2022 oktober;596257;448;514;4240;2581;1659;4157;3673;484;;17;0.0;6104;1.03;596274
1775;Groningen (PV);2022 november;596274;366;498;4088;2439;1649;3868;3441;427;;88;0.01;6192;1.05;596362
1776;Groningen (PV);2022 december;596362;391;632;3723;2471;1252;3794;3402;392;25.0;-287;-0.05;5905;1.0;596075
1777;Groningen (PV);2022;590170;4994;6192;57290;28640;28650;50212;43751;6461;25.0;5905;1.0;5905;1.0;596075
1778;Groningen (PV);2023 januari;596075;386;594;4056;2530;1526;4249;3546;703;0.0;-401;-0.07;-401;-0.07;595674
1779;Groningen (PV);2023 februari;595674;365;516;4421;2228;2193;4222;3399;823;0.0;48;0.01;-353;-0.06;595722
1780;Groningen (PV);2023 maart;595722;387;600;4471;2386;2085;3981;3454;527;0.0;277;0.05;-76;-0.01;595999
1781;Groningen (PV);2023 april;595999;392;472;3760;2082;1678;3489;3088;401;0.0;191;0.03;115;0.02;596190
1782;Groningen (PV);2023 mei;596190;431;461;4037;2222;1815;4071;3592;479;0.0;-64;-0.01;51;0.01;596126
1783;Groningen (PV);2023 juni;596126;434;499;4696;2825;1871;4216;3627;589;0.0;415;0.07;466;0.08;596541
1784;Groningen (PV);2023 juli;596541;421;469;5272;3301;1971;5400;4300;1100;0.0;-176;-0.03;290;0.05;596365
1785;Groningen (PV);2023 augustus;596365;421;419;7989;4178;3811;5321;4587;734;0.0;2670;0.45;2960;0.5;599035
1786;Groningen (PV);2023 september;599035;430;475;7005;3556;3449;4442;3883;559;0.0;2518;0.42;5478;0.92;601553
1787;Groningen (PV);2023 oktober;601553;380;536;4716;2467;2249;4457;3897;560;0.0;103;0.02;5581;0.94;601656
1788;Groningen (PV);2023 november;601656;393;520;4552;2268;2284;4486;3989;497;0.0;-61;-0.01;5520;0.93;601595
1789;Groningen (PV);2023 december;601595;403;618;3998;2214;1784;4112;3620;492;81.0;-248;-0.04;5272;0.88;601347
1790;Groningen (PV);2023;596075;4843;6179;58973;32257;26716;52446;44982;7464;81.0;5272;0.88;5272;0.88;601347
1791;Groningen (PV);2024 januari;601347;388;617;4183;2320;1863;4670;3850;820;;-716;-0.12;-716;-0.12;600631
1792;Groningen (PV);2024 februari;600631;337;566;4870;2313;2557;4496;3766;730;;145;0.02;-571;-0.09;600776
1793;Groningen (PV);2024 maart;600776;383;553;4290;2252;2038;4321;3790;531;;-201;-0.03;-772;-0.13;600575
1794;Groningen (PV);2024 april;600575;398;526;4226;2047;2179;4095;3644;451;;3;0.0;-769;-0.13;600578
1795;Groningen (PV);2024 mei;600578;431;527;3990;2050;1940;3954;3551;403;;-60;-0.01;-829;-0.14;600518
1796;Groningen (PV);2024 juni;600518;426;521;4111;2031;2080;4350;3721;629;;-334;-0.06;-1163;-0.19;600184
1797;Groningen (PV);2024 juli;600184;415;527;4992;2630;2362;5700;4526;1174;;-820;-0.14;-1983;-0.33;599364
1798;Groningen (PV);2024 augustus;599364;410;467;7231;3291;3940;4965;4265;700;;2209;0.37;226;0.04;601573
1799;Groningen (PV);2024 september;601573;428;473;7263;3395;3868;5176;4536;640;;2042;0.34;2268;0.38;603615
1800;Groningen (PV);2024 oktober;603615;408;503;4843;2512;2331;4775;4121;654;;-27;0.0;2241;0.37;603588
1801;Groningen (PV);2024 november;603588;416;488;4630;2472;2158;4415;3940;475;;143;0.02;2384;0.4;603731
1802;Groningen (PV);2024 december;603731;392;522;3965;2253;1712;4310;3884;426;0.0;-475;-0.08;1909;0.32;603256
1803;Groningen (PV);2024;601347;4832;6290;58594;29566;29028;55227;47594;7633;0.0;1909;0.32;1909;0.32;603256
1804;Groningen (PV);2025 januari;603256;411;619;4789;2428;2361;5068;4224;844;;-487;-0.08;-487;-0.08;602769
1805;Groningen (PV);2025 februari;602769;349;624;4873;2272;2601;4461;3805;656;;137;0.02;-350;-0.06;602906
1806;Fryslân (PV);2002 januari;636184;638;552;2853;2337;516;2535;2415;120;;404;0.06;404;0.06;636588
1807;Fryslân (PV);2002 februari;636588;612;464;2398;1993;405;2242;2138;104;;304;0.05;708;0.11;636892
1808;Fryslân (PV);2002 maart;636892;654;532;2294;1930;364;2292;2071;221;;124;0.02;832;0.13;637016
1809;Fryslân (PV);2002 april;637016;647;509;2194;1813;381;2172;1992;180;;160;0.03;992;0.16;637176
1810;Fryslân (PV);2002 mei;637176;638;473;2398;2042;356;2336;2218;118;;227;0.04;1219;0.19;637403
1811;Fryslân (PV);2002 juni;637403;603;457;2256;1959;297;2180;2014;166;;222;0.03;1441;0.23;637625
1812;Fryslân (PV);2002 juli;637625;751;492;3043;2674;369;2710;2512;198;;592;0.09;2033;0.32;638217
1813;Fryslân (PV);2002 augustus;638217;726;475;3152;2807;345;2965;2754;211;;438;0.07;2471;0.39;638655
1814;Fryslân (PV);2002 september;638655;683;447;2751;2351;400;2747;2539;208;;240;0.04;2711;0.43;638895
1815;Fryslân (PV);2002 oktober;638895;726;498;2506;2189;317;2425;2241;184;;309;0.05;3020;0.47;639204
1816;Fryslân (PV);2002 november;639204;630;499;2334;1999;335;2256;2109;147;;209;0.03;3229;0.51;639413
1817;Fryslân (PV);2002 december;639413;679;506;2318;2005;313;2079;1951;128;-38.0;374;0.06;3603;0.57;639787
1818;Fryslân (PV);2002;636184;7987;5904;30497;26099;4398;28939;26954;1985;-38.0;3603;0.57;3603;0.57;639787
1819;Fryslân (PV);2003 januari;639787;730;596;2601;2347;254;2713;2509;204;;22;0.0;22;0.0;639809
1820;Fryslân (PV);2003 februari;639809;587;448;2355;2072;283;2231;2043;188;;263;0.04;285;0.04;640072
1821;Fryslân (PV);2003 maart;640072;691;516;2394;2144;250;2370;2098;272;;199;0.03;484;0.08;640271
1822;Fryslân (PV);2003 april;640271;693;476;2224;1933;291;2161;1873;288;;280;0.04;764;0.12;640551
1823;Fryslân (PV);2003 mei;640551;643;451;2195;1940;255;2189;1982;207;;198;0.03;962;0.15;640749
1824;Fryslân (PV);2003 juni;640749;672;453;2229;2016;213;2340;2109;231;;108;0.02;1070;0.17;640857
1825;Fryslân (PV);2003 juli;640857;685;455;2721;2483;238;2737;2458;279;;214;0.03;1284;0.2;641071
1826;Fryslân (PV);2003 augustus;641071;665;479;2982;2754;228;3083;2839;244;;85;0.01;1369;0.21;641156
1827;Fryslân (PV);2003 september;641156;683;436;2710;2369;341;2837;2621;216;;120;0.02;1489;0.23;641276
1828;Fryslân (PV);2003 oktober;641276;652;475;2450;2154;296;2242;2086;156;;385;0.06;1874;0.29;641661
1829;Fryslân (PV);2003 november;641661;581;466;2051;1860;191;2055;1932;123;;111;0.02;1985;0.31;641772
1830;Fryslân (PV);2003 december;641772;650;542;2214;2064;150;2170;2082;88;142.0;294;0.05;2279;0.36;642066
1831;Fryslân (PV);2003;639787;7932;5793;29126;26136;2990;29128;26632;2496;142.0;2279;0.36;2279;0.36;642066
1832;Fryslân (PV);2004 januari;642066;686;559;2196;2031;165;2272;2084;188;;51;0.01;51;0.01;642117
1833;Fryslân (PV);2004 februari;642117;621;476;1891;1727;164;2125;1895;230;;-89;-0.01;-38;-0.01;642028
1834;Fryslân (PV);2004 maart;642028;648;482;2267;2034;233;2277;2037;240;;156;0.02;118;0.02;642184
1835;Fryslân (PV);2004 april;642184;626;455;1982;1872;110;2100;1880;220;;53;0.01;171;0.03;642237
1836;Fryslân (PV);2004 mei;642237;577;455;2002;1829;173;2085;1910;175;;39;0.01;210;0.03;642276
1837;Fryslân (PV);2004 juni;642276;630;442;2243;2068;175;2261;2153;108;;170;0.03;380;0.06;642446
1838;Fryslân (PV);2004 juli;642446;682;464;2818;2620;198;2863;2547;316;;173;0.03;553;0.09;642619
1839;Fryslân (PV);2004 augustus;642619;631;415;2928;2664;264;2963;2725;238;;181;0.03;734;0.11;642800
1840;Fryslân (PV);2004 september;642800;661;465;2754;2454;300;2911;2664;247;;39;0.01;773;0.12;642839
1841;Fryslân (PV);2004 oktober;642839;597;457;2421;2208;213;2480;2268;212;;81;0.01;854;0.13;642920
1842;Fryslân (PV);2004 november;642920;587;483;2247;2082;165;2322;2185;137;;29;0.0;883;0.14;642949
1843;Fryslân (PV);2004 december;642949;605;485;2155;2042;113;2291;2060;231;44.0;28;0.0;911;0.14;642977
1844;Fryslân (PV);2004;642066;7551;5638;27904;25631;2273;28950;26408;2542;44.0;911;0.14;911;0.14;642977
1845;Fryslân (PV);2005 januari;642977;658;503;2173;2024;149;2302;2131;171;;26;0.0;26;0.0;643003
1846;Fryslân (PV);2005 februari;643003;576;499;2123;1937;186;2151;1965;186;;49;0.01;75;0.01;643052
1847;Fryslân (PV);2005 maart;643052;596;581;2045;1902;143;2359;1881;478;;-299;-0.05;-224;-0.03;642753
1848;Fryslân (PV);2005 april;642753;580;443;2123;2024;99;2267;2073;194;;-7;0.0;-231;-0.04;642746
1849;Fryslân (PV);2005 mei;642746;647;459;1962;1849;113;2224;2033;191;;-74;-0.01;-305;-0.05;642672
1850;Fryslân (PV);2005 juni;642672;613;425;2189;2091;98;2427;2224;203;;-50;-0.01;-355;-0.06;642622
1851;Fryslân (PV);2005 juli;642622;640;441;2670;2507;163;2893;2663;230;;-24;0.0;-379;-0.06;642598
1852;Fryslân (PV);2005 augustus;642598;678;423;2867;2694;173;3174;2980;194;;-52;-0.01;-431;-0.07;642546
1853;Fryslân (PV);2005 september;642546;587;398;3216;2872;344;3412;3248;164;;-7;0.0;-438;-0.07;642539
1854;Fryslân (PV);2005 oktober;642539;610;492;2381;2213;168;2581;2306;275;;-82;-0.01;-520;-0.08;642457
1855;Fryslân (PV);2005 november;642457;618;489;2483;2312;171;2779;2358;421;;-167;-0.03;-687;-0.11;642290
1856;Fryslân (PV);2005 december;642290;574;453;2139;2032;107;2406;2085;321;86.0;-60;-0.01;-747;-0.12;642230
1857;Fryslân (PV);2005;642977;7377;5606;28371;26457;1914;30975;27947;3028;86.0;-747;-0.12;-747;-0.12;642230
1858;Fryslân (PV);2006 januari;642230;630;521;2314;2170;144;2703;2259;444;;-280;-0.04;-280;-0.04;641950
1859;Fryslân (PV);2006 februari;641950;550;488;2082;1928;154;2410;2055;355;;-266;-0.04;-546;-0.09;641684
1860;Fryslân (PV);2006 maart;641684;603;572;2245;2084;161;2476;2129;347;;-200;-0.03;-746;-0.12;641484
1861;Fryslân (PV);2006 april;641484;603;529;1930;1798;132;1990;1790;200;;14;0.0;-732;-0.11;641498
1862;Fryslân (PV);2006 mei;641498;584;455;2237;2043;194;2143;1996;147;;223;0.03;-509;-0.08;641721
1863;Fryslân (PV);2006 juni;641721;600;470;2064;1892;172;2109;1924;185;;85;0.01;-424;-0.07;641806
1864;Fryslân (PV);2006 juli;641806;655;491;2629;2425;204;2752;2439;313;;41;0.01;-383;-0.06;641847
1865;Fryslân (PV);2006 augustus;641847;607;458;3166;2904;262;3112;2882;230;;203;0.03;-180;-0.03;642050
1866;Fryslân (PV);2006 september;642050;595;459;2982;2614;368;2981;2770;211;;137;0.02;-43;-0.01;642187
1867;Fryslân (PV);2006 oktober;642187;616;488;2429;2245;184;2634;2439;195;;-77;-0.01;-120;-0.02;642110
1868;Fryslân (PV);2006 november;642110;612;483;2357;2192;165;2461;2243;218;;25;0.0;-95;-0.01;642135
1869;Fryslân (PV);2006 december;642135;578;509;2178;2062;116;2277;1967;310;104.0;74;0.01;-21;0.0;642209
1870;Fryslân (PV);2006;642230;7233;5923;28613;26357;2256;30048;26893;3155;104.0;-21;0.0;-21;0.0;642209
1871;Fryslân (PV);2007 januari;642209;604;485;2391;2210;181;2563;2320;243;;-53;-0.01;-53;-0.01;642156
1872;Fryslân (PV);2007 februari;642156;565;464;2222;2009;213;2259;2056;203;;64;0.01;11;0.0;642220
1873;Fryslân (PV);2007 maart;642220;602;539;2184;1965;219;2258;2071;187;;-11;0.0;0;0.0;642209
1874;Fryslân (PV);2007 april;642209;562;465;1806;1640;166;1884;1745;139;;19;0.0;19;0.0;642228
1875;Fryslân (PV);2007 mei;642228;564;473;2089;1934;155;2122;1996;126;;58;0.01;77;0.01;642286
1876;Fryslân (PV);2007 juni;642286;551;428;2216;2018;198;2126;1953;173;;213;0.03;290;0.05;642499
1877;Fryslân (PV);2007 juli;642499;605;421;2782;2513;269;2887;2629;258;;79;0.01;369;0.06;642578
1878;Fryslân (PV);2007 augustus;642578;641;426;3107;2747;360;3106;2890;216;;216;0.03;585;0.09;642794
1879;Fryslân (PV);2007 september;642794;636;401;2589;2312;277;2712;2542;170;;112;0.02;697;0.11;642906
1880;Fryslân (PV);2007 oktober;642906;567;410;2696;2407;289;2554;2455;99;;299;0.05;996;0.16;643205
1881;Fryslân (PV);2007 november;643205;599;446;2238;2019;219;2427;2174;253;;-36;-0.01;960;0.15;643169
1882;Fryslân (PV);2007 december;643169;563;490;2070;1874;196;2172;2035;137;49.0;20;0.0;980;0.15;643189
1883;Fryslân (PV);2007;642209;7059;5448;28390;25648;2742;29070;26866;2204;49.0;980;0.15;980;0.15;643189
1884;Fryslân (PV);2008 januari;643189;596;501;2748;2523;225;2817;2632;185;;26;0.0;26;0.0;643215
1885;Fryslân (PV);2008 februari;643215;526;467;2292;2019;273;2425;2232;193;;-74;-0.01;-48;-0.01;643141
1886;Fryslân (PV);2008 maart;643141;545;478;2083;1865;218;2205;2016;189;;-55;-0.01;-103;-0.02;643086
1887;Fryslân (PV);2008 april;643086;574;461;2156;1904;252;2166;1954;212;;103;0.02;0;0.0;643189
1888;Fryslân (PV);2008 mei;643189;605;488;1988;1790;198;2078;1894;184;;27;0.0;27;0.0;643216
1889;Fryslân (PV);2008 juni;643216;594;441;2184;1966;218;2203;1962;241;;134;0.02;161;0.03;643350
1890;Fryslân (PV);2008 juli;643350;643;477;2980;2669;311;2778;2544;234;;368;0.06;529;0.08;643718
1891;Fryslân (PV);2008 augustus;643718;624;412;3101;2652;449;2975;2742;233;;338;0.05;867;0.13;644056
1892;Fryslân (PV);2008 september;644056;606;404;3038;2531;507;2732;2593;139;;508;0.08;1375;0.21;644564
1893;Fryslân (PV);2008 oktober;644564;614;444;2684;2297;387;2761;2381;380;;93;0.01;1468;0.23;644657
1894;Fryslân (PV);2008 november;644657;579;457;2122;1827;295;2156;1952;204;;88;0.01;1556;0.24;644745
1895;Fryslân (PV);2008 december;644745;520;544;2260;1922;338;2265;2051;214;95.0;66;0.01;1622;0.25;644811
1896;Fryslân (PV);2008;643189;7026;5574;29636;25965;3671;29561;26953;2608;95.0;1622;0.25;1622;0.25;644811
1897;Fryslân (PV);2009 januari;644811;568;584;2314;2003;311;2258;2070;188;;40;0.01;40;0.01;644851
1898;Fryslân (PV);2009 februari;644851;531;480;2123;1819;304;2191;2021;170;;-17;0.0;23;0.0;644834
1899;Fryslân (PV);2009 maart;644834;628;498;2102;1831;271;2093;1935;158;;139;0.02;162;0.03;644973
1900;Fryslân (PV);2009 april;644973;548;464;1987;1688;299;2079;1893;186;;-8;0.0;154;0.02;644965
1901;Fryslân (PV);2009 mei;644965;548;432;1730;1530;200;1698;1636;62;;148;0.02;302;0.05;645113
1902;Fryslân (PV);2009 juni;645113;593;409;2049;1770;279;2092;1918;174;;141;0.02;443;0.07;645254
1903;Fryslân (PV);2009 juli;645254;671;460;2719;2455;264;2751;2528;223;;179;0.03;622;0.1;645433
1904;Fryslân (PV);2009 augustus;645433;594;439;2868;2482;386;2680;2490;190;;343;0.05;965;0.15;645776
1905;Fryslân (PV);2009 september;645776;615;433;2732;2358;374;2754;2546;208;;160;0.02;1125;0.17;645936
1906;Fryslân (PV);2009 oktober;645936;662;503;2297;1908;389;2171;2044;127;;285;0.04;1410;0.22;646221
1907;Fryslân (PV);2009 november;646221;551;428;1980;1755;225;2031;1882;149;;72;0.01;1482;0.23;646293
1908;Fryslân (PV);2009 december;646293;600;494;1886;1664;222;2005;1838;167;25.0;12;0.0;1494;0.23;646305
1909;Fryslân (PV);2009;644811;7109;5624;26787;23263;3524;26803;24801;2002;25.0;1494;0.23;1494;0.23;646305
1910;Fryslân (PV);2010 januari;646305;551;472;2187;1916;271;2222;1948;274;;44;0.01;44;0.01;646349
1911;Fryslân (PV);2010 februari;646349;556;453;2016;1764;252;2092;1947;145;;27;0.0;71;0.01;646376
1912;Fryslân (PV);2010 maart;646376;564;507;2194;1872;322;2224;2022;202;;27;0.0;98;0.02;646403
1913;Fryslân (PV);2010 april;646403;540;441;1819;1592;227;1831;1708;123;;87;0.01;185;0.03;646490
1914;Fryslân (PV);2010 mei;646490;537;482;1779;1586;193;1768;1632;136;;66;0.01;251;0.04;646556
1915;Fryslân (PV);2010 juni;646556;614;449;2023;1763;260;2102;1902;200;;86;0.01;337;0.05;646642
1916;Fryslân (PV);2010 juli;646642;651;470;2642;2314;328;2564;2360;204;;259;0.04;596;0.09;646901
1917;Fryslân (PV);2010 augustus;646901;634;410;2964;2503;461;2921;2682;239;;267;0.04;863;0.13;647168
1918;Fryslân (PV);2010 september;647168;620;433;2754;2194;560;2711;2532;179;;230;0.04;1093;0.17;647398
1919;Fryslân (PV);2010 oktober;647398;600;510;2062;1851;211;2248;2029;219;;-96;-0.01;997;0.15;647302
1920;Fryslân (PV);2010 november;647302;549;422;2178;1938;240;2249;2057;192;;56;0.01;1053;0.16;647358
1921;Fryslân (PV);2010 december;647358;596;539;1964;1764;200;2128;1956;172;31.0;-76;-0.01;977;0.15;647282
1922;Fryslân (PV);2010;646305;7012;5588;26582;23057;3525;27060;24775;2285;31.0;977;0.15;977;0.15;647282
1923;Fryslân (PV);2011 januari;647282;553;510;2076;1824;252;2182;1966;216;;-63;-0.01;-63;-0.01;647219
1924;Fryslân (PV);2011 februari;647219;544;455;2073;1816;257;2140;1976;164;;22;0.0;-41;-0.01;647241
1925;Fryslân (PV);2011 maart;647241;583;485;2123;1905;218;2149;1980;169;;72;0.01;31;0.0;647313
1926;Fryslân (PV);2011 april;647313;546;453;1692;1529;163;1829;1678;151;;-44;-0.01;-13;0.0;647269
1927;Fryslân (PV);2011 mei;647269;558;491;1856;1671;185;1850;1721;129;;73;0.01;60;0.01;647342
1928;Fryslân (PV);2011 juni;647342;558;431;1904;1706;198;2066;1827;239;;-35;-0.01;25;0.0;647307
1929;Fryslân (PV);2011 juli;647307;535;434;2393;2076;317;2631;2221;410;;-137;-0.02;-112;-0.02;647170
1930;Fryslân (PV);2011 augustus;647170;635;409;3211;2716;495;2995;2750;245;;442;0.07;330;0.05;647612
1931;Fryslân (PV);2011 september;647612;585;477;2767;2237;530;2781;2549;232;;94;0.01;424;0.07;647706
1932;Fryslân (PV);2011 oktober;647706;511;456;2000;1725;275;2070;1827;243;;-15;0.0;409;0.06;647691
1933;Fryslân (PV);2011 november;647691;515;471;2017;1782;235;2223;1957;266;;-162;-0.03;247;0.04;647529
1934;Fryslân (PV);2011 december;647529;532;534;1771;1572;199;2025;1780;245;-59.0;-315;-0.05;-68;-0.01;647214
1935;Fryslân (PV);2011;647282;6655;5606;25883;22559;3324;26941;24232;2709;-59.0;-68;-0.01;-68;-0.01;647214
1936;Fryslân (PV);2012 januari;647214;554;472;2164;1902;262;2304;2012;292;;-58;-0.01;-58;-0.01;647156
1937;Fryslân (PV);2012 februari;647156;491;503;2067;1818;249;2185;2005;180;;-130;-0.02;-188;-0.03;647026
1938;Fryslân (PV);2012 maart;647026;565;538;1870;1662;208;2087;1905;182;;-190;-0.03;-378;-0.06;646836
1939;Fryslân (PV);2012 april;646836;464;483;1698;1523;175;1731;1576;155;;-52;-0.01;-430;-0.07;646784
1940;Fryslân (PV);2012 mei;646784;593;465;1878;1680;198;1902;1732;170;;104;0.02;-326;-0.05;646888
1941;Fryslân (PV);2012 juni;646888;535;484;2033;1813;220;2086;1858;228;;-2;0.0;-328;-0.05;646886
1942;Fryslân (PV);2012 juli;646886;548;459;2423;2176;247;2496;2224;272;;16;0.0;-312;-0.05;646902
1943;Fryslân (PV);2012 augustus;646902;574;457;3239;2696;543;2962;2738;224;;394;0.06;82;0.01;647296
1944;Fryslân (PV);2012 september;647296;567;461;2461;2102;359;2692;2372;320;;-125;-0.02;-43;-0.01;647171
1945;Fryslân (PV);2012 oktober;647171;587;543;2135;1874;261;2242;1990;252;;-63;-0.01;-106;-0.02;647108
1946;Fryslân (PV);2012 november;647108;507;493;2010;1714;296;2058;1859;199;;-34;-0.01;-140;-0.02;647074
1947;Fryslân (PV);2012 december;647074;517;524;1674;1546;128;1886;1654;232;7.0;-212;-0.03;-352;-0.05;646862
1948;Fryslân (PV);2012;647214;6502;5882;25652;22506;3146;26631;23925;2706;7.0;-352;-0.05;-352;-0.05;646862
1949;Fryslân (PV);2013 januari;646862;544;602;2318;2057;261;2399;2160;239;;-139;-0.02;-139;-0.02;646723
1950;Fryslân (PV);2013 februari;646723;453;564;2021;1825;196;2274;2031;243;;-364;-0.06;-503;-0.08;646359
1951;Fryslân (PV);2013 maart;646359;537;571;1950;1723;227;2000;1827;173;;-84;-0.01;-587;-0.09;646275
1952;Fryslân (PV);2013 april;646275;476;495;1911;1701;210;2011;1798;213;;-119;-0.02;-706;-0.11;646156
1953;Fryslân (PV);2013 mei;646156;511;474;1977;1754;223;1842;1752;90;;172;0.03;-534;-0.08;646328
1954;Fryslân (PV);2013 juni;646328;528;461;1794;1560;234;1831;1604;227;;30;0.0;-504;-0.08;646358
1955;Fryslân (PV);2013 juli;646358;584;455;2613;2246;367;2597;2311;286;;145;0.02;-359;-0.06;646503
1956;Fryslân (PV);2013 augustus;646503;523;460;3135;2601;534;3293;2917;376;;-95;-0.01;-454;-0.07;646408
1957;Fryslân (PV);2013 september;646408;552;437;2685;2304;381;2780;2562;218;;20;0.0;-434;-0.07;646428
1958;Fryslân (PV);2013 oktober;646428;523;496;2205;1970;235;2269;2064;205;;-37;-0.01;-471;-0.07;646391
1959;Fryslân (PV);2013 november;646391;531;411;1968;1775;193;2105;1956;149;;-17;0.0;-488;-0.08;646374
1960;Fryslân (PV);2013 december;646374;501;511;1974;1776;198;2069;1867;202;48.0;-57;-0.01;-545;-0.08;646317
1961;Fryslân (PV);2013;646862;6263;5937;26551;23292;3259;27470;24849;2621;48.0;-545;-0.08;-545;-0.08;646317
1962;Fryslân (PV);2014 januari;646317;550;459;2442;2059;383;2372;2117;255;;161;0.02;161;0.02;646478
1963;Fryslân (PV);2014 februari;646478;485;454;2117;1863;254;2204;2000;204;;-56;-0.01;105;0.02;646422
1964;Fryslân (PV);2014 maart;646422;507;546;2092;1840;252;1977;1832;145;;76;0.01;181;0.03;646498
1965;Fryslân (PV);2014 april;646498;543;453;1903;1682;221;1937;1833;104;;56;0.01;237;0.04;646554
1966;Fryslân (PV);2014 mei;646554;522;457;1877;1681;196;1843;1715;128;;99;0.02;336;0.05;646653
1967;Fryslân (PV);2014 juni;646653;522;442;2072;1833;239;2188;1929;259;;-36;-0.01;300;0.05;646617
1968;Fryslân (PV);2014 juli;646617;576;512;2718;2364;354;2738;2468;270;;44;0.01;344;0.05;646661
1969;Fryslân (PV);2014 augustus;646661;530;510;3312;2697;615;3191;2946;245;;141;0.02;485;0.08;646802
1970;Fryslân (PV);2014 september;646802;545;402;2848;2397;451;2998;2694;304;;-7;0.0;478;0.07;646795
1971;Fryslân (PV);2014 oktober;646795;512;495;2406;2090;316;2574;2188;386;;-151;-0.02;327;0.05;646644
1972;Fryslân (PV);2014 november;646644;514;472;1977;1729;248;2067;1873;194;;-48;-0.01;279;0.04;646596
1973;Fryslân (PV);2014 december;646596;504;581;2205;1991;214;2443;2070;373;-24.0;-339;-0.05;-60;-0.01;646257
1974;Fryslân (PV);2014;646317;6310;5783;27969;24226;3743;28532;25665;2867;-24.0;-60;-0.01;-60;-0.01;646257
1975;Fryslân (PV);2015 januari;646257;548;569;2371;2000;371;2443;2190;253;;-93;-0.01;-93;-0.01;646164
1976;Fryslân (PV);2015 februari;646164;448;533;2261;1986;275;2246;2115;131;;-70;-0.01;-163;-0.03;646094
1977;Fryslân (PV);2015 maart;646094;489;555;2114;1868;246;2164;1996;168;;-116;-0.02;-279;-0.04;645978
1978;Fryslân (PV);2015 april;645978;470;540;1878;1673;205;1940;1805;135;;-132;-0.02;-411;-0.06;645846
1979;Fryslân (PV);2015 mei;645846;518;476;1883;1689;194;1813;1710;103;;112;0.02;-299;-0.05;645958
1980;Fryslân (PV);2015 juni;645958;501;484;2037;1791;246;2191;1922;269;;-137;-0.02;-436;-0.07;645821
1981;Fryslân (PV);2015 juli;645821;510;480;2756;2444;312;2747;2460;287;;39;0.01;-397;-0.06;645860
1982;Fryslân (PV);2015 augustus;645860;489;469;3473;2788;685;3222;2957;265;;271;0.04;-126;-0.02;646131
1983;Fryslân (PV);2015 september;646131;550;483;2851;2494;357;2963;2696;267;;-45;-0.01;-171;-0.03;646086
1984;Fryslân (PV);2015 oktober;646086;486;476;2368;2110;258;2409;2211;198;;-31;0.0;-202;-0.03;646055
1985;Fryslân (PV);2015 november;646055;496;482;2099;1868;231;2073;1905;168;;40;0.01;-162;-0.03;646095
1986;Fryslân (PV);2015 december;646095;506;512;2338;2128;210;2391;2200;191;4.0;-55;-0.01;-217;-0.03;646040
1987;Fryslân (PV);2015;646257;6011;6059;28429;24839;3590;28602;26167;2435;4.0;-217;-0.03;-217;-0.03;646040
1988;Fryslân (PV);2016 januari;646040;469;591;2469;2135;334;2524;2262;262;;-177;-0.03;-177;-0.03;645863
1989;Fryslân (PV);2016 februari;645863;446;551;2482;2191;291;2518;2292;226;;-141;-0.02;-318;-0.05;645722
1990;Fryslân (PV);2016 maart;645722;497;563;2155;1929;226;2156;1942;214;;-67;-0.01;-385;-0.06;645655
1991;Fryslân (PV);2016 april;645655;446;532;2135;1970;165;2247;2080;167;;-198;-0.03;-583;-0.09;645457
1992;Fryslân (PV);2016 mei;645457;516;521;2158;1923;235;2109;1935;174;;44;0.01;-539;-0.08;645501
1993;Fryslân (PV);2016 juni;645501;465;431;2296;2047;249;2298;2027;271;;32;0.0;-507;-0.08;645533
1994;Fryslân (PV);2016 juli;645533;579;501;2909;2582;327;2790;2514;276;;197;0.03;-310;-0.05;645730
1995;Fryslân (PV);2016 augustus;645730;587;478;3758;3141;617;3340;3070;270;;527;0.08;217;0.03;646257
1996;Fryslân (PV);2016 september;646257;543;480;3316;2865;451;3098;2899;199;;281;0.04;498;0.08;646538
1997;Fryslân (PV);2016 oktober;646538;525;526;2602;2345;257;2379;2214;165;;222;0.03;720;0.11;646760
1998;Fryslân (PV);2016 november;646760;463;539;2447;2213;234;2353;2163;190;;18;0.0;738;0.11;646778
1999;Fryslân (PV);2016 december;646778;481;573;2764;2567;197;2562;2349;213;-14.0;96;0.01;834;0.13;646874
2000;Fryslân (PV);2016;646040;6017;6286;31491;27908;3583;30374;27747;2627;-14.0;834;0.13;834;0.13;646874
2001;Fryslân (PV);2017 januari;646874;506;675;2699;2457;242;2625;2323;302;;-95;-0.01;-95;-0.01;646779
2002;Fryslân (PV);2017 februari;646779;418;548;2662;2366;296;2558;2373;185;;-26;0.0;-121;-0.02;646753
2003;Fryslân (PV);2017 maart;646753;528;595;2549;2338;211;2579;2380;199;;-97;-0.01;-218;-0.03;646656
2004;Fryslân (PV);2017 april;646656;481;473;2118;1943;175;2033;1867;166;;93;0.01;-125;-0.02;646749
2005;Fryslân (PV);2017 mei;646749;522;497;2537;2309;228;2378;2173;205;;184;0.03;59;0.01;646933
2006;Fryslân (PV);2017 juni;646933;489;497;2470;2208;262;2402;2078;324;;60;0.01;119;0.02;646993
2007;Fryslân (PV);2017 juli;646993;536;487;3118;2802;316;3136;2800;336;;31;0.0;150;0.02;647024
2008;Fryslân (PV);2017 augustus;647024;514;455;3663;2969;694;3379;3101;278;;343;0.05;493;0.08;647367
2009;Fryslân (PV);2017 september;647367;496;454;3336;2930;406;3170;2945;225;;208;0.03;701;0.11;647575
2010;Fryslân (PV);2017 oktober;647575;509;491;2604;2352;252;2689;2421;268;;-67;-0.01;634;0.1;647508
2011;Fryslân (PV);2017 november;647508;516;529;2437;2234;203;2478;2248;230;;-54;-0.01;580;0.09;647454
2012;Fryslân (PV);2017 december;647454;452;563;2494;2310;184;2564;2358;206;-5.0;-186;-0.03;394;0.06;647268
2013;Fryslân (PV);2017;646874;5967;6264;32687;29218;3469;31991;29067;2924;-5.0;394;0.06;394;0.06;647268
2014;Fryslân (PV);2018 januari;647268;508;629;2618;2256;362;2641;2313;328;;-144;-0.02;-144;-0.02;647124
2015;Fryslân (PV);2018 februari;647124;440;590;2382;2133;249;2379;2151;228;;-147;-0.02;-291;-0.04;646977
2016;Fryslân (PV);2018 maart;646977;440;732;2420;2158;262;2438;2290;148;;-310;-0.05;-601;-0.09;646667
2017;Fryslân (PV);2018 april;646667;485;535;2068;1822;246;2070;1904;166;;-52;-0.01;-653;-0.1;646615
2018;Fryslân (PV);2018 mei;646615;539;524;2177;1928;249;2033;1840;193;;159;0.02;-494;-0.08;646774
2019;Fryslân (PV);2018 juni;646774;432;442;2283;2010;273;2345;2060;285;;-72;-0.01;-566;-0.09;646702
2020;Fryslân (PV);2018 juli;646702;543;506;3115;2737;378;3048;2674;374;;104;0.02;-462;-0.07;646806
2021;Fryslân (PV);2018 augustus;646806;524;511;3999;3160;839;3219;2977;242;;793;0.12;331;0.05;647599
2022;Fryslân (PV);2018 september;647599;488;464;2818;2389;429;2760;2516;244;;82;0.01;413;0.06;647681
2023;Fryslân (PV);2018 oktober;647681;492;534;2582;2276;306;2501;2265;236;;39;0.01;452;0.07;647720
2024;Fryslân (PV);2018 november;647720;438;474;2269;2028;241;2286;2103;183;;-53;-0.01;399;0.06;647667
2025;Fryslân (PV);2018 december;647667;450;485;2238;2032;206;2200;2014;186;2.0;5;0.0;404;0.06;647672
2026;Fryslân (PV);2018;647268;5779;6426;30969;26929;4040;29920;27107;2813;2.0;404;0.06;404;0.06;647672
2027;Fryslân (PV);2019 januari;647672;481;582;2619;2237;382;2540;2310;230;;-22;0.0;-22;0.0;647650
2028;Fryslân (PV);2019 februari;647650;437;470;2334;1983;351;2201;1988;213;;100;0.02;78;0.01;647750
2029;Fryslân (PV);2019 maart;647750;484;594;2330;2054;276;2277;2091;186;;-57;-0.01;21;0.0;647693
2030;Fryslân (PV);2019 april;647693;461;512;2264;1962;302;2129;1985;144;;84;0.01;105;0.02;647777
2031;Fryslân (PV);2019 mei;647777;511;490;2251;2046;205;2157;1994;163;;115;0.02;220;0.03;647892
2032;Fryslân (PV);2019 juni;647892;509;525;2337;2058;279;2070;1814;256;;251;0.04;471;0.07;648143
2033;Fryslân (PV);2019 juli;648143;552;499;3190;2785;405;2981;2580;401;;262;0.04;733;0.11;648405
2034;Fryslân (PV);2019 augustus;648405;584;500;3748;2927;821;2959;2677;282;;873;0.13;1606;0.25;649278
2035;Fryslân (PV);2019 september;649278;532;443;3098;2478;620;2639;2420;219;;548;0.08;2154;0.33;649826
2036;Fryslân (PV);2019 oktober;649826;501;538;2652;2323;329;2435;2273;162;;180;0.03;2334;0.36;650006
2037;Fryslân (PV);2019 november;650006;455;566;2309;2021;288;2229;2009;220;;-31;0.0;2303;0.36;649975
2038;Fryslân (PV);2019 december;649975;450;537;2270;2031;239;2199;1999;200;-2.0;-18;0.0;2285;0.35;649957
2039;Fryslân (PV);2019;647672;5957;6256;31402;26905;4497;28816;26140;2676;-2.0;2285;0.35;2285;0.35;649957
2040;Fryslân (PV);2020 januari;649957;458;599;2768;2388;380;2755;2389;366;;-128;-0.02;-128;-0.02;649829
2041;Fryslân (PV);2020 februari;649829;420;515;2440;2106;334;2376;2195;181;;-31;0.0;-159;-0.02;649798
2042;Fryslân (PV);2020 maart;649798;443;571;2272;2022;250;2152;1942;210;;-8;0.0;-167;-0.03;649790
2043;Fryslân (PV);2020 april;649790;486;617;2081;1935;146;1971;1873;98;;-21;0.0;-188;-0.03;649769
2044;Fryslân (PV);2020 mei;649769;452;490;2161;2025;136;2119;1996;123;;4;0.0;-184;-0.03;649773
2045;Fryslân (PV);2020 juni;649773;506;486;2189;1976;213;2269;2006;263;;-60;-0.01;-244;-0.04;649713
2046;Fryslân (PV);2020 juli;649713;504;468;3007;2670;337;2832;2467;365;;211;0.03;-33;-0.01;649924
2047;Fryslân (PV);2020 augustus;649924;534;486;3345;2849;496;2835;2611;224;;558;0.09;525;0.08;650482
2048;Fryslân (PV);2020 september;650482;523;475;2809;2262;547;2441;2254;187;;416;0.06;941;0.14;650898
2049;Fryslân (PV);2020 oktober;650898;527;572;2756;2493;263;2583;2378;205;;128;0.02;1069;0.16;651026
2050;Fryslân (PV);2020 november;651026;528;581;2435;2236;199;2180;2024;156;;202;0.03;1271;0.2;651228
2051;Fryslân (PV);2020 december;651228;460;593;2692;2480;212;2335;2181;154;-17.0;207;0.03;1478;0.23;651435
2052;Fryslân (PV);2020;649957;5841;6453;30955;27442;3513;28848;26316;2532;-17.0;1478;0.23;1478;0.23;651435
2053;Fryslân (PV);2021 januari;651435;519;694;2731;2544;187;2613;2385;228;0.0;-57;-0.01;-57;-0.01;651378
2054;Fryslân (PV);2021 februari;651378;458;624;2441;2229;212;2336;2106;230;0.0;-61;-0.01;-118;-0.02;651317
2055;Fryslân (PV);2021 maart;651317;512;582;2777;2593;184;2454;2257;197;0.0;253;0.04;135;0.02;651570
2056;Fryslân (PV);2021 april;651570;548;535;2489;2299;190;2266;2079;187;0.0;236;0.04;371;0.06;651806
2057;Fryslân (PV);2021 mei;651806;511;505;2407;2201;206;2037;1917;120;0.0;376;0.06;747;0.11;652182
2058;Fryslân (PV);2021 juni;652182;509;542;2494;2251;243;2167;1945;222;0.0;294;0.05;1041;0.16;652476
2059;Fryslân (PV);2021 juli;652476;602;490;3012;2682;330;2663;2408;255;0.0;461;0.07;1502;0.23;652937
2060;Fryslân (PV);2021 augustus;652937;529;542;3516;2873;643;2810;2542;268;0.0;693;0.11;2195;0.34;653630
2061;Fryslân (PV);2021 september;653630;561;542;2719;2221;498;2465;2327;138;0.0;273;0.04;2468;0.38;653903
2062;Fryslân (PV);2021 oktober;653903;557;604;2691;2430;261;2290;2059;231;0.0;354;0.05;2822;0.43;654257
2063;Fryslân (PV);2021 november;654257;541;653;2345;2134;211;2335;2134;201;0.0;-102;-0.02;2720;0.42;654155
2064;Fryslân (PV);2021 december;654155;472;756;2406;2222;184;2240;1997;243;-18.0;-136;-0.02;2584;0.4;654019
2065;Fryslân (PV);2021;651435;6319;7069;32028;28679;3349;28676;26156;2520;-18.0;2584;0.4;2584;0.4;654019
2066;Fryslân (PV);2022 januari;654019;472;641;2445;2153;292;2250;1993;257;;26;0.0;26;0.0;654045
2067;Fryslân (PV);2022 februari;654045;445;512;2420;2052;368;2047;1843;204;;306;0.05;332;0.05;654351
2068;Fryslân (PV);2022 maart;654351;479;660;3272;2189;1083;2195;2000;195;;896;0.14;1228;0.19;655247
2069;Fryslân (PV);2022 april;655247;479;616;3880;2329;1551;2231;2016;215;;1512;0.23;2740;0.42;656759
2070;Fryslân (PV);2022 mei;656759;467;579;2862;2177;685;2147;1882;265;;603;0.09;3343;0.51;657362
2071;Fryslân (PV);2022 juni;657362;465;531;2534;2017;517;2336;1967;369;;132;0.02;3475;0.53;657494
2072;Fryslân (PV);2022 juli;657494;520;566;3040;2442;598;2619;2172;447;;375;0.06;3850;0.59;657869
2073;Fryslân (PV);2022 augustus;657869;477;534;3751;2778;973;2871;2505;366;;823;0.13;4673;0.71;658692
2074;Fryslân (PV);2022 september;658692;569;523;3227;2445;782;2676;2312;364;;597;0.09;5270;0.81;659289
2075;Fryslân (PV);2022 oktober;659289;514;603;2841;2316;525;2440;2155;285;;312;0.05;5582;0.85;659601
2076;Fryslân (PV);2022 november;659601;475;608;2697;2189;508;2489;2055;434;;75;0.01;5657;0.86;659676
2077;Fryslân (PV);2022 december;659676;439;725;2603;2237;366;2421;2086;335;-21.0;-125;-0.02;5532;0.85;659551
2078;Fryslân (PV);2022;654019;5801;7098;35572;27324;8248;28722;24986;3736;-21.0;5532;0.85;5532;0.85;659551
2079;Fryslân (PV);2023 januari;659551;481;671;2991;2455;536;2736;2305;431;0.0;65;0.01;65;0.01;659616
2080;Fryslân (PV);2023 februari;659616;409;551;2938;2328;610;2368;2056;312;0.0;428;0.06;493;0.07;660044
2081;Fryslân (PV);2023 maart;660044;468;626;2803;2342;461;2503;2153;350;0.0;142;0.02;635;0.1;660186
2082;Fryslân (PV);2023 april;660186;457;581;2293;1985;308;2123;1880;243;0.0;46;0.01;681;0.1;660232
2083;Fryslân (PV);2023 mei;660232;491;544;2544;2189;355;2265;1990;275;0.0;226;0.03;907;0.14;660458
2084;Fryslân (PV);2023 juni;660458;451;569;2555;2150;405;2436;2082;354;0.0;1;0.0;908;0.14;660459
2085;Fryslân (PV);2023 juli;660459;552;578;3350;2804;546;3118;2566;552;0.0;206;0.03;1114;0.17;660665
2086;Fryslân (PV);2023 augustus;660665;503;503;3737;2924;813;3316;2848;468;0.0;421;0.06;1535;0.23;661086
2087;Fryslân (PV);2023 september;661086;482;532;3544;2605;939;2949;2621;328;0.0;545;0.08;2080;0.32;661631
2088;Fryslân (PV);2023 oktober;661631;469;611;2847;2350;497;2522;2258;264;0.0;183;0.03;2263;0.34;661814
2089;Fryslân (PV);2023 november;661814;470;598;2644;2181;463;2375;2003;372;0.0;141;0.02;2404;0.36;661955
2090;Fryslân (PV);2023 december;661955;465;669;2448;2177;271;2271;1932;339;-24.0;-51;-0.01;2353;0.36;661904
2091;Fryslân (PV);2023;659551;5698;7033;34694;28490;6204;30982;26694;4288;-24.0;2353;0.36;2353;0.36;661904
2092;Fryslân (PV);2024 januari;661904;445;666;2828;2383;445;2506;2075;431;;101;0.02;101;0.02;662005
2093;Fryslân (PV);2024 februari;662005;457;577;2788;2265;523;2381;2053;328;;287;0.04;388;0.06;662292
2094;Fryslân (PV);2024 maart;662292;418;605;2449;2129;320;2269;1941;328;;-7;0.0;381;0.06;662285
2095;Fryslân (PV);2024 april;662285;461;618;2277;1966;311;2206;1926;280;;-86;-0.01;295;0.04;662199
2096;Fryslân (PV);2024 mei;662199;506;554;2328;1983;345;2201;1994;207;;79;0.01;374;0.06;662278
2097;Fryslân (PV);2024 juni;662278;462;600;2496;2156;340;2257;1889;368;;101;0.02;475;0.07;662379
2098;Fryslân (PV);2024 juli;662379;517;603;3185;2703;482;2899;2368;531;;200;0.03;675;0.1;662579
2099;Fryslân (PV);2024 augustus;662579;502;574;3497;2758;739;2923;2515;408;;502;0.08;1177;0.18;663081
2100;Fryslân (PV);2024 september;663081;499;578;3469;2593;876;2744;2367;377;;646;0.1;1823;0.28;663727
2101;Fryslân (PV);2024 oktober;663727;470;593;2857;2338;519;2418;2140;278;;316;0.05;2139;0.32;664043
2102;Fryslân (PV);2024 november;664043;456;571;2616;2303;313;2387;2135;252;;114;0.02;2253;0.34;664157
2103;Fryslân (PV);2024 december;664157;468;602;2545;2265;280;2334;2062;272;0.0;77;0.01;2330;0.35;664234
2104;Fryslân (PV);2024;661904;5661;7141;33335;27842;5493;29525;25465;4060;0.0;2330;0.35;2330;0.35;664234
2105;Fryslân (PV);2025 januari;664234;497;726;2945;2578;367;2668;2314;354;;48;0.01;48;0.01;664282
2106;Fryslân (PV);2025 februari;664282;404;647;2755;2270;485;2419;2028;391;;93;0.01;141;0.02;664375
2107;Drenthe (PV);2002 januari;478799;525;432;1933;1584;349;1724;1540;184;;302;0.06;302;0.06;479101
2108;Drenthe (PV);2002 februari;479101;462;370;1572;1336;236;1494;1354;140;;170;0.04;472;0.1;479271
2109;Drenthe (PV);2002 maart;479271;486;422;1686;1456;230;1660;1518;142;;90;0.02;562;0.12;479361
2110;Drenthe (PV);2002 april;479361;435;387;1624;1417;207;1525;1335;190;;147;0.03;709;0.15;479508
2111;Drenthe (PV);2002 mei;479508;493;406;1757;1582;175;1697;1510;187;;147;0.03;856;0.18;479655
2112;Drenthe (PV);2002 juni;479655;440;353;1686;1458;228;1510;1364;146;;263;0.05;1119;0.23;479918
2113;Drenthe (PV);2002 juli;479918;498;395;2272;2032;240;2032;1843;189;;343;0.07;1462;0.31;480261
2114;Drenthe (PV);2002 augustus;480261;501;342;2260;1966;294;2122;1878;244;;297;0.06;1759;0.37;480558
2115;Drenthe (PV);2002 september;480558;504;338;1768;1510;258;1860;1719;141;;74;0.02;1833;0.38;480632
2116;Drenthe (PV);2002 oktober;480632;514;404;1901;1554;347;1742;1586;156;;269;0.06;2102;0.44;480901
2117;Drenthe (PV);2002 november;480901;471;378;1568;1349;219;1568;1397;171;;93;0.02;2195;0.46;480994
2118;Drenthe (PV);2002 december;480994;434;406;1685;1483;202;1388;1222;166;-65.0;260;0.05;2455;0.51;481254
2119;Drenthe (PV);2002;478799;5763;4633;21712;18727;2985;20322;18266;2056;-65.0;2455;0.51;2455;0.51;481254
2120;Drenthe (PV);2003 januari;481254;451;438;1913;1698;215;1795;1600;195;;131;0.03;131;0.03;481385
2121;Drenthe (PV);2003 februari;481385;443;352;1493;1336;157;1574;1379;195;;10;0.0;141;0.03;481395
2122;Drenthe (PV);2003 maart;481395;460;432;1481;1312;169;1638;1485;153;;-129;-0.03;12;0.0;481266
2123;Drenthe (PV);2003 april;481266;452;404;1564;1410;154;1704;1451;253;;-92;-0.02;-80;-0.02;481174
2124;Drenthe (PV);2003 mei;481174;449;368;1461;1326;135;1414;1288;126;;128;0.03;48;0.01;481302
2125;Drenthe (PV);2003 juni;481302;487;332;1584;1443;141;1523;1399;124;;216;0.04;264;0.05;481518
2126;Drenthe (PV);2003 juli;481518;491;343;1999;1844;155;1794;1588;206;;353;0.07;617;0.13;481871
2127;Drenthe (PV);2003 augustus;481871;464;359;1866;1722;144;2004;1736;268;;-33;-0.01;584;0.12;481838
2128;Drenthe (PV);2003 september;481838;464;355;1636;1455;181;1915;1750;165;;-170;-0.04;414;0.09;481668
2129;Drenthe (PV);2003 oktober;481668;494;374;1759;1572;187;1674;1510;164;;205;0.04;619;0.13;481873
2130;Drenthe (PV);2003 november;481873;437;322;1455;1278;177;1385;1242;143;;185;0.04;804;0.17;482058
2131;Drenthe (PV);2003 december;482058;424;416;1619;1483;136;1458;1287;171;188.0;357;0.07;1161;0.24;482415
2132;Drenthe (PV);2003;481254;5516;4495;19830;17879;1951;19878;17715;2163;188.0;1161;0.24;1161;0.24;482415
2133;Drenthe (PV);2004 januari;482415;442;448;1624;1474;150;1566;1466;100;;52;0.01;52;0.01;482467
2134;Drenthe (PV);2004 februari;482467;404;322;1440;1310;130;1568;1445;123;;-46;-0.01;6;0.0;482421
2135;Drenthe (PV);2004 maart;482421;464;402;1615;1496;119;1836;1668;168;;-159;-0.03;-153;-0.03;482262
2136;Drenthe (PV);2004 april;482262;418;359;1553;1458;95;1616;1442;174;;-4;0.0;-157;-0.03;482258
2137;Drenthe (PV);2004 mei;482258;393;356;1475;1327;148;1444;1360;84;;68;0.01;-89;-0.02;482326
2138;Drenthe (PV);2004 juni;482326;461;348;1565;1441;124;1458;1315;143;;220;0.05;131;0.03;482546
2139;Drenthe (PV);2004 juli;482546;489;369;1898;1772;126;1746;1576;170;;272;0.06;403;0.08;482818
2140;Drenthe (PV);2004 augustus;482818;435;350;1780;1631;149;1871;1706;165;;-6;0.0;397;0.08;482812
2141;Drenthe (PV);2004 september;482812;465;350;1650;1499;151;1833;1665;168;;-68;-0.01;329;0.07;482744
2142;Drenthe (PV);2004 oktober;482744;460;332;1630;1496;134;1545;1383;162;;213;0.04;542;0.11;482957
2143;Drenthe (PV);2004 november;482957;472;380;1569;1461;108;1503;1375;128;;158;0.03;700;0.15;483115
2144;Drenthe (PV);2004 december;483115;417;391;1521;1452;69;1437;1291;146;144.0;254;0.05;954;0.2;483369
2145;Drenthe (PV);2004;482415;5320;4407;19320;17817;1503;19423;17692;1731;144.0;954;0.2;954;0.2;483369
2146;Drenthe (PV);2005 januari;483369;417;411;1474;1379;95;1377;1294;83;;103;0.02;103;0.02;483472
2147;Drenthe (PV);2005 februari;483472;351;369;1452;1344;108;1483;1359;124;;-49;-0.01;54;0.01;483423
2148;Drenthe (PV);2005 maart;483423;439;468;1474;1375;99;1684;1484;200;;-239;-0.05;-185;-0.04;483184
2149;Drenthe (PV);2005 april;483184;443;342;1604;1488;116;1461;1337;124;;244;0.05;59;0.01;483428
2150;Drenthe (PV);2005 mei;483428;430;353;1556;1481;75;1380;1229;151;;253;0.05;312;0.06;483681
2151;Drenthe (PV);2005 juni;483681;425;360;1613;1462;151;1417;1281;136;;261;0.05;573;0.12;483942
2152;Drenthe (PV);2005 juli;483942;442;322;1978;1847;131;1667;1507;160;;431;0.09;1004;0.21;484373
2153;Drenthe (PV);2005 augustus;484373;473;335;2217;2050;167;2104;1913;191;;251;0.05;1255;0.26;484624
2154;Drenthe (PV);2005 september;484624;456;297;1916;1774;142;2124;1960;164;;-49;-0.01;1206;0.25;484575
2155;Drenthe (PV);2005 oktober;484575;416;355;1794;1657;137;1879;1598;281;;-24;0.0;1182;0.24;484551
2156;Drenthe (PV);2005 november;484551;408;353;1668;1550;118;1939;1571;368;;-216;-0.04;966;0.2;484335
2157;Drenthe (PV);2005 december;484335;399;384;1721;1638;83;1676;1477;199;86.0;146;0.03;1112;0.23;484481
2158;Drenthe (PV);2005;483369;5099;4349;20467;19045;1422;20191;18010;2181;86.0;1112;0.23;1112;0.23;484481
2159;Drenthe (PV);2006 januari;484481;422;402;1781;1671;110;1686;1566;120;;115;0.02;115;0.02;484596
2160;Drenthe (PV);2006 februari;484596;372;351;1482;1403;79;1452;1284;168;;51;0.01;166;0.03;484647
2161;Drenthe (PV);2006 maart;484647;455;396;1740;1626;114;1553;1424;129;;246;0.05;412;0.09;484893
2162;Drenthe (PV);2006 april;484893;400;381;1368;1285;83;1340;1263;77;;47;0.01;459;0.09;484940
2163;Drenthe (PV);2006 mei;484940;428;370;1522;1411;111;1416;1336;80;;164;0.03;623;0.13;485104
2164;Drenthe (PV);2006 juni;485104;420;356;1611;1524;87;1554;1411;143;;121;0.02;744;0.15;485225
2165;Drenthe (PV);2006 juli;485225;423;374;2078;1905;173;1772;1574;198;;355;0.07;1099;0.23;485580
2166;Drenthe (PV);2006 augustus;485580;435;321;2258;2071;187;2217;2002;215;;155;0.03;1254;0.26;485735
2167;Drenthe (PV);2006 september;485735;405;339;1879;1723;156;2062;1915;147;;-117;-0.02;1137;0.23;485618
2168;Drenthe (PV);2006 oktober;485618;434;389;1796;1634;162;1736;1556;180;;105;0.02;1242;0.26;485723
2169;Drenthe (PV);2006 november;485723;416;323;1614;1498;116;1553;1411;142;;154;0.03;1396;0.29;485877
2170;Drenthe (PV);2006 december;485877;403;344;1639;1532;107;1494;1352;142;116.0;320;0.07;1716;0.35;486197
2171;Drenthe (PV);2006;484481;5013;4346;20768;19283;1485;19835;18094;1741;116.0;1716;0.35;1716;0.35;486197
2172;Drenthe (PV);2007 januari;486197;418;392;1769;1652;117;1667;1486;181;;128;0.03;128;0.03;486325
2173;Drenthe (PV);2007 februari;486325;394;352;1628;1531;97;1550;1402;148;;120;0.02;248;0.05;486445
2174;Drenthe (PV);2007 maart;486445;399;411;1736;1588;148;1497;1401;96;;227;0.05;475;0.1;486672
2175;Drenthe (PV);2007 april;486672;351;310;1380;1258;122;1290;1224;66;;131;0.03;606;0.12;486803
2176;Drenthe (PV);2007 mei;486803;409;366;1699;1566;133;1592;1387;205;;150;0.03;756;0.16;486953
2177;Drenthe (PV);2007 juni;486953;371;349;1566;1424;142;1474;1340;134;;114;0.02;870;0.18;487067
2178;Drenthe (PV);2007 juli;487067;442;351;2153;2004;149;1909;1660;249;;335;0.07;1205;0.25;487402
2179;Drenthe (PV);2007 augustus;487402;433;336;2207;2025;182;2136;1990;146;;168;0.03;1373;0.28;487570
2180;Drenthe (PV);2007 september;487570;437;332;1829;1505;324;1795;1677;118;;139;0.03;1512;0.31;487709
2181;Drenthe (PV);2007 oktober;487709;429;389;1943;1774;169;1878;1738;140;;105;0.02;1617;0.33;487814
2182;Drenthe (PV);2007 november;487814;391;382;1609;1502;107;1609;1458;151;;9;0.0;1626;0.33;487823
2183;Drenthe (PV);2007 december;487823;384;422;1622;1525;97;1362;1247;115;90.0;312;0.06;1938;0.4;488135
2184;Drenthe (PV);2007;486197;4858;4392;21141;19354;1787;19759;18010;1749;90.0;1938;0.4;1938;0.4;488135
2185;Drenthe (PV);2008 januari;488135;437;434;1886;1735;151;1715;1569;146;;174;0.04;174;0.04;488309
2186;Drenthe (PV);2008 februari;488309;383;382;1518;1411;107;1475;1348;127;;44;0.01;218;0.04;488353
2187;Drenthe (PV);2008 maart;488353;375;384;1466;1332;134;1414;1279;135;;43;0.01;261;0.05;488396
2188;Drenthe (PV);2008 april;488396;402;379;1529;1375;154;1381;1294;87;;171;0.04;432;0.09;488567
2189;Drenthe (PV);2008 mei;488567;426;372;1473;1360;113;1394;1252;142;;133;0.03;565;0.12;488700
2190;Drenthe (PV);2008 juni;488700;412;355;1615;1454;161;1492;1393;99;;180;0.04;745;0.15;488880
2191;Drenthe (PV);2008 juli;488880;477;357;2102;1947;155;2052;1738;314;;170;0.03;915;0.19;489050
2192;Drenthe (PV);2008 augustus;489050;422;337;2006;1815;191;2078;1881;197;;13;0.0;928;0.19;489063
2193;Drenthe (PV);2008 september;489063;448;351;2000;1655;345;1992;1844;148;;105;0.02;1033;0.21;489168
2194;Drenthe (PV);2008 oktober;489168;402;379;1840;1646;194;1699;1542;157;;164;0.03;1197;0.25;489332
2195;Drenthe (PV);2008 november;489332;383;382;1597;1463;134;1373;1266;107;;225;0.05;1422;0.29;489557
2196;Drenthe (PV);2008 december;489557;347;401;1717;1577;140;1404;1296;108;102.0;361;0.07;1783;0.37;489918
2197;Drenthe (PV);2008;488135;4914;4513;20749;18770;1979;19469;17702;1767;102.0;1783;0.37;1783;0.37;489918
2198;Drenthe (PV);2009 januari;489918;453;489;1563;1417;146;1632;1425;207;;-105;-0.02;-105;-0.02;489813
2199;Drenthe (PV);2009 februari;489813;333;410;1597;1398;199;1459;1322;137;;61;0.01;-44;-0.01;489874
2200;Drenthe (PV);2009 maart;489874;413;406;1554;1373;181;1403;1271;132;;158;0.03;114;0.02;490032
2201;Drenthe (PV);2009 april;490032;423;369;1547;1329;218;1342;1210;132;;259;0.05;373;0.08;490291
2202;Drenthe (PV);2009 mei;490291;435;330;1295;1149;146;1180;1086;94;;220;0.04;593;0.12;490511
2203;Drenthe (PV);2009 juni;490511;430;332;1453;1241;212;1363;1240;123;;188;0.04;781;0.16;490699
2204;Drenthe (PV);2009 juli;490699;477;353;1975;1695;280;1970;1633;337;;129;0.03;910;0.19;490828
2205;Drenthe (PV);2009 augustus;490828;395;341;1764;1529;235;1919;1770;149;;-101;-0.02;809;0.17;490727
2206;Drenthe (PV);2009 september;490727;423;344;1661;1429;232;1734;1648;86;;6;0.0;815;0.17;490733
2207;Drenthe (PV);2009 oktober;490733;398;367;1487;1316;171;1467;1337;130;;51;0.01;866;0.18;490784
2208;Drenthe (PV);2009 november;490784;392;357;1392;1218;174;1362;1210;152;;65;0.01;931;0.19;490849
2209;Drenthe (PV);2009 december;490849;450;426;1406;1224;182;1307;1227;80;9.0;132;0.03;1063;0.22;490981
2210;Drenthe (PV);2009;489918;5022;4524;18694;16318;2376;18138;16379;1759;9.0;1063;0.22;1063;0.22;490981
2211;Drenthe (PV);2010 januari;490981;378;402;1405;1253;152;1460;1288;172;;-79;-0.02;-79;-0.02;490902
2212;Drenthe (PV);2010 februari;490902;352;394;1410;1245;165;1324;1234;90;;44;0.01;-35;-0.01;490946
2213;Drenthe (PV);2010 maart;490946;391;387;1485;1328;157;1468;1303;165;;21;0.0;-14;0.0;490967
2214;Drenthe (PV);2010 april;490967;355;369;1394;1223;171;1238;1164;74;;142;0.03;128;0.03;491109
2215;Drenthe (PV);2010 mei;491109;392;392;1287;1116;171;1186;1102;84;;101;0.02;229;0.05;491210
2216;Drenthe (PV);2010 juni;491210;376;352;1461;1238;223;1261;1136;125;;224;0.05;453;0.09;491434
2217;Drenthe (PV);2010 juli;491434;408;399;1828;1550;278;1792;1515;277;;45;0.01;498;0.1;491479
2218;Drenthe (PV);2010 augustus;491479;416;373;1770;1584;186;1885;1712;173;;-72;-0.01;426;0.09;491407
2219;Drenthe (PV);2010 september;491407;431;335;1678;1386;292;1763;1621;142;;11;0.0;437;0.09;491418
2220;Drenthe (PV);2010 oktober;491418;432;383;1369;1189;180;1390;1257;133;;28;0.01;465;0.09;491446
2221;Drenthe (PV);2010 november;491446;387;387;1372;1202;170;1468;1287;181;;-96;-0.02;369;0.08;491350
2222;Drenthe (PV);2010 december;491350;432;443;1485;1299;186;1378;1297;81;-35.0;61;0.01;430;0.09;491411
2223;Drenthe (PV);2010;490981;4750;4616;17944;15613;2331;17613;15916;1697;-35.0;430;0.09;430;0.09;491411
2224;Drenthe (PV);2011 januari;491411;398;404;1506;1327;179;1548;1400;148;;-48;-0.01;-48;-0.01;491363
2225;Drenthe (PV);2011 februari;491363;359;364;1408;1239;169;1507;1293;214;;-104;-0.02;-152;-0.03;491259
2226;Drenthe (PV);2011 maart;491259;380;412;1443;1262;181;1470;1289;181;;-59;-0.01;-211;-0.04;491200
2227;Drenthe (PV);2011 april;491200;353;399;1472;1278;194;1317;1194;123;;109;0.02;-102;-0.02;491309
2228;Drenthe (PV);2011 mei;491309;371;387;1345;1210;135;1351;1245;106;;-22;0.0;-124;-0.03;491287
2229;Drenthe (PV);2011 juni;491287;397;342;1333;1159;174;1269;1123;146;;119;0.02;-5;0.0;491406
2230;Drenthe (PV);2011 juli;491406;444;417;1778;1576;202;1615;1432;183;;190;0.04;185;0.04;491596
2231;Drenthe (PV);2011 augustus;491596;410;382;1734;1515;219;2032;1856;176;;-270;-0.05;-85;-0.02;491326
2232;Drenthe (PV);2011 september;491326;391;359;1682;1425;257;1937;1753;184;;-223;-0.05;-308;-0.06;491103
2233;Drenthe (PV);2011 oktober;491103;416;366;1487;1282;205;1620;1437;183;;-83;-0.02;-391;-0.08;491020
2234;Drenthe (PV);2011 november;491020;345;411;1327;1176;151;1491;1324;167;;-230;-0.05;-621;-0.13;490790
2235;Drenthe (PV);2011 december;490790;352;424;1442;1312;130;1372;1254;118;19.0;17;0.0;-604;-0.12;490807
2236;Drenthe (PV);2011;491411;4616;4667;17957;15761;2196;18529;16600;1929;19.0;-604;-0.12;-604;-0.12;490807
2237;Drenthe (PV);2012 januari;490807;394;457;1651;1451;200;1637;1446;191;;-49;-0.01;-49;-0.01;490758
2238;Drenthe (PV);2012 februari;490758;326;404;1507;1321;186;1459;1342;117;;-30;-0.01;-79;-0.02;490728
2239;Drenthe (PV);2012 maart;490728;349;452;1473;1315;158;1580;1374;206;;-210;-0.04;-289;-0.06;490518
2240;Drenthe (PV);2012 april;490518;341;428;1286;1164;122;1344;1229;115;;-145;-0.03;-434;-0.09;490373
2241;Drenthe (PV);2012 mei;490373;367;385;1390;1261;129;1314;1233;81;;58;0.01;-376;-0.08;490431
2242;Drenthe (PV);2012 juni;490431;384;379;1649;1507;142;1604;1452;152;;50;0.01;-326;-0.07;490481
2243;Drenthe (PV);2012 juli;490481;373;349;1817;1606;211;1680;1522;158;;161;0.03;-165;-0.03;490642
2244;Drenthe (PV);2012 augustus;490642;395;408;1804;1551;253;2090;1913;177;;-299;-0.06;-464;-0.09;490343
2245;Drenthe (PV);2012 september;490343;364;389;1548;1387;161;1815;1692;123;;-292;-0.06;-756;-0.15;490051
2246;Drenthe (PV);2012 oktober;490051;411;371;1636;1446;190;1696;1488;208;;-20;0.0;-776;-0.16;490031
2247;Drenthe (PV);2012 november;490031;381;391;1394;1248;146;1428;1326;102;;-44;-0.01;-820;-0.17;489987
2248;Drenthe (PV);2012 december;489987;321;427;1408;1313;95;1371;1274;97;0.0;-69;-0.01;-889;-0.18;489918
2249;Drenthe (PV);2012;490807;4406;4840;18563;16570;1993;19018;17291;1727;0.0;-889;-0.18;-889;-0.18;489918
2250;Drenthe (PV);2013 januari;489918;342;479;1658;1462;196;1609;1481;128;;-88;-0.02;-88;-0.02;489830
2251;Drenthe (PV);2013 februari;489830;318;474;1455;1283;172;1420;1279;141;;-121;-0.02;-209;-0.04;489709
2252;Drenthe (PV);2013 maart;489709;338;491;1396;1265;131;1420;1315;105;;-177;-0.04;-386;-0.08;489532
2253;Drenthe (PV);2013 april;489532;358;416;1327;1161;166;1276;1190;86;;-7;0.0;-393;-0.08;489525
2254;Drenthe (PV);2013 mei;489525;357;402;1355;1207;148;1281;1170;111;;29;0.01;-364;-0.07;489554
2255;Drenthe (PV);2013 juni;489554;334;333;1348;1180;168;1289;1184;105;;60;0.01;-304;-0.06;489614
2256;Drenthe (PV);2013 juli;489614;407;340;1825;1592;233;1781;1626;155;;111;0.02;-193;-0.04;489725
2257;Drenthe (PV);2013 augustus;489725;392;353;1821;1601;220;2191;2035;156;;-331;-0.07;-524;-0.11;489394
2258;Drenthe (PV);2013 september;489394;365;346;1663;1479;184;1906;1775;131;;-224;-0.05;-748;-0.15;489170
2259;Drenthe (PV);2013 oktober;489170;333;373;1609;1447;162;1608;1453;155;;-39;-0.01;-787;-0.16;489131
2260;Drenthe (PV);2013 november;489131;327;382;1524;1369;155;1494;1362;132;;-25;-0.01;-812;-0.17;489106
2261;Drenthe (PV);2013 december;489106;303;400;1399;1263;136;1418;1283;135;-2.0;-118;-0.02;-930;-0.19;488988
2262;Drenthe (PV);2013;489918;4174;4789;18380;16309;2071;18693;17153;1540;-2.0;-930;-0.19;-930;-0.19;488988
2263;Drenthe (PV);2014 januari;488988;340;394;1717;1522;195;1627;1504;123;;36;0.01;36;0.01;489024
2264;Drenthe (PV);2014 februari;489024;308;380;1480;1346;134;1473;1349;124;;-65;-0.01;-29;-0.01;488959
2265;Drenthe (PV);2014 maart;488959;331;384;1374;1255;119;1381;1276;105;;-60;-0.01;-89;-0.02;488899
2266;Drenthe (PV);2014 april;488899;367;378;1385;1183;202;1313;1165;148;;61;0.01;-28;-0.01;488960
2267;Drenthe (PV);2014 mei;488960;379;362;1347;1215;132;1336;1193;143;;28;0.01;0;0.0;488988
2268;Drenthe (PV);2014 juni;488988;361;364;1409;1237;172;1421;1289;132;;-15;0.0;-15;0.0;488973
2269;Drenthe (PV);2014 juli;488973;391;389;1921;1708;213;1846;1694;152;;77;0.02;62;0.01;489050
2270;Drenthe (PV);2014 augustus;489050;385;385;1762;1561;201;2172;1998;174;;-410;-0.08;-348;-0.07;488640
2271;Drenthe (PV);2014 september;488640;381;355;1720;1533;187;1946;1793;153;;-200;-0.04;-548;-0.11;488440
2272;Drenthe (PV);2014 oktober;488440;366;396;1694;1466;228;1606;1468;138;;58;0.01;-490;-0.1;488498
2273;Drenthe (PV);2014 november;488498;333;373;1438;1267;171;1455;1318;137;;-57;-0.01;-547;-0.11;488441
2274;Drenthe (PV);2014 december;488441;360;457;1812;1567;245;1587;1464;123;7.0;135;0.03;-412;-0.08;488576
2275;Drenthe (PV);2014;488988;4302;4617;19059;16860;2199;19163;17511;1652;7.0;-412;-0.08;-412;-0.08;488576
2276;Drenthe (PV);2015 januari;488576;354;515;1863;1654;209;1846;1677;169;;-144;-0.03;-144;-0.03;488432
2277;Drenthe (PV);2015 februari;488432;301;414;1655;1474;181;1610;1487;123;;-68;-0.01;-212;-0.04;488364
2278;Drenthe (PV);2015 maart;488364;326;443;1770;1541;229;1621;1520;101;;32;0.01;-180;-0.04;488396
2279;Drenthe (PV);2015 april;488396;285;435;1565;1310;255;1500;1351;149;;-85;-0.02;-265;-0.05;488311
2280;Drenthe (PV);2015 mei;488311;331;398;1662;1357;305;1386;1293;93;;209;0.04;-56;-0.01;488520
2281;Drenthe (PV);2015 juni;488520;341;381;1767;1415;352;1551;1434;117;;176;0.04;120;0.02;488696
2282;Drenthe (PV);2015 juli;488696;350;408;2412;1982;430;2112;1917;195;;242;0.05;362;0.07;488938
2283;Drenthe (PV);2015 augustus;488938;382;389;2277;1830;447;2324;2161;163;;-54;-0.01;308;0.06;488884
2284;Drenthe (PV);2015 september;488884;349;400;1992;1583;409;2077;1924;153;;-136;-0.03;172;0.04;488748
2285;Drenthe (PV);2015 oktober;488748;342;386;1943;1662;281;1986;1832;154;;-87;-0.02;85;0.02;488661
2286;Drenthe (PV);2015 november;488661;350;407;1719;1372;347;1753;1619;134;;-91;-0.02;-6;0.0;488570
2287;Drenthe (PV);2015 december;488570;318;399;1984;1646;338;1833;1673;160;-11.0;59;0.01;53;0.01;488629
2288;Drenthe (PV);2015;488576;4029;4975;22609;18826;3783;21599;19888;1711;-11.0;53;0.01;53;0.01;488629
2289;Drenthe (PV);2016 januari;488629;332;483;2004;1636;368;1899;1730;169;;-46;-0.01;-46;-0.01;488583
2290;Drenthe (PV);2016 februari;488583;354;413;2153;1662;491;1906;1798;108;;188;0.04;142;0.03;488771
2291;Drenthe (PV);2016 maart;488771;349;469;1989;1581;408;1808;1689;119;;61;0.01;203;0.04;488832
2292;Drenthe (PV);2016 april;488832;328;444;2107;1773;334;1724;1614;110;;267;0.05;470;0.1;489099
2293;Drenthe (PV);2016 mei;489099;362;440;2182;1615;567;1722;1622;100;;382;0.08;852;0.17;489481
2294;Drenthe (PV);2016 juni;489481;352;406;2502;1811;691;2121;1936;185;;327;0.07;1179;0.24;489808
2295;Drenthe (PV);2016 juli;489808;384;380;2853;2154;699;2522;2372;150;;335;0.07;1514;0.31;490143
2296;Drenthe (PV);2016 augustus;490143;377;395;2957;2038;919;2927;2774;153;;12;0.0;1526;0.31;490155
2297;Drenthe (PV);2016 september;490155;381;376;3103;2002;1101;2752;2610;142;;356;0.07;1882;0.39;490511
2298;Drenthe (PV);2016 oktober;490511;368;419;3700;1878;1822;3027;2891;136;;622;0.13;2504;0.51;491133
2299;Drenthe (PV);2016 november;491133;305;438;4255;1775;2480;3617;3471;146;;505;0.1;3009;0.62;491638
2300;Drenthe (PV);2016 december;491638;316;421;4335;1919;2416;4090;3937;153;14.0;154;0.03;3163;0.65;491792
2301;Drenthe (PV);2016;488629;4208;5084;34140;21844;12296;30115;28444;1671;14.0;3163;0.65;3163;0.65;491792
2302;Drenthe (PV);2017 januari;491792;333;548;3583;1999;1584;3827;3706;121;;-459;-0.09;-459;-0.09;491333
2303;Drenthe (PV);2017 februari;491333;304;479;4302;1774;2528;3878;3764;114;;249;0.05;-210;-0.04;491582
2304;Drenthe (PV);2017 maart;491582;343;444;4314;1947;2367;4413;4324;89;;-200;-0.04;-410;-0.08;491382
2305;Drenthe (PV);2017 april;491382;300;398;3575;1539;2036;3489;3403;86;;-12;0.0;-422;-0.09;491370
2306;Drenthe (PV);2017 mei;491370;340;439;3770;1840;1930;3729;3623;106;;-58;-0.01;-480;-0.1;491312
2307;Drenthe (PV);2017 juni;491312;348;401;3031;1765;1266;3304;3191;113;;-326;-0.07;-806;-0.16;490986
2308;Drenthe (PV);2017 juli;490986;378;404;3337;2228;1109;3208;3038;170;;103;0.02;-703;-0.14;491089
2309;Drenthe (PV);2017 augustus;491089;404;416;3659;2434;1225;3459;3307;152;;188;0.04;-515;-0.1;491277
2310;Drenthe (PV);2017 september;491277;356;406;3332;2091;1241;3088;2963;125;;194;0.04;-321;-0.07;491471
2311;Drenthe (PV);2017 oktober;491471;384;391;3212;1977;1235;3067;2924;143;;138;0.03;-183;-0.04;491609
2312;Drenthe (PV);2017 november;491609;372;421;3104;1803;1301;2894;2788;106;;161;0.03;-22;0.0;491770
2313;Drenthe (PV);2017 december;491770;329;455;3323;1943;1380;2837;2731;106;-30.0;330;0.07;308;0.06;492100
2314;Drenthe (PV);2017;491792;4191;5202;42542;23340;19202;41193;39762;1431;-30.0;308;0.06;308;0.06;492100
2315;Drenthe (PV);2018 januari;492100;317;512;2123;1934;189;2620;2478;142;;-692;-0.14;-692;-0.14;491408
2316;Drenthe (PV);2018 februari;491408;303;521;1905;1748;157;1935;1842;93;;-248;-0.05;-940;-0.19;491160
2317;Drenthe (PV);2018 maart;491160;333;553;1960;1775;185;1901;1770;131;;-161;-0.03;-1101;-0.22;490999
2318;Drenthe (PV);2018 april;490999;313;406;1804;1630;174;1627;1516;111;;84;0.02;-1017;-0.21;491083
2319;Drenthe (PV);2018 mei;491083;317;402;1902;1722;180;1731;1641;90;;86;0.02;-931;-0.19;491169
2320;Drenthe (PV);2018 juni;491169;330;405;2011;1840;171;1771;1596;175;;165;0.03;-766;-0.16;491334
2321;Drenthe (PV);2018 juli;491334;343;443;2204;1987;217;2061;1877;184;;43;0.01;-723;-0.15;491377
2322;Drenthe (PV);2018 augustus;491377;362;394;2670;2352;318;2355;2210;145;;283;0.06;-440;-0.09;491660
2323;Drenthe (PV);2018 september;491660;385;386;2216;1973;243;2111;1934;177;;104;0.02;-336;-0.07;491764
2324;Drenthe (PV);2018 oktober;491764;354;425;2340;2087;253;1952;1764;188;;317;0.06;-19;0.0;492081
2325;Drenthe (PV);2018 november;492081;343;410;2097;1903;194;1870;1777;93;;160;0.03;141;0.03;492241
2326;Drenthe (PV);2018 december;492241;292;483;1884;1704;180;1742;1627;115;-25.0;-74;-0.02;67;0.01;492167
2327;Drenthe (PV);2018;492100;3992;5340;25116;22655;2461;23676;22032;1644;-25.0;67;0.01;67;0.01;492167
2328;Drenthe (PV);2019 januari;492167;335;455;2226;1976;250;1981;1840;141;;125;0.03;125;0.03;492292
2329;Drenthe (PV);2019 februari;492292;292;426;1930;1753;177;1843;1694;149;;-47;-0.01;78;0.02;492245
2330;Drenthe (PV);2019 maart;492245;315;456;1956;1760;196;1846;1739;107;;-31;-0.01;47;0.01;492214
2331;Drenthe (PV);2019 april;492214;339;418;1868;1662;206;1599;1483;116;;190;0.04;237;0.05;492404
2332;Drenthe (PV);2019 mei;492404;340;427;1863;1668;195;1712;1615;97;;64;0.01;301;0.06;492468
2333;Drenthe (PV);2019 juni;492468;333;395;1695;1502;193;1545;1415;130;;88;0.02;389;0.08;492556
2334;Drenthe (PV);2019 juli;492556;369;444;2540;2260;280;2043;1857;186;;422;0.09;811;0.16;492978
2335;Drenthe (PV);2019 augustus;492978;389;428;2477;2107;370;2143;1977;166;;295;0.06;1106;0.22;493273
2336;Drenthe (PV);2019 september;493273;376;388;2156;1909;247;2074;1929;145;;70;0.01;1176;0.24;493343
2337;Drenthe (PV);2019 oktober;493343;359;368;2177;1944;233;2008;1814;194;;160;0.03;1336;0.27;493503
2338;Drenthe (PV);2019 november;493503;342;471;2018;1839;179;1830;1693;137;;59;0.01;1395;0.28;493562
2339;Drenthe (PV);2019 december;493562;321;467;2057;1883;174;1744;1645;99;-47.0;120;0.02;1515;0.31;493682
2340;Drenthe (PV);2019;492167;4110;5143;24963;22263;2700;22368;20701;1667;-47.0;1515;0.31;1515;0.31;493682
2341;Drenthe (PV);2020 januari;493682;368;508;2130;1945;185;2012;1881;131;;-22;0.0;-22;0.0;493660
2342;Drenthe (PV);2020 februari;493660;299;427;2006;1849;157;1849;1730;119;;29;0.01;7;0.0;493689
2343;Drenthe (PV);2020 maart;493689;323;459;1899;1740;159;1731;1599;132;;32;0.01;39;0.01;493721
2344;Drenthe (PV);2020 april;493721;345;490;1779;1659;120;1526;1476;50;;108;0.02;147;0.03;493829
2345;Drenthe (PV);2020 mei;493829;330;430;1884;1784;100;1674;1605;69;;110;0.02;257;0.05;493939
2346;Drenthe (PV);2020 juni;493939;309;406;1957;1806;151;1775;1674;101;;85;0.02;342;0.07;494024
2347;Drenthe (PV);2020 juli;494024;369;433;2412;2249;163;2208;2071;137;;140;0.03;482;0.1;494164
2348;Drenthe (PV);2020 augustus;494164;348;442;2152;1923;229;1999;1894;105;;59;0.01;541;0.11;494223
2349;Drenthe (PV);2020 september;494223;404;471;2127;1900;227;1889;1778;111;;171;0.03;712;0.14;494394
2350;Drenthe (PV);2020 oktober;494394;354;487;2221;2094;127;2026;1899;127;;62;0.01;774;0.16;494456
2351;Drenthe (PV);2020 november;494456;325;487;1937;1819;118;1716;1623;93;;59;0.01;833;0.17;494515
2352;Drenthe (PV);2020 december;494515;361;511;2194;2040;154;1760;1653;107;-28.0;256;0.05;1089;0.22;494771
2353;Drenthe (PV);2020;493682;4135;5551;24698;22808;1890;22165;20883;1282;-28.0;1089;0.22;1089;0.22;494771
2354;Drenthe (PV);2021 januari;494771;342;626;2151;2007;144;1847;1726;121;0.0;20;0.0;20;0.0;494791
2355;Drenthe (PV);2021 februari;494791;335;483;2027;1924;103;1679;1611;68;0.0;200;0.04;220;0.04;494991
2356;Drenthe (PV);2021 maart;494991;384;484;2509;2378;131;1977;1883;94;0.0;432;0.09;652;0.13;495423
2357;Drenthe (PV);2021 april;495423;388;479;2169;2080;89;1684;1623;61;0.0;394;0.08;1046;0.21;495817
2358;Drenthe (PV);2021 mei;495817;372;464;1938;1829;109;1566;1486;80;0.0;280;0.06;1326;0.27;496097
2359;Drenthe (PV);2021 juni;496097;338;436;2101;1939;162;1705;1559;146;0.0;298;0.06;1624;0.33;496395
2360;Drenthe (PV);2021 juli;496395;375;420;2405;2208;197;1996;1758;238;0.0;364;0.07;1988;0.4;496759
2361;Drenthe (PV);2021 augustus;496759;376;372;2342;2047;295;1965;1777;188;0.0;381;0.08;2369;0.48;497140
2362;Drenthe (PV);2021 september;497140;420;434;2238;2031;207;1881;1720;161;0.0;343;0.07;2712;0.55;497483
2363;Drenthe (PV);2021 oktober;497483;394;472;2187;2018;169;1842;1696;146;0.0;267;0.05;2979;0.6;497750
2364;Drenthe (PV);2021 november;497750;366;569;2058;1903;155;1743;1650;93;0.0;112;0.02;3091;0.62;497862
2365;Drenthe (PV);2021 december;497862;353;637;1966;1862;104;1760;1624;136;-41.0;-119;-0.02;2972;0.6;497743
2366;Drenthe (PV);2021;494771;4443;5876;26091;24226;1865;21645;20113;1532;-41.0;2972;0.6;2972;0.6;497743
2367;Drenthe (PV);2022 januari;497743;329;477;2109;1968;141;1736;1631;105;;225;0.05;225;0.05;497968
2368;Drenthe (PV);2022 februari;497968;330;466;1835;1685;150;1520;1413;107;;179;0.04;404;0.08;498147
2369;Drenthe (PV);2022 maart;498147;298;521;2773;1775;998;1687;1606;81;;863;0.17;1267;0.25;499010
2370;Drenthe (PV);2022 april;499010;328;517;2636;1863;773;1757;1681;76;;690;0.14;1957;0.39;499700
2371;Drenthe (PV);2022 mei;499700;314;489;2325;1829;496;1853;1680;173;;297;0.06;2254;0.45;499997
2372;Drenthe (PV);2022 juni;499997;330;469;2257;1690;567;1683;1444;239;;435;0.09;2689;0.54;500432
2373;Drenthe (PV);2022 juli;500432;388;511;2709;2131;578;2041;1795;246;;545;0.11;3234;0.65;500977
2374;Drenthe (PV);2022 augustus;500977;350;521;2509;1954;555;2057;1794;263;;281;0.06;3515;0.71;501258
2375;Drenthe (PV);2022 september;501258;375;439;2658;2077;581;2132;1874;258;;462;0.09;3977;0.8;501720
2376;Drenthe (PV);2022 oktober;501720;350;509;2290;1858;432;1889;1674;215;;242;0.05;4219;0.85;501962
2377;Drenthe (PV);2022 november;501962;328;512;2154;1822;332;1873;1681;192;;97;0.02;4316;0.87;502059
2378;Drenthe (PV);2022 december;502059;316;599;2230;2004;226;1923;1697;226;-32.0;-8;0.0;4308;0.87;502051
2379;Drenthe (PV);2022;497743;4036;6030;28485;22656;5829;22151;19970;2181;-32.0;4308;0.87;4308;0.87;502051
2380;Drenthe (PV);2023 januari;502051;330;565;2248;1934;314;1910;1683;227;0.0;103;0.02;103;0.02;502154
2381;Drenthe (PV);2023 februari;502154;312;481;2080;1778;302;1817;1555;262;0.0;94;0.02;197;0.04;502248
2382;Drenthe (PV);2023 maart;502248;349;527;2281;1926;355;1911;1692;219;0.0;192;0.04;389;0.08;502440
2383;Drenthe (PV);2023 april;502440;315;453;1984;1784;200;1708;1470;238;0.0;138;0.03;527;0.1;502578
2384;Drenthe (PV);2023 mei;502578;327;451;2103;1881;222;1743;1550;193;0.0;236;0.05;763;0.15;502814
2385;Drenthe (PV);2023 juni;502814;330;442;2296;2052;244;2097;1835;262;0.0;87;0.02;850;0.17;502901
2386;Drenthe (PV);2023 juli;502901;358;426;2545;2129;416;2319;2064;255;0.0;158;0.03;1008;0.2;503059
2387;Drenthe (PV);2023 augustus;503059;331;440;2576;2030;546;2368;2129;239;0.0;99;0.02;1107;0.22;503158
2388;Drenthe (PV);2023 september;503158;331;436;2559;1983;576;2153;1913;240;0.0;301;0.06;1408;0.28;503459
2389;Drenthe (PV);2023 oktober;503459;367;496;2245;1838;407;1885;1666;219;0.0;231;0.05;1639;0.33;503690
2390;Drenthe (PV);2023 november;503690;358;516;2214;1918;296;1749;1536;213;0.0;307;0.06;1946;0.39;503997
2391;Drenthe (PV);2023 december;503997;333;562;2215;1923;292;1802;1584;218;-52.0;132;0.03;2078;0.41;504129
2392;Drenthe (PV);2023;502051;4041;5795;27346;23176;4170;23462;20677;2785;-52.0;2078;0.41;2078;0.41;504129
2393;Drenthe (PV);2024 januari;504129;336;670;2354;1948;406;1922;1697;225;;98;0.02;98;0.02;504227
2394;Drenthe (PV);2024 februari;504227;303;522;2027;1737;290;1763;1561;202;;45;0.01;143;0.03;504272
2395;Drenthe (PV);2024 maart;504272;295;498;2348;2027;321;1867;1685;182;;278;0.06;421;0.08;504550
2396;Drenthe (PV);2024 april;504550;301;476;2209;1967;242;1875;1645;230;;159;0.03;580;0.12;504709
2397;Drenthe (PV);2024 mei;504709;324;517;1954;1744;210;1675;1535;140;;86;0.02;666;0.13;504795
2398;Drenthe (PV);2024 juni;504795;329;456;2050;1768;282;1677;1389;288;;246;0.05;912;0.18;505041
2399;Drenthe (PV);2024 juli;505041;368;454;2504;2099;405;1972;1707;265;;446;0.09;1358;0.27;505487
2400;Drenthe (PV);2024 augustus;505487;336;493;2569;2147;422;2207;1912;295;;205;0.04;1563;0.31;505692
2401;Drenthe (PV);2024 september;505692;359;454;2421;1996;425;1928;1714;214;;398;0.08;1961;0.39;506090
2402;Drenthe (PV);2024 oktober;506090;327;501;2379;1950;429;1821;1585;236;;384;0.08;2345;0.47;506474
2403;Drenthe (PV);2024 november;506474;338;489;2014;1817;197;1821;1585;236;;42;0.01;2387;0.47;506516
2404;Drenthe (PV);2024 december;506516;351;511;2067;1833;234;1811;1593;218;0.0;96;0.02;2483;0.49;506612
2405;Drenthe (PV);2024;504129;3967;6041;26896;23033;3863;22339;19608;2731;0.0;2483;0.49;2483;0.49;506612
2406;Drenthe (PV);2025 januari;506612;301;587;2153;1870;283;1952;1711;241;;-85;-0.02;-85;-0.02;506527
2407;Drenthe (PV);2025 februari;506527;347;589;2178;1948;230;1873;1646;227;;63;0.01;-22;0.0;506590
2408;Overijssel (PV);2002 januari;1094032;1244;906;3641;3076;565;3351;2913;438;;628;0.06;628;0.06;1094660
2409;Overijssel (PV);2002 februari;1094660;1093;817;3013;2597;416;2786;2461;325;;503;0.05;1131;0.1;1095163
2410;Overijssel (PV);2002 maart;1095163;1231;859;3163;2682;481;3051;2671;380;;484;0.04;1615;0.15;1095647
2411;Overijssel (PV);2002 april;1095647;1157;871;3113;2472;641;2937;2511;426;;462;0.04;2077;0.19;1096109
2412;Overijssel (PV);2002 mei;1096109;1173;801;3122;2677;445;3064;2551;513;;430;0.04;2507;0.23;1096539
2413;Overijssel (PV);2002 juni;1096539;1159;770;3065;2593;472;2994;2541;453;;460;0.04;2967;0.27;1096999
2414;Overijssel (PV);2002 juli;1096999;1248;787;4136;3695;441;3976;3385;591;;621;0.06;3588;0.33;1097620
2415;Overijssel (PV);2002 augustus;1097620;1310;786;4522;3791;731;4240;3775;465;;806;0.07;4394;0.4;1098426
2416;Overijssel (PV);2002 september;1098426;1313;758;4242;3167;1075;3936;3370;566;;861;0.08;5255;0.48;1099287
2417;Overijssel (PV);2002 oktober;1099287;1340;768;3830;3104;726;3757;3012;745;;645;0.06;5900;0.54;1099932
2418;Overijssel (PV);2002 november;1099932;1185;799;3217;2726;491;3193;2690;503;;410;0.04;6310;0.58;1100342
2419;Overijssel (PV);2002 december;1100342;1210;920;2827;2507;320;2939;2418;521;157.0;335;0.03;6645;0.61;1100677
2420;Overijssel (PV);2002;1094032;14663;9842;41891;35087;6804;40224;34298;5926;157.0;6645;0.61;6645;0.61;1100677
2421;Overijssel (PV);2003 januari;1100677;1246;902;3553;3157;396;3563;3077;486;;334;0.03;334;0.03;1101011
2422;Overijssel (PV);2003 februari;1101011;1162;750;2893;2509;384;2895;2584;311;;410;0.04;744;0.07;1101421
2423;Overijssel (PV);2003 maart;1101421;1279;883;3014;2554;460;2925;2482;443;;485;0.04;1229;0.11;1101906
2424;Overijssel (PV);2003 april;1101906;1196;868;2772;2340;432;2817;2379;438;;283;0.03;1512;0.14;1102189
2425;Overijssel (PV);2003 mei;1102189;1200;813;2771;2442;329;3118;2491;627;;40;0.0;1552;0.14;1102229
2426;Overijssel (PV);2003 juni;1102229;1199;767;3153;2751;402;3070;2612;458;;515;0.05;2067;0.19;1102744
2427;Overijssel (PV);2003 juli;1102744;1361;778;3990;3531;459;3824;3219;605;;749;0.07;2816;0.26;1103493
2428;Overijssel (PV);2003 augustus;1103493;1286;801;4209;3543;666;4198;3623;575;;496;0.04;3312;0.3;1103989
2429;Overijssel (PV);2003 september;1103989;1301;769;4040;3258;782;4297;3661;636;;275;0.02;3587;0.33;1104264
2430;Overijssel (PV);2003 oktober;1104264;1271;809;3640;3003;637;3591;3026;565;;511;0.05;4098;0.37;1104775
2431;Overijssel (PV);2003 november;1104775;1224;799;2921;2538;383;3046;2545;501;;300;0.03;4398;0.4;1105075
2432;Overijssel (PV);2003 december;1105075;1132;961;3091;2806;285;3307;2729;578;482.0;437;0.04;4835;0.44;1105512
2433;Overijssel (PV);2003;1100677;14857;9900;40047;34432;5615;40651;34428;6223;482.0;4835;0.44;4835;0.44;1105512
2434;Overijssel (PV);2004 januari;1105512;1195;930;3185;2874;311;3356;2845;511;;94;0.01;94;0.01;1105606
2435;Overijssel (PV);2004 februari;1105606;1087;782;2778;2478;300;2878;2540;338;;205;0.02;299;0.03;1105811
2436;Overijssel (PV);2004 maart;1105811;1191;890;3166;2780;386;3056;2612;444;;411;0.04;710;0.06;1106222
2437;Overijssel (PV);2004 april;1106222;1141;791;2744;2477;267;2624;2326;298;;470;0.04;1180;0.11;1106692
2438;Overijssel (PV);2004 mei;1106692;1131;694;2493;2188;305;2401;2118;283;;529;0.05;1709;0.15;1107221
2439;Overijssel (PV);2004 juni;1107221;1201;735;3040;2647;393;2974;2571;403;;532;0.05;2241;0.2;1107753
2440;Overijssel (PV);2004 juli;1107753;1244;712;3698;3362;336;3852;3277;575;;378;0.03;2619;0.24;1108131
2441;Overijssel (PV);2004 augustus;1108131;1274;763;4188;3614;574;4298;3753;545;;401;0.04;3020;0.27;1108532
2442;Overijssel (PV);2004 september;1108532;1147;710;3605;3070;535;3969;3568;401;;73;0.01;3093;0.28;1108605
2443;Overijssel (PV);2004 oktober;1108605;1221;752;3271;2679;592;3579;2829;750;;161;0.01;3254;0.29;1108766
2444;Overijssel (PV);2004 november;1108766;1149;773;3140;2782;358;3246;2723;523;;270;0.02;3524;0.32;1109036
2445;Overijssel (PV);2004 december;1109036;1117;839;2998;2684;314;3078;2640;438;198.0;396;0.04;3920;0.35;1109432
2446;Overijssel (PV);2004;1105512;14098;9371;38306;33635;4671;39311;33802;5509;198.0;3920;0.35;3920;0.35;1109432
2447;Overijssel (PV);2005 januari;1109432;1134;898;3323;2952;371;3335;2849;486;;224;0.02;224;0.02;1109656
2448;Overijssel (PV);2005 februari;1109656;1097;811;2970;2659;311;2928;2495;433;;328;0.03;552;0.05;1109984
2449;Overijssel (PV);2005 maart;1109984;1230;969;3052;2621;431;2932;2569;363;;381;0.03;933;0.08;1110365
2450;Overijssel (PV);2005 april;1110365;1136;781;2913;2585;328;3159;2463;696;;109;0.01;1042;0.09;1110474
2451;Overijssel (PV);2005 mei;1110474;1185;786;2732;2470;262;2573;2275;298;;558;0.05;1600;0.14;1111032
2452;Overijssel (PV);2005 juni;1111032;1152;722;2876;2575;301;2958;2564;394;;348;0.03;1948;0.18;1111380
2453;Overijssel (PV);2005 juli;1111380;1225;706;3752;3376;376;3818;3197;621;;453;0.04;2401;0.22;1111833
2454;Overijssel (PV);2005 augustus;1111833;1219;693;4470;3941;529;4568;4006;562;;428;0.04;2829;0.25;1112261
2455;Overijssel (PV);2005 september;1112261;1185;657;4472;3776;696;4580;4062;518;;420;0.04;3249;0.29;1112681
2456;Overijssel (PV);2005 oktober;1112681;1207;742;3597;3076;521;3677;3154;523;;385;0.03;3634;0.33;1113066
2457;Overijssel (PV);2005 november;1113066;1077;758;3181;2790;391;3291;2786;505;;209;0.02;3843;0.35;1113275
2458;Overijssel (PV);2005 december;1113275;1095;859;2993;2726;267;3202;2600;602;227.0;254;0.02;4097;0.37;1113529
2459;Overijssel (PV);2005;1109432;13942;9382;40331;35547;4784;41021;35020;6001;227.0;4097;0.37;4097;0.37;1113529
2460;Overijssel (PV);2006 januari;1113529;1171;849;3534;3191;343;3273;2970;303;;583;0.05;583;0.05;1114112
2461;Overijssel (PV);2006 februari;1114112;1043;778;2989;2695;294;2982;2691;291;;272;0.02;855;0.08;1114384
2462;Overijssel (PV);2006 maart;1114384;1144;883;3196;2896;300;3588;2876;712;;-131;-0.01;724;0.07;1114253
2463;Overijssel (PV);2006 april;1114253;1060;842;2798;2520;278;2914;2405;509;;102;0.01;826;0.07;1114355
2464;Overijssel (PV);2006 mei;1114355;1140;766;2953;2621;332;3142;2645;497;;185;0.02;1011;0.09;1114540
2465;Overijssel (PV);2006 juni;1114540;1179;682;3145;2819;326;3152;2675;477;;490;0.04;1501;0.13;1115030
2466;Overijssel (PV);2006 juli;1115030;1188;830;3986;3588;398;3871;3203;668;;473;0.04;1974;0.18;1115503
2467;Overijssel (PV);2006 augustus;1115503;1183;714;4609;4112;497;4798;4208;590;;280;0.03;2254;0.2;1115783
2468;Overijssel (PV);2006 september;1115783;1175;729;4481;3672;809;4641;3967;674;;286;0.03;2540;0.23;1116069
2469;Overijssel (PV);2006 oktober;1116069;1191;740;3241;2848;393;3678;3109;569;;14;0.0;2554;0.23;1116083
2470;Overijssel (PV);2006 november;1116083;1122;769;3258;2960;298;3646;3058;588;;-35;0.0;2519;0.23;1116048
2471;Overijssel (PV);2006 december;1116048;1071;822;2882;2652;230;2976;2594;382;171.0;326;0.03;2845;0.26;1116374
2472;Overijssel (PV);2006;1113529;13667;9404;41072;36574;4498;42661;36401;6260;171.0;2845;0.26;2845;0.26;1116374
2473;Overijssel (PV);2007 januari;1116374;1129;807;3555;3105;450;3720;2972;748;;157;0.01;157;0.01;1116531
2474;Overijssel (PV);2007 februari;1116531;1018;785;3093;2691;402;3081;2808;273;;245;0.02;402;0.04;1116776
2475;Overijssel (PV);2007 maart;1116776;1147;808;3031;2677;354;3032;2654;378;;338;0.03;740;0.07;1117114
2476;Overijssel (PV);2007 april;1117114;1042;761;2766;2466;300;2789;2362;427;;258;0.02;998;0.09;1117372
2477;Overijssel (PV);2007 mei;1117372;1089;733;3000;2680;320;2952;2642;310;;404;0.04;1402;0.13;1117776
2478;Overijssel (PV);2007 juni;1117776;1063;697;3185;2842;343;3298;2801;497;;253;0.02;1655;0.15;1118029
2479;Overijssel (PV);2007 juli;1118029;1192;706;4169;3692;477;4176;3607;569;;479;0.04;2134;0.19;1118508
2480;Overijssel (PV);2007 augustus;1118508;1186;663;4907;4235;672;4812;4236;576;;618;0.06;2752;0.25;1119126
2481;Overijssel (PV);2007 september;1119126;1205;646;4140;3390;750;4359;3766;593;;340;0.03;3092;0.28;1119466
2482;Overijssel (PV);2007 oktober;1119466;1154;719;3561;3076;485;3827;3170;657;;169;0.02;3261;0.29;1119635
2483;Overijssel (PV);2007 november;1119635;1058;766;3174;2851;323;3496;2977;519;;-30;0.0;3231;0.29;1119605
2484;Overijssel (PV);2007 december;1119605;1085;831;2731;2462;269;2844;2424;420;248.0;389;0.03;3620;0.32;1119994
2485;Overijssel (PV);2007;1116374;13368;8922;41312;36167;5145;42386;36419;5967;248.0;3620;0.32;3620;0.32;1119994
2486;Overijssel (PV);2008 januari;1119994;1079;870;3754;3250;504;3615;3172;443;;348;0.03;348;0.03;1120342
2487;Overijssel (PV);2008 februari;1120342;1046;813;3431;2931;500;3107;2755;352;;557;0.05;905;0.08;1120899
2488;Overijssel (PV);2008 maart;1120899;1106;784;3072;2687;385;3065;2654;411;;329;0.03;1234;0.11;1121228
2489;Overijssel (PV);2008 april;1121228;1129;785;3145;2713;432;3111;2693;418;;378;0.03;1612;0.14;1121606
2490;Overijssel (PV);2008 mei;1121606;1122;764;2819;2420;399;2670;2376;294;;507;0.05;2119;0.19;1122113
2491;Overijssel (PV);2008 juni;1122113;1148;721;3204;2739;465;3123;2773;350;;508;0.05;2627;0.23;1122621
2492;Overijssel (PV);2008 juli;1122621;1236;735;4143;3534;609;4108;3503;605;;536;0.05;3163;0.28;1123157
2493;Overijssel (PV);2008 augustus;1123157;1133;707;4799;3998;801;4609;4016;593;;616;0.05;3779;0.34;1123773
2494;Overijssel (PV);2008 september;1123773;1151;706;4319;3403;916;4286;3875;411;;478;0.04;4257;0.38;1124251
2495;Overijssel (PV);2008 oktober;1124251;1131;699;3631;2925;706;3817;3176;641;;246;0.02;4503;0.4;1124497
2496;Overijssel (PV);2008 november;1124497;1057;725;3061;2502;559;3002;2628;374;;391;0.03;4894;0.44;1124888
2497;Overijssel (PV);2008 december;1124888;1073;801;3144;2729;415;3096;2767;329;227.0;547;0.05;5441;0.49;1125435
2498;Overijssel (PV);2008;1119994;13411;9110;42522;35831;6691;41609;36388;5221;227.0;5441;0.49;5441;0.49;1125435
2499;Overijssel (PV);2009 januari;1125435;1150;993;3442;2830;612;3164;2759;405;;435;0.04;435;0.04;1125870
2500;Overijssel (PV);2009 februari;1125870;1019;798;3189;2638;551;2993;2609;384;;417;0.04;852;0.08;1126287
2501;Overijssel (PV);2009 maart;1126287;1167;780;3088;2591;497;3182;2600;582;;293;0.03;1145;0.1;1126580
2502;Overijssel (PV);2009 april;1126580;1092;789;2707;2271;436;2622;2267;355;;388;0.03;1533;0.14;1126968
2503;Overijssel (PV);2009 mei;1126968;1080;706;2508;2110;398;2362;2089;273;;520;0.05;2053;0.18;1127488
2504;Overijssel (PV);2009 juni;1127488;1075;709;2895;2405;490;2800;2343;457;;461;0.04;2514;0.22;1127949
2505;Overijssel (PV);2009 juli;1127949;1145;746;4033;3363;670;3954;3378;576;;478;0.04;2992;0.27;1128427
2506;Overijssel (PV);2009 augustus;1128427;1153;694;4176;3331;845;4242;3745;497;;393;0.03;3385;0.3;1128820
2507;Overijssel (PV);2009 september;1128820;1196;725;4020;3197;823;4223;3836;387;;268;0.02;3653;0.32;1129088
2508;Overijssel (PV);2009 oktober;1129088;1117;767;3399;2595;804;3231;2778;453;;518;0.05;4171;0.37;1129606
2509;Overijssel (PV);2009 november;1129606;1041;746;3012;2434;578;2888;2510;378;;419;0.04;4590;0.41;1130025
2510;Overijssel (PV);2009 december;1130025;1025;798;2829;2504;325;2880;2516;364;144.0;320;0.03;4910;0.44;1130345
2511;Overijssel (PV);2009;1125435;13260;9251;39298;32269;7029;38541;33430;5111;144.0;4910;0.44;4910;0.44;1130345
2512;Overijssel (PV);2010 januari;1130345;1050;823;3201;2735;466;3197;2691;506;;231;0.02;231;0.02;1130576
2513;Overijssel (PV);2010 februari;1130576;1014;819;2993;2469;524;2865;2498;367;;323;0.03;554;0.05;1130899
2514;Overijssel (PV);2010 maart;1130899;1105;820;2994;2483;511;3088;2509;579;;191;0.02;745;0.07;1131090
2515;Overijssel (PV);2010 april;1131090;1062;737;2803;2387;416;2793;2383;410;;335;0.03;1080;0.1;1131425
2516;Overijssel (PV);2010 mei;1131425;1095;784;2557;2129;428;2483;2156;327;;385;0.03;1465;0.13;1131810
2517;Overijssel (PV);2010 juni;1131810;1084;710;2930;2348;582;2688;2350;338;;616;0.05;2081;0.18;1132426
2518;Overijssel (PV);2010 juli;1132426;1191;806;3837;3200;637;3741;3155;586;;481;0.04;2562;0.23;1132907
2519;Overijssel (PV);2010 augustus;1132907;1133;682;4496;3479;1017;4307;3819;488;;640;0.06;3202;0.28;1133547
2520;Overijssel (PV);2010 september;1133547;1116;707;3926;3074;852;4108;3589;519;;227;0.02;3429;0.3;1133774
2521;Overijssel (PV);2010 oktober;1133774;1174;739;3299;2588;711;3223;2714;509;;511;0.05;3940;0.35;1134285
2522;Overijssel (PV);2010 november;1134285;1076;761;2980;2492;488;3162;2666;496;;133;0.01;4073;0.36;1134418
2523;Overijssel (PV);2010 december;1134418;1080;881;2880;2476;404;3008;2548;460;-24.0;47;0.0;4120;0.36;1134465
2524;Overijssel (PV);2010;1130345;13180;9269;38896;31860;7036;38663;33078;5585;-24.0;4120;0.36;4120;0.36;1134465
2525;Overijssel (PV);2011 januari;1134465;1052;856;3281;2733;548;3292;2766;526;;185;0.02;185;0.02;1134650
2526;Overijssel (PV);2011 februari;1134650;1002;725;3114;2545;569;2905;2517;388;;486;0.04;671;0.06;1135136
2527;Overijssel (PV);2011 maart;1135136;1077;793;3015;2487;528;3119;2455;664;;180;0.02;851;0.08;1135316
2528;Overijssel (PV);2011 april;1135316;965;815;2599;2198;401;2798;2306;492;;-49;0.0;802;0.07;1135267
2529;Overijssel (PV);2011 mei;1135267;1004;762;2662;2173;489;2623;2200;423;;281;0.02;1083;0.1;1135548
2530;Overijssel (PV);2011 juni;1135548;1115;733;2828;2280;548;2969;2431;538;;241;0.02;1324;0.12;1135789
2531;Overijssel (PV);2011 juli;1135789;1114;733;3842;3220;622;3857;3126;731;;366;0.03;1690;0.15;1136155
2532;Overijssel (PV);2011 augustus;1136155;1138;691;4669;3645;1024;4595;4017;578;;521;0.05;2211;0.19;1136676
2533;Overijssel (PV);2011 september;1136676;1074;702;4531;3441;1090;4280;3785;495;;623;0.05;2834;0.25;1137299
2534;Overijssel (PV);2011 oktober;1137299;1101;771;3354;2623;731;3351;2770;581;;333;0.03;3167;0.28;1137632
2535;Overijssel (PV);2011 november;1137632;1012;793;2988;2497;491;3296;2703;593;;-89;-0.01;3078;0.27;1137543
2536;Overijssel (PV);2011 december;1137543;997;861;3014;2547;467;3028;2523;505;3.0;125;0.01;3203;0.28;1137668
2537;Overijssel (PV);2011;1134465;12651;9235;39897;32389;7508;40113;33599;6514;3.0;3203;0.28;3203;0.28;1137668
2538;Overijssel (PV);2012 januari;1137668;986;807;3671;3101;570;3756;3181;575;;94;0.01;94;0.01;1137762
2539;Overijssel (PV);2012 februari;1137762;1006;840;3333;2666;667;3313;2847;466;;186;0.02;280;0.02;1137948
2540;Overijssel (PV);2012 maart;1137948;1006;777;3011;2518;493;3171;2688;483;;69;0.01;349;0.03;1138017
2541;Overijssel (PV);2012 april;1138017;973;799;2598;2247;351;2771;2285;486;;1;0.0;350;0.03;1138018
2542;Overijssel (PV);2012 mei;1138018;1063;775;2777;2388;389;2844;2400;444;;221;0.02;571;0.05;1138239
2543;Overijssel (PV);2012 juni;1138239;1006;742;3111;2639;472;3219;2711;508;;156;0.01;727;0.06;1138395
2544;Overijssel (PV);2012 juli;1138395;1140;756;3861;3253;608;4191;3455;736;;54;0.0;781;0.07;1138449
2545;Overijssel (PV);2012 augustus;1138449;1100;726;4654;3746;908;4888;4234;654;;140;0.01;921;0.08;1138589
2546;Overijssel (PV);2012 september;1138589;1081;719;4050;3169;881;4214;3629;585;;198;0.02;1119;0.1;1138787
2547;Overijssel (PV);2012 oktober;1138787;1073;805;3552;2774;778;3377;2909;468;;443;0.04;1562;0.14;1139230
2548;Overijssel (PV);2012 november;1139230;975;793;2947;2564;383;3018;2672;346;;111;0.01;1673;0.15;1139341
2549;Overijssel (PV);2012 december;1139341;958;882;2797;2424;373;2863;2455;408;-1.0;9;0.0;1682;0.15;1139350
2550;Overijssel (PV);2012;1137668;12367;9421;40362;33489;6873;41625;35466;6159;-1.0;1682;0.15;1682;0.15;1139350
2551;Overijssel (PV);2013 januari;1139350;1050;972;3433;2942;491;3510;2896;614;;1;0.0;1;0.0;1139351
2552;Overijssel (PV);2013 februari;1139351;868;825;3327;2689;638;3258;2739;519;;112;0.01;113;0.01;1139463
2553;Overijssel (PV);2013 maart;1139463;960;919;3026;2524;502;3041;2679;362;;26;0.0;139;0.01;1139489
2554;Overijssel (PV);2013 april;1139489;974;831;2655;2285;370;2934;2324;610;;-136;-0.01;3;0.0;1139353
2555;Overijssel (PV);2013 mei;1139353;1020;845;2692;2254;438;2833;2341;492;;34;0.0;37;0.0;1139387
2556;Overijssel (PV);2013 juni;1139387;961;752;2648;2231;417;2656;2184;472;;201;0.02;238;0.02;1139588
2557;Overijssel (PV);2013 juli;1139588;1117;822;3839;3306;533;4123;3354;769;;11;0.0;249;0.02;1139599
2558;Overijssel (PV);2013 augustus;1139599;1097;743;4666;3788;878;5129;4475;654;;-109;-0.01;140;0.01;1139490
2559;Overijssel (PV);2013 september;1139490;1079;733;4182;3241;941;4564;3881;683;;-36;0.0;104;0.01;1139454
2560;Overijssel (PV);2013 oktober;1139454;1051;758;3622;2939;683;3627;3122;505;;288;0.03;392;0.03;1139742
2561;Overijssel (PV);2013 november;1139742;1001;744;2956;2572;384;3191;2767;424;;22;0.0;414;0.04;1139764
2562;Overijssel (PV);2013 december;1139764;973;809;2806;2456;350;3053;2574;479;16.0;-67;-0.01;347;0.03;1139697
2563;Overijssel (PV);2013;1139350;12151;9753;39852;33227;6625;41919;35336;6583;16.0;347;0.03;347;0.03;1139697
2564;Overijssel (PV);2014 januari;1139697;1029;840;3482;2978;504;3632;3015;617;;39;0.0;39;0.0;1139736
2565;Overijssel (PV);2014 februari;1139736;954;766;3422;2823;599;3275;2788;487;;335;0.03;374;0.03;1140071
2566;Overijssel (PV);2014 maart;1140071;1008;814;3146;2643;503;3140;2689;451;;200;0.02;574;0.05;1140271
2567;Overijssel (PV);2014 april;1140271;974;809;2768;2383;385;2961;2440;521;;-28;0.0;546;0.05;1140243
2568;Overijssel (PV);2014 mei;1140243;979;796;2757;2379;378;2871;2382;489;;69;0.01;615;0.05;1140312
2569;Overijssel (PV);2014 juni;1140312;960;772;3017;2602;415;3148;2615;533;;57;0.0;672;0.06;1140369
2570;Overijssel (PV);2014 juli;1140369;1089;745;3956;3352;604;4250;3437;813;;50;0.0;722;0.06;1140419
2571;Overijssel (PV);2014 augustus;1140419;1038;792;4813;3823;990;5021;4378;643;;38;0.0;760;0.07;1140457
2572;Overijssel (PV);2014 september;1140457;1054;787;4415;3487;928;4689;4061;628;;-7;0.0;753;0.07;1140450
2573;Overijssel (PV);2014 oktober;1140450;1120;797;3667;2918;749;3679;3158;521;;311;0.03;1064;0.09;1140761
2574;Overijssel (PV);2014 november;1140761;947;793;2941;2530;411;3036;2696;340;;59;0.01;1123;0.1;1140820
2575;Overijssel (PV);2014 december;1140820;940;912;3434;3010;424;3625;3170;455;-5.0;-168;-0.01;955;0.08;1140652
2576;Overijssel (PV);2014;1139697;12092;9623;41818;34928;6890;43327;36829;6498;-5.0;955;0.08;955;0.08;1140652
2577;Overijssel (PV);2015 januari;1140652;979;1044;3783;3072;711;3692;3078;614;;26;0.0;26;0.0;1140678
2578;Overijssel (PV);2015 februari;1140678;870;926;3728;3027;701;3541;3027;514;;131;0.01;157;0.01;1140809
2579;Overijssel (PV);2015 maart;1140809;933;862;3433;2896;537;3328;2902;426;;176;0.02;333;0.03;1140985
2580;Overijssel (PV);2015 april;1140985;958;890;2923;2446;477;2840;2394;446;;151;0.01;484;0.04;1141136
2581;Overijssel (PV);2015 mei;1141136;1030;711;2899;2497;402;2862;2477;385;;356;0.03;840;0.07;1141492
2582;Overijssel (PV);2015 juni;1141492;936;791;3455;2928;527;3450;2958;492;;150;0.01;990;0.09;1141642
2583;Overijssel (PV);2015 juli;1141642;1047;775;4511;3794;717;4444;3660;784;;339;0.03;1329;0.12;1141981
2584;Overijssel (PV);2015 augustus;1141981;1031;788;5216;4075;1141;4984;4444;540;;475;0.04;1804;0.16;1142456
2585;Overijssel (PV);2015 september;1142456;1026;745;4695;3531;1164;4461;3902;559;;515;0.05;2319;0.2;1142971
2586;Overijssel (PV);2015 oktober;1142971;1066;844;4125;3147;978;3693;3153;540;;654;0.06;2973;0.26;1143625
2587;Overijssel (PV);2015 november;1143625;974;762;3538;2916;622;3421;2977;444;;329;0.03;3302;0.29;1143954
2588;Overijssel (PV);2015 december;1143954;915;847;3839;3141;698;3586;3063;523;5.0;326;0.03;3628;0.32;1144280
2589;Overijssel (PV);2015;1140652;11765;9985;46145;37470;8675;44302;38035;6267;5.0;3628;0.32;3628;0.32;1144280
2590;Overijssel (PV);2016 januari;1144280;972;952;3944;3296;648;3835;3241;594;;129;0.01;129;0.01;1144409
2591;Overijssel (PV);2016 februari;1144409;853;868;4216;3302;914;3889;3346;543;;312;0.03;441;0.04;1144721
2592;Overijssel (PV);2016 maart;1144721;983;945;3641;3037;604;3610;3167;443;;69;0.01;510;0.04;1144790
2593;Overijssel (PV);2016 april;1144790;943;828;3788;3290;498;3547;3075;472;;356;0.03;866;0.08;1145146
2594;Overijssel (PV);2016 mei;1145146;1003;849;3354;2871;483;3235;2677;558;;273;0.02;1139;0.1;1145419
2595;Overijssel (PV);2016 juni;1145419;980;736;3469;2959;510;3619;2964;655;;94;0.01;1233;0.11;1145513
2596;Overijssel (PV);2016 juli;1145513;1009;809;4642;4049;593;4913;4112;801;;-71;-0.01;1162;0.1;1145442
2597;Overijssel (PV);2016 augustus;1145442;1020;784;5676;4494;1182;5309;4624;685;;603;0.05;1765;0.15;1146045
2598;Overijssel (PV);2016 september;1146045;1070;767;5070;3884;1186;4652;4091;561;;721;0.06;2486;0.22;1146766
2599;Overijssel (PV);2016 oktober;1146766;986;816;4020;3411;609;3918;3455;463;;272;0.02;2758;0.24;1147038
2600;Overijssel (PV);2016 november;1147038;965;855;3956;3467;489;3617;3251;366;;449;0.04;3207;0.28;1147487
2601;Overijssel (PV);2016 december;1147487;944;925;4222;3768;454;4017;3563;454;-24.0;200;0.02;3407;0.3;1147687
2602;Overijssel (PV);2016;1144280;11728;10134;49998;41828;8170;48161;41566;6595;-24.0;3407;0.3;3407;0.3;1147687
2603;Overijssel (PV);2017 januari;1147687;958;1125;4323;3707;616;3986;3444;542;;170;0.01;170;0.01;1147857
2604;Overijssel (PV);2017 februari;1147857;878;913;4372;3650;722;3941;3487;454;;396;0.03;566;0.05;1148253
2605;Overijssel (PV);2017 maart;1148253;908;880;4024;3571;453;3899;3418;481;;153;0.01;719;0.06;1148406
2606;Overijssel (PV);2017 april;1148406;873;828;3363;3024;339;3317;2888;429;;91;0.01;810;0.07;1148497
2607;Overijssel (PV);2017 mei;1148497;1030;880;3797;3368;429;3466;3142;324;;481;0.04;1291;0.11;1148978
2608;Overijssel (PV);2017 juni;1148978;904;785;3788;3272;516;3759;3221;538;;148;0.01;1439;0.13;1149126
2609;Overijssel (PV);2017 juli;1149126;1000;776;4596;4004;592;4649;3933;716;;171;0.01;1610;0.14;1149297
2610;Overijssel (PV);2017 augustus;1149297;1013;718;5414;4596;818;5012;4478;534;;697;0.06;2307;0.2;1149994
2611;Overijssel (PV);2017 september;1149994;1020;794;6047;4452;1595;5066;4504;562;;1207;0.1;3514;0.31;1151201
2612;Overijssel (PV);2017 oktober;1151201;986;806;4313;3573;740;3956;3524;432;;537;0.05;4051;0.35;1151738
2613;Overijssel (PV);2017 november;1151738;863;830;3673;3191;482;3699;3200;499;;7;0.0;4058;0.35;1151745
2614;Overijssel (PV);2017 december;1151745;912;919;3733;3306;427;3950;3430;520;-20.0;-244;-0.02;3814;0.33;1151501
2615;Overijssel (PV);2017;1147687;11345;10254;51443;43714;7729;48700;42669;6031;-20.0;3814;0.33;3814;0.33;1151501
2616;Overijssel (PV);2018 januari;1151501;931;1054;3959;3431;528;3970;3377;593;;-134;-0.01;-134;-0.01;1151367
2617;Overijssel (PV);2018 februari;1151367;842;961;4085;3286;799;3719;3279;440;;247;0.02;113;0.01;1151614
2618;Overijssel (PV);2018 maart;1151614;921;1194;3895;3439;456;3747;3315;432;;-125;-0.01;-12;0.0;1151489
2619;Overijssel (PV);2018 april;1151489;896;868;3383;2919;464;3252;2818;434;;159;0.01;147;0.01;1151648
2620;Overijssel (PV);2018 mei;1151648;1016;808;3538;3036;502;3268;2942;326;;478;0.04;625;0.05;1152126
2621;Overijssel (PV);2018 juni;1152126;888;762;3756;3164;592;3510;2938;572;;372;0.03;997;0.09;1152498
2622;Overijssel (PV);2018 juli;1152498;998;820;4914;4207;707;4645;3879;766;;447;0.04;1444;0.13;1152945
2623;Overijssel (PV);2018 augustus;1152945;976;776;5821;4704;1117;5069;4542;527;;952;0.08;2396;0.21;1153897
2624;Overijssel (PV);2018 september;1153897;1020;772;5415;3862;1553;4388;3877;511;;1275;0.11;3671;0.32;1155172
2625;Overijssel (PV);2018 oktober;1155172;936;819;4287;3532;755;4013;3533;480;;391;0.03;4062;0.35;1155563
2626;Overijssel (PV);2018 november;1155563;880;765;3975;3286;689;3569;3198;371;;521;0.05;4583;0.4;1156084
2627;Overijssel (PV);2018 december;1156084;874;911;3858;3350;508;3465;3103;362;-9.0;347;0.03;4930;0.43;1156431
2628;Overijssel (PV);2018;1151501;11178;10510;50886;42216;8670;46615;40801;5814;-9.0;4930;0.43;4930;0.43;1156431
2629;Overijssel (PV);2019 januari;1156431;913;912;4275;3521;754;3852;3259;593;;424;0.04;424;0.04;1156855
2630;Overijssel (PV);2019 februari;1156855;841;841;4044;3268;776;3713;3101;612;;331;0.03;755;0.07;1157186
2631;Overijssel (PV);2019 maart;1157186;891;896;3871;3212;659;3861;3193;668;;5;0.0;760;0.07;1157191
2632;Overijssel (PV);2019 april;1157191;900;860;3757;3131;626;3385;2908;477;;412;0.04;1172;0.1;1157603
2633;Overijssel (PV);2019 mei;1157603;966;903;3773;3259;514;3693;3192;501;;143;0.01;1315;0.11;1157746
2634;Overijssel (PV);2019 juni;1157746;944;819;3570;2988;582;3213;2723;490;;482;0.04;1797;0.16;1158228
2635;Overijssel (PV);2019 juli;1158228;1023;853;4755;3981;774;4551;3742;809;;374;0.03;2171;0.19;1158602
2636;Overijssel (PV);2019 augustus;1158602;1057;828;5625;4428;1197;4644;4096;548;;1210;0.1;3381;0.29;1159812
2637;Overijssel (PV);2019 september;1159812;972;825;5847;3769;2078;4222;3756;466;;1772;0.15;5153;0.45;1161584
2638;Overijssel (PV);2019 oktober;1161584;980;891;4378;3573;805;3897;3398;499;;570;0.05;5723;0.49;1162154
2639;Overijssel (PV);2019 november;1162154;867;883;3945;3292;653;3577;3145;432;;352;0.03;6075;0.53;1162506
2640;Overijssel (PV);2019 december;1162506;871;967;3719;3219;500;3665;3147;518;-58.0;-100;-0.01;5975;0.52;1162406
2641;Overijssel (PV);2019;1156431;11225;10478;51559;41641;9918;46273;39660;6613;-58.0;5975;0.52;5975;0.52;1162406
2642;Overijssel (PV);2020 januari;1162406;954;941;4366;3622;744;4230;3556;674;;149;0.01;149;0.01;1162555
2643;Overijssel (PV);2020 februari;1162555;840;908;4248;3366;882;3811;3293;518;;369;0.03;518;0.04;1162924
2644;Overijssel (PV);2020 maart;1162924;913;1137;3934;3233;701;3609;3233;376;;101;0.01;619;0.05;1163025
2645;Overijssel (PV);2020 april;1163025;814;1239;3429;3123;306;3260;2947;313;;-256;-0.02;363;0.03;1162769
2646;Overijssel (PV);2020 mei;1162769;910;820;3635;3299;336;3241;3006;235;;484;0.04;847;0.07;1163253
2647;Overijssel (PV);2020 juni;1163253;933;809;3670;3204;466;3611;3181;430;;183;0.02;1030;0.09;1163436
2648;Overijssel (PV);2020 juli;1163436;1013;814;4826;4179;647;4508;3910;598;;517;0.04;1547;0.13;1163953
2649;Overijssel (PV);2020 augustus;1163953;1018;826;5416;4319;1097;4715;4104;611;;893;0.08;2440;0.21;1164846
2650;Overijssel (PV);2020 september;1164846;994;839;5065;3767;1298;4303;3786;517;;917;0.08;3357;0.29;1165763
2651;Overijssel (PV);2020 oktober;1165763;953;974;4484;3751;733;4037;3587;450;;426;0.04;3783;0.33;1166189
2652;Overijssel (PV);2020 november;1166189;858;1045;3949;3398;551;3587;3132;455;;175;0.02;3958;0.34;1166364
2653;Overijssel (PV);2020 december;1166364;899;1210;4149;3675;474;3645;3199;446;-24.0;169;0.01;4127;0.36;1166533
2654;Overijssel (PV);2020;1162406;11099;11562;51171;42936;8235;46557;40934;5623;-24.0;4127;0.36;4127;0.36;1166533
2655;Overijssel (PV);2021 januari;1166533;977;1218;4473;3931;542;4262;3738;524;0.0;-30;0.0;-30;0.0;1166503
2656;Overijssel (PV);2021 februari;1166503;876;933;4154;3455;699;3530;3109;421;0.0;567;0.05;537;0.05;1167070
2657;Overijssel (PV);2021 maart;1167070;956;917;4167;3666;501;3903;3477;426;0.0;303;0.03;840;0.07;1167373
2658;Overijssel (PV);2021 april;1167373;947;932;3899;3431;468;3598;3199;399;0.0;316;0.03;1156;0.1;1167689
2659;Overijssel (PV);2021 mei;1167689;900;885;3550;3151;399;3388;3043;345;0.0;177;0.02;1333;0.11;1167866
2660;Overijssel (PV);2021 juni;1167866;935;917;3740;3259;481;3688;3135;553;0.0;70;0.01;1403;0.12;1167936
2661;Overijssel (PV);2021 juli;1167936;1040;873;4414;3821;593;4272;3472;800;0.0;309;0.03;1712;0.15;1168245
2662;Overijssel (PV);2021 augustus;1168245;1070;882;5152;4019;1133;4382;3813;569;0.0;958;0.08;2670;0.23;1169203
2663;Overijssel (PV);2021 september;1169203;999;867;5636;3591;2045;3937;3453;484;0.0;1831;0.16;4501;0.39;1171034
2664;Overijssel (PV);2021 oktober;1171034;1022;943;4312;3526;786;3768;3268;500;0.0;623;0.05;5124;0.44;1171657
2665;Overijssel (PV);2021 november;1171657;927;1120;3954;3346;608;3543;3078;465;0.0;218;0.02;5342;0.46;1171875
2666;Overijssel (PV);2021 december;1171875;979;1201;3774;3295;479;3493;3033;460;-24.0;35;0.0;5377;0.46;1171910
2667;Overijssel (PV);2021;1166533;11628;11688;51225;42491;8734;45764;39818;5946;-24.0;5377;0.46;5377;0.46;1171910
2668;Overijssel (PV);2022 januari;1171910;972;981;4073;3504;569;3673;3098;575;;391;0.03;391;0.03;1172301
2669;Overijssel (PV);2022 februari;1172301;904;912;3968;3164;804;3427;2927;500;;533;0.05;924;0.08;1172834
2670;Overijssel (PV);2022 maart;1172834;910;1038;5568;3394;2174;3460;3067;393;;1980;0.17;2904;0.25;1174814
2671;Overijssel (PV);2022 april;1174814;866;1031;6022;3397;2625;3505;3055;450;;2352;0.2;5256;0.45;1177166
2672;Overijssel (PV);2022 mei;1177166;953;928;5078;3345;1733;3676;3058;618;;1427;0.12;6683;0.57;1178593
2673;Overijssel (PV);2022 juni;1178593;915;895;4580;3254;1326;3652;3018;634;;948;0.08;7631;0.65;1179541
2674;Overijssel (PV);2022 juli;1179541;1005;891;5153;3876;1277;4623;3555;1068;;644;0.05;8275;0.71;1180185
2675;Overijssel (PV);2022 augustus;1180185;1041;943;5882;4211;1671;4591;3712;879;;1389;0.12;9664;0.82;1181574
2676;Overijssel (PV);2022 september;1181574;1010;876;6288;3993;2295;4492;3760;732;;1930;0.16;11594;0.99;1183504
2677;Overijssel (PV);2022 oktober;1183504;956;1053;4634;3575;1059;4170;3461;709;;367;0.03;11961;1.02;1183871
2678;Overijssel (PV);2022 november;1183871;872;948;4304;3341;963;3731;3164;567;;497;0.04;12458;1.06;1184368
2679;Overijssel (PV);2022 december;1184368;897;1223;4255;3546;709;3929;3301;628;-35.0;-35;0.0;12423;1.06;1184333
2680;Overijssel (PV);2022;1171910;11301;11719;59805;42600;17205;46929;39176;7753;-35.0;12423;1.06;12423;1.06;1184333
2681;Overijssel (PV);2023 januari;1184333;822;1131;4658;3734;924;4174;3480;694;0.0;175;0.01;175;0.01;1184508
2682;Overijssel (PV);2023 februari;1184508;786;957;4320;3185;1135;4014;3162;852;0.0;135;0.01;310;0.03;1184643
2683;Overijssel (PV);2023 maart;1184643;941;1043;4280;3465;815;4055;3288;767;0.0;123;0.01;433;0.04;1184766
2684;Overijssel (PV);2023 april;1184766;834;906;3673;3039;634;3640;2960;680;0.0;-39;0.0;394;0.03;1184727
2685;Overijssel (PV);2023 mei;1184727;931;943;4217;3420;797;3628;3055;573;0.0;577;0.05;971;0.08;1185304
2686;Overijssel (PV);2023 juni;1185304;948;911;4292;3558;734;4051;3413;638;0.0;278;0.02;1249;0.11;1185582
2687;Overijssel (PV);2023 juli;1185582;1016;867;5066;4236;830;5114;4121;993;0.0;101;0.01;1350;0.11;1185683
2688;Overijssel (PV);2023 augustus;1185683;1010;865;5943;4623;1320;5479;4653;826;0.0;609;0.05;1959;0.17;1186292
2689;Overijssel (PV);2023 september;1186292;982;865;6239;3927;2312;4890;4105;785;0.0;1466;0.12;3425;0.29;1187758
2690;Overijssel (PV);2023 oktober;1187758;943;960;4977;3722;1255;4071;3461;610;0.0;889;0.07;4314;0.36;1188647
2691;Overijssel (PV);2023 november;1188647;880;939;4459;3581;878;3874;3215;659;0.0;526;0.04;4840;0.41;1189173
2692;Overijssel (PV);2023 december;1189173;842;1140;4115;3475;640;3920;3286;634;-37.0;-140;-0.01;4700;0.4;1189033
2693;Overijssel (PV);2023;1184333;10935;11527;56239;43965;12274;50910;42199;8711;-37.0;4700;0.4;4700;0.4;1189033
2694;Overijssel (PV);2024 januari;1189033;941;1246;4613;3799;814;4339;3478;861;;-31;0.0;-31;0.0;1189002
2695;Overijssel (PV);2024 februari;1189002;914;1044;4876;3617;1259;4056;3305;751;;690;0.06;659;0.06;1189692
2696;Overijssel (PV);2024 maart;1189692;898;965;4573;3755;818;3916;3329;587;;590;0.05;1249;0.11;1190282
2697;Overijssel (PV);2024 april;1190282;871;1003;4426;3650;776;3809;3210;599;;485;0.04;1734;0.15;1190767
2698;Overijssel (PV);2024 mei;1190767;938;894;4173;3472;701;3528;2967;561;;689;0.06;2423;0.2;1191456
2699;Overijssel (PV);2024 juni;1191456;938;907;3931;3241;690;3539;2916;623;;423;0.04;2846;0.24;1191879
2700;Overijssel (PV);2024 juli;1191879;942;937;5361;4442;919;4726;3725;1001;;640;0.05;3486;0.29;1192519
2701;Overijssel (PV);2024 augustus;1192519;982;844;5368;4313;1055;4798;3900;898;;708;0.06;4194;0.35;1193227
2702;Overijssel (PV);2024 september;1193227;957;935;5920;3857;2063;4345;3559;786;;1597;0.13;5791;0.49;1194824
2703;Overijssel (PV);2024 oktober;1194824;942;956;4410;3522;888;3939;3280;659;;457;0.04;6248;0.53;1195281
2704;Overijssel (PV);2024 november;1195281;907;985;4212;3516;696;3821;3123;698;;313;0.03;6561;0.55;1195594
2705;Overijssel (PV);2024 december;1195594;884;1056;4189;3524;665;3819;3103;716;0.0;198;0.02;6759;0.57;1195792
2706;Overijssel (PV);2024;1189033;11114;11772;56052;44708;11344;48635;39895;8740;0.0;6759;0.57;6759;0.57;1195792
2707;Overijssel (PV);2025 januari;1195792;932;1160;4619;3846;773;4232;3447;785;;159;0.01;159;0.01;1195951
2708;Overijssel (PV);2025 februari;1195951;792;1007;4868;3828;1040;3819;3096;723;;834;0.07;993;0.08;1196785
2709;Flevoland (PV);2002 januari;341721;407;164;2048;1753;295;1175;1090;85;;1116;0.33;1116;0.33;342837
2710;Flevoland (PV);2002 februari;342837;414;165;1706;1454;252;1179;1054;125;;776;0.23;1892;0.55;343613
2711;Flevoland (PV);2002 maart;343613;443;142;1795;1503;292;1172;998;174;;924;0.27;2816;0.82;344537
2712;Flevoland (PV);2002 april;344537;405;157;1688;1421;267;1121;993;128;;815;0.24;3631;1.06;345352
2713;Flevoland (PV);2002 mei;345352;458;150;1773;1565;208;1219;1091;128;;862;0.25;4493;1.31;346214
2714;Flevoland (PV);2002 juni;346214;425;160;1686;1434;252;1198;1055;143;;753;0.22;5246;1.54;346967
2715;Flevoland (PV);2002 juli;346967;475;146;2158;1873;285;1616;1465;151;;871;0.25;6117;1.79;347838
2716;Flevoland (PV);2002 augustus;347838;484;166;2070;1733;337;1737;1556;181;;651;0.19;6768;1.98;348489
2717;Flevoland (PV);2002 september;348489;483;164;1831;1563;268;1513;1382;131;;637;0.18;7405;2.17;349126
2718;Flevoland (PV);2002 oktober;349126;459;163;1888;1545;343;1438;1272;166;;746;0.21;8151;2.39;349872
2719;Flevoland (PV);2002 november;349872;456;150;1694;1520;174;1305;1143;162;;695;0.2;8846;2.59;350567
2720;Flevoland (PV);2002 december;350567;438;177;1523;1387;136;1104;993;111;433.0;1113;0.32;9959;2.91;351680
2721;Flevoland (PV);2002;341721;5347;1904;21860;18751;3109;15777;14092;1685;433.0;9959;2.91;9959;2.91;351680
2722;Flevoland (PV);2003 januari;351680;496;184;1767;1567;200;1350;1187;163;;729;0.21;729;0.21;352409
2723;Flevoland (PV);2003 februari;352409;451;162;1480;1298;182;1251;1100;151;;518;0.15;1247;0.35;352927
2724;Flevoland (PV);2003 maart;352927;429;184;1714;1517;197;1273;1147;126;;686;0.19;1933;0.55;353613
2725;Flevoland (PV);2003 april;353613;464;175;1654;1488;166;1145;956;189;;798;0.23;2731;0.78;354411
2726;Flevoland (PV);2003 mei;354411;453;168;1623;1449;174;1093;917;176;;815;0.23;3546;1.01;355226
2727;Flevoland (PV);2003 juni;355226;438;167;1805;1621;184;1347;1158;189;;729;0.21;4275;1.22;355955
2728;Flevoland (PV);2003 juli;355955;467;139;2191;1940;251;1654;1457;197;;865;0.24;5140;1.46;356820
2729;Flevoland (PV);2003 augustus;356820;504;160;2065;1785;280;1681;1525;156;;728;0.2;5868;1.67;357548
2730;Flevoland (PV);2003 september;357548;433;165;2225;1749;476;1714;1417;297;;779;0.22;6647;1.89;358327
2731;Flevoland (PV);2003 oktober;358327;504;149;1853;1617;236;1506;1320;186;;702;0.2;7349;2.09;359029
2732;Flevoland (PV);2003 november;359029;415;145;1561;1394;167;1289;1148;141;;542;0.15;7891;2.24;359571
2733;Flevoland (PV);2003 december;359571;398;184;1668;1531;137;1327;1099;228;-222.0;333;0.09;8224;2.34;359904
2734;Flevoland (PV);2003;351680;5452;1982;21606;18956;2650;16630;14431;2199;-222.0;8224;2.34;8224;2.34;359904
2735;Flevoland (PV);2004 januari;359904;444;186;1495;1335;160;1234;1045;189;;519;0.14;519;0.14;360423
2736;Flevoland (PV);2004 februari;360423;415;146;1446;1294;152;1508;1024;484;;207;0.06;726;0.2;360630
2737;Flevoland (PV);2004 maart;360630;444;148;1589;1436;153;1245;1109;136;;640;0.18;1366;0.38;361270
2738;Flevoland (PV);2004 april;361270;434;157;1377;1213;164;1163;930;233;;491;0.14;1857;0.52;361761
2739;Flevoland (PV);2004 mei;361761;412;141;1289;1151;138;1168;976;192;;392;0.11;2249;0.62;362153
2740;Flevoland (PV);2004 juni;362153;474;129;1588;1426;162;1305;1111;194;;628;0.17;2877;0.8;362781
2741;Flevoland (PV);2004 juli;362781;474;157;1800;1650;150;1657;1417;240;;460;0.13;3337;0.93;363241
2742;Flevoland (PV);2004 augustus;363241;445;177;1819;1592;227;1878;1612;266;;209;0.06;3546;0.99;363450
2743;Flevoland (PV);2004 september;363450;431;160;2040;1724;316;1584;1395;189;;727;0.2;4273;1.19;364177
2744;Flevoland (PV);2004 oktober;364177;464;158;1656;1452;204;1357;1131;226;;605;0.17;4878;1.36;364782
2745;Flevoland (PV);2004 november;364782;441;123;1485;1348;137;1403;1116;287;;400;0.11;5278;1.47;365182
2746;Flevoland (PV);2004 december;365182;424;160;1471;1359;112;1209;1075;134;151.0;677;0.19;5955;1.65;365859
2747;Flevoland (PV);2004;359904;5302;1842;19055;16980;2075;16711;13941;2770;151.0;5955;1.65;5955;1.65;365859
2748;Flevoland (PV);2005 januari;365859;420;152;1599;1449;150;1449;1114;335;;418;0.11;418;0.11;366277
2749;Flevoland (PV);2005 februari;366277;442;164;1439;1302;137;1227;1048;179;;490;0.13;908;0.25;366767
2750;Flevoland (PV);2005 maart;366767;398;184;1587;1424;163;1438;1192;246;;363;0.1;1271;0.35;367130
2751;Flevoland (PV);2005 april;367130;425;155;1557;1395;162;1373;1158;215;;454;0.12;1725;0.47;367584
2752;Flevoland (PV);2005 mei;367584;402;148;1431;1261;170;1117;979;138;;568;0.15;2293;0.63;368152
2753;Flevoland (PV);2005 juni;368152;470;186;1426;1269;157;1291;1094;197;;419;0.11;2712;0.74;368571
2754;Flevoland (PV);2005 juli;368571;491;172;1733;1504;229;1710;1407;303;;342;0.09;3054;0.83;368913
2755;Flevoland (PV);2005 augustus;368913;465;154;1894;1657;237;1992;1634;358;;213;0.06;3267;0.89;369126
2756;Flevoland (PV);2005 september;369126;483;146;2026;1609;417;1749;1508;241;;614;0.17;3881;1.06;369740
2757;Flevoland (PV);2005 oktober;369740;463;154;1665;1468;197;1514;1296;218;;460;0.12;4341;1.19;370200
2758;Flevoland (PV);2005 november;370200;413;158;1562;1367;195;1539;1306;233;;278;0.08;4619;1.26;370478
2759;Flevoland (PV);2005 december;370478;418;173;1489;1324;165;1553;1260;293;-3.0;178;0.05;4797;1.31;370656
2760;Flevoland (PV);2005;365859;5290;1946;19408;17029;2379;17952;14996;2956;-3.0;4797;1.31;4797;1.31;370656
2761;Flevoland (PV);2006 januari;370656;411;157;1589;1408;181;1491;1259;232;;352;0.09;352;0.09;371008
2762;Flevoland (PV);2006 februari;371008;416;179;1421;1286;135;1438;1209;229;;220;0.06;572;0.15;371228
2763;Flevoland (PV);2006 maart;371228;443;191;1523;1336;187;1494;1232;262;;281;0.08;853;0.23;371509
2764;Flevoland (PV);2006 april;371509;400;152;1334;1167;167;1307;1046;261;;275;0.07;1128;0.3;371784
2765;Flevoland (PV);2006 mei;371784;454;174;1437;1259;178;1494;1213;281;;223;0.06;1351;0.36;372007
2766;Flevoland (PV);2006 juni;372007;422;150;1475;1271;204;1574;1226;348;;173;0.05;1524;0.41;372180
2767;Flevoland (PV);2006 juli;372180;448;197;1796;1552;244;1640;1436;204;;407;0.11;1931;0.52;372587
2768;Flevoland (PV);2006 augustus;372587;469;152;2098;1831;267;2032;1726;306;;383;0.1;2314;0.62;372970
2769;Flevoland (PV);2006 september;372970;432;160;1953;1555;398;1918;1596;322;;307;0.08;2621;0.71;373277
2770;Flevoland (PV);2006 oktober;373277;443;172;1584;1378;206;1556;1271;285;;299;0.08;2920;0.79;373576
2771;Flevoland (PV);2006 november;373576;409;161;1520;1340;180;1363;1133;230;;405;0.11;3325;0.9;373981
2772;Flevoland (PV);2006 december;373981;432;181;1403;1253;150;1358;1097;261;147.0;443;0.12;3768;1.02;374424
2773;Flevoland (PV);2006;370656;5179;2026;19133;16636;2497;18665;15444;3221;147.0;3768;1.02;3768;1.02;374424
2774;Flevoland (PV);2007 januari;374424;460;173;1511;1294;217;1414;1194;220;;384;0.1;384;0.1;374808
2775;Flevoland (PV);2007 februari;374808;376;172;1373;1176;197;1230;1070;160;;347;0.09;731;0.2;375155
2776;Flevoland (PV);2007 maart;375155;445;164;1384;1191;193;1346;1156;190;;319;0.09;1050;0.28;375474
2777;Flevoland (PV);2007 april;375474;428;162;1182;990;192;1208;975;233;;240;0.06;1290;0.34;375714
2778;Flevoland (PV);2007 mei;375714;434;176;1528;1299;229;1370;1076;294;;416;0.11;1706;0.46;376130
2779;Flevoland (PV);2007 juni;376130;422;158;1550;1297;253;1473;1222;251;;341;0.09;2047;0.55;376471
2780;Flevoland (PV);2007 juli;376471;436;141;1849;1578;271;1907;1583;324;;237;0.06;2284;0.61;376708
2781;Flevoland (PV);2007 augustus;376708;470;164;1986;1701;285;2051;1740;311;;241;0.06;2525;0.67;376949
2782;Flevoland (PV);2007 september;376949;433;142;1891;1508;383;1586;1360;226;;596;0.16;3121;0.83;377545
2783;Flevoland (PV);2007 oktober;377545;437;183;1601;1390;211;1562;1364;198;;293;0.08;3414;0.91;377838
2784;Flevoland (PV);2007 november;377838;447;153;1546;1340;206;1427;1199;228;;413;0.11;3827;1.02;378251
2785;Flevoland (PV);2007 december;378251;431;188;1342;1191;151;1187;1019;168;39.0;437;0.12;4264;1.14;378688
2786;Flevoland (PV);2007;374424;5219;1976;18743;15955;2788;17761;14958;2803;39.0;4264;1.14;4264;1.14;378688
2787;Flevoland (PV);2008 januari;378688;378;178;1578;1349;229;1449;1314;135;;329;0.09;329;0.09;379017
2788;Flevoland (PV);2008 februari;379017;404;168;1368;1150;218;1277;1114;163;;327;0.09;656;0.17;379344
2789;Flevoland (PV);2008 maart;379344;437;153;1293;1090;203;1193;1039;154;;384;0.1;1040;0.27;379728
2790;Flevoland (PV);2008 april;379728;409;160;1472;1230;242;1389;1122;267;;332;0.09;1372;0.36;380060
2791;Flevoland (PV);2008 mei;380060;402;175;1323;1066;257;1296;1059;237;;254;0.07;1626;0.43;380314
2792;Flevoland (PV);2008 juni;380314;420;138;1554;1260;294;1403;1224;179;;433;0.11;2059;0.54;380747
2793;Flevoland (PV);2008 juli;380747;458;159;1982;1597;385;1797;1491;306;;484;0.13;2543;0.67;381231
2794;Flevoland (PV);2008 augustus;381231;477;149;2111;1739;372;1933;1710;223;;506;0.13;3049;0.81;381737
2795;Flevoland (PV);2008 september;381737;468;164;1892;1459;433;1604;1466;138;;592;0.16;3641;0.96;382329
2796;Flevoland (PV);2008 oktober;382329;426;169;1559;1231;328;1535;1345;190;;281;0.07;3922;1.04;382610
2797;Flevoland (PV);2008 november;382610;394;172;1296;1048;248;1206;1096;110;;312;0.08;4234;1.12;382922
2798;Flevoland (PV);2008 december;382922;428;184;1426;1192;234;1249;1000;249;106.0;527;0.14;4761;1.26;383449
2799;Flevoland (PV);2008;378688;5101;1969;18854;15411;3443;17331;14980;2351;106.0;4761;1.26;4761;1.26;383449
2800;Flevoland (PV);2009 januari;383449;472;200;1472;1179;293;1192;1066;126;;552;0.14;552;0.14;384001
2801;Flevoland (PV);2009 februari;384001;417;163;1323;1053;270;1261;1062;199;;316;0.08;868;0.23;384317
2802;Flevoland (PV);2009 maart;384317;452;177;1367;1068;299;1267;1049;218;;375;0.1;1243;0.32;384692
2803;Flevoland (PV);2009 april;384692;459;167;1188;938;250;1125;978;147;;355;0.09;1598;0.42;385047
2804;Flevoland (PV);2009 mei;385047;421;159;1320;1002;318;1047;944;103;;535;0.14;2133;0.56;385582
2805;Flevoland (PV);2009 juni;385582;450;170;1368;1033;335;1227;999;228;;421;0.11;2554;0.67;386003
2806;Flevoland (PV);2009 juli;386003;456;155;1697;1337;360;1709;1438;271;;289;0.07;2843;0.74;386292
2807;Flevoland (PV);2009 augustus;386292;441;167;1730;1329;401;1667;1433;234;;337;0.09;3180;0.83;386629
2808;Flevoland (PV);2009 september;386629;454;171;1632;1218;414;1607;1370;237;;308;0.08;3488;0.91;386937
2809;Flevoland (PV);2009 oktober;386937;424;180;1465;1102;363;1406;1200;206;;303;0.08;3791;0.99;387240
2810;Flevoland (PV);2009 november;387240;423;157;1212;952;260;1180;1037;143;;298;0.08;4089;1.07;387538
2811;Flevoland (PV);2009 december;387538;423;159;1205;995;210;1205;1018;187;79.0;343;0.09;4432;1.16;387881
2812;Flevoland (PV);2009;383449;5292;2025;16979;13206;3773;15893;13594;2299;79.0;4432;1.16;4432;1.16;387881
2813;Flevoland (PV);2010 januari;387881;434;179;1343;1086;257;1579;1172;407;;19;0.0;19;0.0;387900
2814;Flevoland (PV);2010 februari;387900;383;158;1228;957;271;1289;1095;194;;164;0.04;183;0.05;388064
2815;Flevoland (PV);2010 maart;388064;420;169;1352;1084;268;1359;1138;221;;244;0.06;427;0.11;388308
2816;Flevoland (PV);2010 april;388308;458;150;1157;900;257;1134;932;202;;331;0.09;758;0.2;388639
2817;Flevoland (PV);2010 mei;388639;415;197;1250;946;304;1031;884;147;;437;0.11;1195;0.31;389076
2818;Flevoland (PV);2010 juni;389076;444;180;1503;1099;404;1179;1040;139;;588;0.15;1783;0.46;389664
2819;Flevoland (PV);2010 juli;389664;460;165;1496;1139;357;1601;1266;335;;190;0.05;1973;0.51;389854
2820;Flevoland (PV);2010 augustus;389854;443;169;1862;1330;532;1740;1441;299;;396;0.1;2369;0.61;390250
2821;Flevoland (PV);2010 september;390250;472;170;1801;1382;419;1500;1342;158;;603;0.15;2972;0.77;390853
2822;Flevoland (PV);2010 oktober;390853;463;192;1357;987;370;1298;1085;213;;330;0.08;3302;0.85;391183
2823;Flevoland (PV);2010 november;391183;460;199;1352;1021;331;1235;1064;171;;378;0.1;3680;0.95;391561
2824;Flevoland (PV);2010 december;391561;458;188;1470;1176;294;1320;1043;277;-14.0;406;0.1;4086;1.05;391967
2825;Flevoland (PV);2010;387881;5310;2116;17171;13107;4064;16265;13502;2763;-14.0;4086;1.05;4086;1.05;391967
2826;Flevoland (PV);2011 januari;391967;421;198;1478;1096;382;1278;1055;223;;423;0.11;423;0.11;392390
2827;Flevoland (PV);2011 februari;392390;410;163;1245;956;289;1266;1005;261;;226;0.06;649;0.17;392616
2828;Flevoland (PV);2011 maart;392616;415;187;1444;1054;390;1218;1063;155;;454;0.12;1103;0.28;393070
2829;Flevoland (PV);2011 april;393070;401;189;1266;968;298;1130;1006;124;;348;0.09;1451;0.37;393418
2830;Flevoland (PV);2011 mei;393418;389;184;1254;950;304;1240;1035;205;;219;0.06;1670;0.43;393637
2831;Flevoland (PV);2011 juni;393637;457;129;1237;955;282;1123;921;202;;442;0.11;2112;0.54;394079
2832;Flevoland (PV);2011 juli;394079;459;200;1617;1239;378;1553;1193;360;;323;0.08;2435;0.62;394402
2833;Flevoland (PV);2011 augustus;394402;437;182;1738;1264;474;1857;1481;376;;136;0.03;2571;0.66;394538
2834;Flevoland (PV);2011 september;394538;414;179;1749;1328;421;1708;1425;283;;276;0.07;2847;0.73;394814
2835;Flevoland (PV);2011 oktober;394814;408;179;1337;952;385;1261;1055;206;;305;0.08;3152;0.8;395119
2836;Flevoland (PV);2011 november;395119;409;178;1315;906;409;1378;1098;280;;168;0.04;3320;0.85;395287
2837;Flevoland (PV);2011 december;395287;470;204;1234;984;250;1278;1030;248;16.0;238;0.06;3558;0.91;395525
2838;Flevoland (PV);2011;391967;5090;2172;16914;12652;4262;16290;13367;2923;16.0;3558;0.91;3558;0.91;395525
2839;Flevoland (PV);2012 januari;395525;438;182;1306;1039;267;1324;1103;221;;238;0.06;238;0.06;395763
2840;Flevoland (PV);2012 februari;395763;400;202;1225;950;275;1148;983;165;;275;0.07;513;0.13;396038
2841;Flevoland (PV);2012 maart;396038;403;182;1340;1067;273;1257;1017;240;;304;0.08;817;0.21;396342
2842;Flevoland (PV);2012 april;396342;407;181;1086;849;237;1097;913;184;;215;0.05;1032;0.26;396557
2843;Flevoland (PV);2012 mei;396557;430;193;1206;936;270;1149;951;198;;294;0.07;1326;0.34;396851
2844;Flevoland (PV);2012 juni;396851;415;177;1305;1003;302;1180;1009;171;;363;0.09;1689;0.43;397214
2845;Flevoland (PV);2012 juli;397214;409;188;1522;1148;374;1625;1301;324;;118;0.03;1807;0.46;397332
2846;Flevoland (PV);2012 augustus;397332;441;184;1741;1297;444;1853;1539;314;;145;0.04;1952;0.49;397477
2847;Flevoland (PV);2012 september;397477;447;171;1669;1291;378;1430;1295;135;;515;0.13;2467;0.62;397992
2848;Flevoland (PV);2012 oktober;397992;407;170;1301;950;351;1367;1086;281;;171;0.04;2638;0.67;398163
2849;Flevoland (PV);2012 november;398163;397;169;1191;899;292;1217;1099;118;;202;0.05;2840;0.72;398365
2850;Flevoland (PV);2012 december;398365;397;214;1122;889;233;1243;998;245;14.0;76;0.02;2916;0.74;398441
2851;Flevoland (PV);2012;395525;4991;2213;16014;12318;3696;15890;13294;2596;14.0;2916;0.74;2916;0.74;398441
2852;Flevoland (PV);2013 januari;398441;407;208;1490;1126;364;1450;1212;238;;239;0.06;239;0.06;398680
2853;Flevoland (PV);2013 februari;398680;342;210;1153;886;267;1193;1037;156;;92;0.02;331;0.08;398772
2854;Flevoland (PV);2013 maart;398772;387;225;1322;982;340;1153;1045;108;;331;0.08;662;0.17;399103
2855;Flevoland (PV);2013 april;399103;380;199;1016;767;249;1144;983;161;;53;0.01;715;0.18;399156
2856;Flevoland (PV);2013 mei;399156;387;178;1184;795;389;1206;973;233;;187;0.05;902;0.23;399343
2857;Flevoland (PV);2013 juni;399343;391;157;1189;844;345;1221;976;245;;202;0.05;1104;0.28;399545
2858;Flevoland (PV);2013 juli;399545;463;177;1565;1124;441;1712;1301;411;;139;0.03;1243;0.31;399684
2859;Flevoland (PV);2013 augustus;399684;429;179;1680;1211;469;1853;1533;320;;77;0.02;1320;0.33;399761
2860;Flevoland (PV);2013 september;399761;384;165;1598;1124;474;1731;1430;301;;86;0.02;1406;0.35;399847
2861;Flevoland (PV);2013 oktober;399847;364;189;1309;913;396;1708;1234;474;;-224;-0.06;1182;0.3;399623
2862;Flevoland (PV);2013 november;399623;361;176;1360;901;459;1758;1117;641;;-213;-0.05;969;0.24;399410
2863;Flevoland (PV);2013 december;399410;392;184;1551;965;586;1286;1073;213;10.0;483;0.12;1452;0.36;399893
2864;Flevoland (PV);2013;398441;4687;2247;16417;11638;4779;17415;13914;3501;10.0;1452;0.36;1452;0.36;399893
2865;Flevoland (PV);2014 januari;399893;420;173;1474;1037;437;1488;1291;197;;233;0.06;233;0.06;400126
2866;Flevoland (PV);2014 februari;400126;352;180;1384;943;441;1504;1166;338;;52;0.01;285;0.07;400178
2867;Flevoland (PV);2014 maart;400178;403;170;1279;892;387;1365;1160;205;;147;0.04;432;0.11;400325
2868;Flevoland (PV);2014 april;400325;383;175;1287;886;401;1497;1139;358;;-2;0.0;430;0.11;400323
2869;Flevoland (PV);2014 mei;400323;403;159;1284;893;391;1450;1177;273;;78;0.02;508;0.13;400401
2870;Flevoland (PV);2014 juni;400401;433;163;1401;930;471;1361;1137;224;;310;0.08;818;0.2;400711
2871;Flevoland (PV);2014 juli;400711;439;191;1591;1098;493;1946;1433;513;;-107;-0.03;711;0.18;400604
2872;Flevoland (PV);2014 augustus;400604;404;207;1682;1132;550;2080;1650;430;;-201;-0.05;510;0.13;400403
2873;Flevoland (PV);2014 september;400403;435;174;2101;1298;803;1892;1562;330;;470;0.12;980;0.25;400873
2874;Flevoland (PV);2014 oktober;400873;431;160;1616;1030;586;1734;1341;393;;153;0.04;1133;0.28;401026
2875;Flevoland (PV);2014 november;401026;386;190;1378;886;492;1436;1171;265;;138;0.03;1271;0.32;401164
2876;Flevoland (PV);2014 december;401164;433;194;1621;1080;541;1528;1247;281;295.0;627;0.16;1898;0.47;401791
2877;Flevoland (PV);2014;399893;4922;2136;18098;12105;5993;19281;15474;3807;295.0;1898;0.47;1898;0.47;401791
2878;Flevoland (PV);2015 januari;401791;414;225;1530;989;541;1653;1343;310;;66;0.02;66;0.02;401857
2879;Flevoland (PV);2015 februari;401857;338;204;1612;1125;487;1433;1213;220;;313;0.08;379;0.09;402170
2880;Flevoland (PV);2015 maart;402170;418;208;1587;993;594;1487;1250;237;;310;0.08;689;0.17;402480
2881;Flevoland (PV);2015 april;402480;380;173;1504;1002;502;1485;1154;331;;226;0.06;915;0.23;402706
2882;Flevoland (PV);2015 mei;402706;388;157;1555;952;603;1590;1185;405;;196;0.05;1111;0.28;402902
2883;Flevoland (PV);2015 juni;402902;394;167;1774;1048;726;1797;1340;457;;204;0.05;1315;0.33;403106
2884;Flevoland (PV);2015 juli;403106;400;180;1951;1290;661;2384;1769;615;;-213;-0.05;1102;0.27;402893
2885;Flevoland (PV);2015 augustus;402893;453;181;2049;1501;548;2279;1836;443;;42;0.01;1144;0.28;402935
2886;Flevoland (PV);2015 september;402935;360;173;2108;1378;730;2033;1656;377;;262;0.07;1406;0.35;403197
2887;Flevoland (PV);2015 oktober;403197;419;206;1864;1229;635;1899;1523;376;;178;0.04;1584;0.39;403375
2888;Flevoland (PV);2015 november;403375;388;180;1784;1120;664;1721;1419;302;;271;0.07;1855;0.46;403646
2889;Flevoland (PV);2015 december;403646;383;206;1884;1324;560;1651;1457;194;12.0;422;0.1;2277;0.57;404068
2890;Flevoland (PV);2015;401791;4735;2260;21202;13951;7251;21412;17145;4267;12.0;2277;0.57;2277;0.57;404068
2891;Flevoland (PV);2016 januari;404068;375;262;1719;1204;515;1684;1335;349;;148;0.04;148;0.04;404216
2892;Flevoland (PV);2016 februari;404216;368;196;1812;1280;532;1688;1357;331;;296;0.07;444;0.11;404512
2893;Flevoland (PV);2016 maart;404512;376;232;2021;1429;592;1490;1285;205;;675;0.17;1119;0.28;405187
2894;Flevoland (PV);2016 april;405187;403;187;1763;1324;439;1703;1420;283;;276;0.07;1395;0.35;405463
2895;Flevoland (PV);2016 mei;405463;383;185;1813;1303;510;1542;1287;255;;469;0.12;1864;0.46;405932
2896;Flevoland (PV);2016 juni;405932;411;165;1821;1327;494;1774;1418;356;;293;0.07;2157;0.53;406225
2897;Flevoland (PV);2016 juli;406225;413;190;2041;1477;564;2258;1856;402;;6;0.0;2163;0.54;406231
2898;Flevoland (PV);2016 augustus;406231;404;196;2450;1618;832;2170;1811;359;;488;0.12;2651;0.66;406719
2899;Flevoland (PV);2016 september;406719;420;177;2130;1506;624;2158;1804;354;;215;0.05;2866;0.71;406934
2900;Flevoland (PV);2016 oktober;406934;408;186;1755;1302;453;1702;1444;258;;275;0.07;3141;0.78;407209
2901;Flevoland (PV);2016 november;407209;373;184;1916;1374;542;1850;1512;338;;255;0.06;3396;0.84;407464
2902;Flevoland (PV);2016 december;407464;372;217;1918;1397;521;1725;1423;302;6.0;354;0.09;3750;0.93;407818
2903;Flevoland (PV);2016;404068;4706;2377;23159;16541;6618;21744;17952;3792;6.0;3750;0.93;3750;0.93;407818
2904;Flevoland (PV);2017 januari;407818;411;244;1791;1392;399;1763;1456;307;;195;0.05;195;0.05;408013
2905;Flevoland (PV);2017 februari;408013;371;196;1616;1282;334;1692;1376;316;;99;0.02;294;0.07;408112
2906;Flevoland (PV);2017 maart;408112;360;167;1938;1491;447;1758;1450;308;;373;0.09;667;0.16;408485
2907;Flevoland (PV);2017 april;408485;340;165;1548;1227;321;1387;1234;153;;336;0.08;1003;0.25;408821
2908;Flevoland (PV);2017 mei;408821;346;200;1709;1338;371;1587;1258;329;;268;0.07;1271;0.31;409089
2909;Flevoland (PV);2017 juni;409089;362;158;1795;1354;441;1520;1199;321;;479;0.12;1750;0.43;409568
2910;Flevoland (PV);2017 juli;409568;433;187;2100;1620;480;1980;1637;343;;366;0.09;2116;0.52;409934
2911;Flevoland (PV);2017 augustus;409934;400;199;2198;1748;450;2114;1708;406;;285;0.07;2401;0.59;410219
2912;Flevoland (PV);2017 september;410219;397;161;2128;1575;553;1991;1588;403;;373;0.09;2774;0.68;410592
2913;Flevoland (PV);2017 oktober;410592;394;188;2002;1580;422;1849;1433;416;;359;0.09;3133;0.77;410951
2914;Flevoland (PV);2017 november;410951;393;204;1889;1507;382;1644;1401;243;;434;0.11;3567;0.87;411385
2915;Flevoland (PV);2017 december;411385;358;213;1865;1575;290;1712;1451;261;-13.0;285;0.07;3852;0.94;411670
2916;Flevoland (PV);2017;407818;4565;2282;22579;17689;4890;20997;17191;3806;-13.0;3852;0.94;3852;0.94;411670
2917;Flevoland (PV);2018 januari;411670;403;225;1985;1540;445;1747;1434;313;;416;0.1;416;0.1;412086
2918;Flevoland (PV);2018 februari;412086;374;228;1751;1366;385;1593;1258;335;;304;0.07;720;0.17;412390
2919;Flevoland (PV);2018 maart;412390;388;264;1708;1354;354;1721;1376;345;;111;0.03;831;0.2;412501
2920;Flevoland (PV);2018 april;412501;396;178;1556;1201;355;1456;1197;259;;318;0.08;1149;0.28;412819
2921;Flevoland (PV);2018 mei;412819;382;178;1531;1136;395;1446;1197;249;;289;0.07;1438;0.35;413108
2922;Flevoland (PV);2018 juni;413108;414;175;1821;1388;433;1476;1236;240;;584;0.14;2022;0.49;413692
2923;Flevoland (PV);2018 juli;413692;404;208;2090;1543;547;1831;1500;331;;455;0.11;2477;0.6;414147
2924;Flevoland (PV);2018 augustus;414147;422;190;2526;1986;540;2188;1740;448;;570;0.14;3047;0.74;414717
2925;Flevoland (PV);2018 september;414717;441;170;2120;1580;540;1737;1511;226;;654;0.16;3701;0.9;415371
2926;Flevoland (PV);2018 oktober;415371;386;232;2227;1630;597;1928;1542;386;;453;0.11;4154;1.01;415824
2927;Flevoland (PV);2018 november;415824;393;194;1856;1383;473;1567;1277;290;;488;0.12;4642;1.13;416312
2928;Flevoland (PV);2018 december;416312;390;244;1654;1271;383;1554;1288;266;-12.0;234;0.06;4876;1.18;416546
2929;Flevoland (PV);2018;411670;4793;2486;22825;17378;5447;20244;16556;3688;-12.0;4876;1.18;4876;1.18;416546
2930;Flevoland (PV);2019 januari;416546;407;208;1936;1409;527;1624;1353;271;;511;0.12;511;0.12;417057
2931;Flevoland (PV);2019 februari;417057;355;197;1780;1256;524;1588;1237;351;;350;0.08;861;0.21;417407
2932;Flevoland (PV);2019 maart;417407;391;237;1891;1366;525;1563;1321;242;;482;0.12;1343;0.32;417889
2933;Flevoland (PV);2019 april;417889;391;212;1933;1409;524;1693;1331;362;;419;0.1;1762;0.42;418308
2934;Flevoland (PV);2019 mei;418308;397;202;1885;1358;527;1540;1306;234;;540;0.13;2302;0.55;418848
2935;Flevoland (PV);2019 juni;418848;397;203;1891;1352;539;1465;1254;211;;620;0.15;2922;0.7;419468
2936;Flevoland (PV);2019 juli;419468;435;204;2429;1744;685;2082;1651;431;;578;0.14;3500;0.84;420046
2937;Flevoland (PV);2019 augustus;420046;439;195;2364;1821;543;2159;1717;442;;449;0.11;3949;0.95;420495
2938;Flevoland (PV);2019 september;420495;407;178;2589;1918;671;1883;1494;389;;935;0.22;4884;1.17;421430
2939;Flevoland (PV);2019 oktober;421430;455;222;2320;1649;671;1970;1488;482;;583;0.14;5467;1.31;422013
2940;Flevoland (PV);2019 november;422013;414;201;2082;1503;579;1727;1407;320;;568;0.13;6035;1.45;422581
2941;Flevoland (PV);2019 december;422581;404;210;1955;1488;467;1688;1364;324;-21.0;440;0.1;6475;1.55;423021
2942;Flevoland (PV);2019;416546;4892;2469;25055;18273;6782;20982;16923;4059;-21.0;6475;1.55;6475;1.55;423021
2943;Flevoland (PV);2020 januari;423021;392;241;2265;1668;597;1911;1466;445;;505;0.12;505;0.12;423526
2944;Flevoland (PV);2020 februari;423526;383;202;2016;1598;418;1568;1390;178;;629;0.15;1134;0.27;424155
2945;Flevoland (PV);2020 maart;424155;398;218;1831;1425;406;1643;1326;317;;368;0.09;1502;0.36;424523
2946;Flevoland (PV);2020 april;424523;393;275;1658;1419;239;1445;1233;212;;331;0.08;1833;0.43;424854
2947;Flevoland (PV);2020 mei;424854;382;206;1625;1380;245;1514;1320;194;;287;0.07;2120;0.5;425141
2948;Flevoland (PV);2020 juni;425141;369;202;1765;1442;323;1585;1381;204;;347;0.08;2467;0.58;425488
2949;Flevoland (PV);2020 juli;425488;486;170;2308;1841;467;2129;1809;320;;495;0.12;2962;0.7;425983
2950;Flevoland (PV);2020 augustus;425983;405;224;2338;1851;487;2114;1804;310;;405;0.1;3367;0.8;426388
2951;Flevoland (PV);2020 september;426388;409;218;2113;1617;496;1788;1553;235;;516;0.12;3883;0.92;426904
2952;Flevoland (PV);2020 oktober;426904;448;252;2171;1744;427;1916;1590;326;;451;0.11;4334;1.02;427355
2953;Flevoland (PV);2020 november;427355;402;240;2160;1748;412;1893;1562;331;;429;0.1;4763;1.13;427784
2954;Flevoland (PV);2020 december;427784;404;292;2107;1692;415;1785;1472;313;8.0;442;0.1;5205;1.23;428226
2955;Flevoland (PV);2020;423021;4871;2740;24357;19425;4932;21291;17906;3385;8.0;5205;1.23;5205;1.23;428226
2956;Flevoland (PV);2021 januari;428226;360;314;2272;1902;370;1768;1486;282;0.0;550;0.13;550;0.13;428776
2957;Flevoland (PV);2021 februari;428776;377;224;2133;1593;540;1640;1405;235;0.0;646;0.15;1196;0.28;429422
2958;Flevoland (PV);2021 maart;429422;455;228;2300;1882;418;2026;1535;491;0.0;501;0.12;1697;0.4;429923
2959;Flevoland (PV);2021 april;429923;457;249;2052;1670;382;1685;1475;210;0.0;575;0.13;2272;0.53;430498
2960;Flevoland (PV);2021 mei;430498;417;236;1946;1610;336;1821;1484;337;0.0;306;0.07;2578;0.6;430804
2961;Flevoland (PV);2021 juni;430804;410;190;2128;1699;429;1779;1415;364;0.0;569;0.13;3147;0.73;431373
2962;Flevoland (PV);2021 juli;431373;479;225;2619;2147;472;2132;1765;367;0.0;741;0.17;3888;0.91;432114
2963;Flevoland (PV);2021 augustus;432114;486;211;2536;2028;508;2107;1710;397;0.0;704;0.16;4592;1.07;432818
2964;Flevoland (PV);2021 september;432818;435;222;2133;1572;561;1791;1425;366;0.0;555;0.13;5147;1.2;433373
2965;Flevoland (PV);2021 oktober;433373;466;238;2112;1575;537;1757;1479;278;0.0;583;0.13;5730;1.34;433956
2966;Flevoland (PV);2021 november;433956;422;281;2089;1515;574;1754;1410;344;0.0;476;0.11;6206;1.45;434432
2967;Flevoland (PV);2021 december;434432;415;327;2375;1944;431;2119;1610;509;-5.0;339;0.08;6545;1.53;434771
2968;Flevoland (PV);2021;428226;5179;2945;26695;21137;5558;22379;18199;4180;-5.0;6545;1.53;6545;1.53;434771
2969;Flevoland (PV);2022 januari;434771;445;248;2141;1710;431;1890;1509;381;;448;0.1;448;0.1;435219
2970;Flevoland (PV);2022 februari;435219;389;199;2107;1583;524;1675;1344;331;;622;0.14;1070;0.25;435841
2971;Flevoland (PV);2022 maart;435841;416;268;2763;1605;1158;1798;1405;393;;1113;0.26;2183;0.5;436954
2972;Flevoland (PV);2022 april;436954;376;241;2778;1502;1276;1676;1316;360;;1237;0.28;3420;0.79;438191
2973;Flevoland (PV);2022 mei;438191;443;256;2582;1537;1045;1927;1429;498;;842;0.19;4262;0.98;439033
2974;Flevoland (PV);2022 juni;439033;422;223;2771;1679;1092;1901;1497;404;;1069;0.24;5331;1.23;440102
2975;Flevoland (PV);2022 juli;440102;416;246;2898;1941;957;2138;1658;480;;930;0.21;6261;1.44;441032
2976;Flevoland (PV);2022 augustus;441032;487;208;2840;1924;916;2261;1713;548;;858;0.19;7119;1.64;441890
2977;Flevoland (PV);2022 september;441890;461;189;2999;1973;1026;2234;1725;509;;1037;0.23;8156;1.88;442927
2978;Flevoland (PV);2022 oktober;442927;462;225;2791;1830;961;2044;1517;527;;984;0.22;9140;2.1;443911
2979;Flevoland (PV);2022 november;443911;378;261;2601;1794;807;2210;1609;601;;508;0.11;9648;2.22;444419
2980;Flevoland (PV);2022 december;444419;404;313;2447;1819;628;2222;1565;657;-34.0;282;0.06;9930;2.28;444701
2981;Flevoland (PV);2022;434771;5099;2877;31718;20897;10821;23976;18287;5689;-34.0;9930;2.28;9930;2.28;444701
2982;Flevoland (PV);2023 januari;444701;404;292;2479;1783;696;2048;1556;492;0.0;543;0.12;543;0.12;445244
2983;Flevoland (PV);2023 februari;445244;379;244;2137;1505;632;1768;1327;441;0.0;504;0.11;1047;0.24;445748
2984;Flevoland (PV);2023 maart;445748;420;258;2537;1764;773;2102;1588;514;0.0;597;0.13;1644;0.37;446345
2985;Flevoland (PV);2023 april;446345;364;212;2257;1620;637;1761;1314;447;0.0;648;0.15;2292;0.52;446993
2986;Flevoland (PV);2023 mei;446993;420;218;2268;1655;613;2011;1423;588;0.0;459;0.1;2751;0.62;447452
2987;Flevoland (PV);2023 juni;447452;428;188;2316;1656;660;1919;1397;522;0.0;637;0.14;3388;0.76;448089
2988;Flevoland (PV);2023 juli;448089;470;240;2507;1919;588;2503;1809;694;0.0;234;0.05;3622;0.81;448323
2989;Flevoland (PV);2023 augustus;448323;433;200;2660;1959;701;2517;1907;610;0.0;376;0.08;3998;0.9;448699
2990;Flevoland (PV);2023 september;448699;396;227;2615;1908;707;2232;1685;547;0.0;552;0.12;4550;1.02;449251
2991;Flevoland (PV);2023 oktober;449251;433;275;2731;1983;748;1917;1404;513;0.0;972;0.22;5522;1.24;450223
2992;Flevoland (PV);2023 november;450223;401;272;2276;1646;630;2042;1497;545;0.0;363;0.08;5885;1.32;450586
2993;Flevoland (PV);2023 december;450586;418;286;2150;1706;444;2018;1475;543;-24.0;240;0.05;6125;1.38;450826
2994;Flevoland (PV);2023;444701;4966;2912;28933;21104;7829;24838;18382;6456;-24.0;6125;1.38;6125;1.38;450826
2995;Flevoland (PV);2024 januari;450826;412;308;2271;1763;508;2085;1621;464;;290;0.06;290;0.06;451116
2996;Flevoland (PV);2024 februari;451116;401;284;2104;1578;526;1913;1498;415;;308;0.07;598;0.13;451424
2997;Flevoland (PV);2024 maart;451424;415;283;2152;1594;558;1829;1454;375;;455;0.1;1053;0.23;451879
2998;Flevoland (PV);2024 april;451879;391;257;2034;1460;574;1885;1355;530;;283;0.06;1336;0.3;452162
2999;Flevoland (PV);2024 mei;452162;428;240;2266;1803;463;1846;1364;482;;608;0.13;1944;0.43;452770
3000;Flevoland (PV);2024 juni;452770;386;233;2069;1552;517;1952;1415;537;;270;0.06;2214;0.49;453040
3001;Flevoland (PV);2024 juli;453040;420;250;2679;2068;611;2235;1697;538;;614;0.14;2828;0.63;453654
3002;Flevoland (PV);2024 augustus;453654;432;217;2676;2046;630;2406;1875;531;;485;0.11;3313;0.73;454139
3003;Flevoland (PV);2024 september;454139;390;211;2474;1762;712;2051;1575;476;;602;0.13;3915;0.87;454741
3004;Flevoland (PV);2024 oktober;454741;412;240;2582;1854;728;1942;1512;430;;812;0.18;4727;1.05;455553
3005;Flevoland (PV);2024 november;455553;432;249;2418;1719;699;2009;1499;510;;592;0.13;5319;1.18;456145
3006;Flevoland (PV);2024 december;456145;357;262;2246;1775;471;2040;1428;612;0.0;301;0.07;5620;1.25;456446
3007;Flevoland (PV);2024;450826;4876;3034;27971;20974;6997;24193;18293;5900;0.0;5620;1.25;5620;1.25;456446
3008;Flevoland (PV);2025 januari;456446;447;300;2587;1983;604;2118;1619;499;;616;0.13;616;0.13;457062
3009;Flevoland (PV);2025 februari;457062;367;255;2652;2028;624;1786;1432;354;;978;0.21;1594;0.35;458040
3010;Gelderland (PV);2002 januari;1949233;2147;1594;7285;6257;1028;6718;6106;612;;1120;0.06;1120;0.06;1950353
3011;Gelderland (PV);2002 februari;1950353;1849;1368;6307;5553;754;6190;5481;709;;598;0.03;1718;0.09;1950951
3012;Gelderland (PV);2002 maart;1950951;2053;1605;6679;5778;901;6530;5829;701;;597;0.03;2315;0.12;1951548
3013;Gelderland (PV);2002 april;1951548;2051;1513;6204;5399;805;5902;5340;562;;840;0.04;3155;0.16;1952388
3014;Gelderland (PV);2002 mei;1952388;2060;1458;6476;5657;819;6152;5628;524;;926;0.05;4081;0.21;1953314
3015;Gelderland (PV);2002 juni;1953314;1965;1372;6506;5574;932;6104;5488;616;;995;0.05;5076;0.26;1954309
3016;Gelderland (PV);2002 juli;1954309;2171;1404;8092;7162;930;8358;7542;816;;501;0.03;5577;0.29;1954810
3017;Gelderland (PV);2002 augustus;1954810;2160;1318;9072;7786;1286;8410;7614;796;;1504;0.08;7081;0.36;1956314
3018;Gelderland (PV);2002 september;1956314;2097;1239;8274;7131;1143;7704;6917;787;;1428;0.07;8509;0.44;1957742
3019;Gelderland (PV);2002 oktober;1957742;2164;1443;7577;6478;1099;7097;6396;701;;1201;0.06;9710;0.5;1958943
3020;Gelderland (PV);2002 november;1958943;2009;1398;6548;5864;684;6660;5903;757;;499;0.03;10209;0.52;1959442
3021;Gelderland (PV);2002 december;1959442;2100;1593;6354;5704;650;6143;5452;691;262.0;980;0.05;11189;0.57;1960422
3022;Gelderland (PV);2002;1949233;24826;17305;85374;74343;11031;81968;73696;8272;262.0;11189;0.57;11189;0.57;1960422
3023;Gelderland (PV);2003 januari;1960422;2110;1631;7317;6598;719;7325;6623;702;;471;0.02;471;0.02;1960893
3024;Gelderland (PV);2003 februari;1960893;1905;1417;6214;5452;762;5923;5203;720;;779;0.04;1250;0.06;1961672
3025;Gelderland (PV);2003 maart;1961672;2088;1596;6131;5515;616;6411;5590;821;;212;0.01;1462;0.07;1961884
3026;Gelderland (PV);2003 april;1961884;1948;1481;5765;5236;529;6022;5296;726;;210;0.01;1672;0.09;1962094
3027;Gelderland (PV);2003 mei;1962094;2001;1365;5922;5289;633;5897;5215;682;;661;0.03;2333;0.12;1962755
3028;Gelderland (PV);2003 juni;1962755;1875;1396;6305;5722;583;6508;5751;757;;276;0.01;2609;0.13;1963031
3029;Gelderland (PV);2003 juli;1963031;2109;1373;7822;7186;636;7919;6999;920;;639;0.03;3248;0.17;1963670
3030;Gelderland (PV);2003 augustus;1963670;2102;1450;8239;7213;1026;8077;7315;762;;814;0.04;4062;0.21;1964484
3031;Gelderland (PV);2003 september;1964484;2138;1371;8064;7194;870;8004;7226;778;;827;0.04;4889;0.25;1965311
3032;Gelderland (PV);2003 oktober;1965311;2111;1338;7342;6582;760;7564;6825;739;;551;0.03;5440;0.28;1965862
3033;Gelderland (PV);2003 november;1965862;2020;1415;6383;5781;602;6354;5704;650;;634;0.03;6074;0.31;1966496
3034;Gelderland (PV);2003 december;1966496;1864;1667;6913;6277;636;7056;6246;810;379.0;433;0.02;6507;0.33;1966929
3035;Gelderland (PV);2003;1960422;24271;17500;82417;74045;8372;83060;73993;9067;379.0;6507;0.33;6507;0.33;1966929
3036;Gelderland (PV);2004 januari;1966929;1939;1633;6638;6095;543;6715;5917;798;;229;0.01;229;0.01;1967158
3037;Gelderland (PV);2004 februari;1967158;1772;1423;5970;5510;460;6437;5470;967;;-118;-0.01;111;0.01;1967040
3038;Gelderland (PV);2004 maart;1967040;1971;1469;6592;6060;532;7222;6168;1054;;-128;-0.01;-17;0.0;1966912
3039;Gelderland (PV);2004 april;1966912;1944;1312;5885;5410;475;6277;5546;731;;240;0.01;223;0.01;1967152
3040;Gelderland (PV);2004 mei;1967152;1851;1356;5782;5242;540;5706;5096;610;;571;0.03;794;0.04;1967723
3041;Gelderland (PV);2004 juni;1967723;1980;1300;6845;6189;656;7007;6182;825;;518;0.03;1312;0.07;1968241
3042;Gelderland (PV);2004 juli;1968241;2021;1293;8180;7470;710;7990;7108;882;;918;0.05;2230;0.11;1969159
3043;Gelderland (PV);2004 augustus;1969159;2062;1352;8684;7722;962;8582;7595;987;;812;0.04;3042;0.15;1969971
3044;Gelderland (PV);2004 september;1969971;1943;1238;8539;7515;1024;8613;7563;1050;;631;0.03;3673;0.19;1970602
3045;Gelderland (PV);2004 oktober;1970602;1980;1389;6866;6234;632;7180;6263;917;;277;0.01;3950;0.2;1970879
3046;Gelderland (PV);2004 november;1970879;1882;1338;6567;6034;533;6920;6121;799;;191;0.01;4141;0.21;1971070
3047;Gelderland (PV);2004 december;1971070;1890;1494;6584;6130;454;6762;5974;788;722.0;940;0.05;5081;0.26;1972010
3048;Gelderland (PV);2004;1966929;23235;16597;83132;75611;7521;85411;75003;10408;722.0;5081;0.26;5081;0.26;1972010
3049;Gelderland (PV);2005 januari;1972010;1869;1553;6733;6153;580;6616;5893;723;;433;0.02;433;0.02;1972443
3050;Gelderland (PV);2005 februari;1972443;1758;1528;5864;5331;533;5942;5362;580;;152;0.01;585;0.03;1972595
3051;Gelderland (PV);2005 maart;1972595;1877;1698;6512;6071;441;6606;5857;749;;85;0.0;670;0.03;1972680
3052;Gelderland (PV);2005 april;1972680;1862;1329;6148;5657;491;6333;5643;690;;348;0.02;1018;0.05;1973028
3053;Gelderland (PV);2005 mei;1973028;1862;1457;5747;5344;403;5905;5348;557;;247;0.01;1265;0.06;1973275
3054;Gelderland (PV);2005 juni;1973275;1814;1305;6464;5909;555;6748;5924;824;;225;0.01;1490;0.08;1973500
3055;Gelderland (PV);2005 juli;1973500;1873;1287;7773;7158;615;7891;6962;929;;468;0.02;1958;0.1;1973968
3056;Gelderland (PV);2005 augustus;1973968;1997;1278;9400;8293;1107;9273;8307;966;;846;0.04;2804;0.14;1974814
3057;Gelderland (PV);2005 september;1974814;1854;1244;8790;7873;917;8989;7923;1066;;411;0.02;3215;0.16;1975225
3058;Gelderland (PV);2005 oktober;1975225;1951;1294;7330;6715;615;7525;6737;788;;462;0.02;3677;0.19;1975687
3059;Gelderland (PV);2005 november;1975687;1752;1288;6728;6223;505;7321;6244;1077;;-129;-0.01;3548;0.18;1975558
3060;Gelderland (PV);2005 december;1975558;1733;1452;6714;6333;381;7154;6140;1014;305.0;146;0.01;3694;0.19;1975704
3061;Gelderland (PV);2005;1972010;22202;16713;84203;77060;7143;86303;76340;9963;305.0;3694;0.19;3694;0.19;1975704
3062;Gelderland (PV);2006 januari;1975704;1877;1469;7396;6766;630;7725;6760;965;;79;0.0;79;0.0;1975783
3063;Gelderland (PV);2006 februari;1975783;1708;1376;6486;5950;536;6898;5930;968;;-80;0.0;-1;0.0;1975703
3064;Gelderland (PV);2006 maart;1975703;1902;1524;6972;6412;560;7233;6490;743;;117;0.01;116;0.01;1975820
3065;Gelderland (PV);2006 april;1975820;1725;1375;5968;5428;540;6194;5531;663;;124;0.01;240;0.01;1975944
3066;Gelderland (PV);2006 mei;1975944;1894;1321;6299;5792;507;6519;5698;821;;353;0.02;593;0.03;1976297
3067;Gelderland (PV);2006 juni;1976297;1743;1351;6254;5714;540;6588;5850;738;;58;0.0;651;0.03;1976355
3068;Gelderland (PV);2006 juli;1976355;1907;1516;8037;7332;705;8289;7214;1075;;139;0.01;790;0.04;1976494
3069;Gelderland (PV);2006 augustus;1976494;1947;1277;9609;8502;1107;9809;8665;1144;;470;0.02;1260;0.06;1976964
3070;Gelderland (PV);2006 september;1976964;2011;1260;8707;7606;1101;8468;7499;969;;990;0.05;2250;0.11;1977954
3071;Gelderland (PV);2006 oktober;1977954;1941;1179;7294;6556;738;7496;6578;918;;560;0.03;2810;0.14;1978514
3072;Gelderland (PV);2006 november;1978514;1824;1309;6998;6395;603;7543;6680;863;;-30;0.0;2780;0.14;1978484
3073;Gelderland (PV);2006 december;1978484;1734;1387;6217;5732;485;6487;5662;825;498.0;575;0.03;3355;0.17;1979059
3074;Gelderland (PV);2006;1975704;22213;16344;86237;78185;8052;89249;78557;10692;498.0;3355;0.17;3355;0.17;1979059
3075;Gelderland (PV);2007 januari;1979059;1786;1483;7508;6789;719;7728;6730;998;;83;0.0;83;0.0;1979142
3076;Gelderland (PV);2007 februari;1979142;1645;1332;6290;5665;625;6376;5722;654;;227;0.01;310;0.02;1979369
3077;Gelderland (PV);2007 maart;1979369;1781;1434;6797;6199;598;6951;6177;774;;193;0.01;503;0.03;1979562
3078;Gelderland (PV);2007 april;1979562;1616;1349;5552;5096;456;5791;5069;722;;28;0.0;531;0.03;1979590
3079;Gelderland (PV);2007 mei;1979590;1764;1346;6195;5624;571;6261;5548;713;;352;0.02;883;0.04;1979942
3080;Gelderland (PV);2007 juni;1979942;1719;1255;6631;5997;634;6876;6091;785;;219;0.01;1102;0.06;1980161
3081;Gelderland (PV);2007 juli;1980161;1908;1272;8181;7377;804;8364;7457;907;;453;0.02;1555;0.08;1980614
3082;Gelderland (PV);2007 augustus;1980614;1920;1243;9912;8589;1323;9622;8635;987;;967;0.05;2522;0.13;1981581
3083;Gelderland (PV);2007 september;1981581;1881;1210;8365;7265;1100;7956;7196;760;;1080;0.05;3602;0.18;1982661
3084;Gelderland (PV);2007 oktober;1982661;1811;1352;7749;6869;880;7702;6752;950;;506;0.03;4108;0.21;1983167
3085;Gelderland (PV);2007 november;1983167;1673;1344;7147;6480;667;7234;6356;878;;242;0.01;4350;0.22;1983409
3086;Gelderland (PV);2007 december;1983409;1687;1519;6183;5649;534;6336;5521;815;445.0;460;0.02;4810;0.24;1983869
3087;Gelderland (PV);2007;1979059;21191;16139;86510;77599;8911;87197;77254;9943;445.0;4810;0.24;4810;0.24;1983869
3088;Gelderland (PV);2008 januari;1983869;1727;1585;7978;7129;849;7922;7059;863;;198;0.01;198;0.01;1984067
3089;Gelderland (PV);2008 februari;1984067;1728;1341;6804;5998;806;6564;5860;704;;627;0.03;825;0.04;1984694
3090;Gelderland (PV);2008 maart;1984694;1705;1474;6432;5649;783;6286;5590;696;;377;0.02;1202;0.06;1985071
3091;Gelderland (PV);2008 april;1985071;1717;1386;6834;6044;790;6747;5935;812;;418;0.02;1620;0.08;1985489
3092;Gelderland (PV);2008 mei;1985489;1845;1392;6039;5371;668;5936;5277;659;;556;0.03;2176;0.11;1986045
3093;Gelderland (PV);2008 juni;1986045;1845;1248;6743;6077;666;6919;5972;947;;421;0.02;2597;0.13;1986466
3094;Gelderland (PV);2008 juli;1986466;1992;1326;8621;7717;904;8689;7443;1246;;598;0.03;3195;0.16;1987064
3095;Gelderland (PV);2008 augustus;1987064;1917;1224;9215;8043;1172;9002;7939;1063;;906;0.05;4101;0.21;1987970
3096;Gelderland (PV);2008 september;1987970;1918;1198;9350;7791;1559;8808;7818;990;;1262;0.06;5363;0.27;1989232
3097;Gelderland (PV);2008 oktober;1989232;1906;1396;7952;7016;936;7652;6914;738;;810;0.04;6173;0.31;1990042
3098;Gelderland (PV);2008 november;1990042;1698;1313;6464;5728;736;6460;5768;692;;389;0.02;6562;0.33;1990431
3099;Gelderland (PV);2008 december;1990431;1697;1469;6980;6276;704;7066;6255;811;489.0;631;0.03;7193;0.36;1991062
3100;Gelderland (PV);2008;1983869;21695;16352;89412;78839;10573;88051;77830;10221;489.0;7193;0.36;7193;0.36;1991062
3101;Gelderland (PV);2009 januari;1991062;1705;1851;6986;6124;862;6963;6114;849;;-123;-0.01;-123;-0.01;1990939
3102;Gelderland (PV);2009 februari;1990939;1573;1448;6524;5650;874;6232;5576;656;;417;0.02;294;0.01;1991356
3103;Gelderland (PV);2009 maart;1991356;1809;1345;6847;6013;834;6621;5918;703;;690;0.03;984;0.05;1992046
3104;Gelderland (PV);2009 april;1992046;1780;1374;5780;5078;702;5589;5085;504;;597;0.03;1581;0.08;1992643
3105;Gelderland (PV);2009 mei;1992643;1688;1298;5612;4946;666;5506;4940;566;;496;0.02;2077;0.1;1993139
3106;Gelderland (PV);2009 juni;1993139;1841;1224;6472;5683;789;6248;5566;682;;841;0.04;2918;0.15;1993980
3107;Gelderland (PV);2009 juli;1993980;1976;1243;8188;7101;1087;7716;6736;980;;1205;0.06;4123;0.21;1995185
3108;Gelderland (PV);2009 augustus;1995185;1914;1220;8453;7065;1388;8245;7323;922;;902;0.05;5025;0.25;1996087
3109;Gelderland (PV);2009 september;1996087;1878;1208;8911;7358;1553;8070;7290;780;;1511;0.08;6536;0.33;1997598
3110;Gelderland (PV);2009 oktober;1997598;1728;1377;7126;6141;985;7085;6130;955;;392;0.02;6928;0.35;1997990
3111;Gelderland (PV);2009 november;1997990;1774;1326;6363;5515;848;6434;5509;925;;377;0.02;7305;0.37;1998367
3112;Gelderland (PV);2009 december;1998367;1684;1486;6577;5847;730;6508;5716;792;302.0;569;0.03;7874;0.4;1998936
3113;Gelderland (PV);2009;1991062;21350;16400;83839;72521;11318;81217;71903;9314;302.0;7874;0.4;7874;0.4;1998936
3114;Gelderland (PV);2010 januari;1998936;1752;1437;6938;6080;858;6773;5987;786;;480;0.02;480;0.02;1999416
3115;Gelderland (PV);2010 februari;1999416;1627;1444;6647;5760;887;6433;5813;620;;397;0.02;877;0.04;1999813
3116;Gelderland (PV);2010 maart;1999813;1816;1507;6786;5951;835;6684;5963;721;;411;0.02;1288;0.06;2000224
3117;Gelderland (PV);2010 april;2000224;1644;1376;5758;4974;784;6047;5075;972;;-21;0.0;1267;0.06;2000203
3118;Gelderland (PV);2010 mei;2000203;1729;1466;5736;5030;706;5399;4810;589;;600;0.03;1867;0.09;2000803
3119;Gelderland (PV);2010 juni;2000803;1743;1352;6160;5342;818;6186;5396;790;;365;0.02;2232;0.11;2001168
3120;Gelderland (PV);2010 juli;2001168;1786;1322;7796;6666;1130;7788;6726;1062;;472;0.02;2704;0.14;2001640
3121;Gelderland (PV);2010 augustus;2001640;1869;1353;9029;7463;1566;8631;7705;926;;914;0.05;3618;0.18;2002554
3122;Gelderland (PV);2010 september;2002554;1784;1293;9114;7262;1852;9503;7181;2322;;102;0.01;3720;0.19;2002656
3123;Gelderland (PV);2010 oktober;2002656;1865;1401;6979;5886;1093;6450;5722;728;;993;0.05;4713;0.24;2003649
3124;Gelderland (PV);2010 november;2003649;1804;1278;6652;5830;822;6471;5762;709;;707;0.04;5420;0.27;2004356
3125;Gelderland (PV);2010 december;2004356;1723;1501;6589;5834;755;6369;5650;719;-127.0;315;0.02;5735;0.29;2004671
3126;Gelderland (PV);2010;1998936;21142;16730;84184;72078;12106;82734;71790;10944;-127.0;5735;0.29;5735;0.29;2004671
3127;Gelderland (PV);2011 januari;2004671;1722;1463;6964;6052;912;6855;5990;865;;368;0.02;368;0.02;2005039
3128;Gelderland (PV);2011 februari;2005039;1630;1341;6599;5670;929;6266;5586;680;;622;0.03;990;0.05;2005661
3129;Gelderland (PV);2011 maart;2005661;1681;1439;6609;5752;857;6370;5611;759;;481;0.02;1471;0.07;2006142
3130;Gelderland (PV);2011 april;2006142;1536;1329;5802;5008;794;5813;4979;834;;196;0.01;1667;0.08;2006338
3131;Gelderland (PV);2011 mei;2006338;1796;1387;5891;5156;735;5937;5138;799;;363;0.02;2030;0.1;2006701
3132;Gelderland (PV);2011 juni;2006701;1750;1292;6245;5420;825;5932;5207;725;;771;0.04;2801;0.14;2007472
3133;Gelderland (PV);2011 juli;2007472;1699;1350;7428;6437;991;7451;6378;1073;;326;0.02;3127;0.16;2007798
3134;Gelderland (PV);2011 augustus;2007798;1893;1345;9956;7958;1998;9033;7994;1039;;1471;0.07;4598;0.23;2009269
3135;Gelderland (PV);2011 september;2009269;1728;1291;8839;7387;1452;8298;7316;982;;978;0.05;5576;0.28;2010247
3136;Gelderland (PV);2011 oktober;2010247;1778;1384;6802;5809;993;6880;5922;958;;316;0.02;5892;0.29;2010563
3137;Gelderland (PV);2011 november;2010563;1701;1453;6725;5903;822;6991;5893;1098;;-18;0.0;5874;0.29;2010545
3138;Gelderland (PV);2011 december;2010545;1643;1501;6420;5671;749;6388;5577;811;26.0;200;0.01;6074;0.3;2010745
3139;Gelderland (PV);2011;2004671;20557;16575;84280;72223;12057;82214;71591;10623;26.0;6074;0.3;6074;0.3;2010745
3140;Gelderland (PV);2012 januari;2010745;1658;1535;7471;6551;920;7372;6392;980;;222;0.01;222;0.01;2010967
3141;Gelderland (PV);2012 februari;2010967;1538;1552;7235;6257;978;6890;6044;846;;331;0.02;553;0.03;2011298
3142;Gelderland (PV);2012 maart;2011298;1692;1547;6693;5816;877;6636;5844;792;;202;0.01;755;0.04;2011500
3143;Gelderland (PV);2012 april;2011500;1659;1489;5687;5075;612;5723;4989;734;;134;0.01;889;0.04;2011634
3144;Gelderland (PV);2012 mei;2011634;1667;1486;5994;5305;689;6046;5244;802;;129;0.01;1018;0.05;2011763
3145;Gelderland (PV);2012 juni;2011763;1618;1365;7357;6555;802;7235;6279;956;;375;0.02;1393;0.07;2012138
3146;Gelderland (PV);2012 juli;2012138;1725;1413;8323;7310;1013;8180;7092;1088;;455;0.02;1848;0.09;2012593
3147;Gelderland (PV);2012 augustus;2012593;1815;1302;10326;8357;1969;9385;8370;1015;;1454;0.07;3302;0.16;2014047
3148;Gelderland (PV);2012 september;2014047;1629;1372;8581;7040;1541;7987;7126;861;;851;0.04;4153;0.21;2014898
3149;Gelderland (PV);2012 oktober;2014898;1723;1394;7712;6725;987;7476;6494;982;;565;0.03;4718;0.23;2015463
3150;Gelderland (PV);2012 november;2015463;1635;1353;6768;5991;777;6463;5716;747;;587;0.03;5305;0.26;2016050
3151;Gelderland (PV);2012 december;2016050;1476;1527;6179;5583;596;6454;5618;836;67.0;-259;-0.01;5046;0.25;2015791
3152;Gelderland (PV);2012;2010745;19835;17335;88326;76565;11761;85847;75208;10639;67.0;5046;0.25;5046;0.25;2015791
3153;Gelderland (PV);2013 januari;2015791;1614;1623;7587;6613;974;7451;6543;908;;127;0.01;127;0.01;2015918
3154;Gelderland (PV);2013 februari;2015918;1476;1515;6981;6025;956;6827;5917;910;;115;0.01;242;0.01;2016033
3155;Gelderland (PV);2013 maart;2016033;1627;1752;6498;5741;757;6438;5698;740;;-65;0.0;177;0.01;2015968
3156;Gelderland (PV);2013 april;2015968;1627;1572;5881;5181;700;5932;5235;697;;4;0.0;181;0.01;2015972
3157;Gelderland (PV);2013 mei;2015972;1582;1396;6130;5388;742;6266;5449;817;;50;0.0;231;0.01;2016022
3158;Gelderland (PV);2013 juni;2016022;1560;1324;6209;5359;850;6013;5159;854;;432;0.02;663;0.03;2016454
3159;Gelderland (PV);2013 juli;2016454;1880;1364;8431;7384;1047;8521;7300;1221;;426;0.02;1089;0.05;2016880
3160;Gelderland (PV);2013 augustus;2016880;1756;1291;10187;8512;1675;9558;8579;979;;1094;0.05;2183;0.11;2017974
3161;Gelderland (PV);2013 september;2017974;1797;1303;9881;7992;1889;8954;7861;1093;;1421;0.07;3604;0.18;2019395
3162;Gelderland (PV);2013 oktober;2019395;1623;1403;7517;6435;1082;7964;6561;1403;;-227;-0.01;3377;0.17;2019168
3163;Gelderland (PV);2013 november;2019168;1572;1355;6958;6032;926;6449;5746;703;;726;0.04;4103;0.2;2019894
3164;Gelderland (PV);2013 december;2019894;1569;1428;6748;6053;695;7118;5939;1179;27.0;-202;-0.01;3901;0.19;2019692
3165;Gelderland (PV);2013;2015791;19683;17326;89008;76715;12293;87491;75987;11504;27.0;3901;0.19;3901;0.19;2019692
3166;Gelderland (PV);2014 januari;2019692;1614;1524;8054;6938;1116;7631;6781;850;;513;0.03;513;0.03;2020205
3167;Gelderland (PV);2014 februari;2020205;1484;1360;7305;6243;1062;7148;6350;798;;281;0.01;794;0.04;2020486
3168;Gelderland (PV);2014 maart;2020486;1596;1393;6970;6127;843;6788;6036;752;;385;0.02;1179;0.06;2020871
3169;Gelderland (PV);2014 april;2020871;1595;1334;6645;5733;912;6515;5626;889;;391;0.02;1570;0.08;2021262
3170;Gelderland (PV);2014 mei;2021262;1693;1418;6404;5652;752;6289;5586;703;;390;0.02;1960;0.1;2021652
3171;Gelderland (PV);2014 juni;2021652;1647;1330;6870;5934;936;6451;5516;935;;736;0.04;2696;0.13;2022388
3172;Gelderland (PV);2014 juli;2022388;1728;1432;8715;7704;1011;8652;7409;1243;;359;0.02;3055;0.15;2022747
3173;Gelderland (PV);2014 augustus;2022747;1761;1401;10470;8653;1817;9850;8718;1132;;980;0.05;4035;0.2;2023727
3174;Gelderland (PV);2014 september;2023727;1754;1353;10204;8286;1918;9207;8110;1097;;1398;0.07;5433;0.27;2025125
3175;Gelderland (PV);2014 oktober;2025125;1727;1450;8284;7157;1127;7939;6928;1011;;622;0.03;6055;0.3;2025747
3176;Gelderland (PV);2014 november;2025747;1590;1416;7025;6096;929;6549;5768;781;;650;0.03;6705;0.33;2026397
3177;Gelderland (PV);2014 december;2026397;1662;1615;7903;7047;856;7808;6781;1027;39.0;181;0.01;6886;0.34;2026578
3178;Gelderland (PV);2014;2019692;19851;17026;94849;81570;13279;90827;79609;11218;39.0;6886;0.34;6886;0.34;2026578
3179;Gelderland (PV);2015 januari;2026578;1619;1846;7969;6975;994;7622;6733;889;;120;0.01;120;0.01;2026698
3180;Gelderland (PV);2015 februari;2026698;1427;1649;8136;6864;1272;7443;6611;832;;471;0.02;591;0.03;2027169
3181;Gelderland (PV);2015 maart;2027169;1604;1614;7462;6483;979;7347;6503;844;;105;0.01;696;0.03;2027274
3182;Gelderland (PV);2015 april;2027274;1496;1470;7002;6118;884;6534;5718;816;;494;0.02;1190;0.06;2027768
3183;Gelderland (PV);2015 mei;2027768;1627;1497;6405;5644;761;6186;5531;655;;349;0.02;1539;0.08;2028117
3184;Gelderland (PV);2015 juni;2028117;1668;1334;7300;6225;1075;7039;6040;999;;595;0.03;2134;0.11;2028712
3185;Gelderland (PV);2015 juli;2028712;1686;1428;9642;8447;1195;9351;8071;1280;;549;0.03;2683;0.13;2029261
3186;Gelderland (PV);2015 augustus;2029261;1827;1369;11402;9067;2335;10111;9015;1096;;1749;0.09;4432;0.22;2031010
3187;Gelderland (PV);2015 september;2031010;1738;1333;10145;8069;2076;8914;7867;1047;;1636;0.08;6068;0.3;2032646
3188;Gelderland (PV);2015 oktober;2032646;1636;1467;8492;7078;1414;7809;6825;984;;852;0.04;6920;0.34;2033498
3189;Gelderland (PV);2015 november;2033498;1591;1416;7763;6641;1122;6941;6137;804;;997;0.05;7917;0.39;2034495
3190;Gelderland (PV);2015 december;2034495;1606;1467;8662;7394;1268;7983;7031;952;38.0;856;0.04;8773;0.43;2035351
3191;Gelderland (PV);2015;2026578;19525;17890;100380;85005;15375;93280;82082;11198;38.0;8773;0.43;8773;0.43;2035351
3192;Gelderland (PV);2016 januari;2035351;1521;1683;8712;7297;1415;8112;7065;1047;;438;0.02;438;0.02;2035789
3193;Gelderland (PV);2016 februari;2035789;1565;1530;9691;7715;1976;8610;7590;1020;;1116;0.05;1554;0.08;2036905
3194;Gelderland (PV);2016 maart;2036905;1658;1696;8933;7430;1503;8179;7330;849;;716;0.04;2270;0.11;2037621
3195;Gelderland (PV);2016 april;2037621;1589;1571;8233;6935;1298;7644;6935;709;;607;0.03;2877;0.14;2038228
3196;Gelderland (PV);2016 mei;2038228;1593;1503;8192;6915;1277;7490;6753;737;;792;0.04;3669;0.18;2039020
3197;Gelderland (PV);2016 juni;2039020;1646;1400;8729;7185;1544;8072;7048;1024;;903;0.04;4572;0.22;2039923
3198;Gelderland (PV);2016 juli;2039923;1845;1428;11079;9552;1527;10145;8873;1272;;1351;0.07;5923;0.29;2041274
3199;Gelderland (PV);2016 augustus;2041274;1795;1294;13287;10254;3033;10995;9731;1264;;2793;0.14;8716;0.43;2044067
3200;Gelderland (PV);2016 september;2044067;1646;1402;11337;9088;2249;9969;8932;1037;;1612;0.08;10328;0.51;2045679
3201;Gelderland (PV);2016 oktober;2045679;1593;1479;9130;7946;1184;8505;7475;1030;;739;0.04;11067;0.54;2046418
3202;Gelderland (PV);2016 november;2046418;1506;1470;8855;7776;1079;8063;7282;781;;828;0.04;11895;0.58;2047246
3203;Gelderland (PV);2016 december;2047246;1542;1668;9288;8345;943;8458;7573;885;-49.0;655;0.03;12550;0.62;2047901
3204;Gelderland (PV);2016;2035351;19499;18124;115466;96438;19028;104242;92587;11655;-49.0;12550;0.62;12550;0.62;2047901
3205;Gelderland (PV);2017 januari;2047901;1630;1977;9413;8303;1110;8932;7869;1063;;134;0.01;134;0.01;2048035
3206;Gelderland (PV);2017 februari;2048035;1436;1717;9604;8126;1478;8588;7703;885;;735;0.04;869;0.04;2048770
3207;Gelderland (PV);2017 maart;2048770;1551;1595;9888;8878;1010;8707;7975;732;;1137;0.06;2006;0.1;2049907
3208;Gelderland (PV);2017 april;2049907;1506;1479;8120;7236;884;7314;6565;749;;833;0.04;2839;0.14;2050740
3209;Gelderland (PV);2017 mei;2050740;1624;1465;8526;7542;984;7829;7184;645;;856;0.04;3695;0.18;2051596
3210;Gelderland (PV);2017 juni;2051596;1659;1448;8775;7747;1028;8240;7389;851;;746;0.04;4441;0.22;2052342
3211;Gelderland (PV);2017 juli;2052342;1769;1414;10622;9412;1210;10202;8628;1574;;775;0.04;5216;0.25;2053117
3212;Gelderland (PV);2017 augustus;2053117;1797;1438;13130;10564;2566;10814;9594;1220;;2675;0.13;7891;0.39;2055792
3213;Gelderland (PV);2017 september;2055792;1666;1451;12128;9570;2558;10095;9027;1068;;2248;0.11;10139;0.5;2058040
3214;Gelderland (PV);2017 oktober;2058040;1683;1439;9635;8207;1428;8843;7773;1070;;1036;0.05;11175;0.55;2059076
3215;Gelderland (PV);2017 november;2059076;1605;1516;8756;7714;1042;8312;7347;965;;533;0.03;11708;0.57;2059609
3216;Gelderland (PV);2017 december;2059609;1608;1678;9003;8115;888;8346;7372;974;-93.0;494;0.02;12202;0.6;2060103
3217;Gelderland (PV);2017;2047901;19534;18617;117600;101414;16186;106222;94426;11796;-93.0;12202;0.6;12202;0.6;2060103
3218;Gelderland (PV);2018 januari;2060103;1660;1910;9206;8047;1159;8702;7756;946;;254;0.01;254;0.01;2060357
3219;Gelderland (PV);2018 februari;2060357;1383;1750;9134;7412;1722;8129;7096;1033;;638;0.03;892;0.04;2060995
3220;Gelderland (PV);2018 maart;2060995;1564;2081;9137;8000;1137;8472;7596;876;;148;0.01;1040;0.05;2061143
3221;Gelderland (PV);2018 april;2061143;1543;1522;8072;6948;1124;7507;6739;768;;586;0.03;1626;0.08;2061729
3222;Gelderland (PV);2018 mei;2061729;1675;1448;8285;7088;1197;7625;6869;756;;887;0.04;2513;0.12;2062616
3223;Gelderland (PV);2018 juni;2062616;1717;1376;8454;7271;1183;7814;6914;900;;981;0.05;3494;0.17;2063597
3224;Gelderland (PV);2018 juli;2063597;1789;1487;10403;8994;1409;9487;8071;1416;;1218;0.06;4712;0.23;2064815
3225;Gelderland (PV);2018 augustus;2064815;1682;1464;12617;10057;2560;10654;9435;1219;;2181;0.11;6893;0.33;2066996
3226;Gelderland (PV);2018 september;2066996;1617;1343;10916;8243;2673;8859;7802;1057;;2331;0.11;9224;0.45;2069327
3227;Gelderland (PV);2018 oktober;2069327;1684;1487;10079;8484;1595;9158;7918;1240;;1118;0.05;10342;0.5;2070445
3228;Gelderland (PV);2018 november;2070445;1534;1509;8866;7612;1254;8086;7151;935;;805;0.04;11147;0.54;2071250
3229;Gelderland (PV);2018 december;2071250;1499;1640;8677;7465;1212;7840;6987;853;26.0;722;0.03;11869;0.58;2071972
3230;Gelderland (PV);2018;2060103;19347;19017;113846;95621;18225;102333;90334;11999;26.0;11869;0.58;11869;0.58;2071972
3231;Gelderland (PV);2019 januari;2071972;1579;1770;9252;7839;1413;8777;7572;1205;;284;0.01;284;0.01;2072256
3232;Gelderland (PV);2019 februari;2072256;1386;1661;9210;7344;1866;7941;6937;1004;;994;0.05;1278;0.06;2073250
3233;Gelderland (PV);2019 maart;2073250;1496;1722;9086;7693;1393;8243;7260;983;;617;0.03;1895;0.09;2073867
3234;Gelderland (PV);2019 april;2073867;1561;1609;8463;7229;1234;8018;7174;844;;397;0.02;2292;0.11;2074264
3235;Gelderland (PV);2019 mei;2074264;1687;1609;8601;7284;1317;7861;6984;877;;818;0.04;3110;0.15;2075082
3236;Gelderland (PV);2019 juni;2075082;1629;1414;8028;6634;1394;7345;6286;1059;;898;0.04;4008;0.19;2075980
3237;Gelderland (PV);2019 juli;2075980;1833;1520;11564;9720;1844;10295;8883;1412;;1582;0.08;5590;0.27;2077562
3238;Gelderland (PV);2019 augustus;2077562;1715;1474;13423;10076;3347;10511;9378;1133;;3153;0.15;8743;0.42;2080715
3239;Gelderland (PV);2019 september;2080715;1753;1451;10938;8402;2536;8992;7960;1032;;2248;0.11;10991;0.53;2082963
3240;Gelderland (PV);2019 oktober;2082963;1696;1553;9850;7995;1855;8677;7627;1050;;1316;0.06;12307;0.59;2084279
3241;Gelderland (PV);2019 november;2084279;1554;1607;9048;7617;1431;8207;7239;968;;788;0.04;13095;0.63;2085067
3242;Gelderland (PV);2019 december;2085067;1537;1689;9002;7823;1179;7958;6998;960;-7.0;885;0.04;13980;0.67;2085952
3243;Gelderland (PV);2019;2071972;19426;19079;116465;95656;20809;102825;90298;12527;-7.0;13980;0.67;13980;0.67;2085952
3244;Gelderland (PV);2020 januari;2085952;1679;1713;9776;8217;1559;9036;7651;1385;;706;0.03;706;0.03;2086658
3245;Gelderland (PV);2020 februari;2086658;1569;1673;9535;7631;1904;8364;7401;963;;1067;0.05;1773;0.08;2087725
3246;Gelderland (PV);2020 maart;2087725;1577;2055;8857;7597;1260;8213;7221;992;;166;0.01;1939;0.09;2087891
3247;Gelderland (PV);2020 april;2087891;1577;2367;7945;7155;790;7275;6615;660;;-120;-0.01;1819;0.09;2087771
3248;Gelderland (PV);2020 mei;2087771;1605;1547;7797;7093;704;7444;6860;584;;411;0.02;2230;0.11;2088182
3249;Gelderland (PV);2020 juni;2088182;1602;1455;8553;7591;962;8004;7113;891;;696;0.03;2926;0.14;2088878
3250;Gelderland (PV);2020 juli;2088878;1846;1436;11064;9557;1507;9826;8731;1095;;1648;0.08;4574;0.22;2090526
3251;Gelderland (PV);2020 augustus;2090526;1811;1527;12005;9880;2125;10130;9006;1124;;2159;0.1;6733;0.32;2092685
3252;Gelderland (PV);2020 september;2092685;1737;1500;11088;8834;2254;9424;8335;1089;;1901;0.09;8634;0.41;2094586
3253;Gelderland (PV);2020 oktober;2094586;1696;1773;10539;8870;1669;9510;8404;1106;;952;0.05;9586;0.46;2095538
3254;Gelderland (PV);2020 november;2095538;1585;1798;9040;7705;1335;8055;7211;844;;772;0.04;10358;0.5;2096310
3255;Gelderland (PV);2020 december;2096310;1601;2099;9373;8041;1332;8534;7514;1020;-48.0;293;0.01;10651;0.51;2096603
3256;Gelderland (PV);2020;2085952;19885;20943;115572;98171;17401;103815;92062;11753;-48.0;10651;0.51;10651;0.51;2096603
3257;Gelderland (PV);2021 januari;2096603;1649;2154;10203;8980;1223;9221;8190;1031;0.0;477;0.02;477;0.02;2097080
3258;Gelderland (PV);2021 februari;2097080;1598;1642;9160;7853;1307;8089;7230;859;0.0;1027;0.05;1504;0.07;2098107
3259;Gelderland (PV);2021 maart;2098107;1696;1675;10173;8863;1310;9252;8442;810;0.0;942;0.04;2446;0.12;2099049
3260;Gelderland (PV);2021 april;2099049;1617;1682;9265;8037;1228;8265;7472;793;0.0;935;0.04;3381;0.16;2099984
3261;Gelderland (PV);2021 mei;2099984;1719;1609;8406;7323;1083;7601;6829;772;0.0;915;0.04;4296;0.2;2100899
3262;Gelderland (PV);2021 juni;2100899;1712;1561;8883;7551;1332;8033;7187;846;0.0;1001;0.05;5297;0.25;2101900
3263;Gelderland (PV);2021 juli;2101900;1863;1561;10705;9171;1534;9292;8307;985;0.0;1715;0.08;7012;0.33;2103615
3264;Gelderland (PV);2021 augustus;2103615;1828;1556;11698;9001;2697;9648;8496;1152;0.0;2322;0.11;9334;0.45;2105937
3265;Gelderland (PV);2021 september;2105937;1902;1602;10691;7912;2779;8302;7392;910;0.0;2689;0.13;12023;0.57;2108626
3266;Gelderland (PV);2021 oktober;2108626;1856;1844;9373;7872;1501;8210;7185;1025;0.0;1175;0.06;13198;0.63;2109801
3267;Gelderland (PV);2021 november;2109801;1681;2204;8948;7462;1486;7666;6765;901;0.0;759;0.04;13957;0.67;2110560
3268;Gelderland (PV);2021 december;2110560;1650;2197;8776;7579;1197;8290;7156;1134;-27.0;-88;0.0;13869;0.66;2110472
3269;Gelderland (PV);2021;2096603;20771;21287;116281;97604;18677;101869;90651;11218;-27.0;13869;0.66;13869;0.66;2110472
3270;Gelderland (PV);2022 januari;2110472;1552;1706;9231;7727;1504;8607;7654;953;;470;0.02;470;0.02;2110942
3271;Gelderland (PV);2022 februari;2110942;1509;1698;8883;6882;2001;7646;6777;869;;1048;0.05;1518;0.07;2111990
3272;Gelderland (PV);2022 maart;2111990;1607;1915;12009;7634;4375;8390;7244;1146;;3311;0.16;4829;0.23;2115301
3273;Gelderland (PV);2022 april;2115301;1453;1869;12261;7640;4621;7872;7007;865;;3973;0.19;8802;0.42;2119274
3274;Gelderland (PV);2022 mei;2119274;1708;1685;10014;7276;2738;8082;6812;1270;;1955;0.09;10757;0.51;2121229
3275;Gelderland (PV);2022 juni;2121229;1658;1638;9696;7204;2492;7949;6783;1166;;1767;0.08;12524;0.59;2122996
3276;Gelderland (PV);2022 juli;2122996;1759;1716;10797;8493;2304;9575;7891;1684;;1265;0.06;13789;0.65;2124261
3277;Gelderland (PV);2022 augustus;2124261;1802;1686;13013;9164;3849;9862;8320;1542;;3267;0.15;17056;0.81;2127528
3278;Gelderland (PV);2022 september;2127528;1777;1670;12443;8449;3994;9293;7865;1428;;3257;0.15;20313;0.96;2130785
3279;Gelderland (PV);2022 oktober;2130785;1673;1963;10737;8146;2591;8786;7525;1261;;1661;0.08;21974;1.04;2132446
3280;Gelderland (PV);2022 november;2132446;1542;1761;9756;7575;2181;8561;7218;1343;;976;0.05;22950;1.09;2133422
3281;Gelderland (PV);2022 december;2133422;1523;2174;9936;8098;1838;8959;7639;1320;-40.0;286;0.01;23236;1.1;2133708
3282;Gelderland (PV);2022;2110472;19563;21481;128776;94288;34488;103582;88735;14847;-40.0;23236;1.1;23236;1.1;2133708
3283;Gelderland (PV);2023 januari;2133708;1534;2078;10578;8493;2085;9220;7888;1332;0.0;814;0.04;814;0.04;2134522
3284;Gelderland (PV);2023 februari;2134522;1452;1711;9905;7498;2407;8152;6971;1181;0.0;1494;0.07;2308;0.11;2136016
3285;Gelderland (PV);2023 maart;2136016;1657;2026;10323;8219;2104;9357;8033;1324;0.0;597;0.03;2905;0.14;2136613
3286;Gelderland (PV);2023 april;2136613;1508;1610;9326;7588;1738;8160;6982;1178;0.0;1064;0.05;3969;0.19;2137677
3287;Gelderland (PV);2023 mei;2137677;1631;1660;9483;7408;2075;8160;6981;1179;0.0;1294;0.06;5263;0.25;2138971
3288;Gelderland (PV);2023 juni;2138971;1649;1597;10561;8534;2027;9318;8006;1312;0.0;1295;0.06;6558;0.31;2140266
3289;Gelderland (PV);2023 juli;2140266;1705;1518;11743;9515;2228;10511;8738;1773;0.0;1419;0.07;7977;0.37;2141685
3290;Gelderland (PV);2023 augustus;2141685;1815;1632;14089;10163;3926;11329;9351;1978;0.0;2943;0.14;10920;0.51;2144628
3291;Gelderland (PV);2023 september;2144628;1632;1557;12132;8897;3235;9800;8400;1400;0.0;2407;0.11;13327;0.62;2147035
3292;Gelderland (PV);2023 oktober;2147035;1715;1723;10295;7998;2297;9217;7666;1551;0.0;1070;0.05;14397;0.67;2148105
3293;Gelderland (PV);2023 november;2148105;1556;1918;9342;7523;1819;8261;7104;1157;0.0;719;0.03;15116;0.71;2148824
3294;Gelderland (PV);2023 december;2148824;1543;1927;9374;7973;1401;8691;7322;1369;-52.0;247;0.01;15363;0.72;2149071
3295;Gelderland (PV);2023;2133708;19397;20957;127151;99809;27342;110176;93442;16734;-52.0;15363;0.72;15363;0.72;2149071
3296;Gelderland (PV);2024 januari;2149071;1552;2078;10171;8202;1969;9343;7763;1580;;302;0.01;302;0.01;2149373
3297;Gelderland (PV);2024 februari;2149373;1546;1920;9607;7566;2041;8566;7085;1481;;667;0.03;969;0.05;2150040
3298;Gelderland (PV);2024 maart;2150040;1584;1907;9292;7693;1599;8456;7329;1127;;513;0.02;1482;0.07;2150553
3299;Gelderland (PV);2024 april;2150553;1527;1787;8843;7317;1526;8004;6860;1144;;579;0.03;2061;0.1;2151132
3300;Gelderland (PV);2024 mei;2151132;1593;1760;8968;7403;1565;7871;6720;1151;;930;0.04;2991;0.14;2152062
3301;Gelderland (PV);2024 juni;2152062;1608;1580;8559;7007;1552;7904;6578;1326;;683;0.03;3674;0.17;2152745
3302;Gelderland (PV);2024 juli;2152745;1741;1696;10757;8894;1863;9852;8054;1798;;950;0.04;4624;0.22;2153695
3303;Gelderland (PV);2024 augustus;2153695;1789;1646;12773;9516;3257;10233;8803;1430;;2683;0.12;7307;0.34;2156378
3304;Gelderland (PV);2024 september;2156378;1685;1620;11352;8647;2705;9104;7788;1316;;2313;0.11;9620;0.45;2158691
3305;Gelderland (PV);2024 oktober;2158691;1632;1856;10450;8521;1929;9170;7648;1522;;1056;0.05;10676;0.5;2159747
3306;Gelderland (PV);2024 november;2159747;1588;1750;9558;7916;1642;8677;7334;1343;;719;0.03;11395;0.53;2160466
3307;Gelderland (PV);2024 december;2160466;1590;1852;9701;8280;1421;8517;7140;1377;0.0;922;0.04;12317;0.57;2161388
3308;Gelderland (PV);2024;2149071;19435;21452;120031;96962;23069;105697;89102;16595;0.0;12317;0.57;12317;0.57;2161388
3309;Gelderland (PV);2025 januari;2161388;1664;2143;10615;8623;1992;9380;7896;1484;;756;0.03;756;0.03;2162144
3310;Gelderland (PV);2025 februari;2162144;1452;1927;9714;7674;2040;8406;7047;1359;;833;0.04;1589;0.07;2162977
3311;Utrecht (PV);2002 januari;1139925;1304;878;5534;4801;733;4996;4483;513;;964;0.08;964;0.08;1140889
3312;Utrecht (PV);2002 februari;1140889;1186;753;4557;4025;532;4257;3848;409;;733;0.06;1697;0.15;1141622
3313;Utrecht (PV);2002 maart;1141622;1324;861;4935;4396;539;4567;4122;445;;831;0.07;2528;0.22;1142453
3314;Utrecht (PV);2002 april;1142453;1293;797;4612;4028;584;4172;3714;458;;936;0.08;3464;0.3;1143389
3315;Utrecht (PV);2002 mei;1143389;1359;749;4789;4313;476;4366;4035;331;;1033;0.09;4497;0.39;1144422
3316;Utrecht (PV);2002 juni;1144422;1275;689;4413;3895;518;4287;3787;500;;712;0.06;5209;0.46;1145134
3317;Utrecht (PV);2002 juli;1145134;1440;730;5811;5235;576;5641;4861;780;;880;0.08;6089;0.53;1146014
3318;Utrecht (PV);2002 augustus;1146014;1402;703;6396;5569;827;5519;5041;478;;1576;0.14;7665;0.67;1147590
3319;Utrecht (PV);2002 september;1147590;1415;644;6474;5359;1115;5154;4529;625;;2091;0.18;9756;0.86;1149681
3320;Utrecht (PV);2002 oktober;1149681;1465;724;5391;4886;505;4995;4435;560;;1137;0.1;10893;0.96;1150818
3321;Utrecht (PV);2002 november;1150818;1302;712;4918;4478;440;4696;4191;505;;812;0.07;11705;1.03;1151630
3322;Utrecht (PV);2002 december;1151630;1336;815;4625;4188;437;4609;4059;550;51.0;588;0.05;12293;1.08;1152218
3323;Utrecht (PV);2002;1139925;16101;9055;62455;55173;7282;57259;51105;6154;51.0;12293;1.08;12293;1.08;1152218
3324;Utrecht (PV);2003 januari;1152218;1362;771;5189;4649;540;5073;4550;523;;707;0.06;707;0.06;1152925
3325;Utrecht (PV);2003 februari;1152925;1266;740;4251;3737;514;4015;3563;452;;762;0.07;1469;0.13;1153687
3326;Utrecht (PV);2003 maart;1153687;1314;798;4445;3978;467;4160;3615;545;;801;0.07;2270;0.2;1154488
3327;Utrecht (PV);2003 april;1154488;1341;768;4285;3877;408;4080;3530;550;;778;0.07;3048;0.26;1155266
3328;Utrecht (PV);2003 mei;1155266;1397;798;4191;3804;387;3911;3591;320;;879;0.08;3927;0.34;1156145
3329;Utrecht (PV);2003 juni;1156145;1288;687;4317;3843;474;4265;3838;427;;653;0.06;4580;0.4;1156798
3330;Utrecht (PV);2003 juli;1156798;1446;739;5317;4751;566;5389;4776;613;;635;0.05;5215;0.45;1157433
3331;Utrecht (PV);2003 augustus;1157433;1406;773;5690;4988;702;5241;4614;627;;1082;0.09;6297;0.55;1158515
3332;Utrecht (PV);2003 september;1158515;1374;728;6210;5223;987;5393;4626;767;;1463;0.13;7760;0.67;1159978
3333;Utrecht (PV);2003 oktober;1159978;1430;715;5213;4691;522;5231;4491;740;;697;0.06;8457;0.73;1160675
3334;Utrecht (PV);2003 november;1160675;1333;758;4307;3954;353;4468;3903;565;;414;0.04;8871;0.77;1161089
3335;Utrecht (PV);2003 december;1161089;1265;840;4742;4335;407;4639;4251;388;641.0;1169;0.1;10040;0.87;1162258
3336;Utrecht (PV);2003;1152218;16222;9115;58157;51830;6327;55865;49348;6517;641.0;10040;0.87;10040;0.87;1162258
3337;Utrecht (PV);2004 januari;1162258;1290;888;4640;4221;419;4665;4199;466;;377;0.03;377;0.03;1162635
3338;Utrecht (PV);2004 februari;1162635;1273;696;4514;4044;470;4222;3666;556;;869;0.07;1246;0.11;1163504
3339;Utrecht (PV);2004 maart;1163504;1278;743;4938;4525;413;5019;4253;766;;454;0.04;1700;0.15;1163958
3340;Utrecht (PV);2004 april;1163958;1287;709;4360;4060;300;4480;3931;549;;458;0.04;2158;0.19;1164416
3341;Utrecht (PV);2004 mei;1164416;1256;743;4141;3793;348;4055;3613;442;;599;0.05;2757;0.24;1165015
3342;Utrecht (PV);2004 juni;1165015;1383;740;4852;4384;468;4934;4245;689;;561;0.05;3318;0.29;1165576
3343;Utrecht (PV);2004 juli;1165576;1488;756;5605;5148;457;6006;5204;802;;331;0.03;3649;0.31;1165907
3344;Utrecht (PV);2004 augustus;1165907;1334;728;6322;5715;607;5748;5095;653;;1180;0.1;4829;0.42;1167087
3345;Utrecht (PV);2004 september;1167087;1370;710;6863;5814;1049;5593;4977;616;;1930;0.17;6759;0.58;1169017
3346;Utrecht (PV);2004 oktober;1169017;1338;689;5024;4563;461;4815;4223;592;;858;0.07;7617;0.66;1169875
3347;Utrecht (PV);2004 november;1169875;1224;697;4863;4436;427;4651;4181;470;;739;0.06;8356;0.72;1170614
3348;Utrecht (PV);2004 december;1170614;1250;776;4840;4423;417;5065;4410;655;428.0;677;0.06;9033;0.78;1171291
3349;Utrecht (PV);2004;1162258;15771;8875;60962;55126;5836;59253;51997;7256;428.0;9033;0.78;9033;0.78;1171291
3350;Utrecht (PV);2005 januari;1171291;1304;806;4847;4442;405;4691;4174;517;;654;0.06;654;0.06;1171945
3351;Utrecht (PV);2005 februari;1171945;1173;744;4668;4112;556;4479;4015;464;;618;0.05;1272;0.11;1172563
3352;Utrecht (PV);2005 maart;1172563;1278;847;4661;4262;399;4922;4272;650;;170;0.01;1442;0.12;1172733
3353;Utrecht (PV);2005 april;1172733;1321;735;4687;4291;396;4548;4123;425;;725;0.06;2167;0.19;1173458
3354;Utrecht (PV);2005 mei;1173458;1313;725;4154;3824;330;4075;3672;403;;667;0.06;2834;0.24;1174125
3355;Utrecht (PV);2005 juni;1174125;1322;744;4792;4464;328;5098;4366;732;;272;0.02;3106;0.27;1174397
3356;Utrecht (PV);2005 juli;1174397;1261;652;5738;5261;477;5945;5123;822;;402;0.03;3508;0.3;1174799
3357;Utrecht (PV);2005 augustus;1174799;1309;650;6749;6098;651;6359;5455;904;;1049;0.09;4557;0.39;1175848
3358;Utrecht (PV);2005 september;1175848;1359;638;7255;6183;1072;6161;5267;894;;1815;0.15;6372;0.54;1177663
3359;Utrecht (PV);2005 oktober;1177663;1376;686;5725;5257;468;5527;4858;669;;888;0.08;7260;0.62;1178551
3360;Utrecht (PV);2005 november;1178551;1158;684;5325;4915;410;5062;4448;614;;737;0.06;7997;0.68;1179288
3361;Utrecht (PV);2005 december;1179288;1221;740;5071;4732;339;5268;4616;652;467.0;751;0.06;8748;0.75;1180039
3362;Utrecht (PV);2005;1171291;15395;8651;63672;57841;5831;62135;54389;7746;467.0;8748;0.75;8748;0.75;1180039
3363;Utrecht (PV);2006 januari;1180039;1252;767;5705;5150;555;5599;4921;678;;591;0.05;591;0.05;1180630
3364;Utrecht (PV);2006 februari;1180630;1202;753;5235;4668;567;5086;4447;639;;598;0.05;1189;0.1;1181228
3365;Utrecht (PV);2006 maart;1181228;1300;778;5569;5107;462;5531;4758;773;;560;0.05;1749;0.15;1181788
3366;Utrecht (PV);2006 april;1181788;1271;766;4585;4141;444;4322;3718;604;;768;0.06;2517;0.21;1182556
3367;Utrecht (PV);2006 mei;1182556;1337;717;4924;4379;545;4796;4277;519;;748;0.06;3265;0.28;1183304
3368;Utrecht (PV);2006 juni;1183304;1250;656;5002;4581;421;4933;4363;570;;663;0.06;3928;0.33;1183967
3369;Utrecht (PV);2006 juli;1183967;1315;746;5700;5170;530;5928;5180;748;;341;0.03;4269;0.36;1184308
3370;Utrecht (PV);2006 augustus;1184308;1380;647;7266;6454;812;6469;5681;788;;1530;0.13;5799;0.49;1185838
3371;Utrecht (PV);2006 september;1185838;1304;727;7279;6040;1239;5841;5058;783;;2015;0.17;7814;0.66;1187853
3372;Utrecht (PV);2006 oktober;1187853;1368;677;5805;5246;559;5413;4762;651;;1083;0.09;8897;0.75;1188936
3373;Utrecht (PV);2006 november;1188936;1206;706;5911;5504;407;5467;4910;557;;944;0.08;9841;0.83;1189880
3374;Utrecht (PV);2006 december;1189880;1238;773;4800;4438;362;4887;4334;553;346.0;724;0.06;10565;0.9;1190604
3375;Utrecht (PV);2006;1180039;15423;8713;67781;60878;6903;64272;56409;7863;346.0;10565;0.9;10565;0.9;1190604
3376;Utrecht (PV);2007 januari;1190604;1297;754;5777;5204;573;5425;4836;589;;895;0.08;895;0.08;1191499
3377;Utrecht (PV);2007 februari;1191499;1170;647;5223;4554;669;4819;4211;608;;927;0.08;1822;0.15;1192426
3378;Utrecht (PV);2007 maart;1192426;1362;784;5119;4618;501;4958;4396;562;;739;0.06;2561;0.22;1193165
3379;Utrecht (PV);2007 april;1193165;1205;682;4423;3938;485;4392;3814;578;;554;0.05;3115;0.26;1193719
3380;Utrecht (PV);2007 mei;1193719;1329;639;4974;4509;465;5140;4461;679;;524;0.04;3639;0.31;1194243
3381;Utrecht (PV);2007 juni;1194243;1225;642;4923;4394;529;4798;4264;534;;708;0.06;4347;0.37;1194951
3382;Utrecht (PV);2007 juli;1194951;1358;710;5992;5336;656;6108;5318;790;;532;0.04;4879;0.41;1195483
3383;Utrecht (PV);2007 augustus;1195483;1342;636;7008;6146;862;6540;5621;919;;1174;0.1;6053;0.51;1196657
3384;Utrecht (PV);2007 september;1196657;1384;637;7061;5718;1343;5719;4929;790;;2089;0.17;8142;0.68;1198746
3385;Utrecht (PV);2007 oktober;1198746;1350;680;5872;5197;675;5591;4923;668;;951;0.08;9093;0.76;1199697
3386;Utrecht (PV);2007 november;1199697;1229;714;5558;4875;683;5183;4478;705;;890;0.07;9983;0.84;1200587
3387;Utrecht (PV);2007 december;1200587;1202;761;4469;4055;414;4549;4042;507;402.0;763;0.06;10746;0.9;1201350
3388;Utrecht (PV);2007;1190604;15453;8286;66399;58544;7855;63222;55293;7929;402.0;10746;0.9;10746;0.9;1201350
3389;Utrecht (PV);2008 januari;1201350;1234;822;5879;5243;636;5859;5150;709;;432;0.04;432;0.04;1201782
3390;Utrecht (PV);2008 februari;1201782;1180;723;5357;4531;826;5228;4464;764;;586;0.05;1018;0.08;1202368
3391;Utrecht (PV);2008 maart;1202368;1239;743;4699;4158;541;4644;4064;580;;551;0.05;1569;0.13;1202919
3392;Utrecht (PV);2008 april;1202919;1251;743;4960;4316;644;4808;4297;511;;660;0.05;2229;0.19;1203579
3393;Utrecht (PV);2008 mei;1203579;1337;696;4399;3917;482;4452;4034;418;;588;0.05;2817;0.23;1204167
3394;Utrecht (PV);2008 juni;1204167;1276;680;4960;4288;672;4861;4365;496;;695;0.06;3512;0.29;1204862
3395;Utrecht (PV);2008 juli;1204862;1407;686;6167;5344;823;6518;5501;1017;;370;0.03;3882;0.32;1205232
3396;Utrecht (PV);2008 augustus;1205232;1342;639;6316;5496;820;6449;5539;910;;570;0.05;4452;0.37;1205802
3397;Utrecht (PV);2008 september;1205802;1366;652;7870;6234;1636;6156;5424;732;;2428;0.2;6880;0.57;1208230
3398;Utrecht (PV);2008 oktober;1208230;1288;727;5973;5094;879;5553;4992;561;;981;0.08;7861;0.65;1209211
3399;Utrecht (PV);2008 november;1209211;1253;703;4786;4106;680;4570;4044;526;;766;0.06;8627;0.72;1209977
3400;Utrecht (PV);2008 december;1209977;1283;829;5312;4754;558;5209;4566;643;335.0;892;0.07;9519;0.79;1210869
3401;Utrecht (PV);2008;1201350;15456;8643;66678;57481;9197;64307;56440;7867;335.0;9519;0.79;9519;0.79;1210869
3402;Utrecht (PV);2009 januari;1210869;1248;947;5213;4576;637;5216;4613;603;;298;0.02;298;0.02;1211167
3403;Utrecht (PV);2009 februari;1211167;1158;723;4931;4049;882;4654;4139;515;;712;0.06;1010;0.08;1211879
3404;Utrecht (PV);2009 maart;1211879;1260;738;4833;4227;606;4751;4216;535;;604;0.05;1614;0.13;1212483
3405;Utrecht (PV);2009 april;1212483;1194;704;4148;3654;494;4050;3540;510;;588;0.05;2202;0.18;1213071
3406;Utrecht (PV);2009 mei;1213071;1311;707;3842;3331;511;4045;3483;562;;401;0.03;2603;0.21;1213472
3407;Utrecht (PV);2009 juni;1213472;1262;634;4365;3794;571;4495;3815;680;;498;0.04;3101;0.26;1213970
3408;Utrecht (PV);2009 juli;1213970;1422;705;5531;4683;848;5777;4978;799;;471;0.04;3572;0.29;1214441
3409;Utrecht (PV);2009 augustus;1214441;1402;620;6310;5309;1001;5803;4899;904;;1289;0.11;4861;0.4;1215730
3410;Utrecht (PV);2009 september;1215730;1344;691;7283;5496;1787;5502;4851;651;;2434;0.2;7295;0.6;1218164
3411;Utrecht (PV);2009 oktober;1218164;1289;692;5259;4489;770;4870;4377;493;;986;0.08;8281;0.68;1219150
3412;Utrecht (PV);2009 november;1219150;1264;657;4754;4140;614;4418;3892;526;;943;0.08;9224;0.76;1220093
3413;Utrecht (PV);2009 december;1220093;1308;768;4614;4165;449;4706;4131;575;369.0;817;0.07;10041;0.83;1220910
3414;Utrecht (PV);2009;1210869;15462;8586;61083;51913;9170;58287;50934;7353;369.0;10041;0.83;10041;0.83;1220910
3415;Utrecht (PV);2010 januari;1220910;1216;775;4582;4007;575;4919;4174;745;;104;0.01;104;0.01;1221014
3416;Utrecht (PV);2010 februari;1221014;1130;739;4922;3964;958;4629;4058;571;;684;0.06;788;0.06;1221698
3417;Utrecht (PV);2010 maart;1221698;1242;811;4753;4133;620;4796;4173;623;;388;0.03;1176;0.1;1222086
3418;Utrecht (PV);2010 april;1222086;1249;742;4117;3514;603;4055;3550;505;;569;0.05;1745;0.14;1222655
3419;Utrecht (PV);2010 mei;1222655;1282;704;3948;3396;552;3963;3499;464;;563;0.05;2308;0.19;1223218
3420;Utrecht (PV);2010 juni;1223218;1303;671;4417;3803;614;4568;3925;643;;481;0.04;2789;0.23;1223699
3421;Utrecht (PV);2010 juli;1223699;1375;695;5357;4579;778;6036;4744;1292;;1;0.0;2790;0.23;1223700
3422;Utrecht (PV);2010 augustus;1223700;1366;648;6384;5424;960;5815;5024;791;;1287;0.11;4077;0.33;1224987
3423;Utrecht (PV);2010 september;1224987;1357;706;6887;5126;1761;5659;4918;741;;1879;0.15;5956;0.49;1226866
3424;Utrecht (PV);2010 oktober;1226866;1374;699;4989;4242;747;4851;4210;641;;813;0.07;6769;0.55;1227679
3425;Utrecht (PV);2010 november;1227679;1268;711;4721;4050;671;4639;4066;573;;639;0.05;7408;0.61;1228318
3426;Utrecht (PV);2010 december;1228318;1267;867;4565;3970;595;4490;3951;539;1.0;476;0.04;7884;0.65;1228794
3427;Utrecht (PV);2010;1220910;15429;8768;59642;50208;9434;58420;50292;8128;1.0;7884;0.65;7884;0.65;1228794
3428;Utrecht (PV);2011 januari;1228794;1170;785;4814;4117;697;4794;4084;710;;405;0.03;405;0.03;1229199
3429;Utrecht (PV);2011 februari;1229199;1196;689;4883;3894;989;4531;4028;503;;859;0.07;1264;0.1;1230058
3430;Utrecht (PV);2011 maart;1230058;1240;746;4769;4089;680;4722;4117;605;;541;0.04;1805;0.15;1230599
3431;Utrecht (PV);2011 april;1230599;1209;746;4128;3559;569;4068;3586;482;;523;0.04;2328;0.19;1231122
3432;Utrecht (PV);2011 mei;1231122;1300;765;4341;3763;578;4712;3809;903;;164;0.01;2492;0.2;1231286
3433;Utrecht (PV);2011 juni;1231286;1268;693;4161;3569;592;4424;3726;698;;312;0.03;2804;0.23;1231598
3434;Utrecht (PV);2011 juli;1231598;1319;729;5228;4442;786;5828;4778;1050;;-10;0.0;2794;0.23;1231588
3435;Utrecht (PV);2011 augustus;1231588;1335;721;6771;5737;1034;6322;5354;968;;1063;0.09;3857;0.31;1232651
3436;Utrecht (PV);2011 september;1232651;1317;700;7266;5309;1957;5563;4813;750;;2320;0.19;6177;0.5;1234971
3437;Utrecht (PV);2011 oktober;1234971;1212;709;5000;4310;690;4647;3962;685;;856;0.07;7033;0.57;1235827
3438;Utrecht (PV);2011 november;1235827;1087;784;4959;4305;654;4567;4019;548;;695;0.06;7728;0.63;1236522
3439;Utrecht (PV);2011 december;1236522;1176;771;4848;4338;510;4648;4043;605;-14.0;591;0.05;8319;0.68;1237113
3440;Utrecht (PV);2011;1228794;14829;8838;61168;51432;9736;58826;50319;8507;-14.0;8319;0.68;8319;0.68;1237113
3441;Utrecht (PV);2012 januari;1237117;1244;802;5357;4609;748;5432;4603;829;;367;0.03;367;0.03;1237484
3442;Utrecht (PV);2012 februari;1237484;1123;793;5222;4274;948;4803;4072;731;;749;0.06;1116;0.09;1238233
3443;Utrecht (PV);2012 maart;1238233;1245;845;4875;4274;601;4796;4249;547;;479;0.04;1595;0.13;1238712
3444;Utrecht (PV);2012 april;1238712;1186;745;4234;3722;512;4025;3547;478;;650;0.05;2245;0.18;1239362
3445;Utrecht (PV);2012 mei;1239362;1282;735;4287;3746;541;4471;3715;756;;363;0.03;2608;0.21;1239725
3446;Utrecht (PV);2012 juni;1239725;1266;684;4724;4166;558;5038;4383;655;;268;0.02;2876;0.23;1239993
3447;Utrecht (PV);2012 juli;1239993;1347;724;5527;4726;801;5711;4802;909;;439;0.04;3315;0.27;1240432
3448;Utrecht (PV);2012 augustus;1240432;1242;697;6579;5641;938;6232;5351;881;;892;0.07;4207;0.34;1241324
3449;Utrecht (PV);2012 september;1241324;1334;681;6972;5093;1879;5602;4589;1013;;2023;0.16;6230;0.5;1243347
3450;Utrecht (PV);2012 oktober;1243347;1243;721;5530;4715;815;5085;4357;728;;967;0.08;7197;0.58;1244314
3451;Utrecht (PV);2012 november;1244314;1218;740;4611;4038;573;4464;3916;548;;625;0.05;7822;0.63;1244939
3452;Utrecht (PV);2012 december;1244939;1148;766;4534;4061;473;4518;3853;665;-43.0;355;0.03;8177;0.66;1245294
3453;Utrecht (PV);2012;1237117;14878;8933;62452;53065;9387;60177;51437;8740;-43.0;8177;0.66;8177;0.66;1245294
3454;Utrecht (PV);2013 januari;1245294;1241;876;5424;4655;769;5490;4683;807;;299;0.02;299;0.02;1245593
3455;Utrecht (PV);2013 februari;1245593;1115;790;5146;4190;956;4767;3995;772;;704;0.06;1003;0.08;1246297
3456;Utrecht (PV);2013 maart;1246297;1172;876;4690;4140;550;4709;4086;623;;277;0.02;1280;0.1;1246574
3457;Utrecht (PV);2013 april;1246574;1125;812;4205;3672;533;4229;3567;662;;289;0.02;1569;0.13;1246863
3458;Utrecht (PV);2013 mei;1246863;1178;721;4244;3648;596;4329;3717;612;;372;0.03;1941;0.16;1247235
3459;Utrecht (PV);2013 juni;1247235;1169;733;4158;3555;603;4183;3616;567;;411;0.03;2352;0.19;1247646
3460;Utrecht (PV);2013 juli;1247646;1255;738;5505;4624;881;5674;4705;969;;348;0.03;2700;0.22;1247994
3461;Utrecht (PV);2013 augustus;1247994;1281;667;6755;5829;926;6150;5275;875;;1219;0.1;3919;0.31;1249213
3462;Utrecht (PV);2013 september;1249213;1213;673;7723;5752;1971;6356;5114;1242;;1907;0.15;5826;0.47;1251120
3463;Utrecht (PV);2013 oktober;1251120;1226;737;5858;4974;884;5241;4546;695;;1106;0.09;6932;0.56;1252226
3464;Utrecht (PV);2013 november;1252226;1174;697;5115;4407;708;4653;4187;466;;939;0.07;7871;0.63;1253165
3465;Utrecht (PV);2013 december;1253165;1164;781;5003;4450;553;4930;4203;727;51.0;507;0.04;8378;0.67;1253672
3466;Utrecht (PV);2013;1245294;14313;9101;63826;53896;9930;60711;51694;9017;51.0;8378;0.67;8378;0.67;1253672
3467;Utrecht (PV);2014 januari;1253672;1173;820;5795;5038;757;5738;4973;765;;410;0.03;410;0.03;1254082
3468;Utrecht (PV);2014 februari;1254082;1164;727;5579;4548;1031;4954;4327;627;;1062;0.08;1472;0.12;1255144
3469;Utrecht (PV);2014 maart;1255144;1214;818;4980;4385;595;4705;4277;428;;671;0.05;2143;0.17;1255815
3470;Utrecht (PV);2014 april;1255815;1199;732;5134;4491;643;4629;4061;568;;972;0.08;3115;0.25;1256787
3471;Utrecht (PV);2014 mei;1256787;1212;705;4583;4056;527;4513;3986;527;;577;0.05;3692;0.29;1257364
3472;Utrecht (PV);2014 juni;1257364;1246;696;4744;4019;725;4808;4011;797;;486;0.04;4178;0.33;1257850
3473;Utrecht (PV);2014 juli;1257850;1281;729;6262;5346;916;6305;5253;1052;;509;0.04;4687;0.37;1258359
3474;Utrecht (PV);2014 augustus;1258359;1376;740;7366;6409;957;6742;5839;903;;1260;0.1;5947;0.47;1259619
3475;Utrecht (PV);2014 september;1259619;1339;716;8316;6296;2020;7145;5809;1336;;1794;0.14;7741;0.62;1261413
3476;Utrecht (PV);2014 oktober;1261413;1280;753;6267;5181;1086;5746;4940;806;;1048;0.08;8789;0.7;1262461
3477;Utrecht (PV);2014 november;1262461;1150;771;5372;4629;743;4981;4419;562;;770;0.06;9559;0.76;1263231
3478;Utrecht (PV);2014 december;1263231;1187;880;5919;5221;698;5913;5259;654;28.0;341;0.03;9900;0.79;1263572
3479;Utrecht (PV);2014;1253672;14821;9087;70317;59619;10698;66179;57154;9025;28.0;9900;0.79;9900;0.79;1263572
3480;Utrecht (PV);2015 januari;1263572;1182;897;6014;5201;813;5808;4980;828;;491;0.04;491;0.04;1264063
3481;Utrecht (PV);2015 februari;1264063;1046;874;5961;4838;1123;5435;4748;687;;698;0.06;1189;0.09;1264761
3482;Utrecht (PV);2015 maart;1264761;1147;865;5539;4824;715;5653;4858;795;;168;0.01;1357;0.11;1264929
3483;Utrecht (PV);2015 april;1264929;1086;819;5078;4413;665;4934;4343;591;;411;0.03;1768;0.14;1265340
3484;Utrecht (PV);2015 mei;1265340;1202;766;4959;4426;533;4881;4266;615;;514;0.04;2282;0.18;1265854
3485;Utrecht (PV);2015 juni;1265854;1227;730;5479;4589;890;5323;4600;723;;653;0.05;2935;0.23;1266507
3486;Utrecht (PV);2015 juli;1266507;1281;746;7141;6106;1035;7020;5970;1050;;656;0.05;3591;0.28;1267163
3487;Utrecht (PV);2015 augustus;1267163;1313;667;7912;6771;1141;7275;6176;1099;;1283;0.1;4874;0.39;1268446
3488;Utrecht (PV);2015 september;1268446;1275;723;8669;6428;2241;6603;5867;736;;2618;0.21;7492;0.59;1271064
3489;Utrecht (PV);2015 oktober;1271064;1177;811;6685;5703;982;5987;5268;719;;1064;0.08;8556;0.68;1272128
3490;Utrecht (PV);2015 november;1272128;1215;788;5959;5059;900;5419;4737;682;;967;0.08;9523;0.75;1273095
3491;Utrecht (PV);2015 december;1273095;1220;798;6240;5392;848;6142;5375;767;-2.0;518;0.04;10041;0.79;1273613
3492;Utrecht (PV);2015;1263572;14371;9484;75636;63750;11886;70480;61188;9292;-2.0;10041;0.79;10041;0.79;1273613
3493;Utrecht (PV);2016 januari;1273613;1203;837;6100;5149;951;5823;5082;741;;643;0.05;643;0.05;1274256
3494;Utrecht (PV);2016 februari;1274256;1047;851;6667;5318;1349;5737;5165;572;;1126;0.09;1769;0.14;1275382
3495;Utrecht (PV);2016 maart;1275382;1180;917;6091;5271;820;5824;5298;526;;530;0.04;2299;0.18;1275912
3496;Utrecht (PV);2016 april;1275912;1143;760;5513;4888;625;5402;4759;643;;494;0.04;2793;0.22;1276406
3497;Utrecht (PV);2016 mei;1276406;1264;772;5552;4852;700;5356;4770;586;;688;0.05;3481;0.27;1277094
3498;Utrecht (PV);2016 juni;1277094;1267;683;5812;5071;741;5739;4970;769;;657;0.05;4138;0.32;1277751
3499;Utrecht (PV);2016 juli;1277751;1305;739;7377;6433;944;7231;6378;853;;712;0.06;4850;0.38;1278463
3500;Utrecht (PV);2016 augustus;1278463;1311;741;8880;7318;1562;7900;6879;1021;;1550;0.12;6400;0.5;1280013
3501;Utrecht (PV);2016 september;1280013;1270;719;8504;6496;2008;6946;6168;778;;2109;0.16;8509;0.67;1282122
3502;Utrecht (PV);2016 oktober;1282122;1235;836;6928;5835;1093;6086;5513;573;;1241;0.1;9750;0.77;1283363
3503;Utrecht (PV);2016 november;1283363;1124;797;6487;5617;870;6049;5371;678;;765;0.06;10515;0.83;1284128
3504;Utrecht (PV);2016 december;1284128;1116;957;6585;5911;674;6385;5649;736;17.0;376;0.03;10891;0.86;1284504
3505;Utrecht (PV);2016;1273613;14465;9609;80496;68159;12337;74478;66002;8476;17.0;10891;0.86;10891;0.86;1284504
3506;Utrecht (PV);2017 januari;1284504;1256;939;6675;5862;813;6522;5556;966;;470;0.04;470;0.04;1284974
3507;Utrecht (PV);2017 februari;1284974;1043;907;6828;5647;1181;5771;5217;554;;1193;0.09;1663;0.13;1286167
3508;Utrecht (PV);2017 maart;1286167;1133;819;6323;5610;713;5836;5241;595;;801;0.06;2464;0.19;1286968
3509;Utrecht (PV);2017 april;1286968;1249;764;5350;4749;601;5165;4589;576;;670;0.05;3134;0.24;1287638
3510;Utrecht (PV);2017 mei;1287638;1242;809;5893;5177;716;5449;4831;618;;877;0.07;4011;0.31;1288515
3511;Utrecht (PV);2017 juni;1288515;1215;710;6207;5412;795;6113;5093;1020;;599;0.05;4610;0.36;1289114
3512;Utrecht (PV);2017 juli;1289114;1235;720;7579;6580;999;7383;6420;963;;711;0.06;5321;0.41;1289825
3513;Utrecht (PV);2017 augustus;1289825;1317;794;8659;7244;1415;7778;6963;815;;1404;0.11;6725;0.52;1291229
3514;Utrecht (PV);2017 september;1291229;1241;767;8701;6510;2191;6825;6063;762;;2350;0.18;9075;0.71;1293579
3515;Utrecht (PV);2017 oktober;1293579;1194;802;7042;5845;1197;6334;5592;742;;1100;0.09;10175;0.79;1294679
3516;Utrecht (PV);2017 november;1294679;1227;786;6050;5259;791;5694;5076;618;;797;0.06;10972;0.85;1295476
3517;Utrecht (PV);2017 december;1295476;1180;884;5786;5107;679;6061;5275;786;-13.0;8;0.0;10980;0.85;1295484
3518;Utrecht (PV);2017;1284504;14532;9701;81093;69002;12091;74931;65916;9015;-13.0;10980;0.85;10980;0.85;1295484
3519;Utrecht (PV);2018 januari;1295484;1217;921;6906;6022;884;6364;5426;938;;838;0.06;838;0.06;1296322
3520;Utrecht (PV);2018 februari;1296322;1021;974;6669;5349;1320;5807;5153;654;;909;0.07;1747;0.13;1297231
3521;Utrecht (PV);2018 maart;1297231;1124;1007;6575;5806;769;5950;5352;598;;742;0.06;2489;0.19;1297973
3522;Utrecht (PV);2018 april;1297973;1111;784;5645;4940;705;5439;4635;804;;533;0.04;3022;0.23;1298506
3523;Utrecht (PV);2018 mei;1298506;1205;833;5559;4784;775;5287;4585;702;;644;0.05;3666;0.28;1299150
3524;Utrecht (PV);2018 juni;1299150;1224;728;5795;4944;851;5818;4900;918;;473;0.04;4139;0.32;1299623
3525;Utrecht (PV);2018 juli;1299623;1299;763;7190;5963;1227;6899;5962;937;;827;0.06;4966;0.38;1300450
3526;Utrecht (PV);2018 augustus;1300450;1287;759;8252;6815;1437;7674;6598;1076;;1106;0.09;6072;0.47;1301556
3527;Utrecht (PV);2018 september;1301556;1298;703;7938;5767;2171;6275;5477;798;;2258;0.17;8330;0.64;1303814
3528;Utrecht (PV);2018 oktober;1303814;1281;771;7314;5890;1424;6230;5567;663;;1594;0.12;9924;0.77;1305408
3529;Utrecht (PV);2018 november;1305408;1190;744;6248;5295;953;5743;5161;582;;951;0.07;10875;0.84;1306359
3530;Utrecht (PV);2018 december;1306359;1097;882;5982;5293;689;5641;5018;623;-25.0;531;0.04;11406;0.88;1306890
3531;Utrecht (PV);2018;1295484;14354;9869;80073;66868;13205;73127;63834;9293;-25.0;11406;0.88;11406;0.88;1306890
3532;Utrecht (PV);2019 januari;1342158;1268;901;6973;5835;1138;6794;5657;1137;;546;0.04;546;0.04;1342704
3533;Utrecht (PV);2019 februari;1342704;1055;853;6646;5218;1428;5992;5165;827;;856;0.06;1402;0.1;1343560
3534;Utrecht (PV);2019 maart;1343560;1204;945;6276;5386;890;5672;5044;628;;863;0.06;2265;0.17;1344423
3535;Utrecht (PV);2019 april;1344423;1231;835;6572;5561;1011;5650;5086;564;;1318;0.1;3583;0.27;1345741
3536;Utrecht (PV);2019 mei;1345741;1204;810;6527;5669;858;5673;5081;592;;1248;0.09;4831;0.36;1346989
3537;Utrecht (PV);2019 juni;1346989;1298;780;5633;4743;890;5631;4595;1036;;520;0.04;5351;0.4;1347509
3538;Utrecht (PV);2019 juli;1347509;1313;858;7561;6304;1257;7310;6149;1161;;706;0.05;6057;0.45;1348215
3539;Utrecht (PV);2019 augustus;1348215;1381;825;8508;6749;1759;7567;6556;1011;;1497;0.11;7554;0.56;1349712
3540;Utrecht (PV);2019 september;1349712;1335;740;8362;6022;2340;6706;5884;822;;2251;0.17;9805;0.73;1351963
3541;Utrecht (PV);2019 oktober;1351963;1294;836;7121;5632;1489;5986;5251;735;;1593;0.12;11398;0.85;1353556
3542;Utrecht (PV);2019 november;1353556;1201;864;6235;5201;1034;5621;5027;594;;951;0.07;12349;0.92;1354507
3543;Utrecht (PV);2019 december;1354507;1151;929;6397;5511;886;6247;5517;730;-45.0;327;0.02;12676;0.94;1354834
3544;Utrecht (PV);2019;1342158;14935;10176;82811;67831;14980;74849;65012;9837;-45.0;12676;0.94;12676;0.94;1354834
3545;Utrecht (PV);2020 januari;1354834;1222;932;6969;5857;1112;6891;5757;1134;;368;0.03;368;0.03;1355202
3546;Utrecht (PV);2020 februari;1355202;1191;891;6936;5477;1459;5903;5237;666;;1333;0.1;1701;0.13;1356535
3547;Utrecht (PV);2020 maart;1356535;1191;1019;5991;5281;710;5876;5282;594;;287;0.02;1988;0.15;1356822
3548;Utrecht (PV);2020 april;1356822;1191;1238;5641;5134;507;5676;5212;464;;-82;-0.01;1906;0.14;1356740
3549;Utrecht (PV);2020 mei;1356740;1173;836;5749;5254;495;5753;5250;503;;333;0.02;2239;0.17;1357073
3550;Utrecht (PV);2020 juni;1357073;1227;760;6145;5538;607;6249;5483;766;;363;0.03;2602;0.19;1357436
3551;Utrecht (PV);2020 juli;1357436;1323;771;7622;6680;942;7777;6814;963;;397;0.03;2999;0.22;1357833
3552;Utrecht (PV);2020 augustus;1357833;1349;841;8594;7006;1588;7798;6889;909;;1304;0.1;4303;0.32;1359137
3553;Utrecht (PV);2020 september;1359137;1350;742;8213;6353;1860;7091;6296;795;;1730;0.13;6033;0.45;1360867
3554;Utrecht (PV);2020 oktober;1360867;1298;921;7099;6110;989;6996;6251;745;;480;0.04;6513;0.48;1361347
3555;Utrecht (PV);2020 november;1361347;1148;1024;6249;5427;822;6235;5587;648;;138;0.01;6651;0.49;1361485
3556;Utrecht (PV);2020 december;1361485;1113;1204;6337;5581;756;6542;5841;701;-36.0;-332;-0.02;6319;0.47;1361153
3557;Utrecht (PV);2020;1354834;14776;11179;81545;69698;11847;78787;69899;8888;-36.0;6319;0.47;6319;0.47;1361153
3558;Utrecht (PV);2021 januari;1361153;1196;1024;7400;6700;700;7447;6796;651;0.0;125;0.01;125;0.01;1361278
3559;Utrecht (PV);2021 februari;1361278;1146;935;6477;5686;791;6406;5794;612;0.0;282;0.02;407;0.03;1361560
3560;Utrecht (PV);2021 maart;1361560;1291;904;7479;6722;757;7418;6748;670;0.0;448;0.03;855;0.06;1362008
3561;Utrecht (PV);2021 april;1362008;1286;924;6652;5964;688;6654;6071;583;0.0;360;0.03;1215;0.09;1362368
3562;Utrecht (PV);2021 mei;1362368;1271;871;6041;5427;614;5969;5377;592;0.0;472;0.03;1687;0.12;1362840
3563;Utrecht (PV);2021 juni;1362840;1354;813;5952;5190;762;6050;5277;773;0.0;443;0.03;2130;0.16;1363283
3564;Utrecht (PV);2021 juli;1363283;1401;831;7439;6333;1106;7416;6509;907;0.0;593;0.04;2723;0.2;1363876
3565;Utrecht (PV);2021 augustus;1363876;1394;851;8499;6686;1813;7551;6620;931;0.0;1491;0.11;4214;0.31;1365367
3566;Utrecht (PV);2021 september;1365367;1407;896;8318;5929;2389;6663;5916;747;0.0;2166;0.16;6380;0.47;1367533
3567;Utrecht (PV);2021 oktober;1367533;1432;932;7300;5615;1685;6302;5669;633;0.0;1498;0.11;7878;0.58;1369031
3568;Utrecht (PV);2021 november;1369031;1331;1130;6570;5395;1175;5922;5320;602;0.0;849;0.06;8727;0.64;1369880
3569;Utrecht (PV);2021 december;1369880;1275;1212;6600;5812;788;6630;5895;735;-40.0;-7;0.0;8720;0.64;1369873
3570;Utrecht (PV);2021;1361153;15784;11323;84727;71459;13268;80428;71992;8436;-40.0;8720;0.64;8720;0.64;1369873
3571;Utrecht (PV);2022 januari;1369873;1197;974;7080;5903;1177;6453;5626;827;;850;0.06;850;0.06;1370723
3572;Utrecht (PV);2022 februari;1370723;1054;903;6914;5506;1408;5906;5318;588;;1159;0.08;2009;0.15;1371882
3573;Utrecht (PV);2022 maart;1371882;1168;1005;8300;5453;2847;5899;5283;616;;2564;0.19;4573;0.33;1374446
3574;Utrecht (PV);2022 april;1374446;1068;955;8506;5722;2784;6231;5640;591;;2388;0.17;6961;0.51;1376834
3575;Utrecht (PV);2022 mei;1376834;1169;869;7730;5692;2038;6086;5446;640;;1944;0.14;8905;0.65;1378778
3576;Utrecht (PV);2022 juni;1378778;1216;892;6737;5371;1366;6130;5113;1017;;931;0.07;9836;0.72;1379709
3577;Utrecht (PV);2022 juli;1379709;1275;891;7669;6152;1517;7270;6040;1230;;783;0.06;10619;0.78;1380492
3578;Utrecht (PV);2022 augustus;1380492;1298;871;9212;6787;2425;7842;6704;1138;;1797;0.13;12416;0.91;1382289
3579;Utrecht (PV);2022 september;1382289;1214;848;9178;6472;2706;7233;6158;1075;;2311;0.17;14727;1.08;1384600
3580;Utrecht (PV);2022 oktober;1384600;1258;1001;7988;6132;1856;6837;5908;929;;1408;0.1;16135;1.18;1386008
3581;Utrecht (PV);2022 november;1386008;1176;1016;7291;5954;1337;6203;5466;737;;1248;0.09;17383;1.27;1387256
3582;Utrecht (PV);2022 december;1387256;1136;1236;7294;6198;1096;6778;5883;895;-29.0;387;0.03;17770;1.3;1387643
3583;Utrecht (PV);2022;1369873;14229;11461;93899;71342;22557;78868;68585;10283;-29.0;17770;1.3;17770;1.3;1387643
3584;Utrecht (PV);2023 januari;1387643;1148;1117;7602;6346;1256;7094;6054;1040;0.0;539;0.04;539;0.04;1388182
3585;Utrecht (PV);2023 februari;1388182;1027;935;7130;5715;1415;6179;5351;828;0.0;1043;0.08;1582;0.11;1389225
3586;Utrecht (PV);2023 maart;1389225;1171;1066;7531;6291;1240;6633;5855;778;0.0;1003;0.07;2585;0.19;1390228
3587;Utrecht (PV);2023 april;1390228;1073;905;6327;5293;1034;5858;5285;573;0.0;637;0.05;3222;0.23;1390865
3588;Utrecht (PV);2023 mei;1390865;1259;886;6810;5669;1141;6006;5281;725;0.0;1177;0.08;4399;0.32;1392042
3589;Utrecht (PV);2023 juni;1392042;1218;926;7216;6207;1009;6784;5749;1035;0.0;724;0.05;5123;0.37;1392766
3590;Utrecht (PV);2023 juli;1392766;1262;869;8336;7053;1283;7832;6594;1238;0.0;897;0.06;6020;0.43;1393663
3591;Utrecht (PV);2023 augustus;1393663;1291;862;9873;7761;2112;8407;7174;1233;0.0;1895;0.14;7915;0.57;1395558
3592;Utrecht (PV);2023 september;1395558;1122;891;9310;6762;2548;7356;6276;1080;0.0;2185;0.16;10100;0.73;1397743
3593;Utrecht (PV);2023 oktober;1397743;1200;1006;8013;6325;1688;6868;5945;923;0.0;1339;0.1;11439;0.82;1399082
3594;Utrecht (PV);2023 november;1399082;1172;1041;6765;5634;1131;6224;5425;799;0.0;672;0.05;12111;0.87;1399754
3595;Utrecht (PV);2023 december;1399754;1127;1053;6835;5790;1045;6584;5581;1003;-22.0;303;0.02;12414;0.89;1400057
3596;Utrecht (PV);2023;1387643;14070;11557;91748;74846;16902;81825;70570;11255;-22.0;12414;0.89;12414;0.89;1400057
3597;Utrecht (PV);2024 januari;1400057;1218;1128;6880;5754;1126;6671;5669;1002;;299;0.02;299;0.02;1400356
3598;Utrecht (PV);2024 februari;1400356;1173;970;7133;5705;1428;6049;5256;793;;1287;0.09;1586;0.11;1401643
3599;Utrecht (PV);2024 maart;1401643;1136;1062;6575;5588;987;6110;5360;750;;539;0.04;2125;0.15;1402182
3600;Utrecht (PV);2024 april;1402182;1183;957;6285;5378;907;5772;5074;698;;739;0.05;2864;0.2;1402921
3601;Utrecht (PV);2024 mei;1402921;1261;945;6241;5371;870;5919;5183;736;;638;0.05;3502;0.25;1403559
3602;Utrecht (PV);2024 juni;1403559;1246;912;5775;4936;839;5769;4861;908;;340;0.02;3842;0.27;1403899
3603;Utrecht (PV);2024 juli;1403899;1276;904;7274;6054;1220;7496;6100;1396;;150;0.01;3992;0.29;1404049
3604;Utrecht (PV);2024 augustus;1404049;1297;849;8549;6658;1891;7824;6620;1204;;1173;0.08;5165;0.37;1405222
3605;Utrecht (PV);2024 september;1405222;1270;891;8364;6191;2173;6976;6004;972;;1767;0.13;6932;0.5;1406989
3606;Utrecht (PV);2024 oktober;1406989;1219;946;7904;6414;1490;6984;6103;881;;1193;0.08;8125;0.58;1408182
3607;Utrecht (PV);2024 november;1408182;1178;957;6813;5937;876;6401;5617;784;;633;0.04;8758;0.63;1408815
3608;Utrecht (PV);2024 december;1408815;1121;1021;6726;6028;698;6763;5756;1007;0.0;63;0.0;8821;0.63;1408878
3609;Utrecht (PV);2024;1400057;14578;11542;84519;70014;14505;78734;67603;11131;0.0;8821;0.63;8821;0.63;1408878
3610;Utrecht (PV);2025 januari;1408878;1171;1140;7618;6631;987;7076;6000;1076;;573;0.04;573;0.04;1409451
3611;Utrecht (PV);2025 februari;1409451;1096;1057;7241;5933;1308;6166;5366;800;;1114;0.08;1687;0.12;1410565
3612;Noord-Holland (PV);2002 januari;2559477;2711;2149;11485;9091;2394;10747;9464;1283;;1300;0.05;1300;0.05;2560777
3613;Noord-Holland (PV);2002 februari;2560777;2464;1793;9727;7743;1984;9390;8021;1369;;1008;0.04;2308;0.09;2561785
3614;Noord-Holland (PV);2002 maart;2561785;2766;2014;10010;7944;2066;9719;8310;1409;;1043;0.04;3351;0.13;2562828
3615;Noord-Holland (PV);2002 april;2562828;2578;1849;9528;7592;1936;9267;7813;1454;;990;0.04;4341;0.17;2563818
3616;Noord-Holland (PV);2002 mei;2563818;2744;1808;9873;7862;2011;10130;8347;1783;;679;0.03;5020;0.2;2564497
3617;Noord-Holland (PV);2002 juni;2564497;2668;1734;9413;7503;1910;9874;7892;1982;;473;0.02;5493;0.21;2564970
3618;Noord-Holland (PV);2002 juli;2564970;2970;1891;12167;9411;2756;11542;9823;1719;;1704;0.07;7197;0.28;2566674
3619;Noord-Holland (PV);2002 augustus;2566674;2933;1855;12367;9389;2978;11577;9812;1765;;1868;0.07;9065;0.35;2568542
3620;Noord-Holland (PV);2002 september;2568542;2841;1716;11231;8735;2496;10741;9043;1698;;1615;0.06;10680;0.42;2570157
3621;Noord-Holland (PV);2002 oktober;2570157;2890;1788;11232;8816;2416;10828;9107;1721;;1506;0.06;12186;0.48;2571663
3622;Noord-Holland (PV);2002 november;2571663;2541;1828;9670;7987;1683;9276;8119;1157;;1107;0.04;13293;0.52;2572770
3623;Noord-Holland (PV);2002 december;2572770;2665;2078;9108;7736;1372;9652;8201;1451;307.0;350;0.01;13643;0.53;2573120
3624;Noord-Holland (PV);2002;2559477;32771;22503;125811;99809;26002;122743;103952;18791;307.0;13643;0.53;13643;0.53;2573120
3625;Noord-Holland (PV);2003 januari;2573120;2705;2090;11069;8944;2125;10800;9042;1758;;884;0.03;884;0.03;2574004
3626;Noord-Holland (PV);2003 februari;2574004;2515;1749;9261;7449;1812;8631;7388;1243;;1396;0.05;2280;0.09;2575400
3627;Noord-Holland (PV);2003 maart;2575400;2719;2036;9718;7829;1889;9628;8025;1603;;773;0.03;3053;0.12;2576173
3628;Noord-Holland (PV);2003 april;2576173;2891;1927;9282;7573;1709;9185;7629;1556;;1061;0.04;4114;0.16;2577234
3629;Noord-Holland (PV);2003 mei;2577234;2689;1782;8786;7314;1472;8855;7515;1340;;838;0.03;4952;0.19;2578072
3630;Noord-Holland (PV);2003 juni;2578072;2684;1750;9339;7632;1707;9943;7899;2044;;330;0.01;5282;0.21;2578402
3631;Noord-Holland (PV);2003 juli;2578402;2960;1787;11267;9085;2182;11260;9474;1786;;1180;0.05;6462;0.25;2579582
3632;Noord-Holland (PV);2003 augustus;2579582;2876;1711;11560;9081;2479;11122;9215;1907;;1603;0.06;8065;0.31;2581185
3633;Noord-Holland (PV);2003 september;2581185;2902;1720;11226;8935;2291;10571;8889;1682;;1837;0.07;9902;0.38;2583022
3634;Noord-Holland (PV);2003 oktober;2583022;2817;1842;11053;9112;1941;10613;8906;1707;;1415;0.05;11317;0.44;2584437
3635;Noord-Holland (PV);2003 november;2584437;2633;1833;9547;8088;1459;9654;8092;1562;;693;0.03;12010;0.47;2585130
3636;Noord-Holland (PV);2003 december;2585130;2486;2178;10181;8961;1220;10720;9042;1678;2366.0;2135;0.08;14145;0.55;2587265
3637;Noord-Holland (PV);2003;2573120;32877;22405;122289;100003;22286;120982;101116;19866;2366.0;14145;0.55;14145;0.55;2587265
3638;Noord-Holland (PV);2004 januari;2587265;2690;2166;10376;8511;1865;10172;8523;1649;;728;0.03;728;0.03;2587993
3639;Noord-Holland (PV);2004 februari;2587993;2456;1797;9433;7848;1585;9856;8005;1851;;236;0.01;964;0.04;2588229
3640;Noord-Holland (PV);2004 maart;2588229;2792;1917;10363;8655;1708;10587;8752;1835;;651;0.03;1615;0.06;2588880
3641;Noord-Holland (PV);2004 april;2588880;2587;1794;8898;7569;1329;9509;7577;1932;;182;0.01;1797;0.07;2589062
3642;Noord-Holland (PV);2004 mei;2589062;2706;1721;8652;7076;1576;8731;7101;1630;;906;0.03;2703;0.1;2589968
3643;Noord-Holland (PV);2004 juni;2589968;2734;1626;10166;8412;1754;10220;8299;1921;;1054;0.04;3757;0.15;2591022
3644;Noord-Holland (PV);2004 juli;2591022;2840;1704;11697;9788;1909;12365;9714;2651;;468;0.02;4225;0.16;2591490
3645;Noord-Holland (PV);2004 augustus;2591490;2871;1752;12240;9892;2348;12347;9742;2605;;1012;0.04;5237;0.2;2592502
3646;Noord-Holland (PV);2004 september;2592502;2669;1665;11963;9362;2601;10716;9101;1615;;2251;0.09;7488;0.29;2594753
3647;Noord-Holland (PV);2004 oktober;2594753;2711;1710;10332;8535;1797;10142;8561;1581;;1191;0.05;8679;0.34;2595944
3648;Noord-Holland (PV);2004 november;2595944;2554;1734;9891;8353;1538;9482;8282;1200;;1229;0.05;9908;0.38;2597173
3649;Noord-Holland (PV);2004 december;2597173;2660;1876;10325;8916;1409;10449;8928;1521;1270.0;1930;0.07;11838;0.46;2599103
3650;Noord-Holland (PV);2004;2587265;32270;21462;124336;102917;21419;124576;102585;21991;1270.0;11838;0.46;11838;0.46;2599103
3651;Noord-Holland (PV);2005 januari;2599103;2585;2057;10145;8523;1622;10178;8659;1519;;495;0.02;495;0.02;2599598
3652;Noord-Holland (PV);2005 februari;2599598;2489;1850;9633;8092;1541;10088;8070;2018;;184;0.01;679;0.03;2599782
3653;Noord-Holland (PV);2005 maart;2599782;2658;2178;10048;8427;1621;10399;8471;1928;;129;0.0;808;0.03;2599911
3654;Noord-Holland (PV);2005 april;2599911;2693;1803;9321;7861;1460;10110;8071;2039;;101;0.0;909;0.03;2600012
3655;Noord-Holland (PV);2005 mei;2600012;2727;1828;8651;7334;1317;9214;7537;1677;;336;0.01;1245;0.05;2600348
3656;Noord-Holland (PV);2005 juni;2600348;2535;1665;9957;8407;1550;10463;8412;2051;;364;0.01;1609;0.06;2600712
3657;Noord-Holland (PV);2005 juli;2600712;2773;1623;11261;9464;1797;11955;9438;2517;;456;0.02;2065;0.08;2601168
3658;Noord-Holland (PV);2005 augustus;2601168;2826;1607;12787;10625;2162;12975;10643;2332;;1031;0.04;3096;0.12;2602199
3659;Noord-Holland (PV);2005 september;2602199;2693;1587;13522;10694;2828;12560;10290;2270;;2068;0.08;5164;0.2;2604267
3660;Noord-Holland (PV);2005 oktober;2604267;2677;1689;11679;9689;1990;11841;9251;2590;;826;0.03;5990;0.23;2605093
3661;Noord-Holland (PV);2005 november;2605093;2546;1751;10911;9198;1713;11182;9062;2120;;524;0.02;6514;0.25;2605617
3662;Noord-Holland (PV);2005 december;2605617;2504;1900;10842;9332;1510;11730;9060;2670;1251.0;967;0.04;7481;0.29;2606584
3663;Noord-Holland (PV);2005;2599103;31706;21538;128757;107646;21111;132695;106964;25731;1251.0;7481;0.29;7481;0.29;2606584
3664;Noord-Holland (PV);2006 januari;2606584;2571;1872;11248;9591;1657;11479;9330;2149;;468;0.02;468;0.02;2607052
3665;Noord-Holland (PV);2006 februari;2607052;2344;1830;10801;8843;1958;10640;8396;2244;;675;0.03;1143;0.04;2607727
3666;Noord-Holland (PV);2006 maart;2607727;2615;2060;11274;9399;1875;12117;9155;2962;;-288;-0.01;855;0.03;2607439
3667;Noord-Holland (PV);2006 april;2607439;2349;1797;9357;7814;1543;10132;7710;2422;;-223;-0.01;632;0.02;2607216
3668;Noord-Holland (PV);2006 mei;2607216;2563;1700;10178;8462;1716;11543;8302;3241;;-502;-0.02;130;0.0;2606714
3669;Noord-Holland (PV);2006 juni;2606714;2531;1652;10339;8582;1757;10500;8351;2149;;718;0.03;848;0.03;2607432
3670;Noord-Holland (PV);2006 juli;2607432;2580;1859;11190;9164;2026;11819;9146;2673;;92;0.0;940;0.04;2607524
3671;Noord-Holland (PV);2006 augustus;2607524;2635;1584;13092;10730;2362;13311;10811;2500;;832;0.03;1772;0.07;2608356
3672;Noord-Holland (PV);2006 september;2608356;2601;1607;13335;10291;3044;12291;9914;2377;;2038;0.08;3810;0.15;2610394
3673;Noord-Holland (PV);2006 oktober;2610394;2726;1582;11756;9610;2146;11941;9302;2639;;959;0.04;4769;0.18;2611353
3674;Noord-Holland (PV);2006 november;2611353;2422;1661;10949;9157;1792;11281;8940;2341;;429;0.02;5198;0.2;2611782
3675;Noord-Holland (PV);2006 december;2611782;2519;1865;9873;8377;1496;10523;8431;2092;1284.0;1288;0.05;6486;0.25;2613070
3676;Noord-Holland (PV);2006;2606584;30456;21069;133392;110020;23372;137577;107788;29789;1284.0;6486;0.25;6486;0.25;2613070
3677;Noord-Holland (PV);2007 januari;2613070;2393;1913;12222;9748;2474;11850;9647;2203;;852;0.03;852;0.03;2613922
3678;Noord-Holland (PV);2007 februari;2613922;2389;1658;10803;8611;2192;9876;8302;1574;;1658;0.06;2510;0.1;2615580
3679;Noord-Holland (PV);2007 maart;2615580;2586;1818;10581;8707;1874;10590;8424;2166;;759;0.03;3269;0.13;2616339
3680;Noord-Holland (PV);2007 april;2616339;2422;1735;9477;7711;1766;9230;7629;1601;;934;0.04;4203;0.16;2617273
3681;Noord-Holland (PV);2007 mei;2617273;2546;1752;10181;8113;2068;10112;8138;1974;;863;0.03;5066;0.19;2618136
3682;Noord-Holland (PV);2007 juni;2618136;2458;1662;10474;8373;2101;10877;8441;2436;;393;0.02;5459;0.21;2618529
3683;Noord-Holland (PV);2007 juli;2618529;2666;1655;12847;10177;2670;13618;10173;3445;;240;0.01;5699;0.22;2618769
3684;Noord-Holland (PV);2007 augustus;2618769;2773;1653;14107;11176;2931;13736;10904;2832;;1491;0.06;7190;0.28;2620260
3685;Noord-Holland (PV);2007 september;2620260;2714;1614;12802;9415;3387;11309;9090;2219;;2593;0.1;9783;0.37;2622853
3686;Noord-Holland (PV);2007 oktober;2622853;2711;1801;12653;10014;2639;12508;9598;2910;;1055;0.04;10838;0.41;2623908
3687;Noord-Holland (PV);2007 november;2623908;2431;1748;11291;9022;2269;11284;8822;2462;;690;0.03;11528;0.44;2624598
3688;Noord-Holland (PV);2007 december;2624598;2421;2015;10054;8329;1725;9931;8185;1746;1036.0;1565;0.06;13093;0.5;2626163
3689;Noord-Holland (PV);2007;2613070;30510;21024;137492;109396;28096;134921;107353;27568;1036.0;13093;0.5;13093;0.5;2626163
3690;Noord-Holland (PV);2008 januari;2626163;2477;2001;12979;10316;2663;12172;9922;2250;;1283;0.05;1283;0.05;2627446
3691;Noord-Holland (PV);2008 februari;2627446;2303;1780;11838;8941;2897;10414;8437;1977;;1947;0.07;3230;0.12;2629393
3692;Noord-Holland (PV);2008 maart;2629393;2487;1836;10584;8373;2211;10168;7953;2215;;1067;0.04;4297;0.16;2630460
3693;Noord-Holland (PV);2008 april;2630460;2462;1817;11202;8627;2575;10486;8336;2150;;1361;0.05;5658;0.22;2631821
3694;Noord-Holland (PV);2008 mei;2631821;2569;1774;10253;7983;2270;9553;7688;1865;;1495;0.06;7153;0.27;2633316
3695;Noord-Holland (PV);2008 juni;2633316;2562;1631;11347;8701;2646;10855;8603;2252;;1423;0.05;8576;0.33;2634739
3696;Noord-Holland (PV);2008 juli;2634739;2842;1749;13475;10216;3259;13462;10208;3254;;1106;0.04;9682;0.37;2635845
3697;Noord-Holland (PV);2008 augustus;2635845;2752;1686;14036;10541;3495;13094;10347;2747;;2008;0.08;11690;0.45;2637853
3698;Noord-Holland (PV);2008 september;2637853;2749;1629;14891;10304;4587;12258;9871;2387;;3753;0.14;15443;0.59;2641606
3699;Noord-Holland (PV);2008 oktober;2641606;2689;1751;13252;10085;3167;11634;9339;2295;;2556;0.1;17999;0.69;2644162
3700;Noord-Holland (PV);2008 november;2644162;2441;1671;11042;8483;2559;10523;8027;2496;;1289;0.05;19288;0.73;2645451
3701;Noord-Holland (PV);2008 december;2645451;2512;1974;11135;8889;2246;11705;8784;2921;1026.0;994;0.04;20282;0.77;2646445
3702;Noord-Holland (PV);2008;2626163;30845;21299;146034;111459;34575;136324;107515;28809;1026.0;20282;0.77;20282;0.77;2646445
3703;Noord-Holland (PV);2009 januari;2646445;2524;2291;12087;9037;3050;11247;8733;2514;;1073;0.04;1073;0.04;2647518
3704;Noord-Holland (PV);2009 februari;2647518;2348;1790;10921;8283;2638;9361;7906;1455;;2118;0.08;3191;0.12;2649636
3705;Noord-Holland (PV);2009 maart;2649636;2630;1748;11203;8622;2581;10183;8142;2041;;1902;0.07;5093;0.19;2651538
3706;Noord-Holland (PV);2009 april;2651538;2547;1707;9890;7354;2536;9628;7102;2526;;1102;0.04;6195;0.23;2652640
3707;Noord-Holland (PV);2009 mei;2652640;2655;1643;9368;7102;2266;8556;6955;1601;;1824;0.07;8019;0.3;2654464
3708;Noord-Holland (PV);2009 juni;2654464;2666;1583;10503;7979;2524;9833;7883;1950;;1753;0.07;9772;0.37;2656217
3709;Noord-Holland (PV);2009 juli;2656217;2736;1658;12223;9428;2795;11529;9318;2211;;1772;0.07;11544;0.44;2657989
3710;Noord-Holland (PV);2009 augustus;2657989;2737;1564;13772;9877;3895;12549;9235;3314;;2396;0.09;13940;0.53;2660385
3711;Noord-Holland (PV);2009 september;2660385;2766;1616;14089;9674;4415;11621;9239;2382;;3618;0.14;17558;0.66;2664003
3712;Noord-Holland (PV);2009 oktober;2664003;2596;1672;12011;9136;2875;11368;8485;2883;;1567;0.06;19125;0.72;2665570
3713;Noord-Holland (PV);2009 november;2665570;2578;1697;10515;8236;2279;9645;7919;1726;;1751;0.07;20876;0.79;2667321
3714;Noord-Holland (PV);2009 december;2667321;2572;1879;10698;8550;2148;10802;8289;2513;1174.0;1763;0.07;22639;0.86;2669084
3715;Noord-Holland (PV);2009;2646445;31355;20848;137280;103278;34002;126322;99206;27116;1174.0;22639;0.86;22639;0.86;2669084
3716;Noord-Holland (PV);2010 januari;2669084;2593;1992;11418;8559;2859;10675;8097;2578;;1344;0.05;1344;0.05;2670428
3717;Noord-Holland (PV);2010 februari;2670428;2337;1762;10921;8376;2545;9444;7789;1655;;2052;0.08;3396;0.13;2672480
3718;Noord-Holland (PV);2010 maart;2672480;2545;1814;11579;8807;2772;11250;8444;2806;;1060;0.04;4456;0.17;2673540
3719;Noord-Holland (PV);2010 april;2673540;2613;1642;9783;7477;2306;8735;6983;1752;;2019;0.08;6475;0.24;2675559
3720;Noord-Holland (PV);2010 mei;2675559;2570;1658;9153;7103;2050;8877;6948;1929;;1188;0.04;7663;0.29;2676747
3721;Noord-Holland (PV);2010 juni;2676747;2702;1691;10583;7950;2633;9909;7685;2224;;1685;0.06;9348;0.35;2678432
3722;Noord-Holland (PV);2010 juli;2678432;2821;1721;11893;9086;2807;11344;8773;2571;;1649;0.06;10997;0.41;2680081
3723;Noord-Holland (PV);2010 augustus;2680081;2752;1558;15308;10538;4770;12613;9735;2878;;3889;0.15;14886;0.56;2683970
3724;Noord-Holland (PV);2010 september;2683970;2790;1687;14145;9851;4294;11559;8834;2725;;3689;0.14;18575;0.7;2687659
3725;Noord-Holland (PV);2010 oktober;2687659;2697;1811;11482;8587;2895;10395;7952;2443;;1973;0.07;20548;0.77;2689632
3726;Noord-Holland (PV);2010 november;2689632;2575;1701;11146;8394;2752;10605;7793;2812;;1415;0.05;21963;0.82;2691047
3727;Noord-Holland (PV);2010 december;2691047;2598;1937;10660;8372;2288;10783;8150;2633;-108.0;430;0.02;22393;0.84;2691477
3728;Noord-Holland (PV);2010;2669084;31593;20974;138071;103100;34971;126189;97183;29006;-108.0;22393;0.84;22393;0.84;2691477
3729;Noord-Holland (PV);2011 januari;2691477;2607;1898;11691;8654;3037;10478;8191;2287;;1922;0.07;1922;0.07;2693399
3730;Noord-Holland (PV);2011 februari;2693399;2301;1675;10667;8071;2596;9390;7571;1819;;1903;0.07;3825;0.14;2695302
3731;Noord-Holland (PV);2011 maart;2695302;2523;1834;11215;8418;2797;10316;8057;2259;;1588;0.06;5413;0.2;2696890
3732;Noord-Holland (PV);2011 april;2696890;2461;1780;9825;7475;2350;10018;7095;2923;;488;0.02;5901;0.22;2697378
3733;Noord-Holland (PV);2011 mei;2697378;2528;1732;10194;7630;2564;9297;7309;1988;;1693;0.06;7594;0.28;2699071
3734;Noord-Holland (PV);2011 juni;2699071;2527;1627;10205;7457;2748;9967;7375;2592;;1138;0.04;8732;0.32;2700209
3735;Noord-Holland (PV);2011 juli;2700209;2600;1741;12333;9020;3313;12231;8754;3477;;961;0.04;9693;0.36;2701170
3736;Noord-Holland (PV);2011 augustus;2701170;2676;1660;15491;10510;4981;13943;9907;4036;;2564;0.09;12257;0.46;2703734
3737;Noord-Holland (PV);2011 september;2703734;2638;1722;14130;9947;4183;12844;9444;3400;;2202;0.08;14459;0.54;2705936
3738;Noord-Holland (PV);2011 oktober;2705936;2604;1834;11326;8368;2958;10295;7933;2362;;1801;0.07;16260;0.6;2707737
3739;Noord-Holland (PV);2011 november;2707737;2449;1693;11551;8627;2924;10619;8216;2403;;1688;0.06;17948;0.67;2709425
3740;Noord-Holland (PV);2011 december;2709425;2422;1905;10802;8558;2244;11217;8409;2808;309.0;411;0.02;18359;0.68;2709836
3741;Noord-Holland (PV);2011;2691477;30336;21101;139430;102735;36695;130615;98261;32354;309.0;18359;0.68;18359;0.68;2709836
3742;Noord-Holland (PV);2012 januari;2709822;2474;1949;12321;9413;2908;12571;8932;3639;;275;0.01;275;0.01;2710097
3743;Noord-Holland (PV);2012 februari;2710097;2272;1935;11630;8583;3047;10257;8109;2148;;1710;0.06;1985;0.07;2711807
3744;Noord-Holland (PV);2012 maart;2711807;2449;1938;11215;8770;2445;11069;8376;2693;;657;0.02;2642;0.1;2712464
3745;Noord-Holland (PV);2012 april;2712464;2388;1899;9645;7369;2276;9011;6965;2046;;1123;0.04;3765;0.14;2713587
3746;Noord-Holland (PV);2012 mei;2713587;2588;1810;10039;7644;2395;9736;7341;2395;;1081;0.04;4846;0.18;2714668
3747;Noord-Holland (PV);2012 juni;2714668;2490;1777;11044;8555;2489;11743;8607;3136;;14;0.0;4860;0.18;2714682
3748;Noord-Holland (PV);2012 juli;2714682;2576;1742;12901;9714;3187;13133;9130;4003;;602;0.02;5462;0.2;2715284
3749;Noord-Holland (PV);2012 augustus;2715284;2605;1703;15827;10830;4997;13512;10128;3384;;3217;0.12;8679;0.32;2718501
3750;Noord-Holland (PV);2012 september;2718501;2542;1703;13870;9719;4151;11563;8918;2645;;3146;0.12;11825;0.44;2721647
3751;Noord-Holland (PV);2012 oktober;2721647;2590;1826;12297;9006;3291;11108;8609;2499;;1953;0.07;13778;0.51;2723600
3752;Noord-Holland (PV);2012 november;2723600;2486;1804;11117;8382;2735;10647;7966;2681;;1152;0.04;14930;0.55;2724752
3753;Noord-Holland (PV);2012 december;2724752;2331;2032;10369;8402;1967;11166;8081;3085;46.0;-452;-0.02;14478;0.53;2724300
3754;Noord-Holland (PV);2012;2709822;29791;22118;142275;106387;35888;135516;101162;34354;46.0;14478;0.53;14478;0.53;2724300
3755;Noord-Holland (PV);2013 januari;2724300;2425;2062;12514;9283;3231;11517;8763;2754;;1360;0.05;1360;0.05;2725660
3756;Noord-Holland (PV);2013 februari;2725660;2155;1917;11249;8458;2791;10453;7956;2497;;1034;0.04;2394;0.09;2726694
3757;Noord-Holland (PV);2013 maart;2726694;2451;2088;10779;8288;2491;10369;7756;2613;;773;0.03;3167;0.12;2727467
3758;Noord-Holland (PV);2013 april;2727467;2333;1876;10092;7671;2421;10012;7211;2801;;537;0.02;3704;0.14;2728004
3759;Noord-Holland (PV);2013 mei;2728004;2467;1811;10272;7668;2604;9599;7250;2349;;1329;0.05;5033;0.18;2729333
3760;Noord-Holland (PV);2013 juni;2729333;2471;1731;9879;7392;2487;9617;7230;2387;;1002;0.04;6035;0.22;2730335
3761;Noord-Holland (PV);2013 juli;2730335;2655;1793;13143;9894;3249;13154;9426;3728;;851;0.03;6886;0.25;2731186
3762;Noord-Holland (PV);2013 augustus;2731186;2675;1736;16295;11118;5177;13560;10298;3262;;3674;0.13;10560;0.39;2734860
3763;Noord-Holland (PV);2013 september;2734860;2597;1647;15240;10917;4323;12966;9872;3094;;3224;0.12;13784;0.51;2738084
3764;Noord-Holland (PV);2013 oktober;2738084;2461;1789;12518;9416;3102;11446;8897;2549;;1744;0.06;15528;0.57;2739828
3765;Noord-Holland (PV);2013 november;2739828;2289;1744;11048;8509;2539;10670;8102;2568;;923;0.03;16451;0.6;2740751
3766;Noord-Holland (PV);2013 december;2740751;2333;1832;11163;8841;2322;11234;8583;2651;188.0;618;0.02;17069;0.63;2741369
3767;Noord-Holland (PV);2013;2724300;29312;22026;144192;107455;36737;134597;101344;33253;188.0;17069;0.63;17069;0.63;2741369
3768;Noord-Holland (PV);2014 januari;2741369;2448;1926;13891;10073;3818;12486;9735;2751;;1927;0.07;1927;0.07;2743296
3769;Noord-Holland (PV);2014 februari;2743296;2265;1742;12294;9161;3133;10782;8632;2150;;2035;0.07;3962;0.14;2745331
3770;Noord-Holland (PV);2014 maart;2745331;2546;1869;11880;8842;3038;11032;8592;2440;;1525;0.06;5487;0.2;2746856
3771;Noord-Holland (PV);2014 april;2746856;2327;1688;11544;8615;2929;10702;8267;2435;;1481;0.05;6968;0.25;2748337
3772;Noord-Holland (PV);2014 mei;2748337;2462;1784;10751;8084;2667;10451;7894;2557;;978;0.04;7946;0.29;2749315
3773;Noord-Holland (PV);2014 juni;2749315;2448;1682;11670;8740;2930;11446;8620;2826;;990;0.04;8936;0.33;2750305
3774;Noord-Holland (PV);2014 juli;2750305;2666;1818;13844;10347;3497;14198;10455;3743;;494;0.02;9430;0.34;2750799
3775;Noord-Holland (PV);2014 augustus;2750799;2677;1720;17378;11625;5753;14669;11044;3625;;3666;0.13;13096;0.48;2754465
3776;Noord-Holland (PV);2014 september;2754465;2662;1696;16146;11205;4941;14217;10664;3553;;2895;0.11;15991;0.58;2757360
3777;Noord-Holland (PV);2014 oktober;2757360;2629;1791;14045;10316;3729;12624;9816;2808;;2259;0.08;18250;0.67;2759619
3778;Noord-Holland (PV);2014 november;2759619;2420;1785;12168;9018;3150;11024;8681;2343;;1779;0.06;20029;0.73;2761398
3779;Noord-Holland (PV);2014 december;2761398;2409;2116;13548;10568;2980;13422;10295;3127;112.0;531;0.02;20560;0.75;2761929
3780;Noord-Holland (PV);2014;2741369;29959;21617;159159;116594;42565;147053;112695;34358;112.0;20560;0.75;20560;0.75;2761929
3781;Noord-Holland (PV);2015 januari;2761929;2443;2343;14676;10589;4087;13359;10096;3263;;1417;0.05;1417;0.05;2763346
3782;Noord-Holland (PV);2015 februari;2763346;2170;1984;12618;9621;2997;11284;9239;2045;;1520;0.06;2937;0.11;2764866
3783;Noord-Holland (PV);2015 maart;2764866;2377;2078;13630;10561;3069;12283;9819;2464;;1646;0.06;4583;0.17;2766512
3784;Noord-Holland (PV);2015 april;2766512;2268;1877;12251;8982;3269;11075;8674;2401;;1567;0.06;6150;0.22;2768079
3785;Noord-Holland (PV);2015 mei;2768079;2410;1880;11054;8676;2378;10515;8438;2077;;1069;0.04;7219;0.26;2769148
3786;Noord-Holland (PV);2015 juni;2769148;2441;1783;13096;9824;3272;12572;9530;3042;;1182;0.04;8401;0.3;2770330
3787;Noord-Holland (PV);2015 juli;2770330;2722;1812;15902;11880;4022;15711;11736;3975;;1101;0.04;9502;0.34;2771431
3788;Noord-Holland (PV);2015 augustus;2771431;2714;1806;18841;12559;6282;16410;12071;4339;;3339;0.12;12841;0.46;2774770
3789;Noord-Holland (PV);2015 september;2774770;2713;1785;17809;12158;5651;15044;11530;3514;;3693;0.13;16534;0.6;2778463
3790;Noord-Holland (PV);2015 oktober;2778463;2523;1912;15205;10992;4213;13298;10722;2576;;2518;0.09;19052;0.69;2780981
3791;Noord-Holland (PV);2015 november;2780981;2332;1794;13857;10080;3777;11839;9702;2137;;2556;0.09;21608;0.78;2783537
3792;Noord-Holland (PV);2015 december;2783537;2396;1978;14453;11101;3352;13610;11014;2596;56.0;1317;0.05;22925;0.83;2784854
3793;Noord-Holland (PV);2015;2761929;29509;23032;173392;127023;46369;157000;122571;34429;56.0;22925;0.83;22925;0.83;2784854
3794;Noord-Holland (PV);2016 januari;2784854;2460;2146;15021;10634;4387;13354;10269;3085;;1981;0.07;1981;0.07;2786835
3795;Noord-Holland (PV);2016 februari;2786835;2317;2080;14816;11126;3690;12996;10685;2311;;2057;0.07;4038;0.14;2788892
3796;Noord-Holland (PV);2016 maart;2788892;2449;2040;14188;10628;3560;12759;10198;2561;;1838;0.07;5876;0.21;2790730
3797;Noord-Holland (PV);2016 april;2790730;2411;1868;13732;10165;3567;12541;9967;2574;;1734;0.06;7610;0.27;2792464
3798;Noord-Holland (PV);2016 mei;2792464;2441;1899;13203;9503;3700;11718;9541;2177;;2027;0.07;9637;0.35;2794491
3799;Noord-Holland (PV);2016 juni;2794491;2569;1781;13868;10237;3631;13191;10080;3111;;1465;0.05;11102;0.4;2795956
3800;Noord-Holland (PV);2016 juli;2795956;2753;1879;16321;12332;3989;15459;11735;3724;;1736;0.06;12838;0.46;2797692
3801;Noord-Holland (PV);2016 augustus;2797692;2614;1801;20380;13196;7184;17066;13454;3612;;4127;0.15;16965;0.61;2801819
3802;Noord-Holland (PV);2016 september;2801819;2616;1769;18446;12555;5891;15599;12360;3239;;3694;0.13;20659;0.74;2805513
3803;Noord-Holland (PV);2016 oktober;2805513;2486;1874;15751;11450;4301;14553;11412;3141;;1810;0.06;22469;0.81;2807323
3804;Noord-Holland (PV);2016 november;2807323;2386;1932;14662;10636;4026;13386;10700;2686;;1730;0.06;24199;0.87;2809053
3805;Noord-Holland (PV);2016 december;2809053;2374;2207;14621;11296;3325;14319;11302;3017;-39.0;430;0.02;24629;0.88;2809483
3806;Noord-Holland (PV);2016;2784854;29876;23276;185009;133758;51251;166941;131703;35238;-39.0;24629;0.88;24629;0.88;2809483
3807;Noord-Holland (PV);2017 januari;2809483;2387;2411;16178;11726;4452;14903;11572;3331;;1251;0.04;1251;0.04;2810734
3808;Noord-Holland (PV);2017 februari;2810734;2176;2037;15565;11226;4339;13498;10960;2538;;2206;0.08;3457;0.12;2812940
3809;Noord-Holland (PV);2017 maart;2812940;2408;2024;15658;11751;3907;14384;11749;2635;;1658;0.06;5115;0.18;2814598
3810;Noord-Holland (PV);2017 april;2814598;2397;1783;12669;9601;3068;11741;9451;2290;;1542;0.05;6657;0.24;2816140
3811;Noord-Holland (PV);2017 mei;2816140;2496;1970;14205;10486;3719;13407;10690;2717;;1324;0.05;7981;0.28;2817464
3812;Noord-Holland (PV);2017 juni;2817464;2413;1715;14399;10337;4062;13753;10448;3305;;1344;0.05;9325;0.33;2818808
3813;Noord-Holland (PV);2017 juli;2818808;2676;1754;16613;12111;4502;16636;12491;4145;;899;0.03;10224;0.36;2819707
3814;Noord-Holland (PV);2017 augustus;2819707;2547;1653;20997;12861;8136;17728;13894;3834;;4163;0.15;14387;0.51;2823870
3815;Noord-Holland (PV);2017 september;2823870;2585;1792;19078;12495;6583;16562;13021;3541;;3309;0.12;17696;0.63;2827179
3816;Noord-Holland (PV);2017 oktober;2827179;2509;1828;16375;11265;5110;14866;11591;3275;;2190;0.08;19886;0.71;2829369
3817;Noord-Holland (PV);2017 november;2829369;2423;1850;15118;10684;4434;13750;10885;2865;;1941;0.07;21827;0.78;2831310
3818;Noord-Holland (PV);2017 december;2831310;2376;2049;14021;10710;3311;14393;11205;3188;-83.0;-128;0.0;21699;0.77;2831182
3819;Noord-Holland (PV);2017;2809483;29393;22866;190876;135253;55623;175621;137957;37664;-83.0;21699;0.77;21699;0.77;2831182
3820;Noord-Holland (PV);2018 januari;2831182;2462;2232;16855;11301;5554;15039;11788;3251;;2046;0.07;2046;0.07;2833228
3821;Noord-Holland (PV);2018 februari;2833228;2074;2169;14983;10265;4718;12995;10416;2579;;1893;0.07;3939;0.14;2835121
3822;Noord-Holland (PV);2018 maart;2835121;2289;2380;15164;11328;3836;14857;11653;3204;;216;0.01;4155;0.15;2835337
3823;Noord-Holland (PV);2018 april;2835337;2328;1818;13877;9912;3965;12598;10010;2588;;1789;0.06;5944;0.21;2837126
3824;Noord-Holland (PV);2018 mei;2837126;2548;1830;14232;10000;4232;12816;10202;2614;;2134;0.08;8078;0.29;2839260
3825;Noord-Holland (PV);2018 juni;2839260;2449;1734;14050;9859;4191;14059;10520;3539;;706;0.02;8784;0.31;2839966
3826;Noord-Holland (PV);2018 juli;2839966;2681;1878;16511;11297;5214;16264;11946;4318;;1050;0.04;9834;0.35;2841016
3827;Noord-Holland (PV);2018 augustus;2841016;2625;1860;21606;12297;9309;18231;13619;4612;;4140;0.15;13974;0.49;2845156
3828;Noord-Holland (PV);2018 september;2845156;2531;1763;18697;11439;7258;15910;12177;3733;;3555;0.12;17529;0.62;2848711
3829;Noord-Holland (PV);2018 oktober;2848711;2503;1855;16976;11148;5828;15171;12042;3129;;2453;0.09;19982;0.71;2851164
3830;Noord-Holland (PV);2018 november;2851164;2383;1888;15417;10521;4896;13545;11181;2364;;2367;0.08;22349;0.79;2853531
3831;Noord-Holland (PV);2018 december;2853531;2380;2017;13754;10042;3712;14190;10843;3347;-99.0;-172;-0.01;22177;0.78;2853359
3832;Noord-Holland (PV);2018;2831182;29253;23424;192122;129409;62713;175675;136397;39278;-99.0;22177;0.78;22177;0.78;2853359
3833;Noord-Holland (PV);2019 januari;2853359;2406;2192;17598;11324;6274;15307;11912;3395;;2505;0.09;2505;0.09;2855864
3834;Noord-Holland (PV);2019 februari;2855864;2088;1927;15387;10260;5127;13577;10890;2687;;1971;0.07;4476;0.16;2857835
3835;Noord-Holland (PV);2019 maart;2857835;2360;2028;15413;10674;4739;14365;11229;3136;;1380;0.05;5856;0.21;2859215
3836;Noord-Holland (PV);2019 april;2859215;2457;1907;15121;10473;4648;13590;10864;2726;;2081;0.07;7937;0.28;2861296
3837;Noord-Holland (PV);2019 mei;2861296;2452;1838;14703;10257;4446;14017;11098;2919;;1300;0.05;9237;0.32;2862596
3838;Noord-Holland (PV);2019 juni;2862596;2475;1823;13992;9439;4553;13729;10148;3581;;915;0.03;10152;0.36;2863511
3839;Noord-Holland (PV);2019 juli;2863511;2621;1872;18580;12462;6118;17956;13537;4419;;1373;0.05;11525;0.4;2864884
3840;Noord-Holland (PV);2019 augustus;2864884;2634;1793;22945;12701;10244;18383;13869;4514;;5403;0.19;16928;0.59;2870287
3841;Noord-Holland (PV);2019 september;2870287;2585;1710;20005;11757;8248;16398;12812;3586;;4482;0.16;21410;0.75;2874769
3842;Noord-Holland (PV);2019 oktober;2874769;2506;1957;18253;11702;6551;15413;12465;2948;;3389;0.12;24799;0.87;2878158
3843;Noord-Holland (PV);2019 november;2878158;2400;1920;15598;10816;4782;13982;11401;2581;;2096;0.07;26895;0.94;2880254
3844;Noord-Holland (PV);2019 december;2880254;2270;2119;14435;10715;3720;15264;11643;3621;-49.0;-727;-0.03;26168;0.92;2879527
3845;Noord-Holland (PV);2019;2853359;29254;23086;202030;132580;69450;181981;141868;40113;-49.0;26168;0.92;26168;0.92;2879527
3846;Noord-Holland (PV);2020 januari;2879527;2349;2199;18812;12083;6729;16623;12721;3902;;2339;0.08;2339;0.08;2881866
3847;Noord-Holland (PV);2020 februari;2881866;2245;1889;16240;11107;5133;14607;11647;2960;;1989;0.07;4328;0.15;2883855
3848;Noord-Holland (PV);2020 maart;2883855;2319;2369;14864;11091;3773;15267;11716;3551;;-453;-0.02;3875;0.13;2883402
3849;Noord-Holland (PV);2020 april;2883402;2285;2785;11767;9771;1996;12625;10614;2011;;-1358;-0.05;2517;0.09;2882044
3850;Noord-Holland (PV);2020 mei;2882044;2433;1887;12731;10699;2032;13480;11478;2002;;-203;-0.01;2314;0.08;2881841
3851;Noord-Holland (PV);2020 juni;2881841;2467;1661;13625;10706;2919;13939;11287;2652;;492;0.02;2806;0.1;2882333
3852;Noord-Holland (PV);2020 juli;2882333;2643;1770;16979;12699;4280;17201;13753;3448;;651;0.02;3457;0.12;2882984
3853;Noord-Holland (PV);2020 augustus;2882984;2606;1990;19586;13274;6312;18078;14330;3748;;2124;0.07;5581;0.19;2885108
3854;Noord-Holland (PV);2020 september;2885108;2556;1825;19223;12817;6406;16906;13730;3176;;3048;0.11;8629;0.3;2888156
3855;Noord-Holland (PV);2020 oktober;2888156;2481;2288;17509;12588;4921;16709;13578;3131;;993;0.03;9622;0.33;2889149
3856;Noord-Holland (PV);2020 november;2889149;2338;2230;15768;11489;4279;15434;12364;3070;;442;0.02;10064;0.35;2889591
3857;Noord-Holland (PV);2020 december;2889591;2309;2588;15604;11763;3841;16322;12876;3446;-108.0;-1105;-0.04;8959;0.31;2888486
3858;Noord-Holland (PV);2020;2879527;29031;25481;192708;140087;52621;187191;150094;37097;-108.0;8959;0.31;8959;0.31;2888486
3859;Noord-Holland (PV);2021 januari;2888486;2321;2645;16323;12630;3693;17044;13812;3232;0.0;-1045;-0.04;-1045;-0.04;2887441
3860;Noord-Holland (PV);2021 februari;2887441;2342;2187;15186;11704;3482;14514;12385;2129;0.0;827;0.03;-218;-0.01;2888268
3861;Noord-Holland (PV);2021 maart;2888268;2613;2104;16666;13196;3470;16891;14219;2672;0.0;284;0.01;66;0.0;2888552
3862;Noord-Holland (PV);2021 april;2888552;2520;2010;14976;11782;3194;14817;12500;2317;0.0;669;0.02;735;0.03;2889221
3863;Noord-Holland (PV);2021 mei;2889221;2539;1985;13695;10616;3079;13292;11341;1951;0.0;957;0.03;1692;0.06;2890178
3864;Noord-Holland (PV);2021 juni;2890178;2612;1848;14607;10691;3916;13752;11139;2613;0.0;1619;0.06;3311;0.11;2891797
3865;Noord-Holland (PV);2021 juli;2891797;2757;1941;16773;12320;4453;16895;13237;3658;0.0;694;0.02;4005;0.14;2892491
3866;Noord-Holland (PV);2021 augustus;2892491;2766;2047;21642;13223;8419;17906;14016;3890;0.0;4455;0.15;8460;0.29;2896946
3867;Noord-Holland (PV);2021 september;2896946;2761;2001;21106;11856;9250;15614;12298;3316;0.0;6252;0.22;14712;0.51;2903198
3868;Noord-Holland (PV);2021 oktober;2903198;2685;2189;18211;11517;6694;14782;11940;2842;0.0;3925;0.14;18637;0.65;2907123
3869;Noord-Holland (PV);2021 november;2907123;2555;2355;16936;10993;5943;14246;11495;2751;0.0;2890;0.1;21527;0.75;2910013
3870;Noord-Holland (PV);2021 december;2910013;2448;2660;16168;11699;4469;16007;12391;3616;-135.0;-186;-0.01;21341;0.74;2909827
3871;Noord-Holland (PV);2021;2888486;30919;25972;202289;142227;60062;185760;150773;34987;-135.0;21341;0.74;21341;0.74;2909827
3872;Noord-Holland (PV);2022 januari;2909827;2381;2221;15839;11119;4720;15064;11999;3065;;935;0.03;935;0.03;2910762
3873;Noord-Holland (PV);2022 februari;2910762;2161;2018;16236;10402;5834;13649;11006;2643;;2730;0.09;3665;0.13;2913492
3874;Noord-Holland (PV);2022 maart;2913492;2293;2323;20275;10759;9516;14504;11652;2852;;5741;0.2;9406;0.32;2919233
3875;Noord-Holland (PV);2022 april;2919233;2229;2271;21224;10919;10305;14263;11641;2622;;6919;0.24;16325;0.56;2926152
3876;Noord-Holland (PV);2022 mei;2926152;2392;2060;17927;10777;7150;14337;11497;2840;;3922;0.13;20247;0.7;2930074
3877;Noord-Holland (PV);2022 juni;2930074;2454;1954;17210;10794;6416;15331;11318;4013;;2379;0.08;22626;0.78;2932453
3878;Noord-Holland (PV);2022 juli;2932453;2489;2212;19839;13180;6659;18771;13798;4973;;1345;0.05;23971;0.82;2933798
3879;Noord-Holland (PV);2022 augustus;2933798;2606;2039;25988;13680;12308;20014;14737;5277;;6541;0.22;30512;1.05;2940339
3880;Noord-Holland (PV);2022 september;2940339;2547;1958;23518;13134;10384;17927;13878;4049;;6180;0.21;36692;1.26;2946519
3881;Noord-Holland (PV);2022 oktober;2946519;2411;2207;18723;11840;6883;16478;12948;3530;;2449;0.08;39141;1.35;2948968
3882;Noord-Holland (PV);2022 november;2948968;2266;2070;18563;11726;6837;15429;12422;3007;;3330;0.11;42471;1.46;2952298
3883;Noord-Holland (PV);2022 december;2952298;2179;2558;17003;11688;5315;16098;12629;3469;-202.0;324;0.01;42795;1.47;2952622
3884;Noord-Holland (PV);2022;2909827;28408;25891;232345;140018;92327;191865;149525;42340;-202.0;42795;1.47;42795;1.47;2952622
3885;Noord-Holland (PV);2023 januari;2952622;2240;2534;18439;12107;6332;16739;12832;3907;0.0;1406;0.05;1406;0.05;2954028
3886;Noord-Holland (PV);2023 februari;2954028;2003;2129;18823;11416;7407;14895;11411;3484;0.0;3802;0.13;5208;0.18;2957830
3887;Noord-Holland (PV);2023 maart;2957830;2338;2477;18082;12105;5977;15906;12374;3532;0.0;2037;0.07;7245;0.25;2959867
3888;Noord-Holland (PV);2023 april;2959867;2105;2049;15592;10509;5083;14090;10951;3139;0.0;1558;0.05;8803;0.3;2961425
3889;Noord-Holland (PV);2023 mei;2961425;2424;1981;16494;10777;5717;14565;11420;3145;0.0;2372;0.08;11175;0.38;2963797
3890;Noord-Holland (PV);2023 juni;2963797;2352;1992;16835;11102;5733;15859;11806;4053;0.0;1336;0.05;12511;0.42;2965133
3891;Noord-Holland (PV);2023 juli;2965133;2462;1975;18777;12979;5798;19077;14008;5069;0.0;187;0.01;12698;0.43;2965320
3892;Noord-Holland (PV);2023 augustus;2965320;2507;1879;23833;14028;9805;20756;15286;5470;0.0;3705;0.12;16403;0.56;2969025
3893;Noord-Holland (PV);2023 september;2969025;2297;2038;22665;13343;9322;18615;14203;4412;0.0;4309;0.15;20712;0.7;2973334
3894;Noord-Holland (PV);2023 oktober;2973334;2424;2205;18214;11896;6318;16038;12397;3641;0.0;2395;0.08;23107;0.78;2975729
3895;Noord-Holland (PV);2023 november;2975729;2275;2277;17231;11556;5675;15197;11750;3447;0.0;2032;0.07;25139;0.85;2977761
3896;Noord-Holland (PV);2023 december;2977761;2118;2541;15507;11613;3894;16042;12011;4031;-316.0;-1274;-0.04;23865;0.81;2976487
3897;Noord-Holland (PV);2023;2952622;27545;26077;220492;143431;77061;197779;150449;47330;-316.0;23865;0.81;23865;0.81;2976487
3898;Noord-Holland (PV);2024 januari;2976487;2338;2618;17462;12366;5096;16748;12317;4431;;434;0.01;434;0.01;2976921
3899;Noord-Holland (PV);2024 februari;2976921;2211;2269;17177;11331;5846;14760;11426;3334;;2359;0.08;2793;0.09;2979280
3900;Noord-Holland (PV);2024 maart;2979280;2381;2397;16050;11497;4553;14775;11548;3227;;1259;0.04;4052;0.14;2980539
3901;Noord-Holland (PV);2024 april;2980539;2271;2177;15673;10878;4795;14023;11073;2950;;1744;0.06;5796;0.19;2982283
3902;Noord-Holland (PV);2024 mei;2982283;2383;2111;15103;10748;4355;14096;11073;3023;;1279;0.04;7075;0.24;2983562
3903;Noord-Holland (PV);2024 juni;2983562;2387;1926;15080;10669;4411;14393;10570;3823;;1148;0.04;8223;0.28;2984710
3904;Noord-Holland (PV);2024 juli;2984710;2478;1996;18612;12883;5729;18766;13380;5386;;328;0.01;8551;0.29;2985038
3905;Noord-Holland (PV);2024 augustus;2985038;2480;2065;21652;12900;8752;19552;14030;5522;;2515;0.08;11066;0.37;2987553
3906;Noord-Holland (PV);2024 september;2987553;2373;2029;21590;12634;8956;18127;13436;4691;;3807;0.13;14873;0.5;2991360
3907;Noord-Holland (PV);2024 oktober;2991360;2402;2235;18024;12485;5539;17304;12877;4427;;887;0.03;15760;0.53;2992247
3908;Noord-Holland (PV);2024 november;2992247;2266;2132;17133;12006;5127;15773;12241;3532;;1494;0.05;17254;0.58;2993741
3909;Noord-Holland (PV);2024 december;2993741;2225;2276;16558;11975;4583;17160;12979;4181;0.0;-653;-0.02;16601;0.56;2993088
3910;Noord-Holland (PV);2024;2976487;28195;26231;210114;142372;67742;195477;146950;48527;0.0;16601;0.56;16601;0.56;2993088
3911;Noord-Holland (PV);2025 januari;2993088;2376;2663;21134;13070;8064;18578;14646;3932;;2269;0.08;2269;0.08;2995357
3912;Noord-Holland (PV);2025 februari;2995357;1978;2401;18878;11534;7344;16554;13125;3429;;1901;0.06;4170;0.14;2997258
3913;Zuid-Holland (PV);2002 januari;3423780;3720;2966;14792;12254;2538;14548;12798;1750;;998;0.03;998;0.03;3424778
3914;Zuid-Holland (PV);2002 februari;3424778;3309;2586;13037;10866;2171;12270;10850;1420;;1490;0.04;2488;0.07;3426268
3915;Zuid-Holland (PV);2002 maart;3426268;3578;2876;13265;11022;2243;13099;11160;1939;;868;0.03;3356;0.1;3427136
3916;Zuid-Holland (PV);2002 april;3427136;3414;2512;12826;10670;2156;12526;10974;1552;;1202;0.04;4558;0.13;3428338
3917;Zuid-Holland (PV);2002 mei;3428338;3528;2552;13419;11259;2160;13345;11614;1731;;1050;0.03;5608;0.16;3429388
3918;Zuid-Holland (PV);2002 juni;3429388;3473;2413;12480;10418;2062;12348;10776;1572;;1192;0.03;6800;0.2;3430580
3919;Zuid-Holland (PV);2002 juli;3430580;3871;2452;16108;13033;3075;16473;13793;2680;;1054;0.03;7854;0.23;3431634
3920;Zuid-Holland (PV);2002 augustus;3431634;3789;2424;16744;13189;3555;16717;14021;2696;;1392;0.04;9246;0.27;3433026
3921;Zuid-Holland (PV);2002 september;3433026;3730;2273;15567;12272;3295;14565;12370;2195;;2459;0.07;11705;0.34;3435485
3922;Zuid-Holland (PV);2002 oktober;3435485;3806;2456;15365;12214;3151;14696;12532;2164;;2019;0.06;13724;0.4;3437504
3923;Zuid-Holland (PV);2002 november;3437504;3444;2520;13887;11714;2173;13473;11843;1630;;1338;0.04;15062;0.44;3438842
3924;Zuid-Holland (PV);2002 december;3438842;3533;2959;12458;10670;1788;12639;11067;1572;747.0;1140;0.03;16202;0.47;3439982
3925;Zuid-Holland (PV);2002;3423780;43195;30989;169948;139581;30367;166699;143798;22901;747.0;16202;0.47;16202;0.47;3439982
3926;Zuid-Holland (PV);2003 januari;3439982;3662;2897;15300;12672;2628;14873;12826;2047;;1192;0.03;1192;0.03;3441174
3927;Zuid-Holland (PV);2003 februari;3441174;3336;2534;12208;10085;2123;12574;10264;2310;;436;0.01;1628;0.05;3441610
3928;Zuid-Holland (PV);2003 maart;3441610;3513;2989;12524;10457;2067;12258;10490;1768;;790;0.02;2418;0.07;3442400
3929;Zuid-Holland (PV);2003 april;3442400;3516;2652;11777;9868;1909;11633;10359;1274;;1008;0.03;3426;0.1;3443408
3930;Zuid-Holland (PV);2003 mei;3443408;3512;2403;11949;9899;2050;11342;10101;1241;;1716;0.05;5142;0.15;3445124
3931;Zuid-Holland (PV);2003 juni;3445124;3476;2387;12395;10367;2028;12766;10742;2024;;718;0.02;5860;0.17;3445842
3932;Zuid-Holland (PV);2003 juli;3445842;3715;2393;14782;12202;2580;17801;13062;4739;;-1697;-0.05;4163;0.12;3444145
3933;Zuid-Holland (PV);2003 augustus;3444145;3796;2423;15285;11957;3328;15078;12436;2642;;1580;0.05;5743;0.17;3445725
3934;Zuid-Holland (PV);2003 september;3445725;3637;2354;16276;12492;3784;14994;12346;2648;;2565;0.07;8308;0.24;3448290
3935;Zuid-Holland (PV);2003 oktober;3448290;3646;2505;15314;11936;3378;14638;12168;2470;;1817;0.05;10125;0.29;3450107
3936;Zuid-Holland (PV);2003 november;3450107;3372;2367;12631;10492;2139;13411;10733;2678;;225;0.01;10350;0.3;3450332
3937;Zuid-Holland (PV);2003 december;3450332;3382;2888;13609;11564;2045;14113;12165;1948;1620.0;1610;0.05;11960;0.35;3451942
3938;Zuid-Holland (PV);2003;3439982;42563;30792;164050;133991;30059;165481;137692;27789;1620.0;11960;0.35;11960;0.35;3451942
3939;Zuid-Holland (PV);2004 januari;3451942;3515;3041;13729;11373;2356;14049;11674;2375;;154;0.0;154;0.0;3452096
3940;Zuid-Holland (PV);2004 februari;3452096;3291;2438;12140;10189;1951;12301;10445;1856;;692;0.02;846;0.02;3452788
3941;Zuid-Holland (PV);2004 maart;3452788;3445;2542;12857;10983;1874;13787;11340;2447;;-27;0.0;819;0.02;3452761
3942;Zuid-Holland (PV);2004 april;3452761;3488;2400;11661;10139;1522;12734;10443;2291;;15;0.0;834;0.02;3452776
3943;Zuid-Holland (PV);2004 mei;3452776;3438;2451;10989;9413;1576;11864;9854;2010;;112;0.0;946;0.03;3452888
3944;Zuid-Holland (PV);2004 juni;3452888;3585;2292;13215;11091;2124;14057;11617;2440;;451;0.01;1397;0.04;3453339
3945;Zuid-Holland (PV);2004 juli;3453339;3817;2345;14064;11667;2397;15389;12544;2845;;147;0.0;1544;0.04;3453486
3946;Zuid-Holland (PV);2004 augustus;3453486;3578;2466;15505;12287;3218;15956;12906;3050;;661;0.02;2205;0.06;3454147
3947;Zuid-Holland (PV);2004 september;3454147;3553;2288;15249;12191;3058;14952;12394;2558;;1562;0.05;3767;0.11;3455709
3948;Zuid-Holland (PV);2004 oktober;3455709;3419;2389;13548;10898;2650;13910;11195;2715;;668;0.02;4435;0.13;3456377
3949;Zuid-Holland (PV);2004 november;3456377;3407;2409;13006;11105;1901;13535;11604;1931;;469;0.01;4904;0.14;3456846
3950;Zuid-Holland (PV);2004 december;3456846;3510;2597;12796;11203;1593;13785;11687;2098;1611.0;1535;0.04;6439;0.19;3458381
3951;Zuid-Holland (PV);2004;3451942;42046;29658;158759;132539;26220;166319;137703;28616;1611.0;6439;0.19;6439;0.19;3458381
3952;Zuid-Holland (PV);2005 januari;3458381;3424;2695;12376;10625;1751;13614;11292;2322;;-509;-0.01;-509;-0.01;3457872
3953;Zuid-Holland (PV);2005 februari;3457872;3114;2523;11705;9971;1734;12509;10273;2236;;-213;-0.01;-722;-0.02;3457659
3954;Zuid-Holland (PV);2005 maart;3457659;3501;2972;12654;10842;1812;13637;11157;2480;;-454;-0.01;-1176;-0.03;3457205
3955;Zuid-Holland (PV);2005 april;3457205;3373;2424;11921;10265;1656;13073;10692;2381;;-203;-0.01;-1379;-0.04;3457002
3956;Zuid-Holland (PV);2005 mei;3457002;3367;2466;11110;9600;1510;12269;9982;2287;;-258;-0.01;-1637;-0.05;3456744
3957;Zuid-Holland (PV);2005 juni;3456744;3418;2372;12461;10829;1632;13774;11247;2527;;-267;-0.01;-1904;-0.06;3456477
3958;Zuid-Holland (PV);2005 juli;3456477;3572;2224;14066;12117;1949;15477;12945;2532;;-63;0.0;-1967;-0.06;3456414
3959;Zuid-Holland (PV);2005 augustus;3456414;3575;2303;16943;14018;2925;18282;14600;3682;;-67;0.0;-2034;-0.06;3456347
3960;Zuid-Holland (PV);2005 september;3456347;3487;2229;16422;12986;3436;15938;13119;2819;;1742;0.05;-292;-0.01;3458089
3961;Zuid-Holland (PV);2005 oktober;3458089;3367;2369;14203;11813;2390;14640;12209;2431;;561;0.02;269;0.01;3458650
3962;Zuid-Holland (PV);2005 november;3458650;3226;2360;13411;11279;2132;14162;11699;2463;;115;0.0;384;0.01;3458765
3963;Zuid-Holland (PV);2005 december;3458765;3267;2562;13746;11977;1769;15565;12555;3010;1224.0;110;0.0;494;0.01;3458875
3964;Zuid-Holland (PV);2005;3458381;40691;29499;161018;136322;24696;172940;141770;31170;1224.0;494;0.01;494;0.01;3458875
3965;Zuid-Holland (PV);2006 januari;3458875;3293;2689;13870;11922;1948;15019;12509;2510;;-545;-0.02;-545;-0.02;3458330
3966;Zuid-Holland (PV);2006 februari;3458330;3148;2412;12626;10697;1929;13738;11191;2547;;-376;-0.01;-921;-0.03;3457954
3967;Zuid-Holland (PV);2006 maart;3457954;3328;2752;13969;11830;2139;15584;12259;3325;;-1039;-0.03;-1960;-0.06;3456915
3968;Zuid-Holland (PV);2006 april;3456915;3166;2440;11213;9578;1635;13003;10028;2975;;-1064;-0.03;-3024;-0.09;3455851
3969;Zuid-Holland (PV);2006 mei;3455851;3445;2392;12208;10320;1888;13772;10756;3016;;-511;-0.01;-3535;-0.1;3455340
3970;Zuid-Holland (PV);2006 juni;3455340;3307;2320;12955;10878;2077;13868;11348;2520;;74;0.0;-3461;-0.1;3455414
3971;Zuid-Holland (PV);2006 juli;3455414;3545;2687;14063;11832;2231;15823;12746;3077;;-902;-0.03;-4363;-0.13;3454512
3972;Zuid-Holland (PV);2006 augustus;3454512;3459;2213;16835;13539;3296;17677;14355;3322;;404;0.01;-3959;-0.11;3454916
3973;Zuid-Holland (PV);2006 september;3454916;3574;2141;15905;12252;3653;16825;12488;4337;;513;0.01;-3446;-0.1;3455429
3974;Zuid-Holland (PV);2006 oktober;3455429;3513;2223;14402;11542;2860;15435;11848;3587;;257;0.01;-3189;-0.09;3455686
3975;Zuid-Holland (PV);2006 november;3455686;3317;2314;13857;11611;2246;16158;11960;4198;;-1298;-0.04;-4487;-0.13;3454388
3976;Zuid-Holland (PV);2006 december;3454388;3259;2470;12231;10600;1631;13831;11183;2648;1520.0;709;0.02;-3778;-0.11;3455097
3977;Zuid-Holland (PV);2006;3458875;40354;29053;164134;136601;27533;180733;142671;38062;1520.0;-3778;-0.11;-3778;-0.11;3455097
3978;Zuid-Holland (PV);2007 januari;3455097;3302;2754;14496;12017;2479;15671;12611;3060;;-627;-0.02;-627;-0.02;3454470
3979;Zuid-Holland (PV);2007 februari;3454470;3020;2364;12795;10468;2327;12705;10864;1841;;746;0.02;119;0.0;3455216
3980;Zuid-Holland (PV);2007 maart;3455216;3232;2552;13802;11485;2317;14234;11748;2486;;248;0.01;367;0.01;3455464
3981;Zuid-Holland (PV);2007 april;3455464;3206;2457;11755;9788;1967;12188;10089;2099;;316;0.01;683;0.02;3455780
3982;Zuid-Holland (PV);2007 mei;3455780;3341;2289;12684;10505;2179;13223;11005;2218;;513;0.01;1196;0.03;3456293
3983;Zuid-Holland (PV);2007 juni;3456293;3235;2273;13159;10871;2288;13554;11165;2389;;567;0.02;1763;0.05;3456860
3984;Zuid-Holland (PV);2007 juli;3456860;3442;2293;15150;12252;2898;16523;12805;3718;;-224;-0.01;1539;0.04;3456636
3985;Zuid-Holland (PV);2007 augustus;3456636;3468;2312;16953;13350;3603;17973;14039;3934;;136;0.0;1675;0.05;3456772
3986;Zuid-Holland (PV);2007 september;3456772;3441;2058;16359;12434;3925;15325;12417;2908;;2417;0.07;4092;0.12;3459189
3987;Zuid-Holland (PV);2007 oktober;3459189;3347;2397;16307;12764;3543;15775;12913;2862;;1482;0.04;5574;0.16;3460671
3988;Zuid-Holland (PV);2007 november;3460671;3191;2502;14223;11639;2584;14551;11825;2726;;361;0.01;5935;0.17;3461032
3989;Zuid-Holland (PV);2007 december;3461032;3240;2747;11990;10180;1810;13481;10360;3121;1401.0;403;0.01;6338;0.18;3461435
3990;Zuid-Holland (PV);2007;3455097;39465;28998;169673;137753;31920;175203;141841;33362;1401.0;6338;0.18;6338;0.18;3461435
3991;Zuid-Holland (PV);2008 januari;3461435;3355;2845;15711;12645;3066;15327;12953;2374;;894;0.03;894;0.03;3462329
3992;Zuid-Holland (PV);2008 februari;3462329;3146;2332;13847;10931;2916;13419;11236;2183;;1242;0.04;2136;0.06;3463571
3993;Zuid-Holland (PV);2008 maart;3463571;3290;2645;13289;10571;2718;12963;10963;2000;;971;0.03;3107;0.09;3464542
3994;Zuid-Holland (PV);2008 april;3464542;3243;2371;13448;10656;2792;12757;10928;1829;;1563;0.05;4670;0.13;3466105
3995;Zuid-Holland (PV);2008 mei;3466105;3428;2385;12146;9733;2413;12207;9953;2254;;982;0.03;5652;0.16;3467087
3996;Zuid-Holland (PV);2008 juni;3467087;3357;2201;13511;10743;2768;13141;10858;2283;;1526;0.04;7178;0.21;3468613
3997;Zuid-Holland (PV);2008 juli;3468613;3671;2301;16302;12800;3502;16615;13286;3329;;1057;0.03;8235;0.24;3469670
3998;Zuid-Holland (PV);2008 augustus;3469670;3673;2248;16639;12580;4059;16396;12955;3441;;1668;0.05;9903;0.29;3471338
3999;Zuid-Holland (PV);2008 september;3471338;3649;2157;18247;13257;4990;15914;13064;2850;;3825;0.11;13728;0.4;3475163
4000;Zuid-Holland (PV);2008 oktober;3475163;3421;2290;16441;12402;4039;14620;12420;2200;;2952;0.08;16680;0.48;3478115
4001;Zuid-Holland (PV);2008 november;3478115;3292;2335;13677;10689;2988;12786;10691;2095;;1848;0.05;18528;0.54;3479963
4002;Zuid-Holland (PV);2008 december;3479963;3458;2609;13979;11487;2492;14905;11764;3141;1672.0;1595;0.05;20123;0.58;3481558
4003;Zuid-Holland (PV);2008;3461435;40983;28719;177237;138494;38743;171050;141071;29979;1672.0;20123;0.58;20123;0.58;3481558
4004;Zuid-Holland (PV);2009 januari;3481558;3504;2940;14656;11558;3098;14034;11674;2360;;1186;0.03;1186;0.03;3482744
4005;Zuid-Holland (PV);2009 februari;3482744;3014;2448;13052;10217;2835;11892;10150;1742;;1726;0.05;2912;0.08;3484470
4006;Zuid-Holland (PV);2009 maart;3484470;3342;2452;14094;10927;3167;12980;10858;2122;;2004;0.06;4916;0.14;3486474
4007;Zuid-Holland (PV);2009 april;3486474;3387;2259;12293;9700;2593;12227;9736;2491;;1194;0.03;6110;0.18;3487668
4008;Zuid-Holland (PV);2009 mei;3487668;3437;2268;11754;9579;2175;11263;9524;1739;;1660;0.05;7770;0.22;3489328
4009;Zuid-Holland (PV);2009 juni;3489328;3350;2242;12951;10133;2818;12573;10157;2416;;1486;0.04;9256;0.27;3490814
4010;Zuid-Holland (PV);2009 juli;3490814;3644;2206;15605;11956;3649;15509;12219;3290;;1534;0.04;10790;0.31;3492348
4011;Zuid-Holland (PV);2009 augustus;3492348;3579;2225;16677;12075;4602;15379;12051;3328;;2652;0.08;13442;0.39;3495000
4012;Zuid-Holland (PV);2009 september;3495000;3621;2201;17491;12368;5123;14793;11939;2854;;4118;0.12;17560;0.5;3499118
4013;Zuid-Holland (PV);2009 oktober;3499118;3483;2424;15079;11437;3642;13647;11113;2534;;2491;0.07;20051;0.58;3501609
4014;Zuid-Holland (PV);2009 november;3501609;3360;2306;13689;10720;2969;12475;10379;2096;;2268;0.06;22319;0.64;3503877
4015;Zuid-Holland (PV);2009 december;3503877;3366;2524;13050;10732;2318;13360;10759;2601;1202.0;1734;0.05;24053;0.69;3505611
4016;Zuid-Holland (PV);2009;3481558;41087;28495;170391;131402;38989;160132;130559;29573;1202.0;24053;0.69;24053;0.69;3505611
4017;Zuid-Holland (PV);2010 januari;3505611;3344;2747;13965;11148;2817;13151;10955;2196;;1411;0.04;1411;0.04;3507022
4018;Zuid-Holland (PV);2010 februari;3507022;3105;2443;13716;10439;3277;12840;10415;2425;;1538;0.04;2949;0.08;3508560
4019;Zuid-Holland (PV);2010 maart;3508560;3403;2562;14456;11233;3223;14056;11148;2908;;1241;0.04;4190;0.12;3509801
4020;Zuid-Holland (PV);2010 april;3509801;3337;2307;12445;9790;2655;12258;9825;2433;;1217;0.03;5407;0.15;3511018
4021;Zuid-Holland (PV);2010 mei;3511018;3376;2388;11958;9472;2486;11609;9508;2101;;1337;0.04;6744;0.19;3512355
4022;Zuid-Holland (PV);2010 juni;3512355;3455;2209;13295;10332;2963;13039;10337;2702;;1502;0.04;8246;0.24;3513857
4023;Zuid-Holland (PV);2010 juli;3513857;3509;2322;15327;11652;3675;15136;11490;3646;;1378;0.04;9624;0.27;3515235
4024;Zuid-Holland (PV);2010 augustus;3515235;3499;2218;18217;12605;5612;16307;12549;3758;;3191;0.09;12815;0.37;3518426
4025;Zuid-Holland (PV);2010 september;3518426;3635;2239;17817;12139;5678;14579;11699;2880;;4634;0.13;17449;0.5;3523060
4026;Zuid-Holland (PV);2010 oktober;3523060;3571;2457;14712;10796;3916;12970;10587;2383;;2856;0.08;20305;0.58;3525916
4027;Zuid-Holland (PV);2010 november;3525916;3585;2245;13459;10148;3311;12782;9973;2809;;2017;0.06;22322;0.64;3527933
4028;Zuid-Holland (PV);2010 december;3527933;3568;2586;12868;10213;2655;13248;10226;3022;-211.0;391;0.01;22713;0.65;3528324
4029;Zuid-Holland (PV);2010;3505611;41387;28723;172235;129967;42268;161975;128712;33263;-211.0;22713;0.65;22713;0.65;3528324
4030;Zuid-Holland (PV);2011 januari;3528324;3507;2621;14133;10673;3460;13229;10795;2434;;1790;0.05;1790;0.05;3530114
4031;Zuid-Holland (PV);2011 februari;3530114;3213;2178;13528;10144;3384;12259;10068;2191;;2304;0.07;4094;0.12;3532418
4032;Zuid-Holland (PV);2011 maart;3532418;3428;2628;13975;10708;3267;13368;10678;2690;;1407;0.04;5501;0.16;3533825
4033;Zuid-Holland (PV);2011 april;3533825;3350;2284;12133;9422;2711;11746;9336;2410;;1453;0.04;6954;0.2;3535278
4034;Zuid-Holland (PV);2011 mei;3535278;3437;2343;12275;9554;2721;12214;9641;2573;;1155;0.03;8109;0.23;3536433
4035;Zuid-Holland (PV);2011 juni;3536433;3560;2224;12346;9322;3024;12217;9244;2973;;1465;0.04;9574;0.27;3537898
4036;Zuid-Holland (PV);2011 juli;3537898;3640;2311;15263;11100;4163;15416;11315;4101;;1176;0.03;10750;0.3;3539074
4037;Zuid-Holland (PV);2011 augustus;3539074;3600;2217;19393;13033;6360;16610;12950;3660;;4166;0.12;14916;0.42;3543240
4038;Zuid-Holland (PV);2011 september;3543240;3589;2197;18361;12120;6241;15364;11824;3540;;4389;0.12;19305;0.55;3547629
4039;Zuid-Holland (PV);2011 oktober;3547629;3472;2390;14686;10751;3935;13670;10507;3163;;2098;0.06;21403;0.61;3549727
4040;Zuid-Holland (PV);2011 november;3549727;3313;2364;14653;10875;3778;12953;10503;2450;;2649;0.07;24052;0.68;3552376
4041;Zuid-Holland (PV);2011 december;3552376;3299;2654;12859;10154;2705;13565;10338;3227;82.0;21;0.0;24073;0.68;3552397
4042;Zuid-Holland (PV);2011;3528324;41408;28411;173605;127856;45749;162611;127199;35412;82.0;24073;0.68;24073;0.68;3552397
4043;Zuid-Holland (PV);2012 januari;3552407;3371;2625;15198;11725;3473;15184;11886;3298;;760;0.02;760;0.02;3553167
4044;Zuid-Holland (PV);2012 februari;3553167;3309;2676;13855;10407;3448;13366;10405;2961;;1122;0.03;1882;0.05;3554289
4045;Zuid-Holland (PV);2012 maart;3554289;3385;2720;13969;10706;3263;13962;10571;3391;;672;0.02;2554;0.07;3554961
4046;Zuid-Holland (PV);2012 april;3554961;3334;2499;11941;9099;2842;12284;9268;3016;;492;0.01;3046;0.09;3555453
4047;Zuid-Holland (PV);2012 mei;3555453;3492;2419;12472;9555;2917;13108;9732;3376;;437;0.01;3483;0.1;3555890
4048;Zuid-Holland (PV);2012 juni;3555890;3332;2292;13269;10320;2949;13987;10395;3592;;322;0.01;3805;0.11;3556212
4049;Zuid-Holland (PV);2012 juli;3556212;3430;2277;15270;11521;3749;16825;11877;4948;;-402;-0.01;3403;0.1;3555810
4050;Zuid-Holland (PV);2012 augustus;3555810;3633;2200;18748;13007;5741;17901;12792;5109;;2280;0.06;5683;0.16;3558090
4051;Zuid-Holland (PV);2012 september;3558090;3441;2186;17156;11342;5814;14498;10908;3590;;3913;0.11;9596;0.27;3562003
4052;Zuid-Holland (PV);2012 oktober;3562003;3506;2413;15825;11296;4529;14922;11088;3834;;1996;0.06;11592;0.33;3563999
4053;Zuid-Holland (PV);2012 november;3563999;3320;2424;13513;10200;3313;13941;10123;3818;;468;0.01;12060;0.34;3564467
4054;Zuid-Holland (PV);2012 december;3564467;3261;2680;12127;9870;2257;13313;9980;3333;73.0;-532;-0.01;11528;0.32;3563935
4055;Zuid-Holland (PV);2012;3552407;40814;29411;173343;129048;44295;173291;129025;44266;73.0;11528;0.32;11528;0.32;3563935
4056;Zuid-Holland (PV);2013 januari;3563935;3383;2898;14847;11545;3302;15153;11764;3389;;179;0.01;179;0.01;3564114
4057;Zuid-Holland (PV);2013 februari;3564114;2969;2560;13802;10445;3357;13307;10426;2881;;904;0.03;1083;0.03;3565018
4058;Zuid-Holland (PV);2013 maart;3565018;3294;2730;13575;10313;3262;13503;10387;3116;;636;0.02;1719;0.05;3565654
4059;Zuid-Holland (PV);2013 april;3565654;3143;2587;12291;9318;2973;12889;9295;3594;;-42;0.0;1677;0.05;3565612
4060;Zuid-Holland (PV);2013 mei;3565612;3213;2337;12328;9432;2896;12592;9440;3152;;612;0.02;2289;0.06;3566224
4061;Zuid-Holland (PV);2013 juni;3566224;3201;2233;11773;8960;2813;12270;8918;3352;;471;0.01;2760;0.08;3566695
4062;Zuid-Holland (PV);2013 juli;3566695;3558;2342;15845;11491;4354;16196;11466;4730;;865;0.02;3625;0.1;3567560
4063;Zuid-Holland (PV);2013 augustus;3567560;3516;2254;18505;12734;5771;17306;12563;4743;;2461;0.07;6086;0.17;3570021
4064;Zuid-Holland (PV);2013 september;3570021;3377;2166;18861;12839;6022;16732;12195;4537;;3340;0.09;9426;0.26;3573361
4065;Zuid-Holland (PV);2013 oktober;3573361;3390;2419;16443;11746;4697;14432;11190;3242;;2982;0.08;12408;0.35;3576343
4066;Zuid-Holland (PV);2013 november;3576343;3184;2255;13811;10457;3354;13424;10298;3126;;1316;0.04;13724;0.39;3577659
4067;Zuid-Holland (PV);2013 december;3577659;3122;2467;13011;10213;2798;14404;10365;4039;111.0;-627;-0.02;13097;0.37;3577032
4068;Zuid-Holland (PV);2013;3563935;39350;29248;175092;129493;45599;172208;128307;43901;111.0;13097;0.37;13097;0.37;3577032
4069;Zuid-Holland (PV);2014 januari;3577032;3369;2569;15758;11806;3952;15352;11689;3663;;1206;0.03;1206;0.03;3578238
4070;Zuid-Holland (PV);2014 februari;3578238;3046;2289;14786;10797;3989;13589;10802;2787;;1954;0.05;3160;0.09;3580192
4071;Zuid-Holland (PV);2014 maart;3580192;3345;2517;13726;10393;3333;13136;10339;2797;;1418;0.04;4578;0.13;3581610
4072;Zuid-Holland (PV);2014 april;3581610;3263;2355;13110;9754;3356;12665;9864;2801;;1353;0.04;5931;0.17;3582963
4073;Zuid-Holland (PV);2014 mei;3582963;3391;2341;12575;9604;2971;11958;9516;2442;;1667;0.05;7598;0.21;3584630
4074;Zuid-Holland (PV);2014 juni;3584630;3413;2121;12812;9575;3237;12826;9547;3279;;1278;0.04;8876;0.25;3585908
4075;Zuid-Holland (PV);2014 juli;3585908;3699;2411;16134;12286;3848;16995;12151;4844;;427;0.01;9303;0.26;3586335
4076;Zuid-Holland (PV);2014 augustus;3586335;3528;2285;19240;13816;5424;17577;13293;4284;;2906;0.08;12209;0.34;3589241
4077;Zuid-Holland (PV);2014 september;3589241;3599;2337;21485;14246;7239;16978;13218;3760;;5769;0.16;17978;0.5;3595010
4078;Zuid-Holland (PV);2014 oktober;3595010;3524;2365;17094;12362;4732;15335;11667;3668;;2918;0.08;20896;0.58;3597928
4079;Zuid-Holland (PV);2014 november;3597928;3325;2447;13981;10725;3256;12864;10110;2754;;1995;0.06;22891;0.64;3599923
4080;Zuid-Holland (PV);2014 december;3599923;3277;2694;15312;12288;3024;15785;11946;3839;-22.0;88;0.0;22979;0.64;3600011
4081;Zuid-Holland (PV);2014;3577032;40779;28731;186013;137652;48361;175060;134142;40918;-22.0;22979;0.64;22979;0.64;3600011
4082;Zuid-Holland (PV);2015 januari;3600011;3244;3121;15840;12012;3828;15384;11821;3563;;579;0.02;579;0.02;3600590
4083;Zuid-Holland (PV);2015 februari;3600590;3005;2643;15023;11250;3773;14015;10995;3020;;1370;0.04;1949;0.05;3601960
4084;Zuid-Holland (PV);2015 maart;3601960;3105;2887;15661;12114;3547;15043;11870;3173;;836;0.02;2785;0.08;3602796
4085;Zuid-Holland (PV);2015 april;3602796;3047;2435;13469;10497;2972;13442;10441;3001;;639;0.02;3424;0.1;3603435
4086;Zuid-Holland (PV);2015 mei;3603435;3335;2448;12668;10063;2605;12653;9921;2732;;902;0.03;4326;0.12;3604337
4087;Zuid-Holland (PV);2015 juni;3604337;3343;2178;14444;11139;3305;14838;10945;3893;;771;0.02;5097;0.14;3605108
4088;Zuid-Holland (PV);2015 juli;3605108;3505;2380;17844;13675;4169;18968;13500;5468;;1;0.0;5098;0.14;3605109
4089;Zuid-Holland (PV);2015 augustus;3605109;3345;2254;21271;14466;6805;18298;13968;4330;;4064;0.11;9162;0.25;3609173
4090;Zuid-Holland (PV);2015 september;3609173;3526;2343;21485;14034;7451;16614;13222;3392;;6054;0.17;15216;0.42;3615227
4091;Zuid-Holland (PV);2015 oktober;3615227;3482;2586;17922;12933;4989;15118;12306;2812;;3700;0.1;18916;0.53;3618927
4092;Zuid-Holland (PV);2015 november;3618927;3195;2403;15537;11875;3662;13642;11167;2475;;2687;0.07;21603;0.6;3621614
4093;Zuid-Holland (PV);2015 december;3621614;3205;2608;16349;12965;3384;16041;12314;3727;-216.0;689;0.02;22292;0.62;3622303
4094;Zuid-Holland (PV);2015;3600011;39337;30286;197513;147023;50490;184056;142470;41586;-216.0;22292;0.62;22292;0.62;3622303
4095;Zuid-Holland (PV);2016 januari;3622303;3249;2881;16342;12675;3667;15448;12003;3445;;1262;0.03;1262;0.03;3623565
4096;Zuid-Holland (PV);2016 februari;3623565;3122;2683;17485;12872;4613;15603;12028;3575;;2321;0.06;3583;0.1;3625886
4097;Zuid-Holland (PV);2016 maart;3625886;3263;2818;16101;12432;3669;15173;12026;3147;;1373;0.04;4956;0.14;3627259
4098;Zuid-Holland (PV);2016 april;3627259;3215;2481;14982;11876;3106;13960;11439;2521;;1756;0.05;6712;0.19;3629015
4099;Zuid-Holland (PV);2016 mei;3629015;3418;2483;15016;11859;3157;13595;11236;2359;;2356;0.06;9068;0.25;3631371
4100;Zuid-Holland (PV);2016 juni;3631371;3352;2359;16658;12852;3806;15765;12120;3645;;1886;0.05;10954;0.3;3633257
4101;Zuid-Holland (PV);2016 juli;3633257;3594;2382;18137;14228;3909;19228;14118;5110;;121;0.0;11075;0.31;3633378
4102;Zuid-Holland (PV);2016 augustus;3633378;3557;2424;24527;16437;8090;19966;15427;4539;;5694;0.16;16769;0.46;3639072
4103;Zuid-Holland (PV);2016 september;3639072;3593;2264;22108;15434;6674;18573;14280;4293;;4864;0.13;21633;0.6;3643936
4104;Zuid-Holland (PV);2016 oktober;3643936;3390;2578;18870;13934;4936;16376;12919;3457;;3306;0.09;24939;0.69;3647242
4105;Zuid-Holland (PV);2016 november;3647242;3128;2513;17752;13650;4102;15763;12516;3247;;2604;0.07;27543;0.76;3649846
4106;Zuid-Holland (PV);2016 december;3649846;3274;2878;17374;14363;3011;17222;13511;3711;-172.0;376;0.01;27919;0.77;3650222
4107;Zuid-Holland (PV);2016;3622303;40155;30744;215352;162612;52740;196672;153623;43049;-172.0;27919;0.77;27919;0.77;3650222
4108;Zuid-Holland (PV);2017 januari;3650222;3328;3386;18986;14808;4178;17591;14051;3540;;1337;0.04;1337;0.04;3651559
4109;Zuid-Holland (PV);2017 februari;3651559;2877;2701;17844;13695;4149;15954;12849;3105;;2066;0.06;3403;0.09;3653625
4110;Zuid-Holland (PV);2017 maart;3653625;3162;2599;18528;14664;3864;16705;13888;2817;;2386;0.07;5789;0.16;3656011
4111;Zuid-Holland (PV);2017 april;3656011;3101;2448;15079;12188;2891;13839;11511;2328;;1893;0.05;7682;0.21;3657904
4112;Zuid-Holland (PV);2017 mei;3657904;3341;2547;16525;13162;3363;15760;12325;3435;;1559;0.04;9241;0.25;3659463
4113;Zuid-Holland (PV);2017 juni;3659463;3277;2269;17014;13036;3978;16275;12556;3719;;1747;0.05;10988;0.3;3661210
4114;Zuid-Holland (PV);2017 juli;3661210;3404;2400;19823;15396;4427;19668;14845;4823;;1159;0.03;12147;0.33;3662369
4115;Zuid-Holland (PV);2017 augustus;3662369;3623;2409;25097;16509;8588;20779;15780;4999;;5532;0.15;17679;0.48;3667901
4116;Zuid-Holland (PV);2017 september;3667901;3399;2307;22685;15156;7529;18226;14202;4024;;5551;0.15;23230;0.64;3673452
4117;Zuid-Holland (PV);2017 oktober;3673452;3423;2418;19917;14641;5276;17188;13785;3403;;3734;0.1;26964;0.74;3677186
4118;Zuid-Holland (PV);2017 november;3677186;3276;2486;18095;13448;4647;15865;12823;3042;;3020;0.08;29984;0.82;3680206
4119;Zuid-Holland (PV);2017 december;3680206;3217;2903;17024;13438;3586;16244;12935;3309;-256.0;838;0.02;30822;0.84;3681044
4120;Zuid-Holland (PV);2017;3650222;39428;30873;226617;170141;56476;204094;161550;42544;-256.0;30822;0.84;30822;0.84;3681044
4121;Zuid-Holland (PV);2018 januari;3681044;3369;3175;18395;14152;4243;17192;13851;3341;;1397;0.04;1397;0.04;3682441
4122;Zuid-Holland (PV);2018 februari;3682441;2898;2833;17502;12927;4575;15232;12617;2615;;2335;0.06;3732;0.1;3684776
4123;Zuid-Holland (PV);2018 maart;3684776;3175;3266;16895;13236;3659;15767;12806;2961;;1037;0.03;4769;0.13;3685813
4124;Zuid-Holland (PV);2018 april;3685813;3065;2512;15562;12103;3459;14262;11793;2469;;1853;0.05;6622;0.18;3687666
4125;Zuid-Holland (PV);2018 mei;3687666;3390;2373;16183;12275;3908;14656;12055;2601;;2544;0.07;9166;0.25;3690210
4126;Zuid-Holland (PV);2018 juni;3690210;3338;2346;16286;12556;3730;15777;12216;3561;;1501;0.04;10667;0.29;3691711
4127;Zuid-Holland (PV);2018 juli;3691711;3577;2459;18704;14085;4619;19469;14166;5303;;353;0.01;11020;0.3;3692064
4128;Zuid-Holland (PV);2018 augustus;3692064;3594;2487;24266;15909;8357;20756;15864;4892;;4617;0.13;15637;0.42;3696681
4129;Zuid-Holland (PV);2018 september;3696681;3500;2321;21898;14070;7828;17078;13516;3562;;5999;0.16;21636;0.59;3702680
4130;Zuid-Holland (PV);2018 oktober;3702680;3304;2561;19843;14217;5626;17325;13909;3416;;3261;0.09;24897;0.68;3705941
4131;Zuid-Holland (PV);2018 november;3705941;3113;2562;18167;13030;5137;15740;12675;3065;;2978;0.08;27875;0.76;3708919
4132;Zuid-Holland (PV);2018 december;3708919;2993;2637;16081;12425;3656;15916;12551;3365;-279.0;242;0.01;28117;0.76;3709161
4133;Zuid-Holland (PV);2018;3681044;39316;31532;219782;160985;58797;199170;158019;41151;-279.0;28117;0.76;28117;0.76;3709161
4134;Zuid-Holland (PV);2019 januari;3673893;3384;2897;18641;13732;4909;16641;13396;3245;;2487;0.07;2487;0.07;3676380
4135;Zuid-Holland (PV);2019 februari;3676380;2791;2610;17761;12684;5077;15074;12416;2658;;2868;0.08;5355;0.15;3679248
4136;Zuid-Holland (PV);2019 maart;3679248;3153;2775;17568;12992;4576;15535;12840;2695;;2411;0.07;7766;0.21;3681659
4137;Zuid-Holland (PV);2019 april;3681659;3107;2493;16701;12528;4173;15358;12557;2801;;1957;0.05;9723;0.26;3683616
4138;Zuid-Holland (PV);2019 mei;3683616;3392;2570;17184;12725;4459;15349;12658;2691;;2657;0.07;12380;0.34;3686273
4139;Zuid-Holland (PV);2019 juni;3686273;3300;2322;15300;11373;3927;14688;11323;3365;;1590;0.04;13970;0.38;3687863
4140;Zuid-Holland (PV);2019 juli;3687863;3603;2519;20315;14897;5418;20160;15012;5148;;1239;0.03;15209;0.41;3689102
4141;Zuid-Holland (PV);2019 augustus;3689102;3557;2331;24011;15284;8727;19784;15247;4537;;5453;0.15;20662;0.56;3694555
4142;Zuid-Holland (PV);2019 september;3694555;3516;2313;23702;14503;9199;17556;13939;3617;;7349;0.2;28011;0.76;3701904
4143;Zuid-Holland (PV);2019 oktober;3701904;3328;2564;19996;13574;6422;16476;13346;3130;;4284;0.12;32295;0.88;3706188
4144;Zuid-Holland (PV);2019 november;3706188;3141;2677;17405;12857;4548;15765;12699;3066;;2104;0.06;34399;0.94;3708292
4145;Zuid-Holland (PV);2019 december;3708292;3018;2800;16785;13056;3729;16474;12959;3515;-125.0;404;0.01;34803;0.95;3708696
4146;Zuid-Holland (PV);2019;3673893;39290;30871;225369;160205;65164;198860;158392;40468;-125.0;34803;0.95;34803;0.95;3708696
4147;Zuid-Holland (PV);2020 januari;3708696;3352;2855;19126;14326;4800;17922;14172;3750;;1701;0.05;1701;0.05;3710397
4148;Zuid-Holland (PV);2020 februari;3710397;2950;2551;17909;12969;4940;15879;12764;3115;;2429;0.07;4130;0.11;3712826
4149;Zuid-Holland (PV);2020 maart;3712826;3114;2859;16996;13163;3833;16334;13216;3118;;917;0.02;5047;0.14;3713743
4150;Zuid-Holland (PV);2020 april;3713743;3034;3791;14744;12071;2673;14374;12168;2206;;-387;-0.01;4660;0.13;3713356
4151;Zuid-Holland (PV);2020 mei;3713356;3175;2694;14820;12611;2209;14569;12701;1868;;732;0.02;5392;0.15;3714088
4152;Zuid-Holland (PV);2020 juni;3714088;3204;2410;16434;13338;3096;16290;13485;2805;;938;0.03;6330;0.17;3715026
4153;Zuid-Holland (PV);2020 juli;3715026;3589;2454;20190;15867;4323;20370;15920;4450;;955;0.03;7285;0.2;3715981
4154;Zuid-Holland (PV);2020 augustus;3715981;3373;2655;21761;16196;5565;20938;16594;4344;;1541;0.04;8826;0.24;3717522
4155;Zuid-Holland (PV);2020 september;3717522;3346;2545;24084;15799;8285;18693;15247;3446;;6192;0.17;15018;0.4;3723714
4156;Zuid-Holland (PV);2020 oktober;3723714;3264;3235;21127;15619;5508;19209;15465;3744;;1947;0.05;16965;0.46;3725661
4157;Zuid-Holland (PV);2020 november;3725661;3176;3313;18303;13958;4345;17346;13681;3665;;820;0.02;17785;0.48;3726481
4158;Zuid-Holland (PV);2020 december;3726481;3021;3372;18035;14111;3924;17909;13987;3922;-206.0;-431;-0.01;17354;0.47;3726050
4159;Zuid-Holland (PV);2020;3708696;38598;34734;223529;170028;53501;209833;169400;40433;-206.0;17354;0.47;17354;0.47;3726050
4160;Zuid-Holland (PV);2021 januari;3726050;3215;3522;19353;15255;4098;18321;15492;2829;0.0;725;0.02;725;0.02;3726775
4161;Zuid-Holland (PV);2021 februari;3726775;3041;2778;17951;13936;4015;16410;13944;2466;0.0;1804;0.05;2529;0.07;3728579
4162;Zuid-Holland (PV);2021 maart;3728579;3377;2874;19611;15546;4065;18489;15728;2761;0.0;1625;0.04;4154;0.11;3730204
4163;Zuid-Holland (PV);2021 april;3730204;3256;2760;17324;14038;3286;16794;14448;2346;0.0;1026;0.03;5180;0.14;3731230
4164;Zuid-Holland (PV);2021 mei;3731230;3404;2683;16294;13194;3100;15641;13405;2236;0.0;1374;0.04;6554;0.18;3732604
4165;Zuid-Holland (PV);2021 juni;3732604;3284;2346;16827;13510;3317;16555;13439;3116;0.0;1210;0.03;7764;0.21;3733814
4166;Zuid-Holland (PV);2021 juli;3733814;3602;2573;19257;14882;4375;19779;15835;3944;0.0;507;0.01;8271;0.22;3734321
4167;Zuid-Holland (PV);2021 augustus;3734321;3586;2613;24064;16042;8022;20471;16262;4209;0.0;4566;0.12;12837;0.34;3738887
4168;Zuid-Holland (PV);2021 september;3738887;3772;2573;24244;14688;9556;17807;14625;3182;0.0;7636;0.2;20473;0.55;3746523
4169;Zuid-Holland (PV);2021 oktober;3746523;3471;2790;19555;13743;5812;16529;13775;2754;0.0;3707;0.1;24180;0.65;3750230
4170;Zuid-Holland (PV);2021 november;3750230;3298;3240;18388;13522;4866;15780;13184;2596;0.0;2666;0.07;26846;0.72;3752896
4171;Zuid-Holland (PV);2021 december;3752896;3217;3536;18639;14127;4512;17155;14132;3023;-117.0;1048;0.03;27894;0.75;3753944
4172;Zuid-Holland (PV);2021;3726050;40523;34288;231507;172483;59024;209731;174269;35462;-117.0;27894;0.75;27894;0.75;3753944
4173;Zuid-Holland (PV);2022 januari;3753944;3177;2959;18039;13516;4523;16582;13421;3161;;1675;0.04;1675;0.04;3755619
4174;Zuid-Holland (PV);2022 februari;3755619;2882;2671;17846;12862;4984;15243;12466;2777;;2814;0.07;4489;0.12;3758433
4175;Zuid-Holland (PV);2022 maart;3758433;3070;3025;24319;13696;10623;16167;13443;2724;;8197;0.22;12686;0.34;3766630
4176;Zuid-Holland (PV);2022 april;3766630;2891;2886;23346;13191;10155;15995;13379;2616;;7356;0.2;20042;0.53;3773986
4177;Zuid-Holland (PV);2022 mei;3773986;3202;2650;20496;13341;7155;15895;13050;2845;;5153;0.14;25195;0.67;3779139
4178;Zuid-Holland (PV);2022 juni;3779139;3137;2710;19117;13382;5735;17124;13214;3910;;2420;0.06;27615;0.74;3781559
4179;Zuid-Holland (PV);2022 juli;3781559;3338;2703;20736;14729;6007;20461;15387;5074;;910;0.02;28525;0.76;3782469
4180;Zuid-Holland (PV);2022 augustus;3782469;3416;2668;26641;16268;10373;21605;16299;5306;;5784;0.15;34309;0.91;3788253
4181;Zuid-Holland (PV);2022 september;3788253;3579;2647;27161;16084;11077;19818;15540;4278;;8275;0.22;42584;1.13;3796528
4182;Zuid-Holland (PV);2022 oktober;3796528;3205;2958;21473;14856;6617;17883;14213;3670;;3837;0.1;46421;1.24;3800365
4183;Zuid-Holland (PV);2022 november;3800365;2967;2820;20853;14092;6761;16985;13681;3304;;4015;0.11;50436;1.34;3804380
4184;Zuid-Holland (PV);2022 december;3804380;2994;3523;19305;14311;4994;18115;14196;3919;-135.0;526;0.01;50962;1.36;3804906
4185;Zuid-Holland (PV);2022;3753944;37858;34220;259332;170328;89004;211873;168289;43584;-135.0;50962;1.36;50962;1.36;3804906
4186;Zuid-Holland (PV);2023 januari;3804906;3006;3308;20470;14801;5669;18551;14530;4021;0.0;1617;0.04;1617;0.04;3806523
4187;Zuid-Holland (PV);2023 februari;3806523;2792;2747;19824;13531;6293;16867;13228;3639;0.0;3002;0.08;4619;0.12;3809525
4188;Zuid-Holland (PV);2023 maart;3809525;3114;3176;19864;14241;5623;17543;13903;3640;0.0;2259;0.06;6878;0.18;3811784
4189;Zuid-Holland (PV);2023 april;3811784;3050;2609;16906;12598;4308;15532;12337;3195;0.0;1815;0.05;8693;0.23;3813599
4190;Zuid-Holland (PV);2023 mei;3813599;3189;2667;18106;13431;4675;16221;13139;3082;0.0;2407;0.06;11100;0.29;3816006
4191;Zuid-Holland (PV);2023 juni;3816006;3223;2560;19725;14574;5151;18452;14362;4090;0.0;1936;0.05;13036;0.34;3817942
4192;Zuid-Holland (PV);2023 juli;3817942;3355;2523;22486;17048;5438;22169;16673;5496;0.0;1149;0.03;14185;0.37;3819091
4193;Zuid-Holland (PV);2023 augustus;3819091;3343;2604;27606;17867;9739;22360;17039;5321;0.0;5985;0.16;20170;0.53;3825076
4194;Zuid-Holland (PV);2023 september;3825076;3163;2594;26603;17150;9453;19885;15771;4114;0.0;7287;0.19;27457;0.72;3832363
4195;Zuid-Holland (PV);2023 oktober;3832363;3114;2774;22874;15541;7333;18447;14776;3671;0.0;4767;0.12;32224;0.85;3837130
4196;Zuid-Holland (PV);2023 november;3837130;3122;3000;20048;14379;5669;17191;13691;3500;0.0;2979;0.08;35203;0.93;3840109
4197;Zuid-Holland (PV);2023 december;3840109;2956;3198;18709;14163;4546;17921;13964;3957;-195.0;351;0.01;35554;0.93;3840460
4198;Zuid-Holland (PV);2023;3804906;37427;33760;253221;179324;73897;221139;173413;47726;-195.0;35554;0.93;35554;0.93;3840460
4199;Zuid-Holland (PV);2024 januari;3840460;3047;3385;20113;14530;5583;18702;14401;4301;;1073;0.03;1073;0.03;3841533
4200;Zuid-Holland (PV);2024 februari;3841533;2790;3067;19333;13717;5616;17279;13437;3842;;1777;0.05;2850;0.07;3843310
4201;Zuid-Holland (PV);2024 maart;3843310;3152;3016;18738;13745;4993;16751;13523;3228;;2123;0.06;4973;0.13;3845433
4202;Zuid-Holland (PV);2024 april;3845433;2929;2803;17821;13307;4514;15977;12898;3079;;1970;0.05;6943;0.18;3847403
4203;Zuid-Holland (PV);2024 mei;3847403;3168;2692;17823;13626;4197;16734;13437;3297;;1565;0.04;8508;0.22;3848968
4204;Zuid-Holland (PV);2024 juni;3848968;3020;2662;17305;13020;4285;17295;12870;4425;;368;0.01;8876;0.23;3849336
4205;Zuid-Holland (PV);2024 juli;3849336;3250;2680;21144;15732;5412;21504;15615;5889;;210;0.01;9086;0.24;3849546
4206;Zuid-Holland (PV);2024 augustus;3849546;3366;2657;24129;15731;8398;20649;15533;5116;;4189;0.11;13275;0.35;3853735
4207;Zuid-Holland (PV);2024 september;3853735;3253;2567;24022;15131;8891;19338;14811;4527;;5370;0.14;18645;0.49;3859105
4208;Zuid-Holland (PV);2024 oktober;3859105;3190;2883;21205;14953;6252;18762;14748;4014;;2750;0.07;21395;0.56;3861855
4209;Zuid-Holland (PV);2024 november;3861855;2942;2843;18265;13438;4827;17004;13266;3738;;1360;0.04;22755;0.59;3863215
4210;Zuid-Holland (PV);2024 december;3863215;3001;3036;17802;14005;3797;18062;13680;4382;0.0;-295;-0.01;22460;0.58;3862920
4211;Zuid-Holland (PV);2024;3840460;37108;34291;237700;170935;66765;218057;168219;49838;0.0;22460;0.58;22460;0.58;3862920
4212;Zuid-Holland (PV);2025 januari;3862920;3034;3478;20584;15703;4881;18467;14467;4000;;1673;0.04;1673;0.04;3864593
4213;Zuid-Holland (PV);2025 februari;3864593;2769;3236;19236;14119;5117;17509;13554;3955;;1260;0.03;2933;0.08;3865853
4214;Zeeland (PV);2002 januari;377235;380;390;1414;1125;289;1289;1150;139;;115;0.03;115;0.03;377350
4215;Zeeland (PV);2002 februari;377350;361;344;1092;877;215;1047;906;141;;62;0.02;177;0.05;377412
4216;Zeeland (PV);2002 maart;377412;334;378;1276;1026;250;1176;1027;149;;56;0.01;233;0.06;377468
4217;Zeeland (PV);2002 april;377468;339;346;1182;993;189;1131;1011;120;;44;0.01;277;0.07;377512
4218;Zeeland (PV);2002 mei;377512;366;294;1367;1201;166;1186;1079;107;;253;0.07;530;0.14;377765
4219;Zeeland (PV);2002 juni;377765;326;285;1329;1167;162;1222;1085;137;;148;0.04;678;0.18;377913
4220;Zeeland (PV);2002 juli;377913;385;324;1732;1496;236;1533;1362;171;;260;0.07;938;0.25;378173
4221;Zeeland (PV);2002 augustus;378173;361;313;1678;1415;263;1720;1498;222;;6;0.0;944;0.25;378179
4222;Zeeland (PV);2002 september;378179;391;260;1452;1255;197;1657;1496;161;;-74;-0.02;870;0.23;378105
4223;Zeeland (PV);2002 oktober;378105;352;289;1439;1246;193;1359;1213;146;;143;0.04;1013;0.27;378248
4224;Zeeland (PV);2002 november;378248;315;329;1267;1054;213;1347;1104;243;;-94;-0.02;919;0.24;378154
4225;Zeeland (PV);2002 december;378154;335;350;1174;1025;149;1120;1004;116;155.0;194;0.05;1113;0.3;378348
4226;Zeeland (PV);2002;377235;4245;3902;16402;13880;2522;15787;13935;1852;155.0;1113;0.3;1113;0.3;378348
4227;Zeeland (PV);2003 januari;378348;352;329;1455;1224;231;1331;1202;129;;147;0.04;147;0.04;378495
4228;Zeeland (PV);2003 februari;378495;340;308;1010;866;144;997;862;135;;45;0.01;192;0.05;378540
4229;Zeeland (PV);2003 maart;378540;314;350;1156;980;176;1095;949;146;;25;0.01;217;0.06;378565
4230;Zeeland (PV);2003 april;378565;348;308;1090;941;149;995;852;143;;135;0.04;352;0.09;378700
4231;Zeeland (PV);2003 mei;378700;367;303;1139;1004;135;1061;947;114;;142;0.04;494;0.13;378842
4232;Zeeland (PV);2003 juni;378842;366;269;1109;957;152;1049;927;122;;157;0.04;651;0.17;378999
4233;Zeeland (PV);2003 juli;378999;375;288;1556;1358;198;1593;1350;243;;50;0.01;701;0.19;379049
4234;Zeeland (PV);2003 augustus;379049;401;288;1474;1293;181;1525;1379;146;;62;0.02;763;0.2;379111
4235;Zeeland (PV);2003 september;379111;379;285;1404;1199;205;1664;1532;132;;-166;-0.04;597;0.16;378945
4236;Zeeland (PV);2003 oktober;378945;347;304;1324;1199;125;1441;1314;127;;-74;-0.02;523;0.14;378871
4237;Zeeland (PV);2003 november;378871;312;268;1125;977;148;1139;1023;116;;30;0.01;553;0.15;378901
4238;Zeeland (PV);2003 december;378901;298;359;1240;1137;103;1169;993;176;117.0;127;0.03;680;0.18;379028
4239;Zeeland (PV);2003;378348;4199;3659;15082;13135;1947;15059;13330;1729;117.0;680;0.18;680;0.18;379028
4240;Zeeland (PV);2004 januari;379028;351;387;1172;1038;134;1118;994;124;;18;0.0;18;0.0;379046
4241;Zeeland (PV);2004 februari;379046;341;310;1034;948;86;1017;879;138;;48;0.01;66;0.02;379094
4242;Zeeland (PV);2004 maart;379094;321;321;1184;1053;131;1100;977;123;;84;0.02;150;0.04;379178
4243;Zeeland (PV);2004 april;379178;285;291;1034;935;99;994;851;143;;34;0.01;184;0.05;379212
4244;Zeeland (PV);2004 mei;379212;337;275;1040;889;151;892;805;87;;210;0.06;394;0.1;379422
4245;Zeeland (PV);2004 juni;379422;347;273;1216;1040;176;1053;927;126;;237;0.06;631;0.17;379659
4246;Zeeland (PV);2004 juli;379659;334;271;1393;1221;172;1300;1102;198;;156;0.04;787;0.21;379815
4247;Zeeland (PV);2004 augustus;379815;389;303;1478;1295;183;1550;1387;163;;14;0.0;801;0.21;379829
4248;Zeeland (PV);2004 september;379829;357;276;1457;1272;185;1621;1479;142;;-83;-0.02;718;0.19;379746
4249;Zeeland (PV);2004 oktober;379746;364;309;1185;1056;129;1170;1010;160;;70;0.02;788;0.21;379816
4250;Zeeland (PV);2004 november;379816;333;307;1150;1028;122;1179;1038;141;;-3;0.0;785;0.21;379813
4251;Zeeland (PV);2004 december;379813;329;332;1259;1123;136;1191;1037;154;100.0;165;0.04;950;0.25;379978
4252;Zeeland (PV);2004;379028;4088;3655;14602;12898;1704;14185;12486;1699;100.0;950;0.25;950;0.25;379978
4253;Zeeland (PV);2005 januari;379978;353;316;1302;1175;127;1224;1074;150;;115;0.03;115;0.03;380093
4254;Zeeland (PV);2005 februari;380093;288;351;1124;988;136;1211;959;252;;-150;-0.04;-35;-0.01;379943
4255;Zeeland (PV);2005 maart;379943;304;331;1166;1045;121;1135;975;160;;4;0.0;-31;-0.01;379947
4256;Zeeland (PV);2005 april;379947;319;318;1241;1098;143;1157;991;166;;85;0.02;54;0.01;380032
4257;Zeeland (PV);2005 mei;380032;328;301;1125;1005;120;1057;888;169;;95;0.02;149;0.04;380127
4258;Zeeland (PV);2005 juni;380127;353;302;1193;1032;161;1063;918;145;;181;0.05;330;0.09;380308
4259;Zeeland (PV);2005 juli;380308;338;290;1523;1375;148;1428;1196;232;;143;0.04;473;0.12;380451
4260;Zeeland (PV);2005 augustus;380451;372;265;1762;1569;193;1905;1697;208;;-36;-0.01;437;0.12;380415
4261;Zeeland (PV);2005 september;380415;353;271;1557;1375;182;1792;1526;266;;-153;-0.04;284;0.07;380262
4262;Zeeland (PV);2005 oktober;380262;318;304;1285;1138;147;1337;1091;246;;-38;-0.01;246;0.06;380224
4263;Zeeland (PV);2005 november;380224;281;318;1218;1086;132;1187;1024;163;;-6;0.0;240;0.06;380218
4264;Zeeland (PV);2005 december;380218;306;328;1186;1057;129;1280;1067;213;84.0;-32;-0.01;208;0.05;380186
4265;Zeeland (PV);2005;379978;3913;3695;15682;13943;1739;15776;13406;2370;84.0;208;0.05;208;0.05;380186
4266;Zeeland (PV);2006 januari;380186;304;347;1301;1135;166;1282;1071;211;;-24;-0.01;-24;-0.01;380162
4267;Zeeland (PV);2006 februari;380162;303;297;1131;992;139;1156;1007;149;;-19;0.0;-43;-0.01;380143
4268;Zeeland (PV);2006 maart;380143;318;337;1239;1055;184;1261;1083;178;;-41;-0.01;-84;-0.02;380102
4269;Zeeland (PV);2006 april;380102;298;291;1113;981;132;1101;938;163;;19;0.0;-65;-0.02;380121
4270;Zeeland (PV);2006 mei;380121;309;254;1177;1049;128;1049;917;132;;183;0.05;118;0.03;380304
4271;Zeeland (PV);2006 juni;380304;329;291;1249;1125;124;1187;1019;168;;100;0.03;218;0.06;380404
4272;Zeeland (PV);2006 juli;380404;324;288;1580;1430;150;1401;1236;165;;215;0.06;433;0.11;380619
4273;Zeeland (PV);2006 augustus;380619;350;309;1747;1533;214;1896;1701;195;;-108;-0.03;325;0.09;380511
4274;Zeeland (PV);2006 september;380511;334;281;1288;1096;192;1596;1428;168;;-255;-0.07;70;0.02;380256
4275;Zeeland (PV);2006 oktober;380256;353;271;1369;1197;172;1276;1123;153;;175;0.05;245;0.06;380431
4276;Zeeland (PV);2006 november;380431;302;303;1209;1072;137;1181;1031;150;;27;0.01;272;0.07;380458
4277;Zeeland (PV);2006 december;380458;293;338;1170;1054;116;1131;946;185;45.0;39;0.01;311;0.08;380497
4278;Zeeland (PV);2006;380186;3817;3607;15573;13719;1854;15517;13500;2017;45.0;311;0.08;311;0.08;380497
4279;Zeeland (PV);2007 januari;380497;322;315;1407;1227;180;1380;1152;228;;34;0.01;34;0.01;380531
4280;Zeeland (PV);2007 februari;380531;281;278;1147;966;181;1124;913;211;;26;0.01;60;0.02;380557
4281;Zeeland (PV);2007 maart;380557;311;353;1325;1104;221;1215;1042;173;;68;0.02;128;0.03;380625
4282;Zeeland (PV);2007 april;380625;308;266;1071;928;143;1036;850;186;;77;0.02;205;0.05;380702
4283;Zeeland (PV);2007 mei;380702;292;286;1069;931;138;993;820;173;;82;0.02;287;0.08;380784
4284;Zeeland (PV);2007 juni;380784;313;283;1165;992;173;1181;952;229;;14;0.0;301;0.08;380798
4285;Zeeland (PV);2007 juli;380798;305;282;1469;1254;215;1364;1170;194;;128;0.03;429;0.11;380926
4286;Zeeland (PV);2007 augustus;380926;336;290;1600;1400;200;1768;1559;209;;-122;-0.03;307;0.08;380804
4287;Zeeland (PV);2007 september;380804;333;303;1304;1085;219;1510;1351;159;;-176;-0.05;131;0.03;380628
4288;Zeeland (PV);2007 oktober;380628;369;265;1337;1123;214;1480;1241;239;;-39;-0.01;92;0.02;380589
4289;Zeeland (PV);2007 november;380589;294;305;1252;1056;196;1341;1146;195;;-100;-0.03;-8;0.0;380489
4290;Zeeland (PV);2007 december;380489;287;319;1132;979;153;1073;908;165;69.0;96;0.03;88;0.02;380585
4291;Zeeland (PV);2007;380497;3751;3545;15278;13045;2233;15465;13104;2361;69.0;88;0.02;88;0.02;380585
4292;Zeeland (PV);2008 januari;380585;311;348;1478;1250;228;1353;1158;195;;88;0.02;88;0.02;380673
4293;Zeeland (PV);2008 februari;380673;302;323;1268;1037;231;1211;1043;168;;36;0.01;124;0.03;380709
4294;Zeeland (PV);2008 maart;380709;328;345;1153;957;196;1101;935;166;;35;0.01;159;0.04;380744
4295;Zeeland (PV);2008 april;380744;317;335;1163;978;185;1136;906;230;;9;0.0;168;0.04;380753
4296;Zeeland (PV);2008 mei;380753;319;320;1023;855;168;949;829;120;;73;0.02;241;0.06;380826
4297;Zeeland (PV);2008 juni;380826;293;299;1147;951;196;1110;947;163;;31;0.01;272;0.07;380857
4298;Zeeland (PV);2008 juli;380857;356;283;1620;1397;223;1540;1319;221;;153;0.04;425;0.11;381010
4299;Zeeland (PV);2008 augustus;381010;312;242;1669;1347;322;1757;1518;239;;-18;0.0;407;0.11;380992
4300;Zeeland (PV);2008 september;380992;363;267;1571;1217;354;1804;1622;182;;-137;-0.04;270;0.07;380855
4301;Zeeland (PV);2008 oktober;380855;343;295;1312;1086;226;1389;1164;225;;-29;-0.01;241;0.06;380826
4302;Zeeland (PV);2008 november;380826;327;293;1206;935;271;1296;1024;272;;-56;-0.01;185;0.05;380770
4303;Zeeland (PV);2008 december;380770;336;305;1163;983;180;1107;943;164;127.0;214;0.06;399;0.1;380984
4304;Zeeland (PV);2008;380585;3907;3655;15773;12993;2780;15753;13408;2345;127.0;399;0.1;399;0.1;380984
4305;Zeeland (PV);2009 januari;380984;316;407;1313;1001;312;1087;961;126;;135;0.04;135;0.04;381119
4306;Zeeland (PV);2009 februari;381119;271;296;1089;864;225;1038;919;119;;26;0.01;161;0.04;381145
4307;Zeeland (PV);2009 maart;381145;304;273;1172;941;231;1081;942;139;;122;0.03;283;0.07;381267
4308;Zeeland (PV);2009 april;381267;339;302;981;782;199;977;769;208;;41;0.01;324;0.09;381308
4309;Zeeland (PV);2009 mei;381308;295;280;1045;828;217;906;814;92;;154;0.04;478;0.13;381462
4310;Zeeland (PV);2009 juni;381462;299;284;1171;902;269;1016;869;147;;170;0.04;648;0.17;381632
4311;Zeeland (PV);2009 juli;381632;316;262;1394;1155;239;1296;1116;180;;152;0.04;800;0.21;381784
4312;Zeeland (PV);2009 augustus;381784;333;280;1366;1141;225;1716;1485;231;;-297;-0.08;503;0.13;381487
4313;Zeeland (PV);2009 september;381487;331;281;1536;1226;310;1662;1499;163;;-76;-0.02;427;0.11;381411
4314;Zeeland (PV);2009 oktober;381411;292;253;1127;821;306;1240;982;258;;-74;-0.02;353;0.09;381337
4315;Zeeland (PV);2009 november;381337;309;268;1038;764;274;1066;888;178;;13;0.0;366;0.1;381350
4316;Zeeland (PV);2009 december;381350;323;315;1081;915;166;1078;935;143;48.0;59;0.02;425;0.11;381409
4317;Zeeland (PV);2009;380984;3728;3501;14313;11340;2973;14163;12179;1984;48.0;425;0.11;425;0.11;381409
4318;Zeeland (PV);2010 januari;381409;307;381;1144;915;229;1048;917;131;;22;0.01;22;0.01;381431
4319;Zeeland (PV);2010 februari;381431;296;319;1163;905;258;996;890;106;;144;0.04;166;0.04;381575
4320;Zeeland (PV);2010 maart;381575;291;335;1177;906;271;1067;839;228;;66;0.02;232;0.06;381641
4321;Zeeland (PV);2010 april;381641;300;298;1054;851;203;986;873;113;;70;0.02;302;0.08;381711
4322;Zeeland (PV);2010 mei;381711;287;273;940;768;172;887;770;117;;67;0.02;369;0.1;381778
4323;Zeeland (PV);2010 juni;381778;287;285;1088;850;238;996;829;167;;94;0.02;463;0.12;381872
4324;Zeeland (PV);2010 juli;381872;307;312;1327;1012;315;1253;1071;182;;69;0.02;532;0.14;381941
4325;Zeeland (PV);2010 augustus;381941;326;250;1595;1197;398;1715;1560;155;;-44;-0.01;488;0.13;381897
4326;Zeeland (PV);2010 september;381897;339;295;1488;1121;367;1780;1495;285;;-248;-0.06;240;0.06;381649
4327;Zeeland (PV);2010 oktober;381649;345;310;1149;941;208;1227;999;228;;-43;-0.01;197;0.05;381606
4328;Zeeland (PV);2010 november;381606;317;325;1117;904;213;1092;912;180;;17;0.0;214;0.06;381623
4329;Zeeland (PV);2010 december;381623;295;367;1169;982;187;1171;996;175;-19.0;-93;-0.02;121;0.03;381530
4330;Zeeland (PV);2010;381409;3697;3750;14411;11352;3059;14218;12151;2067;-19.0;121;0.03;121;0.03;381530
4331;Zeeland (PV);2011 januari;381530;330;314;1335;1067;268;1272;1067;205;;79;0.02;79;0.02;381609
4332;Zeeland (PV);2011 februari;381609;317;285;1133;858;275;1072;921;151;;93;0.02;172;0.05;381702
4333;Zeeland (PV);2011 maart;381702;293;331;1390;975;415;1128;975;153;;224;0.06;396;0.1;381926
4334;Zeeland (PV);2011 april;381926;299;333;1130;855;275;1083;927;156;;13;0.0;409;0.11;381939
4335;Zeeland (PV);2011 mei;381939;335;307;1210;948;262;1061;868;193;;177;0.05;586;0.15;382116
4336;Zeeland (PV);2011 juni;382116;324;317;1116;895;221;1099;893;206;;24;0.01;610;0.16;382140
4337;Zeeland (PV);2011 juli;382140;343;280;1408;1060;348;1296;1083;213;;175;0.05;785;0.21;382315
4338;Zeeland (PV);2011 augustus;382315;323;292;1665;1272;393;1988;1739;249;;-292;-0.08;493;0.13;382023
4339;Zeeland (PV);2011 september;382023;320;274;1431;1038;393;1719;1478;241;;-242;-0.06;251;0.07;381781
4340;Zeeland (PV);2011 oktober;381781;319;309;1146;862;284;1343;1100;243;;-187;-0.05;64;0.02;381594
4341;Zeeland (PV);2011 november;381594;252;312;1107;881;226;1302;1033;269;;-255;-0.07;-191;-0.05;381339
4342;Zeeland (PV);2011 december;381339;307;316;1141;941;200;1068;890;178;4.0;68;0.02;-123;-0.03;381407
4343;Zeeland (PV);2011;381530;3762;3670;15212;11652;3560;15431;12974;2457;4.0;-123;-0.03;-123;-0.03;381407
4344;Zeeland (PV);2012 januari;381407;285;338;1289;1015;274;1503;1067;436;;-267;-0.07;-267;-0.07;381140
4345;Zeeland (PV);2012 februari;381140;300;332;1133;825;308;1091;888;203;;10;0.0;-257;-0.07;381150
4346;Zeeland (PV);2012 maart;381150;344;362;1205;928;277;1159;923;236;;28;0.01;-229;-0.06;381178
4347;Zeeland (PV);2012 april;381178;311;295;1056;814;242;989;759;230;;83;0.02;-146;-0.04;381261
4348;Zeeland (PV);2012 mei;381261;283;292;1163;887;276;1088;896;192;;66;0.02;-80;-0.02;381327
4349;Zeeland (PV);2012 juni;381327;300;279;1273;985;288;1128;884;244;;166;0.04;86;0.02;381493
4350;Zeeland (PV);2012 juli;381493;303;300;1478;1131;347;1287;1119;168;;194;0.05;280;0.07;381687
4351;Zeeland (PV);2012 augustus;381687;340;297;1792;1321;471;2004;1778;226;;-169;-0.04;111;0.03;381518
4352;Zeeland (PV);2012 september;381518;303;296;1260;920;340;1535;1356;179;;-268;-0.07;-157;-0.04;381250
4353;Zeeland (PV);2012 oktober;381250;308;286;1241;892;349;1306;1005;301;;-43;-0.01;-200;-0.05;381207
4354;Zeeland (PV);2012 november;381207;267;357;1127;863;264;1137;948;189;;-100;-0.03;-300;-0.08;381107
4355;Zeeland (PV);2012 december;381107;291;319;1133;907;226;1122;953;169;-13.0;-30;-0.01;-330;-0.09;381077
4356;Zeeland (PV);2012;381407;3635;3753;15150;11488;3662;15349;12576;2773;-13.0;-330;-0.09;-330;-0.09;381077
4357;Zeeland (PV);2013 januari;381077;335;368;1409;1106;303;1305;1095;210;;71;0.02;71;0.02;381148
4358;Zeeland (PV);2013 februari;381148;278;378;1195;881;314;1074;899;175;;21;0.01;92;0.02;381169
4359;Zeeland (PV);2013 maart;381169;300;372;1120;889;231;1037;874;163;;11;0.0;103;0.03;381180
4360;Zeeland (PV);2013 april;381180;285;362;1085;841;244;985;792;193;;23;0.01;126;0.03;381203
4361;Zeeland (PV);2013 mei;381203;277;301;1125;871;254;1080;909;171;;21;0.01;147;0.04;381224
4362;Zeeland (PV);2013 juni;381224;299;302;1187;904;283;1043;866;177;;141;0.04;288;0.08;381365
4363;Zeeland (PV);2013 juli;381365;323;305;1385;1052;333;1395;1176;219;;8;0.0;296;0.08;381373
4364;Zeeland (PV);2013 augustus;381373;271;272;1695;1274;421;1995;1755;240;;-301;-0.08;-5;0.0;381072
4365;Zeeland (PV);2013 september;381072;301;260;1447;1070;377;1756;1538;218;;-268;-0.07;-273;-0.07;380804
4366;Zeeland (PV);2013 oktober;380804;303;280;1218;947;271;1288;1075;213;;-47;-0.01;-320;-0.08;380757
4367;Zeeland (PV);2013 november;380757;261;305;1096;837;259;1159;975;184;;-107;-0.03;-427;-0.11;380650
4368;Zeeland (PV);2013 december;380650;280;322;1104;875;229;1095;893;202;4.0;-29;-0.01;-456;-0.12;380621
4369;Zeeland (PV);2013;381077;3513;3827;15066;11547;3519;15212;12847;2365;4.0;-456;-0.12;-456;-0.12;380621
4370;Zeeland (PV);2014 januari;380621;297;312;1300;983;317;1295;1031;264;;-10;0.0;-10;0.0;380611
4371;Zeeland (PV);2014 februari;380611;270;261;1133;911;222;1082;876;206;;60;0.02;50;0.01;380671
4372;Zeeland (PV);2014 maart;380671;286;313;1199;1001;198;1120;933;187;;52;0.01;102;0.03;380723
4373;Zeeland (PV);2014 april;380723;274;304;1147;896;251;1106;881;225;;11;0.0;113;0.03;380734
4374;Zeeland (PV);2014 mei;380734;334;297;1073;823;250;925;742;183;;185;0.05;298;0.08;380919
4375;Zeeland (PV);2014 juni;380919;310;243;1203;946;257;1144;888;256;;126;0.03;424;0.11;381045
4376;Zeeland (PV);2014 juli;381045;320;322;1479;1151;328;1448;1168;280;;29;0.01;453;0.12;381074
4377;Zeeland (PV);2014 augustus;381074;330;266;1714;1313;401;1860;1642;218;;-82;-0.02;371;0.1;380992
4378;Zeeland (PV);2014 september;380992;347;287;1383;1079;304;1701;1476;225;;-258;-0.07;113;0.03;380734
4379;Zeeland (PV);2014 oktober;380734;307;313;1304;997;307;1256;1052;204;;42;0.01;155;0.04;380776
4380;Zeeland (PV);2014 november;380776;296;302;1142;881;261;1134;944;190;;2;0.0;157;0.04;380778
4381;Zeeland (PV);2014 december;380778;276;312;1185;955;230;1203;936;267;2.0;-52;-0.01;105;0.03;380726
4382;Zeeland (PV);2014;380621;3647;3532;15262;11936;3326;15274;12569;2705;2.0;105;0.03;105;0.03;380726
4383;Zeeland (PV);2015 januari;380726;290;411;1283;991;292;1227;966;261;;-65;-0.02;-65;-0.02;380661
4384;Zeeland (PV);2015 februari;380661;245;342;1249;969;280;1112;949;163;;40;0.01;-25;-0.01;380701
4385;Zeeland (PV);2015 maart;380701;290;398;1159;942;217;1165;956;209;;-114;-0.03;-139;-0.04;380587
4386;Zeeland (PV);2015 april;380587;315;328;1142;909;233;1071;855;216;;58;0.02;-81;-0.02;380645
4387;Zeeland (PV);2015 mei;380645;311;325;1089;846;243;956;781;175;;119;0.03;38;0.01;380764
4388;Zeeland (PV);2015 juni;380764;298;333;1237;957;280;1142;872;270;;60;0.02;98;0.03;380824
4389;Zeeland (PV);2015 juli;380824;311;295;1666;1326;340;1429;1220;209;;253;0.07;351;0.09;381077
4390;Zeeland (PV);2015 augustus;381077;331;275;1833;1357;476;1785;1548;237;;104;0.03;455;0.12;381181
4391;Zeeland (PV);2015 september;381181;346;292;1498;1115;383;1557;1341;216;;-5;0.0;450;0.12;381176
4392;Zeeland (PV);2015 oktober;381176;288;320;1259;971;288;1265;1045;220;;-38;-0.01;412;0.11;381138
4393;Zeeland (PV);2015 november;381138;292;300;1225;936;289;1231;1036;195;;-14;0.0;398;0.1;381124
4394;Zeeland (PV);2015 december;381124;287;311;1467;1191;276;1317;1120;197;2.0;128;0.03;526;0.14;381252
4395;Zeeland (PV);2015;380726;3604;3930;16107;12510;3597;15257;12689;2568;2.0;526;0.14;526;0.14;381252
4396;Zeeland (PV);2016 januari;381252;283;363;1486;1029;457;1268;1055;213;;138;0.04;138;0.04;381390
4397;Zeeland (PV);2016 februari;381390;270;331;1364;994;370;1210;1030;180;;93;0.02;231;0.06;381483
4398;Zeeland (PV);2016 maart;381483;284;358;1343;1043;300;1153;959;194;;116;0.03;347;0.09;381599
4399;Zeeland (PV);2016 april;381599;303;306;1276;969;307;1277;1010;267;;-4;0.0;343;0.09;381595
4400;Zeeland (PV);2016 mei;381595;298;292;1166;935;231;1170;941;229;;2;0.0;345;0.09;381597
4401;Zeeland (PV);2016 juni;381597;296;320;1343;1016;327;1228;1038;190;;91;0.02;436;0.11;381688
4402;Zeeland (PV);2016 juli;381688;271;286;1575;1297;278;1531;1300;231;;29;0.01;465;0.12;381717
4403;Zeeland (PV);2016 augustus;381717;337;294;2027;1474;553;1995;1758;237;;75;0.02;540;0.14;381792
4404;Zeeland (PV);2016 september;381792;279;292;1757;1364;393;1837;1615;222;;-93;-0.02;447;0.12;381699
4405;Zeeland (PV);2016 oktober;381699;294;360;1529;1224;305;1569;1344;225;;-106;-0.03;341;0.09;381593
4406;Zeeland (PV);2016 november;381593;257;312;1396;1139;257;1382;1178;204;;-41;-0.01;300;0.08;381552
4407;Zeeland (PV);2016 december;381552;287;371;1474;1202;272;1375;1160;215;1.0;16;0.0;316;0.08;381568
4408;Zeeland (PV);2016;381252;3459;3885;17736;13686;4050;16995;14388;2607;1.0;316;0.08;316;0.08;381568
4409;Zeeland (PV);2017 januari;381568;247;439;1553;1255;298;1417;1217;200;;-56;-0.01;-56;-0.01;381512
4410;Zeeland (PV);2017 februari;381512;291;388;1460;1171;289;1279;1096;183;;84;0.02;28;0.01;381596
4411;Zeeland (PV);2017 maart;381596;281;340;1590;1296;294;1315;1113;202;;216;0.06;244;0.06;381812
4412;Zeeland (PV);2017 april;381812;275;309;1269;1065;204;1221;1044;177;;14;0.0;258;0.07;381826
4413;Zeeland (PV);2017 mei;381826;278;305;1399;1107;292;1257;1032;225;;115;0.03;373;0.1;381941
4414;Zeeland (PV);2017 juni;381941;304;314;1372;1084;288;1285;1062;223;;77;0.02;450;0.12;382018
4415;Zeeland (PV);2017 juli;382018;306;276;1602;1281;321;1615;1370;245;;17;0.0;467;0.12;382035
4416;Zeeland (PV);2017 augustus;382035;293;306;2095;1585;510;1932;1682;250;;150;0.04;617;0.16;382185
4417;Zeeland (PV);2017 september;382185;293;305;1580;1272;308;1633;1428;205;;-65;-0.02;552;0.14;382120
4418;Zeeland (PV);2017 oktober;382120;308;305;1502;1159;343;1516;1230;286;;-11;0.0;541;0.14;382109
4419;Zeeland (PV);2017 november;382109;271;330;1585;1229;356;1368;1183;185;;158;0.04;699;0.18;382267
4420;Zeeland (PV);2017 december;382267;292;327;1418;1189;229;1324;1103;221;-22.0;37;0.01;736;0.19;382304
4421;Zeeland (PV);2017;381568;3439;3944;18425;14693;3732;17162;14560;2602;-22.0;736;0.19;736;0.19;382304
4422;Zeeland (PV);2018 januari;382304;284;367;1659;1246;413;1401;1209;192;;175;0.05;175;0.05;382479
4423;Zeeland (PV);2018 februari;382479;253;399;1435;1117;318;1275;1084;191;;14;0.0;189;0.05;382493
4424;Zeeland (PV);2018 maart;382493;277;448;1512;1201;311;1415;1155;260;;-74;-0.02;115;0.03;382419
4425;Zeeland (PV);2018 april;382419;298;303;1311;1034;277;1147;952;195;;159;0.04;274;0.07;382578
4426;Zeeland (PV);2018 mei;382578;294;330;1258;952;306;1144;941;203;;78;0.02;352;0.09;382656
4427;Zeeland (PV);2018 juni;382656;268;278;1597;1285;312;1368;1148;220;;219;0.06;571;0.15;382875
4428;Zeeland (PV);2018 juli;382875;297;331;1814;1407;407;1670;1392;278;;110;0.03;681;0.18;382985
4429;Zeeland (PV);2018 augustus;382985;283;285;2139;1455;684;1918;1636;282;;219;0.06;900;0.24;383204
4430;Zeeland (PV);2018 september;383204;297;304;1492;1143;349;1626;1348;278;;-141;-0.04;759;0.2;383063
4431;Zeeland (PV);2018 oktober;383063;295;317;1519;1137;382;1428;1177;251;;69;0.02;828;0.22;383132
4432;Zeeland (PV);2018 november;383132;246;337;1403;1128;275;1414;1169;245;;-102;-0.03;726;0.19;383030
4433;Zeeland (PV);2018 december;383030;286;344;1332;1080;252;1288;1029;259;16.0;2;0.0;728;0.19;383032
4434;Zeeland (PV);2018;382304;3378;4043;18471;14185;4286;17094;14240;2854;16.0;728;0.19;728;0.19;383032
4435;Zeeland (PV);2019 januari;383032;271;354;1716;1229;487;1457;1237;220;;176;0.05;176;0.05;383208
4436;Zeeland (PV);2019 februari;383208;270;338;1431;1116;315;1255;1085;170;;108;0.03;284;0.07;383316
4437;Zeeland (PV);2019 maart;383316;277;351;1387;1076;311;1326;1051;275;;-13;0.0;271;0.07;383303
4438;Zeeland (PV);2019 april;383303;284;313;1307;1031;276;1333;1061;272;;-55;-0.01;216;0.06;383248
4439;Zeeland (PV);2019 mei;383248;285;329;1394;1062;332;1292;1085;207;;58;0.02;274;0.07;383306
4440;Zeeland (PV);2019 juni;383306;242;318;1376;1085;291;1279;1011;268;;21;0.01;295;0.08;383327
4441;Zeeland (PV);2019 juli;383327;328;320;1877;1450;427;1719;1446;273;;166;0.04;461;0.12;383493
4442;Zeeland (PV);2019 augustus;383493;335;307;1905;1305;600;1767;1524;243;;166;0.04;627;0.16;383659
4443;Zeeland (PV);2019 september;383659;305;280;1554;1217;337;1667;1380;287;;-88;-0.02;539;0.14;383571
4444;Zeeland (PV);2019 oktober;383571;268;313;1437;1069;368;1360;1081;279;;32;0.01;571;0.15;383603
4445;Zeeland (PV);2019 november;383603;260;361;1359;1088;271;1428;1179;249;;-170;-0.04;401;0.1;383433
4446;Zeeland (PV);2019 december;383433;297;350;1411;1144;267;1305;1076;229;2.0;55;0.01;456;0.12;383488
4447;Zeeland (PV);2019;383032;3422;3934;18154;13872;4282;17188;14216;2972;2.0;456;0.12;456;0.12;383488
4448;Zeeland (PV);2020 januari;383488;259;371;1712;1321;391;1483;1227;256;;117;0.03;117;0.03;383605
4449;Zeeland (PV);2020 februari;383605;263;359;1331;1031;300;1232;1031;201;;3;0.0;120;0.03;383608
4450;Zeeland (PV);2020 maart;383608;256;384;1662;1311;351;1349;1141;208;;185;0.05;305;0.08;383793
4451;Zeeland (PV);2020 april;383793;263;416;1429;1204;225;1148;993;155;;128;0.03;433;0.11;383921
4452;Zeeland (PV);2020 mei;383921;273;319;1314;1069;245;1095;956;139;;173;0.05;606;0.16;384094
4453;Zeeland (PV);2020 juni;384094;278;301;1478;1157;321;1253;1111;142;;202;0.05;808;0.21;384296
4454;Zeeland (PV);2020 juli;384296;321;309;1762;1386;376;1570;1303;267;;204;0.05;1012;0.26;384500
4455;Zeeland (PV);2020 augustus;384500;320;332;1911;1441;470;1681;1436;245;;218;0.06;1230;0.32;384718
4456;Zeeland (PV);2020 september;384718;294;295;1770;1305;465;1549;1302;247;;220;0.06;1450;0.38;384938
4457;Zeeland (PV);2020 oktober;384938;323;336;1771;1442;329;1499;1277;222;;259;0.07;1709;0.45;385197
4458;Zeeland (PV);2020 november;385197;246;359;1334;1068;266;1160;954;206;;61;0.02;1770;0.46;385258
4459;Zeeland (PV);2020 december;385258;328;358;1527;1277;250;1344;1100;244;-11.0;142;0.04;1912;0.5;385400
4460;Zeeland (PV);2020;383488;3424;4139;19001;15012;3989;16363;13831;2532;-11.0;1912;0.5;1912;0.5;385400
4461;Zeeland (PV);2021 januari;385400;276;402;1573;1286;287;1368;1164;204;0.0;79;0.02;79;0.02;385479
4462;Zeeland (PV);2021 februari;385479;261;379;1403;1148;255;1262;1100;162;0.0;23;0.01;102;0.03;385502
4463;Zeeland (PV);2021 maart;385502;336;428;1555;1254;301;1321;1088;233;0.0;142;0.04;244;0.06;385644
4464;Zeeland (PV);2021 april;385644;289;364;1429;1172;257;1240;984;256;0.0;114;0.03;358;0.09;385758
4465;Zeeland (PV);2021 mei;385758;284;373;1271;1027;244;1113;915;198;0.0;69;0.02;427;0.11;385827
4466;Zeeland (PV);2021 juni;385827;298;336;1414;1104;310;1291;1067;224;0.0;85;0.02;512;0.13;385912
4467;Zeeland (PV);2021 juli;385912;315;353;1792;1430;362;1547;1251;296;0.0;207;0.05;719;0.19;386119
4468;Zeeland (PV);2021 augustus;386119;312;349;2008;1486;522;1640;1355;285;0.0;331;0.09;1050;0.27;386450
4469;Zeeland (PV);2021 september;386450;347;354;1818;1300;518;1430;1198;232;0.0;381;0.1;1431;0.37;386831
4470;Zeeland (PV);2021 oktober;386831;310;362;1455;1114;341;1344;1063;281;0.0;59;0.02;1490;0.39;386890
4471;Zeeland (PV);2021 november;386890;298;457;1408;1120;288;1224;1034;190;0.0;25;0.01;1515;0.39;386915
4472;Zeeland (PV);2021 december;386915;266;576;1430;1133;297;1262;983;279;-6.0;-148;-0.04;1367;0.35;386767
4473;Zeeland (PV);2021;385400;3592;4733;18556;14574;3982;16042;13202;2840;-6.0;1367;0.35;1367;0.35;386767
4474;Zeeland (PV);2022 januari;386767;295;399;1562;1207;355;1352;1126;226;;106;0.03;106;0.03;386873
4475;Zeeland (PV);2022 februari;386873;267;377;1487;1167;320;1252;1006;246;;125;0.03;231;0.06;386998
4476;Zeeland (PV);2022 maart;386998;292;418;2209;1165;1044;1308;1073;235;;775;0.2;1006;0.26;387773
4477;Zeeland (PV);2022 april;387773;250;386;2427;1300;1127;1346;1083;263;;945;0.24;1951;0.5;388718
4478;Zeeland (PV);2022 mei;388718;324;341;1821;1169;652;1248;974;274;;556;0.14;2507;0.65;389274
4479;Zeeland (PV);2022 juni;389274;287;338;1835;1236;599;1375;1044;331;;409;0.11;2916;0.75;389683
4480;Zeeland (PV);2022 juli;389683;301;337;1739;1210;529;1441;1066;375;;262;0.07;3178;0.82;389945
4481;Zeeland (PV);2022 augustus;389945;294;338;2493;1564;929;1811;1424;387;;638;0.16;3816;0.99;390583
4482;Zeeland (PV);2022 september;390583;313;303;1929;1347;582;1614;1271;343;;325;0.08;4141;1.07;390908
4483;Zeeland (PV);2022 oktober;390908;298;362;1741;1266;475;1568;1196;372;;109;0.03;4250;1.1;391017
4484;Zeeland (PV);2022 november;391017;260;361;1643;1143;500;1455;1100;355;;87;0.02;4337;1.12;391104
4485;Zeeland (PV);2022 december;391104;295;461;1800;1363;437;1590;1243;347;-24.0;20;0.01;4357;1.13;391124
4486;Zeeland (PV);2022;386767;3476;4421;22686;15137;7549;17360;13606;3754;-24.0;4357;1.13;4357;1.13;391124
4487;Zeeland (PV);2023 januari;391124;264;440;1669;1260;409;1573;1219;354;0.0;-80;-0.02;-80;-0.02;391044
4488;Zeeland (PV);2023 februari;391044;247;381;1492;1076;416;1330;1069;261;0.0;28;0.01;-52;-0.01;391072
4489;Zeeland (PV);2023 maart;391072;287;393;1712;1296;416;1450;1165;285;0.0;156;0.04;104;0.03;391228
4490;Zeeland (PV);2023 april;391228;265;364;1358;1045;313;1220;985;235;0.0;39;0.01;143;0.04;391267
4491;Zeeland (PV);2023 mei;391267;311;339;1556;1194;362;1362;1084;278;0.0;166;0.04;309;0.08;391433
4492;Zeeland (PV);2023 juni;391433;259;327;1655;1219;436;1449;1155;294;0.0;138;0.04;447;0.11;391571
4493;Zeeland (PV);2023 juli;391571;306;346;1879;1453;426;1906;1527;379;0.0;-67;-0.02;380;0.1;391504
4494;Zeeland (PV);2023 augustus;391504;295;328;2138;1436;702;2010;1692;318;0.0;95;0.02;475;0.12;391599
4495;Zeeland (PV);2023 september;391599;287;342;1769;1259;510;1806;1466;340;0.0;-92;-0.02;383;0.1;391507
4496;Zeeland (PV);2023 oktober;391507;292;346;1740;1243;497;1564;1230;334;0.0;122;0.03;505;0.13;391629
4497;Zeeland (PV);2023 november;391629;263;381;1653;1178;475;1404;1103;301;0.0;131;0.03;636;0.16;391760
4498;Zeeland (PV);2023 december;391760;283;432;1586;1230;356;1555;1220;335;-8.0;-126;-0.03;510;0.13;391634
4499;Zeeland (PV);2023;391124;3359;4419;20207;14889;5318;18629;14915;3714;-8.0;510;0.13;510;0.13;391634
4500;Zeeland (PV);2024 januari;391634;256;418;1827;1337;490;1578;1197;381;;87;0.02;87;0.02;391721
4501;Zeeland (PV);2024 februari;391721;259;387;1637;1140;497;1298;1025;273;;211;0.05;298;0.08;391932
4502;Zeeland (PV);2024 maart;391932;273;392;1758;1308;450;1466;1156;310;;173;0.04;471;0.12;392105
4503;Zeeland (PV);2024 april;392105;245;387;1664;1201;463;1350;1093;257;;172;0.04;643;0.16;392277
4504;Zeeland (PV);2024 mei;392277;293;363;1451;1117;334;1374;1038;336;;7;0.0;650;0.17;392284
4505;Zeeland (PV);2024 juni;392284;266;374;1553;1182;371;1330;1004;326;;115;0.03;765;0.2;392399
4506;Zeeland (PV);2024 juli;392399;309;339;1798;1438;360;1813;1363;450;;-45;-0.01;720;0.18;392354
4507;Zeeland (PV);2024 augustus;392354;322;355;2237;1590;647;1874;1531;343;;330;0.08;1050;0.27;392684
4508;Zeeland (PV);2024 september;392684;290;312;1642;1166;476;1603;1275;328;;17;0.0;1067;0.27;392701
4509;Zeeland (PV);2024 oktober;392701;264;377;1912;1485;427;1608;1256;352;;191;0.05;1258;0.32;392892
4510;Zeeland (PV);2024 november;392892;244;395;1512;1170;342;1257;1020;237;;104;0.03;1362;0.35;392996
4511;Zeeland (PV);2024 december;392996;226;397;1654;1383;271;1431;1090;341;0.0;52;0.01;1414;0.36;393048
4512;Zeeland (PV);2024;391634;3247;4496;20645;15517;5128;17982;14048;3934;0.0;1414;0.36;1414;0.36;393048
4513;Zeeland (PV);2025 januari;393048;264;453;1810;1376;434;1539;1168;371;;82;0.02;82;0.02;393130
4514;Zeeland (PV);2025 februari;393130;226;395;1757;1357;400;1363;1077;286;;225;0.06;307;0.08;393355
4515;Noord-Brabant (PV);2002 januari;2391123;2427;1844;8491;7195;1296;8336;7161;1175;;738;0.03;738;0.03;2391861
4516;Noord-Brabant (PV);2002 februari;2391861;2225;1720;6827;5719;1108;6824;5819;1005;;508;0.02;1246;0.05;2392369
4517;Noord-Brabant (PV);2002 maart;2392369;2411;1917;7605;6429;1176;7661;6361;1300;;438;0.02;1684;0.07;2392807
4518;Noord-Brabant (PV);2002 april;2392807;2294;1605;6942;5854;1088;6931;5713;1218;;700;0.03;2384;0.1;2393507
4519;Noord-Brabant (PV);2002 mei;2393507;2453;1609;7509;6376;1133;7507;6383;1124;;846;0.04;3230;0.14;2394353
4520;Noord-Brabant (PV);2002 juni;2394353;2337;1517;6922;5890;1032;7052;5760;1292;;690;0.03;3920;0.16;2395043
4521;Noord-Brabant (PV);2002 juli;2395043;2628;1596;8934;7563;1371;9096;7522;1574;;870;0.04;4790;0.2;2395913
4522;Noord-Brabant (PV);2002 augustus;2395913;2637;1491;9574;7896;1678;9684;8211;1473;;1036;0.04;5826;0.24;2396949
4523;Noord-Brabant (PV);2002 september;2396949;2551;1410;8700;7239;1461;8825;7323;1502;;1016;0.04;6842;0.29;2397965
4524;Noord-Brabant (PV);2002 oktober;2397965;2552;1655;8061;6833;1228;8329;6893;1436;;629;0.03;7471;0.31;2398594
4525;Noord-Brabant (PV);2002 november;2398594;2299;1601;7235;6315;920;7400;6368;1032;;533;0.02;8004;0.33;2399127
4526;Noord-Brabant (PV);2002 december;2399127;2364;1813;7177;6327;850;7372;6333;1039;715.0;1071;0.04;9075;0.38;2400198
4527;Noord-Brabant (PV);2002;2391123;29178;19778;93977;79636;14341;95017;79847;15170;715.0;9075;0.38;9075;0.38;2400198
4528;Noord-Brabant (PV);2003 januari;2400198;2525;1732;8246;7022;1224;8196;7080;1116;;843;0.04;843;0.04;2401041
4529;Noord-Brabant (PV);2003 februari;2401041;2235;1574;6674;5787;887;7162;5931;1231;;173;0.01;1016;0.04;2401214
4530;Noord-Brabant (PV);2003 maart;2401214;2416;1779;6639;5695;944;7045;5857;1188;;231;0.01;1247;0.05;2401445
4531;Noord-Brabant (PV);2003 april;2401445;2268;1695;6671;5824;847;6983;5965;1018;;261;0.01;1508;0.06;2401706
4532;Noord-Brabant (PV);2003 mei;2401706;2397;1548;6674;5803;871;6897;5958;939;;626;0.03;2134;0.09;2402332
4533;Noord-Brabant (PV);2003 juni;2402332;2430;1524;7117;6153;964;7180;5934;1246;;843;0.04;2977;0.12;2403175
4534;Noord-Brabant (PV);2003 juli;2403175;2645;1600;8559;7363;1196;8793;7337;1456;;811;0.03;3788;0.16;2403986
4535;Noord-Brabant (PV);2003 augustus;2403986;2458;1632;8600;7257;1343;9030;7536;1494;;396;0.02;4184;0.17;2404382
4536;Noord-Brabant (PV);2003 september;2404382;2550;1519;8891;7554;1337;8823;7449;1374;;1099;0.05;5283;0.22;2405481
4537;Noord-Brabant (PV);2003 oktober;2405481;2384;1681;8352;7237;1115;8582;7092;1490;;473;0.02;5756;0.24;2405954
4538;Noord-Brabant (PV);2003 november;2405954;2217;1640;7199;6310;889;7507;6321;1186;;269;0.01;6025;0.25;2406223
4539;Noord-Brabant (PV);2003 december;2406223;2255;1765;7343;6667;676;8169;6852;1317;1107.0;771;0.03;6796;0.28;2406994
4540;Noord-Brabant (PV);2003;2400198;28780;19689;90965;78672;12293;94367;79312;15055;1107.0;6796;0.28;6796;0.28;2406994
4541;Noord-Brabant (PV);2004 januari;2406994;2277;1878;7542;6651;891;8152;6815;1337;;-211;-0.01;-211;-0.01;2406783
4542;Noord-Brabant (PV);2004 februari;2406783;2160;1606;6519;5796;723;7089;5807;1282;;-16;0.0;-227;-0.01;2406767
4543;Noord-Brabant (PV);2004 maart;2406767;2307;1739;7505;6609;896;7925;6524;1401;;148;0.01;-79;0.0;2406915
4544;Noord-Brabant (PV);2004 april;2406915;2260;1566;6326;5661;665;6941;5702;1239;;79;0.0;0;0.0;2406994
4545;Noord-Brabant (PV);2004 mei;2406994;2302;1612;6198;5480;718;6355;5488;867;;533;0.02;533;0.02;2407527
4546;Noord-Brabant (PV);2004 juni;2407527;2279;1518;7455;6504;951;7614;6452;1162;;602;0.03;1135;0.05;2408129
4547;Noord-Brabant (PV);2004 juli;2408129;2477;1447;8377;7346;1031;8829;7393;1436;;578;0.02;1713;0.07;2408707
4548;Noord-Brabant (PV);2004 augustus;2408707;2429;1555;9044;7757;1287;9447;8051;1396;;471;0.02;2184;0.09;2409178
4549;Noord-Brabant (PV);2004 september;2409178;2318;1438;9041;7678;1363;9280;7864;1416;;641;0.03;2825;0.12;2409819
4550;Noord-Brabant (PV);2004 oktober;2409819;2245;1598;6946;6057;889;7550;6345;1205;;43;0.0;2868;0.12;2409862
4551;Noord-Brabant (PV);2004 november;2409862;2171;1482;7410;6421;989;7655;6436;1219;;444;0.02;3312;0.14;2410306
4552;Noord-Brabant (PV);2004 december;2410306;2207;1680;7500;6723;777;7944;6756;1188;970.0;1053;0.04;4365;0.18;2411359
4553;Noord-Brabant (PV);2004;2406994;27432;19119;89863;78683;11180;94781;79633;15148;970.0;4365;0.18;4365;0.18;2411359
4554;Noord-Brabant (PV);2005 januari;2411359;2232;1727;7696;6817;879;8151;6877;1274;;50;0.0;50;0.0;2411409
4555;Noord-Brabant (PV);2005 februari;2411409;2132;1894;6698;5921;777;7049;5966;1083;;-113;0.0;-63;0.0;2411296
4556;Noord-Brabant (PV);2005 maart;2411296;2249;1961;7225;6265;960;7148;6042;1106;;365;0.02;302;0.01;2411661
4557;Noord-Brabant (PV);2005 april;2411661;2116;1554;7194;6298;896;7244;6127;1117;;512;0.02;814;0.03;2412173
4558;Noord-Brabant (PV);2005 mei;2412173;2176;1580;6450;5598;852;6693;5575;1118;;353;0.01;1167;0.05;2412526
4559;Noord-Brabant (PV);2005 juni;2412526;2183;1529;7498;6502;996;7589;6290;1299;;563;0.02;1730;0.07;2413089
4560;Noord-Brabant (PV);2005 juli;2413089;2349;1508;8448;7446;1002;8792;7494;1298;;497;0.02;2227;0.09;2413586
4561;Noord-Brabant (PV);2005 augustus;2413586;2332;1440;10140;8892;1248;10301;8589;1712;;731;0.03;2958;0.12;2414317
4562;Noord-Brabant (PV);2005 september;2414317;2291;1417;9746;8208;1538;9991;8503;1488;;629;0.03;3587;0.15;2414946
4563;Noord-Brabant (PV);2005 oktober;2414946;2242;1491;7939;6899;1040;8383;7114;1269;;307;0.01;3894;0.16;2415253
4564;Noord-Brabant (PV);2005 november;2415253;1991;1409;7604;6614;990;8043;6707;1336;;143;0.01;4037;0.17;2415396
4565;Noord-Brabant (PV);2005 december;2415396;2008;1668;7758;6855;903;8206;6912;1294;658.0;550;0.02;4587;0.19;2415946
4566;Noord-Brabant (PV);2005;2411359;26301;19178;94396;82315;12081;97590;82196;15394;658.0;4587;0.19;4587;0.19;2415946
4567;Noord-Brabant (PV);2006 januari;2415946;2173;1740;8331;7318;1013;8754;7416;1338;;10;0.0;10;0.0;2415956
4568;Noord-Brabant (PV);2006 februari;2415956;1965;1598;7118;6166;952;7584;6303;1281;;-99;0.0;-89;0.0;2415857
4569;Noord-Brabant (PV);2006 maart;2415857;2211;1753;8005;6964;1041;8402;7005;1397;;61;0.0;-28;0.0;2415918
4570;Noord-Brabant (PV);2006 april;2415918;2051;1575;6465;5562;903;6975;5730;1245;;-34;0.0;-62;0.0;2415884
4571;Noord-Brabant (PV);2006 mei;2415884;2237;1507;7221;6233;988;7434;6327;1107;;517;0.02;455;0.02;2416401
4572;Noord-Brabant (PV);2006 juni;2416401;2106;1536;7471;6471;1000;7779;6466;1313;;262;0.01;717;0.03;2416663
4573;Noord-Brabant (PV);2006 juli;2416663;2282;1764;8911;7701;1210;9290;7750;1540;;139;0.01;856;0.04;2416802
4574;Noord-Brabant (PV);2006 augustus;2416802;2336;1504;11035;9390;1645;11149;9293;1856;;718;0.03;1574;0.07;2417520
4575;Noord-Brabant (PV);2006 september;2417520;2266;1499;9265;7756;1509;9717;8084;1633;;315;0.01;1889;0.08;2417835
4576;Noord-Brabant (PV);2006 oktober;2417835;2234;1464;8474;7263;1211;8810;7452;1358;;434;0.02;2323;0.1;2418269
4577;Noord-Brabant (PV);2006 november;2418269;2107;1589;7717;6675;1042;8081;6859;1222;;154;0.01;2477;0.1;2418423
4578;Noord-Brabant (PV);2006 december;2418423;2039;1609;7081;6311;770;7522;6299;1223;630.0;619;0.03;3096;0.13;2419042
4579;Noord-Brabant (PV);2006;2415946;26007;19138;97094;83810;13284;101497;84984;16513;630.0;3096;0.13;3096;0.13;2419042
4580;Noord-Brabant (PV);2007 januari;2419042;2069;1708;8546;7463;1083;8901;7577;1324;;6;0.0;6;0.0;2419048
4581;Noord-Brabant (PV);2007 februari;2419048;1902;1614;7338;6442;896;7762;6531;1231;;-136;-0.01;-130;-0.01;2418912
4582;Noord-Brabant (PV);2007 maart;2418912;2095;1730;7817;6752;1065;8218;6908;1310;;-36;0.0;-166;-0.01;2418876
4583;Noord-Brabant (PV);2007 april;2418876;2022;1573;6689;5799;890;6717;5726;991;;421;0.02;255;0.01;2419297
4584;Noord-Brabant (PV);2007 mei;2419297;2091;1555;7543;6435;1108;7410;6320;1090;;669;0.03;924;0.04;2419966
4585;Noord-Brabant (PV);2007 juni;2419966;2077;1507;8027;6836;1191;7821;6638;1183;;776;0.03;1700;0.07;2420742
4586;Noord-Brabant (PV);2007 juli;2420742;2292;1391;9669;8258;1411;9540;7959;1581;;1030;0.04;2730;0.11;2421772
4587;Noord-Brabant (PV);2007 augustus;2421772;2326;1514;10452;8717;1735;10243;8633;1610;;1021;0.04;3751;0.16;2422793
4588;Noord-Brabant (PV);2007 september;2422793;2252;1424;8905;7167;1738;9095;7681;1414;;638;0.03;4389;0.18;2423431
4589;Noord-Brabant (PV);2007 oktober;2423431;2209;1574;8762;7221;1541;8746;7355;1391;;651;0.03;5040;0.21;2424082
4590;Noord-Brabant (PV);2007 november;2424082;1967;1665;8145;6899;1246;8323;6956;1367;;124;0.01;5164;0.21;2424206
4591;Noord-Brabant (PV);2007 december;2424206;2025;1762;7052;6108;944;7441;6288;1153;747.0;621;0.03;5785;0.24;2424827
4592;Noord-Brabant (PV);2007;2419042;25327;19017;98945;84097;14848;100217;84572;15645;747.0;5785;0.24;5785;0.24;2424827
4593;Noord-Brabant (PV);2008 januari;2424827;2171;1805;9374;7716;1658;9260;7967;1293;;480;0.02;480;0.02;2425307
4594;Noord-Brabant (PV);2008 februari;2425307;2052;1695;7797;6481;1316;7689;6581;1108;;465;0.02;945;0.04;2425772
4595;Noord-Brabant (PV);2008 maart;2425772;1996;1750;7672;6361;1311;7563;6417;1146;;355;0.01;1300;0.05;2426127
4596;Noord-Brabant (PV);2008 april;2426127;2079;1601;8031;6649;1382;7855;6705;1150;;654;0.03;1954;0.08;2426781
4597;Noord-Brabant (PV);2008 mei;2426781;2211;1639;7177;6022;1155;6931;5981;950;;818;0.03;2772;0.11;2427599
4598;Noord-Brabant (PV);2008 juni;2427599;2235;1497;7806;6493;1313;7620;6441;1179;;924;0.04;3696;0.15;2428523
4599;Noord-Brabant (PV);2008 juli;2428523;2388;1552;9661;8105;1556;9571;8064;1507;;926;0.04;4622;0.19;2429449
4600;Noord-Brabant (PV);2008 augustus;2429449;2349;1538;10728;8587;2141;10101;8494;1607;;1438;0.06;6060;0.25;2430887
4601;Noord-Brabant (PV);2008 september;2430887;2317;1432;10333;7956;2377;9709;8386;1323;;1509;0.06;7569;0.31;2432396
4602;Noord-Brabant (PV);2008 oktober;2432396;2201;1537;8926;7252;1674;8661;7446;1215;;929;0.04;8498;0.35;2433325
4603;Noord-Brabant (PV);2008 november;2433325;1977;1587;7429;6150;1279;7349;6291;1058;;470;0.02;8968;0.37;2433795
4604;Noord-Brabant (PV);2008 december;2433795;2011;1813;7873;6711;1162;7874;6806;1068;568.0;765;0.03;9733;0.4;2434560
4605;Noord-Brabant (PV);2008;2424827;25987;19446;102807;84483;18324;100183;85579;14604;568.0;9733;0.4;9733;0.4;2434560
4606;Noord-Brabant (PV);2009 januari;2434560;2098;2012;8200;6744;1456;7991;6762;1229;;295;0.01;295;0.01;2434855
4607;Noord-Brabant (PV);2009 februari;2434855;1889;1699;7341;6010;1331;7016;6090;926;;515;0.02;810;0.03;2435370
4608;Noord-Brabant (PV);2009 maart;2435370;2105;1689;7561;6068;1493;7489;6314;1175;;488;0.02;1298;0.05;2435858
4609;Noord-Brabant (PV);2009 april;2435858;2038;1546;6952;5700;1252;6966;5795;1171;;478;0.02;1776;0.07;2436336
4610;Noord-Brabant (PV);2009 mei;2436336;2102;1547;6663;5473;1190;6539;5485;1054;;679;0.03;2455;0.1;2437015
4611;Noord-Brabant (PV);2009 juni;2437015;2209;1445;7261;5748;1513;7082;5791;1291;;943;0.04;3398;0.14;2437958
4612;Noord-Brabant (PV);2009 juli;2437958;2375;1581;9094;7430;1664;8828;7363;1465;;1060;0.04;4458;0.18;2439018
4613;Noord-Brabant (PV);2009 augustus;2439018;2302;1487;9292;7377;1915;8937;7572;1365;;1170;0.05;5628;0.23;2440188
4614;Noord-Brabant (PV);2009 september;2440188;2239;1425;10344;7910;2434;9335;8119;1216;;1823;0.07;7451;0.31;2442011
4615;Noord-Brabant (PV);2009 oktober;2442011;2189;1656;8367;6506;1861;8008;6763;1245;;892;0.04;8343;0.34;2442903
4616;Noord-Brabant (PV);2009 november;2442903;2044;1567;7398;6054;1344;7424;6199;1225;;451;0.02;8794;0.36;2443354
4617;Noord-Brabant (PV);2009 december;2443354;2009;1630;7405;6319;1086;7386;6239;1147;406.0;804;0.03;9598;0.39;2444158
4618;Noord-Brabant (PV);2009;2434560;25599;19284;95878;77339;18539;93001;78492;14509;406.0;9598;0.39;9598;0.39;2444158
4619;Noord-Brabant (PV);2010 januari;2444158;2034;1844;8065;6634;1431;7876;6816;1060;;379;0.02;379;0.02;2444537
4620;Noord-Brabant (PV);2010 februari;2444537;1941;1644;7468;6079;1389;6939;6137;802;;826;0.03;1205;0.05;2445363
4621;Noord-Brabant (PV);2010 maart;2445363;1999;1642;8099;6538;1561;7818;6618;1200;;638;0.03;1843;0.08;2446001
4622;Noord-Brabant (PV);2010 april;2446001;2007;1660;6716;5578;1138;6588;5571;1017;;475;0.02;2318;0.09;2446476
4623;Noord-Brabant (PV);2010 mei;2446476;2105;1608;6660;5483;1177;6622;5639;983;;535;0.02;2853;0.12;2447011
4624;Noord-Brabant (PV);2010 juni;2447011;2095;1509;7572;6097;1475;7062;6008;1054;;1096;0.04;3949;0.16;2448107
4625;Noord-Brabant (PV);2010 juli;2448107;2313;1558;8829;7154;1675;8398;7006;1392;;1186;0.05;5135;0.21;2449293
4626;Noord-Brabant (PV);2010 augustus;2449293;2308;1487;10317;8263;2054;9499;8200;1299;;1639;0.07;6774;0.28;2450932
4627;Noord-Brabant (PV);2010 september;2450932;2315;1523;10290;7741;2549;9511;8034;1477;;1571;0.06;8345;0.34;2452503
4628;Noord-Brabant (PV);2010 oktober;2452503;2199;1647;8187;6383;1804;7693;6578;1115;;1046;0.04;9391;0.38;2453549
4629;Noord-Brabant (PV);2010 november;2453549;2153;1589;7456;6032;1424;7513;6244;1269;;507;0.02;9898;0.4;2454056
4630;Noord-Brabant (PV);2010 december;2454056;2076;1792;7227;6018;1209;7297;6094;1203;-55.0;159;0.01;10057;0.41;2454215
4631;Noord-Brabant (PV);2010;2444158;25545;19503;96886;78000;18886;92816;78945;13871;-55.0;10057;0.41;10057;0.41;2454215
4632;Noord-Brabant (PV);2011 januari;2454215;2069;1776;8250;6727;1523;8043;6796;1247;;500;0.02;500;0.02;2454715
4633;Noord-Brabant (PV);2011 februari;2454715;1990;1509;7750;6197;1553;7298;6277;1021;;933;0.04;1433;0.06;2455648
4634;Noord-Brabant (PV);2011 maart;2455648;1968;1764;7639;6185;1454;7395;6290;1105;;448;0.02;1881;0.08;2456096
4635;Noord-Brabant (PV);2011 april;2456096;1994;1732;6941;5656;1285;7038;5696;1342;;165;0.01;2046;0.08;2456261
4636;Noord-Brabant (PV);2011 mei;2456261;2136;1653;7134;5851;1283;7020;5799;1221;;597;0.02;2643;0.11;2456858
4637;Noord-Brabant (PV);2011 juni;2456858;2101;1555;7140;5711;1429;6821;5564;1257;;865;0.04;3508;0.14;2457723
4638;Noord-Brabant (PV);2011 juli;2457723;2309;1585;9137;7525;1612;8956;7288;1668;;905;0.04;4413;0.18;2458628
4639;Noord-Brabant (PV);2011 augustus;2458628;2261;1564;11481;8871;2610;10433;8569;1864;;1745;0.07;6158;0.25;2460373
4640;Noord-Brabant (PV);2011 september;2460373;2192;1525;10721;7893;2828;9547;7941;1606;;1841;0.07;7999;0.33;2462214
4641;Noord-Brabant (PV);2011 oktober;2462214;2061;1613;8161;6480;1681;7717;6387;1330;;892;0.04;8891;0.36;2463106
4642;Noord-Brabant (PV);2011 november;2463106;1968;1627;7729;6358;1371;7599;6396;1203;;471;0.02;9362;0.38;2463577
4643;Noord-Brabant (PV);2011 december;2463577;1966;1872;7649;6441;1208;7685;6404;1281;51.0;109;0.0;9471;0.39;2463686
4644;Noord-Brabant (PV);2011;2454215;25015;19775;99732;79895;19837;95552;79407;16145;51.0;9471;0.39;9471;0.39;2463686
4645;Noord-Brabant (PV);2012 januari;2463686;1955;1885;8705;7243;1462;8786;7229;1557;;-11;0.0;-11;0.0;2463675
4646;Noord-Brabant (PV);2012 februari;2463675;1877;1822;7821;6377;1444;7568;6487;1081;;308;0.01;297;0.01;2463983
4647;Noord-Brabant (PV);2012 maart;2463983;2016;1934;8035;6506;1529;7772;6426;1346;;345;0.01;642;0.03;2464328
4648;Noord-Brabant (PV);2012 april;2464328;1973;1686;6679;5473;1206;6865;5513;1352;;101;0.0;743;0.03;2464429
4649;Noord-Brabant (PV);2012 mei;2464429;2055;1617;7230;5921;1309;6921;5833;1088;;747;0.03;1490;0.06;2465176
4650;Noord-Brabant (PV);2012 juni;2465176;2007;1595;8314;6861;1453;8151;6734;1417;;575;0.02;2065;0.08;2465751
4651;Noord-Brabant (PV);2012 juli;2465751;2070;1627;9598;7799;1799;9350;7677;1673;;691;0.03;2756;0.11;2466442
4652;Noord-Brabant (PV);2012 augustus;2466442;2269;1554;11869;9208;2661;10510;8868;1642;;2074;0.08;4830;0.2;2468516
4653;Noord-Brabant (PV);2012 september;2468516;2163;1507;9905;7290;2615;8914;7489;1425;;1647;0.07;6477;0.26;2470163
4654;Noord-Brabant (PV);2012 oktober;2470163;2004;1657;8695;6955;1740;8512;7155;1357;;530;0.02;7007;0.28;2470693
4655;Noord-Brabant (PV);2012 november;2470693;1828;1718;7839;6467;1372;7649;6504;1145;;300;0.01;7307;0.3;2470993
4656;Noord-Brabant (PV);2012 december;2470993;1810;1854;7402;6379;1023;7403;6308;1095;63.0;18;0.0;7325;0.3;2471011
4657;Noord-Brabant (PV);2012;2463686;24027;20456;102092;82479;19613;98401;82223;16178;63.0;7325;0.3;7325;0.3;2471011
4658;Noord-Brabant (PV);2013 januari;2471011;1971;1889;9099;7500;1599;8967;7570;1397;;214;0.01;214;0.01;2471225
4659;Noord-Brabant (PV);2013 februari;2471225;1689;1799;7915;6386;1529;7517;6522;995;;288;0.01;502;0.02;2471513
4660;Noord-Brabant (PV);2013 maart;2471513;1905;2103;8294;6773;1521;7904;6617;1287;;192;0.01;694;0.03;2471705
4661;Noord-Brabant (PV);2013 april;2471705;1874;1777;7324;5831;1493;6805;5798;1007;;616;0.02;1310;0.05;2472321
4662;Noord-Brabant (PV);2013 mei;2472321;2010;1676;7533;6096;1437;7036;5921;1115;;831;0.03;2141;0.09;2473152
4663;Noord-Brabant (PV);2013 juni;2473152;1965;1553;7561;5959;1602;7056;5825;1231;;917;0.04;3058;0.12;2474069
4664;Noord-Brabant (PV);2013 juli;2474069;2257;1617;10037;7993;2044;9701;7770;1931;;976;0.04;4034;0.16;2475045
4665;Noord-Brabant (PV);2013 augustus;2475045;2153;1597;12166;9583;2583;11150;9312;1838;;1572;0.06;5606;0.23;2476617
4666;Noord-Brabant (PV);2013 september;2476617;2077;1474;11041;8143;2898;9971;8455;1516;;1673;0.07;7279;0.29;2478290
4667;Noord-Brabant (PV);2013 oktober;2478290;1963;1685;8919;7103;1816;8786;7318;1468;;411;0.02;7690;0.31;2478701
4668;Noord-Brabant (PV);2013 november;2478701;1852;1620;8270;6768;1502;8125;6752;1373;;377;0.02;8067;0.33;2479078
4669;Noord-Brabant (PV);2013 december;2479078;1842;1755;8455;7158;1297;8398;6927;1471;52.0;196;0.01;8263;0.33;2479274
4670;Noord-Brabant (PV);2013;2471011;23558;20545;106614;85293;21321;101416;84787;16629;52.0;8263;0.33;8263;0.33;2479274
4671;Noord-Brabant (PV);2014 januari;2479274;1954;1813;10048;8109;1939;9692;7957;1735;;497;0.02;497;0.02;2479771
4672;Noord-Brabant (PV);2014 februari;2479771;1827;1648;9017;7276;1741;8477;7191;1286;;719;0.03;1216;0.05;2480490
4673;Noord-Brabant (PV);2014 maart;2480490;2023;1777;8517;6684;1833;7641;6435;1206;;1122;0.05;2338;0.09;2481612
4674;Noord-Brabant (PV);2014 april;2481612;1927;1674;8320;6553;1767;7863;6524;1339;;710;0.03;3048;0.12;2482322
4675;Noord-Brabant (PV);2014 mei;2482322;2010;1671;7559;6153;1406;7213;5991;1222;;685;0.03;3733;0.15;2483007
4676;Noord-Brabant (PV);2014 juni;2483007;2081;1533;8224;6462;1762;7790;6346;1444;;982;0.04;4715;0.19;2483989
4677;Noord-Brabant (PV);2014 juli;2483989;2238;1786;10821;8691;2130;10171;8225;1946;;1102;0.04;5817;0.23;2485091
4678;Noord-Brabant (PV);2014 augustus;2485091;2171;1613;12274;9648;2626;11515;9517;1998;;1317;0.05;7134;0.29;2486408
4679;Noord-Brabant (PV);2014 september;2486408;2117;1620;12030;8866;3164;10704;8920;1784;;1823;0.07;8957;0.36;2488231
4680;Noord-Brabant (PV);2014 oktober;2488231;2070;1772;9382;7440;1942;9415;7643;1772;;265;0.01;9222;0.37;2488496
4681;Noord-Brabant (PV);2014 november;2488496;1903;1828;8385;6760;1625;8173;6825;1348;;287;0.01;9509;0.38;2488783
4682;Noord-Brabant (PV);2014 december;2488783;1922;2088;9748;7958;1790;9608;7973;1635;-6.0;-32;0.0;9477;0.38;2488751
4683;Noord-Brabant (PV);2014;2479274;24243;20823;114325;90600;23725;108262;89547;18715;-6.0;9477;0.38;9477;0.38;2488751
4684;Noord-Brabant (PV);2015 januari;2488751;1925;2251;10358;8084;2274;9728;8178;1550;;304;0.01;304;0.01;2489055
4685;Noord-Brabant (PV);2015 februari;2489055;1689;2048;9335;7380;1955;8749;7447;1302;;227;0.01;531;0.02;2489282
4686;Noord-Brabant (PV);2015 maart;2489282;1821;2092;9565;7509;2056;8902;7345;1557;;392;0.02;923;0.04;2489674
4687;Noord-Brabant (PV);2015 april;2489674;1822;1797;8532;6718;1814;7989;6637;1352;;568;0.02;1491;0.06;2490242
4688;Noord-Brabant (PV);2015 mei;2490242;1983;1795;8215;6610;1605;7801;6473;1328;;602;0.02;2093;0.08;2490844
4689;Noord-Brabant (PV);2015 juni;2490844;1929;1663;9533;7343;2190;8661;7158;1503;;1138;0.05;3231;0.13;2491982
4690;Noord-Brabant (PV);2015 juli;2491982;2205;1697;11807;9258;2549;11106;9080;2026;;1209;0.05;4440;0.18;2493191
4691;Noord-Brabant (PV);2015 augustus;2493191;2204;1627;12922;10110;2812;11939;10052;1887;;1560;0.06;6000;0.24;2494751
4692;Noord-Brabant (PV);2015 september;2494751;2214;1695;12998;9310;3688;11203;9435;1768;;2314;0.09;8314;0.33;2497065
4693;Noord-Brabant (PV);2015 oktober;2497065;1974;1804;10503;7997;2506;9828;8167;1661;;845;0.03;9159;0.37;2497910
4694;Noord-Brabant (PV);2015 november;2497910;1884;1696;9571;7463;2108;9200;7771;1429;;559;0.02;9718;0.39;2498469
4695;Noord-Brabant (PV);2015 december;2498469;1906;1773;9714;7875;1839;9581;7856;1725;14.0;280;0.01;9998;0.4;2498749
4696;Noord-Brabant (PV);2015;2488751;23556;21938;123053;95657;27396;114687;95599;19088;14.0;9998;0.4;9998;0.4;2498749
4697;Noord-Brabant (PV);2016 januari;2498749;1952;2042;10504;8091;2413;9967;8287;1680;;447;0.02;447;0.02;2499196
4698;Noord-Brabant (PV);2016 februari;2499196;1812;1897;10744;8079;2665;9967;8521;1446;;692;0.03;1139;0.05;2499888
4699;Noord-Brabant (PV);2016 maart;2499888;1890;2086;11156;8277;2879;10006;8338;1668;;954;0.04;2093;0.08;2500842
4700;Noord-Brabant (PV);2016 april;2500842;1944;1881;10582;7953;2629;9964;8303;1661;;681;0.03;2774;0.11;2501523
4701;Noord-Brabant (PV);2016 mei;2501523;2071;1825;10178;7552;2626;9120;7814;1306;;1304;0.05;4078;0.16;2502827
4702;Noord-Brabant (PV);2016 juni;2502827;2013;1656;11122;8213;2909;9869;8416;1453;;1610;0.06;5688;0.23;2504437
4703;Noord-Brabant (PV);2016 juli;2504437;2234;1727;12651;9790;2861;11911;9948;1963;;1247;0.05;6935;0.28;2505684
4704;Noord-Brabant (PV);2016 augustus;2505684;2290;1724;15078;11220;3858;13252;11219;2033;;2392;0.1;9327;0.37;2508076
4705;Noord-Brabant (PV);2016 september;2508076;2063;1703;14844;10334;4510;12296;10510;1786;;2908;0.12;12235;0.49;2510984
4706;Noord-Brabant (PV);2016 oktober;2510984;1977;1854;11113;8739;2374;10304;8879;1425;;932;0.04;13167;0.53;2511916
4707;Noord-Brabant (PV);2016 november;2511916;1899;1866;10713;8596;2117;9983;8524;1459;;763;0.03;13930;0.56;2512679
4708;Noord-Brabant (PV);2016 december;2512679;1862;2095;10933;9098;1835;10830;9060;1770;-18.0;-148;-0.01;13782;0.55;2512531
4709;Noord-Brabant (PV);2016;2498749;24007;22356;139618;105942;33676;127469;107819;19650;-18.0;13782;0.55;13782;0.55;2512531
4710;Noord-Brabant (PV);2017 januari;2512531;1934;2285;11920;9639;2281;11100;9436;1664;;469;0.02;469;0.02;2513000
4711;Noord-Brabant (PV);2017 februari;2513000;1742;2085;11111;8803;2308;10079;8674;1405;;689;0.03;1158;0.05;2513689
4712;Noord-Brabant (PV);2017 maart;2513689;1926;2055;11694;9150;2544;10147;8915;1232;;1418;0.06;2576;0.1;2515107
4713;Noord-Brabant (PV);2017 april;2515107;1772;1766;9973;7874;2099;8973;7731;1242;;1006;0.04;3582;0.14;2516113
4714;Noord-Brabant (PV);2017 mei;2516113;1990;1799;10975;8597;2378;9762;8311;1451;;1404;0.06;4986;0.2;2517517
4715;Noord-Brabant (PV);2017 juni;2517517;1947;1770;10972;8527;2445;9666;8294;1372;;1483;0.06;6469;0.26;2519000
4716;Noord-Brabant (PV);2017 juli;2519000;2095;1758;13581;10741;2840;12726;10425;2301;;1192;0.05;7661;0.3;2520192
4717;Noord-Brabant (PV);2017 augustus;2520192;2241;1689;15473;11344;4129;13190;11103;2087;;2835;0.11;10496;0.42;2523027
4718;Noord-Brabant (PV);2017 september;2523027;2113;1675;14273;9908;4365;11659;9982;1677;;3052;0.12;13548;0.54;2526079
4719;Noord-Brabant (PV);2017 oktober;2526079;2003;1786;11732;9057;2675;10594;8948;1646;;1355;0.05;14903;0.59;2527434
4720;Noord-Brabant (PV);2017 november;2527434;1938;1874;11200;8841;2359;10136;8671;1465;;1128;0.04;16031;0.64;2528562
4721;Noord-Brabant (PV);2017 december;2528562;1828;2160;10649;8947;1702;10497;8767;1730;-96.0;-276;-0.01;15755;0.63;2528286
4722;Noord-Brabant (PV);2017;2512531;23529;22702;143553;111428;32125;128529;109257;19272;-96.0;15755;0.63;15755;0.63;2528286
4723;Noord-Brabant (PV);2018 januari;2528286;1882;2187;11703;9168;2535;10781;8958;1823;;617;0.02;617;0.02;2528903
4724;Noord-Brabant (PV);2018 februari;2528903;1654;2328;10738;8216;2522;9422;8021;1401;;642;0.03;1259;0.05;2529545
4725;Noord-Brabant (PV);2018 maart;2529545;1843;2514;11403;8987;2416;10448;8813;1635;;284;0.01;1543;0.06;2529829
4726;Noord-Brabant (PV);2018 april;2529829;1894;1783;9655;7414;2241;8804;7343;1461;;962;0.04;2505;0.1;2530791
4727;Noord-Brabant (PV);2018 mei;2530791;2113;1792;10525;8184;2341;9014;7756;1258;;1832;0.07;4337;0.17;2532623
4728;Noord-Brabant (PV);2018 juni;2532623;1989;1758;10767;8285;2482;9601;7886;1715;;1397;0.06;5734;0.23;2534020
4729;Noord-Brabant (PV);2018 juli;2534020;2100;1728;12819;9946;2873;11800;9473;2327;;1391;0.05;7125;0.28;2535411
4730;Noord-Brabant (PV);2018 augustus;2535411;2158;1667;15990;10949;5041;12160;10135;2025;;4321;0.17;11446;0.45;2539732
4731;Noord-Brabant (PV);2018 september;2539732;2119;1698;12160;8673;3487;10516;8625;1891;;2065;0.08;13511;0.53;2541797
4732;Noord-Brabant (PV);2018 oktober;2541797;1991;1878;12180;9166;3014;10919;8932;1987;;1374;0.05;14885;0.59;2543171
4733;Noord-Brabant (PV);2018 november;2543171;1946;1872;11511;8803;2708;10428;8563;1865;;1157;0.05;16042;0.63;2544328
4734;Noord-Brabant (PV);2018 december;2544328;1803;1945;10250;8263;1987;9575;7887;1688;-55.0;478;0.02;16520;0.65;2544806
4735;Noord-Brabant (PV);2018;2528286;23492;23150;139701;106054;33647;123468;102392;21076;-55.0;16520;0.65;16520;0.65;2544806
4736;Noord-Brabant (PV);2019 januari;2544806;1974;2069;12584;9276;3308;10913;9141;1772;;1576;0.06;1576;0.06;2546382
4737;Noord-Brabant (PV);2019 februari;2546382;1627;1980;11106;8126;2980;9380;7899;1481;;1373;0.05;2949;0.12;2547755
4738;Noord-Brabant (PV);2019 maart;2547755;1879;2092;10939;8180;2759;9745;8123;1622;;981;0.04;3930;0.15;2548736
4739;Noord-Brabant (PV);2019 april;2548736;1929;1951;10977;8343;2634;9763;8249;1514;;1192;0.05;5122;0.2;2549928
4740;Noord-Brabant (PV);2019 mei;2549928;1975;1857;11009;8313;2696;9357;7957;1400;;1770;0.07;6892;0.27;2551698
4741;Noord-Brabant (PV);2019 juni;2551698;1981;1716;9693;7419;2274;8926;7289;1637;;1032;0.04;7924;0.31;2552730
4742;Noord-Brabant (PV);2019 juli;2552730;2115;1811;13018;9834;3184;11804;9415;2389;;1518;0.06;9442;0.37;2554248
4743;Noord-Brabant (PV);2019 augustus;2554248;2068;1762;14874;10107;4767;11730;9737;1993;;3450;0.14;12892;0.51;2557698
4744;Noord-Brabant (PV);2019 september;2557698;2129;1668;13438;9093;4345;11221;8872;2349;;2678;0.1;15570;0.61;2560376
4745;Noord-Brabant (PV);2019 oktober;2560376;2115;1934;12179;8987;3192;11079;8907;2172;;1281;0.05;16851;0.66;2561657
4746;Noord-Brabant (PV);2019 november;2561657;1929;1952;11265;8613;2652;9991;8455;1536;;1251;0.05;18102;0.71;2562908
4747;Noord-Brabant (PV);2019 december;2562908;1738;2094;10443;8391;2052;10010;8143;1867;-30.0;47;0.0;18149;0.71;2562955
4748;Noord-Brabant (PV);2019;2544806;23459;22886;141525;104682;36843;123919;102187;21732;-30.0;18149;0.71;18149;0.71;2562955
4749;Noord-Brabant (PV);2020 januari;2562955;1914;2105;12583;9428;3155;11347;9328;2019;;1045;0.04;1045;0.04;2564000
4750;Noord-Brabant (PV);2020 februari;2564000;1702;2018;11338;8429;2909;9794;8282;1512;;1228;0.05;2273;0.09;2565228
4751;Noord-Brabant (PV);2020 maart;2565228;1928;3063;11113;8661;2452;9989;8419;1570;;-11;0.0;2262;0.09;2565217
4752;Noord-Brabant (PV);2020 april;2565217;1873;3321;9338;7835;1503;9070;7815;1255;;-1180;-0.05;1082;0.04;2564037
4753;Noord-Brabant (PV);2020 mei;2564037;1942;1925;10003;8270;1733;9383;8197;1186;;637;0.02;1719;0.07;2564674
4754;Noord-Brabant (PV);2020 juni;2564674;1943;1638;11064;8714;2350;10033;8564;1469;;1336;0.05;3055;0.12;2566010
4755;Noord-Brabant (PV);2020 juli;2566010;2232;1673;13685;10675;3010;12849;10727;2122;;1395;0.05;4450;0.17;2567405
4756;Noord-Brabant (PV);2020 augustus;2567405;2137;1840;14263;10495;3768;12410;10529;1881;;2150;0.08;6600;0.26;2569555
4757;Noord-Brabant (PV);2020 september;2569555;2090;1697;14484;9871;4613;11694;10010;1684;;3183;0.12;9783;0.38;2572738
4758;Noord-Brabant (PV);2020 oktober;2572738;2033;2273;13093;10077;3016;12214;10347;1867;;639;0.02;10422;0.41;2573377
4759;Noord-Brabant (PV);2020 november;2573377;1895;2303;11487;8754;2733;10432;8873;1559;;647;0.03;11069;0.43;2574024
4760;Noord-Brabant (PV);2020 december;2574024;1724;2699;11609;9014;2595;10666;9095;1571;-43.0;-75;0.0;10994;0.43;2573949
4761;Noord-Brabant (PV);2020;2562955;23413;26555;144060;110223;33837;129881;110186;19695;-43.0;10994;0.43;10994;0.43;2573949
4762;Noord-Brabant (PV);2021 januari;2573949;1980;2557;12939;10390;2549;11864;10402;1462;0.0;498;0.02;498;0.02;2574447
4763;Noord-Brabant (PV);2021 februari;2574447;1887;2101;11640;8792;2848;10268;9034;1234;0.0;1158;0.04;1656;0.06;2575605
4764;Noord-Brabant (PV);2021 maart;2575605;2096;2058;13053;10163;2890;11739;10212;1527;0.0;1352;0.05;3008;0.12;2576957
4765;Noord-Brabant (PV);2021 april;2576957;2059;2070;11879;9312;2567;10769;9273;1496;0.0;1099;0.04;4107;0.16;2578056
4766;Noord-Brabant (PV);2021 mei;2578056;2142;1965;11200;8721;2479;9996;8576;1420;0.0;1381;0.05;5488;0.21;2579437
4767;Noord-Brabant (PV);2021 juni;2579437;2125;1821;11582;8451;3131;10400;8716;1684;0.0;1486;0.06;6974;0.27;2580923
4768;Noord-Brabant (PV);2021 juli;2580923;2315;1879;13408;10132;3276;11869;9843;2026;0.0;1975;0.08;8949;0.35;2582898
4769;Noord-Brabant (PV);2021 augustus;2582898;2287;1889;14386;10016;4370;11897;9937;1960;0.0;2887;0.11;11836;0.46;2585785
4770;Noord-Brabant (PV);2021 september;2585785;2289;1820;14760;9044;5716;10750;8795;1955;0.0;4479;0.17;16315;0.63;2590264
4771;Noord-Brabant (PV);2021 oktober;2590264;2276;2097;11820;8413;3407;10473;8592;1881;0.0;1526;0.06;17841;0.69;2591790
4772;Noord-Brabant (PV);2021 november;2591790;2009;2644;11419;8284;3135;9912;8289;1623;0.0;872;0.03;18713;0.73;2592662
4773;Noord-Brabant (PV);2021 december;2592662;2077;2764;11448;8738;2710;10548;8595;1953;-1.0;212;0.01;18925;0.74;2592874
4774;Noord-Brabant (PV);2021;2573949;25542;25665;149534;110456;39078;130485;110264;20221;-1.0;18925;0.74;18925;0.74;2592874
4775;Noord-Brabant (PV);2022 januari;2592874;2034;2195;11555;8527;3028;10068;8445;1623;;1326;0.05;1326;0.05;2594200
4776;Noord-Brabant (PV);2022 februari;2594200;1762;2015;11355;8075;3280;9433;8012;1421;;1669;0.06;2995;0.12;2595869
4777;Noord-Brabant (PV);2022 maart;2595869;1964;2454;15945;8951;6994;10273;8614;1659;;5182;0.2;8177;0.32;2601051
4778;Noord-Brabant (PV);2022 april;2601051;1840;2103;14227;8196;6031;9875;8313;1562;;4089;0.16;12266;0.47;2605140
4779;Noord-Brabant (PV);2022 mei;2605140;1961;2098;12936;8063;4873;10143;8323;1820;;2656;0.1;14922;0.58;2607796
4780;Noord-Brabant (PV);2022 juni;2607796;2046;1959;13172;8216;4956;10530;8426;2104;;2729;0.1;17651;0.68;2610525
4781;Noord-Brabant (PV);2022 juli;2610525;2134;2030;14312;9618;4694;12203;9495;2708;;2213;0.08;19864;0.77;2612738
4782;Noord-Brabant (PV);2022 augustus;2612738;2188;2084;17016;10270;6746;12755;10292;2463;;4365;0.17;24229;0.93;2617103
4783;Noord-Brabant (PV);2022 september;2617103;2142;1858;16448;9676;6772;12424;10077;2347;;4308;0.16;28537;1.1;2621411
4784;Noord-Brabant (PV);2022 oktober;2621411;2097;2226;14286;9029;5257;11694;9569;2125;;2463;0.09;31000;1.2;2623874
4785;Noord-Brabant (PV);2022 november;2623874;1900;2109;13451;8732;4719;11332;9271;2061;;1910;0.07;32910;1.27;2625784
4786;Noord-Brabant (PV);2022 december;2625784;1748;2569;13283;9385;3898;12023;9753;2270;-13.0;426;0.02;33336;1.29;2626210
4787;Noord-Brabant (PV);2022;2592874;23816;25700;167986;106738;61248;132753;108590;24163;-13.0;33336;1.29;33336;1.29;2626210
4788;Noord-Brabant (PV);2023 januari;2626210;1875;2526;13987;9550;4437;12342;10025;2317;0.0;994;0.04;994;0.04;2627204
4789;Noord-Brabant (PV);2023 februari;2627204;1767;2222;12595;8184;4411;10802;9008;1794;0.0;1338;0.05;2332;0.09;2628542
4790;Noord-Brabant (PV);2023 maart;2628542;1894;2567;14420;9403;5017;12648;10365;2283;0.0;1099;0.04;3431;0.13;2629641
4791;Noord-Brabant (PV);2023 april;2629641;1833;2101;11810;8175;3635;10538;8720;1818;0.0;1004;0.04;4435;0.17;2630645
4792;Noord-Brabant (PV);2023 mei;2630645;2127;2002;12364;8340;4024;11071;8998;2073;0.0;1418;0.05;5853;0.22;2632063
4793;Noord-Brabant (PV);2023 juni;2632063;1917;2073;13620;9293;4327;12434;9976;2458;0.0;1030;0.04;6883;0.26;2633093
4794;Noord-Brabant (PV);2023 juli;2633093;2136;1854;14819;10386;4433;13504;10643;2861;0.0;1597;0.06;8480;0.32;2634690
4795;Noord-Brabant (PV);2023 augustus;2634690;2074;1940;17402;10702;6700;13772;11273;2499;0.0;3764;0.14;12244;0.47;2638454
4796;Noord-Brabant (PV);2023 september;2638454;2065;1947;14995;9087;5908;12134;10114;2020;0.0;2979;0.11;15223;0.58;2641433
4797;Noord-Brabant (PV);2023 oktober;2641433;2053;2175;14082;8997;5085;12028;9821;2207;0.0;1932;0.07;17155;0.65;2643365
4798;Noord-Brabant (PV);2023 november;2643365;1851;2238;13298;8895;4403;11738;9767;1971;0.0;1173;0.04;18328;0.7;2644538
4799;Noord-Brabant (PV);2023 december;2644538;1833;2426;12614;8994;3620;11822;9531;2291;2.0;201;0.01;18529;0.71;2644739
4800;Noord-Brabant (PV);2023;2626210;23425;26071;166006;110006;56000;144833;118241;26592;2.0;18529;0.71;18529;0.71;2644739
4801;Noord-Brabant (PV);2024 januari;2644739;1922;2436;14531;9700;4831;12506;10322;2184;;1511;0.06;1511;0.06;2646250
4802;Noord-Brabant (PV);2024 februari;2646250;1803;2346;13506;8743;4763;11776;9571;2205;;1187;0.04;2698;0.1;2647437
4803;Noord-Brabant (PV);2024 maart;2647437;1890;2309;13887;9292;4595;12336;10305;2031;;1132;0.04;3830;0.14;2648569
4804;Noord-Brabant (PV);2024 april;2648569;1929;2166;12694;8561;4133;11300;9173;2127;;1157;0.04;4987;0.19;2649726
4805;Noord-Brabant (PV);2024 mei;2649726;2193;2144;13056;8708;4348;11402;9384;2018;;1703;0.06;6690;0.25;2651429
4806;Noord-Brabant (PV);2024 juni;2651429;2062;1919;12505;8634;3871;11495;9312;2183;;1153;0.04;7843;0.3;2652582
4807;Noord-Brabant (PV);2024 juli;2652582;2039;2007;15398;10386;5012;14110;11016;3094;;1320;0.05;9163;0.35;2653902
4808;Noord-Brabant (PV);2024 augustus;2653902;2145;2131;17841;11138;6703;14122;11334;2788;;3733;0.14;12896;0.49;2657635
4809;Noord-Brabant (PV);2024 september;2657635;2059;2106;15589;9575;6014;12610;10083;2527;;2932;0.11;15828;0.6;2660567
4810;Noord-Brabant (PV);2024 oktober;2660567;2017;2213;14970;9485;5485;12752;10381;2371;;2022;0.08;17850;0.67;2662589
4811;Noord-Brabant (PV);2024 november;2662589;1896;2103;14102;9292;4810;12400;10152;2248;;1495;0.06;19345;0.73;2664084
4812;Noord-Brabant (PV);2024 december;2664084;1860;2288;14300;9824;4476;13592;10793;2799;0.0;280;0.01;19625;0.74;2664364
4813;Noord-Brabant (PV);2024;2644739;23815;26168;172379;113338;59041;150401;121826;28575;0.0;19625;0.74;19625;0.74;2664364
4814;Noord-Brabant (PV);2025 januari;2664364;1902;2674;15766;10441;5325;14126;11544;2582;;868;0.03;868;0.03;2665232
4815;Noord-Brabant (PV);2025 februari;2665232;1743;2541;14938;9631;5307;12990;10780;2210;;1150;0.04;2018;0.08;2666382
4816;Limburg (PV);2002 januari;1143296;989;1045;4324;3531;793;4346;3625;721;;-78;-0.01;-78;-0.01;1143218
4817;Limburg (PV);2002 februari;1143218;937;947;3439;2927;512;3550;2915;635;;-121;-0.01;-199;-0.02;1143097
4818;Limburg (PV);2002 maart;1143097;941;1154;3758;3152;606;3776;3098;678;;-231;-0.02;-430;-0.04;1142866
4819;Limburg (PV);2002 april;1142866;881;914;3433;2846;587;3482;2857;625;;-82;-0.01;-512;-0.04;1142784
4820;Limburg (PV);2002 mei;1142784;988;863;3738;3123;615;3912;3091;821;;-49;0.0;-561;-0.05;1142735
4821;Limburg (PV);2002 juni;1142735;950;888;3565;3020;545;3863;2992;871;;-236;-0.02;-797;-0.07;1142499
4822;Limburg (PV);2002 juli;1142499;1014;870;4511;3894;617;4658;3826;832;;-3;0.0;-800;-0.07;1142496
4823;Limburg (PV);2002 augustus;1142496;1044;837;4846;4163;683;4782;3998;784;;271;0.02;-529;-0.05;1142767
4824;Limburg (PV);2002 september;1142767;1031;793;4370;3682;688;4789;3931;858;;-181;-0.02;-710;-0.06;1142586
4825;Limburg (PV);2002 oktober;1142586;978;894;4115;3351;764;4320;3506;814;;-121;-0.01;-831;-0.07;1142465
4826;Limburg (PV);2002 november;1142465;842;842;3610;3138;472;3952;3252;700;;-342;-0.03;-1173;-0.1;1142123
4827;Limburg (PV);2002 december;1142123;889;943;3203;2878;325;3814;3070;744;431.0;-234;-0.02;-1407;-0.12;1141889
4828;Limburg (PV);2002;1143296;11484;10990;46912;39705;7207;49244;40161;9083;431.0;-1407;-0.12;-1407;-0.12;1141889
4829;Limburg (PV);2003 januari;1141889;993;998;4234;3596;638;4606;3802;804;;-377;-0.03;-377;-0.03;1141512
4830;Limburg (PV);2003 februari;1141512;854;840;3762;3135;627;3873;3308;565;;-97;-0.01;-474;-0.04;1141415
4831;Limburg (PV);2003 maart;1141415;963;1053;3299;2840;459;3541;2937;604;;-332;-0.03;-806;-0.07;1141083
4832;Limburg (PV);2003 april;1141083;914;957;3356;2813;543;3583;2929;654;;-270;-0.02;-1076;-0.09;1140813
4833;Limburg (PV);2003 mei;1140813;920;841;3185;2703;482;3259;2754;505;;5;0.0;-1071;-0.09;1140818
4834;Limburg (PV);2003 juni;1140818;931;913;3545;3054;491;3815;3154;661;;-252;-0.02;-1323;-0.12;1140566
4835;Limburg (PV);2003 juli;1140566;1060;886;4177;3601;576;4423;3604;819;;-72;-0.01;-1395;-0.12;1140494
4836;Limburg (PV);2003 augustus;1140494;1012;1052;4415;3885;530;4574;3724;850;;-199;-0.02;-1594;-0.14;1140295
4837;Limburg (PV);2003 september;1140295;912;835;4577;3911;666;4836;4181;655;;-182;-0.02;-1776;-0.16;1140113
4838;Limburg (PV);2003 oktober;1140113;905;824;3835;3229;606;4367;3553;814;;-451;-0.04;-2227;-0.2;1139662
4839;Limburg (PV);2003 november;1139662;826;849;3442;2971;471;3624;2991;633;;-205;-0.02;-2432;-0.21;1139457
4840;Limburg (PV);2003 december;1139457;900;1006;3470;3050;420;3869;3100;769;383.0;-122;-0.01;-2554;-0.22;1139335
4841;Limburg (PV);2003;1141889;11190;11054;45297;38788;6509;48370;40037;8333;383.0;-2554;-0.22;-2554;-0.22;1139335
4842;Limburg (PV);2004 januari;1139335;886;1062;3565;3102;463;3881;3126;755;;-492;-0.04;-492;-0.04;1138843
4843;Limburg (PV);2004 februari;1138843;849;873;3054;2659;395;3212;2672;540;;-182;-0.02;-674;-0.06;1138661
4844;Limburg (PV);2004 maart;1138661;829;907;3541;3034;507;4026;3087;939;;-563;-0.05;-1237;-0.11;1138098
4845;Limburg (PV);2004 april;1138098;806;823;3289;2874;415;3601;2799;802;;-329;-0.03;-1566;-0.14;1137769
4846;Limburg (PV);2004 mei;1137769;884;848;2968;2548;420;3085;2548;537;;-81;-0.01;-1647;-0.14;1137688
4847;Limburg (PV);2004 juni;1137688;916;849;3620;3109;511;3893;3127;766;;-206;-0.02;-1853;-0.16;1137482
4848;Limburg (PV);2004 juli;1137482;945;843;4305;3770;535;4730;3711;1019;;-323;-0.03;-2176;-0.19;1137159
4849;Limburg (PV);2004 augustus;1137159;928;872;4576;4008;568;4956;4158;798;;-324;-0.03;-2500;-0.22;1136835
4850;Limburg (PV);2004 september;1136835;1004;844;4731;4015;716;4911;4163;748;;-20;0.0;-2520;-0.22;1136815
4851;Limburg (PV);2004 oktober;1136815;939;926;3751;3174;577;3886;3229;657;;-122;-0.01;-2642;-0.23;1136693
4852;Limburg (PV);2004 november;1136693;902;832;3712;3122;590;3812;3165;647;;-30;0.0;-2672;-0.23;1136663
4853;Limburg (PV);2004 december;1136663;865;939;3507;3090;417;3840;3201;639;439.0;32;0.0;-2640;-0.23;1136695
4854;Limburg (PV);2004;1139335;10753;10618;44619;38505;6114;47833;38986;8847;439.0;-2640;-0.23;-2640;-0.23;1136695
4855;Limburg (PV);2005 januari;1136695;809;945;3799;3207;592;3950;3203;747;;-287;-0.03;-287;-0.03;1136408
4856;Limburg (PV);2005 februari;1136408;792;1115;3258;2799;459;3392;2848;544;;-457;-0.04;-744;-0.07;1135951
4857;Limburg (PV);2005 maart;1135951;835;1102;3356;2899;457;3813;3136;677;;-724;-0.06;-1468;-0.13;1135227
4858;Limburg (PV);2005 april;1135227;825;859;3560;3143;417;3930;3222;708;;-404;-0.04;-1872;-0.16;1134823
4859;Limburg (PV);2005 mei;1134823;785;894;3178;2795;383;3357;2895;462;;-288;-0.03;-2160;-0.19;1134535
4860;Limburg (PV);2005 juni;1134535;858;845;3686;3257;429;4235;3333;902;;-536;-0.05;-2696;-0.24;1133999
4861;Limburg (PV);2005 juli;1133999;913;747;4167;3727;440;4482;3699;783;;-149;-0.01;-2845;-0.25;1133850
4862;Limburg (PV);2005 augustus;1133850;937;807;4806;4239;567;5339;4464;875;;-403;-0.04;-3248;-0.29;1133447
4863;Limburg (PV);2005 september;1133447;891;754;4669;4045;624;5119;4321;798;;-313;-0.03;-3561;-0.31;1133134
4864;Limburg (PV);2005 oktober;1133134;851;816;3788;3259;529;4303;3512;791;;-480;-0.04;-4041;-0.36;1132654
4865;Limburg (PV);2005 november;1132654;763;828;3810;3250;560;4046;3338;708;;-301;-0.03;-4342;-0.38;1132353
4866;Limburg (PV);2005 december;1132353;792;917;3716;3285;431;4151;3355;796;145.0;-415;-0.04;-4757;-0.42;1131938
4867;Limburg (PV);2005;1136695;10051;10629;45793;39905;5888;50117;41326;8791;145.0;-4757;-0.42;-4757;-0.42;1131938
4868;Limburg (PV);2006 januari;1131938;815;942;4086;3574;512;4480;3694;786;;-521;-0.05;-521;-0.05;1131417
4869;Limburg (PV);2006 februari;1131417;775;867;3332;2887;445;3487;2965;522;;-247;-0.02;-768;-0.07;1131170
4870;Limburg (PV);2006 maart;1131170;804;929;3981;3436;545;4303;3461;842;;-447;-0.04;-1215;-0.11;1130723
4871;Limburg (PV);2006 april;1130723;750;888;3195;2728;467;3437;2787;650;;-380;-0.03;-1595;-0.14;1130343
4872;Limburg (PV);2006 mei;1130343;804;889;3471;3002;469;3678;2959;719;;-292;-0.03;-1887;-0.17;1130051
4873;Limburg (PV);2006 juni;1130051;847;857;3489;3029;460;3737;3014;723;;-258;-0.02;-2145;-0.19;1129793
4874;Limburg (PV);2006 juli;1129793;861;980;4148;3651;497;4581;3712;869;;-552;-0.05;-2697;-0.24;1129241
4875;Limburg (PV);2006 augustus;1129241;915;801;5173;4509;664;5580;4670;910;;-293;-0.03;-2990;-0.26;1128948
4876;Limburg (PV);2006 september;1128948;893;820;4407;3815;592;4861;4034;827;;-381;-0.03;-3371;-0.3;1128567
4877;Limburg (PV);2006 oktober;1128567;835;774;4148;3477;671;4415;3674;741;;-206;-0.02;-3577;-0.32;1128361
4878;Limburg (PV);2006 november;1128361;764;821;3869;3287;582;4225;3407;818;;-413;-0.04;-3990;-0.35;1127948
4879;Limburg (PV);2006 december;1127948;794;923;3291;2871;420;3683;2997;686;378.0;-143;-0.01;-4133;-0.37;1127805
4880;Limburg (PV);2006;1131938;9857;10491;46590;40266;6324;50467;41374;9093;378.0;-4133;-0.37;-4133;-0.37;1127805
4881;Limburg (PV);2007 januari;1127805;786;961;4167;3591;576;4460;3633;827;;-468;-0.04;-468;-0.04;1127337
4882;Limburg (PV);2007 februari;1127337;730;800;3462;2900;562;3597;2959;638;;-205;-0.02;-673;-0.06;1127132
4883;Limburg (PV);2007 maart;1127132;782;964;3848;3276;572;4059;3339;720;;-393;-0.03;-1066;-0.09;1126739
4884;Limburg (PV);2007 april;1126739;763;846;3124;2719;405;3379;2749;630;;-338;-0.03;-1404;-0.12;1126401
4885;Limburg (PV);2007 mei;1126401;773;768;3450;2987;463;3589;2919;670;;-134;-0.01;-1538;-0.14;1126267
4886;Limburg (PV);2007 juni;1126267;787;773;3502;2925;577;3764;2989;775;;-248;-0.02;-1786;-0.16;1126019
4887;Limburg (PV);2007 juli;1126019;831;852;4201;3593;608;4501;3618;883;;-321;-0.03;-2107;-0.19;1125698
4888;Limburg (PV);2007 augustus;1125698;854;801;4675;3993;682;5416;4414;1002;;-688;-0.06;-2795;-0.25;1125010
4889;Limburg (PV);2007 september;1125010;797;771;4226;3555;671;4509;3826;683;;-257;-0.02;-3052;-0.27;1124753
4890;Limburg (PV);2007 oktober;1124753;807;889;4083;3254;829;4243;3525;718;;-242;-0.02;-3294;-0.29;1124511
4891;Limburg (PV);2007 november;1124511;778;852;3824;3244;580;4237;3371;866;;-487;-0.04;-3781;-0.34;1124024
4892;Limburg (PV);2007 december;1124024;770;978;3153;2714;439;3401;2790;611;137.0;-319;-0.03;-4100;-0.36;1123705
4893;Limburg (PV);2007;1127805;9458;10255;45715;38751;6964;49155;40132;9023;137.0;-4100;-0.36;-4100;-0.36;1123705
4894;Limburg (PV);2008 januari;1123705;774;971;4375;3663;712;4410;3697;713;;-232;-0.02;-232;-0.02;1123473
4895;Limburg (PV);2008 februari;1123473;725;931;3655;3068;587;3758;3108;650;;-309;-0.03;-541;-0.05;1123164
4896;Limburg (PV);2008 maart;1123164;787;982;3643;3064;579;3595;2964;631;;-147;-0.01;-688;-0.06;1123017
4897;Limburg (PV);2008 april;1123017;750;883;3790;3146;644;3784;3154;630;;-127;-0.01;-815;-0.07;1122890
4898;Limburg (PV);2008 mei;1122890;845;884;3387;2798;589;3289;2743;546;;59;0.01;-756;-0.07;1122949
4899;Limburg (PV);2008 juni;1122949;793;805;3713;2996;717;3617;2961;656;;84;0.01;-672;-0.06;1123033
4900;Limburg (PV);2008 juli;1123033;905;801;4553;3840;713;4792;3904;888;;-135;-0.01;-807;-0.07;1122898
4901;Limburg (PV);2008 augustus;1122898;810;829;4673;3855;818;4800;4003;797;;-146;-0.01;-953;-0.08;1122752
4902;Limburg (PV);2008 september;1122752;844;774;4930;3796;1134;4865;4088;777;;135;0.01;-818;-0.07;1122887
4903;Limburg (PV);2008 oktober;1122887;778;852;4214;3259;955;4362;3560;802;;-222;-0.02;-1040;-0.09;1122665
4904;Limburg (PV);2008 november;1122665;685;855;3735;2933;802;3617;2965;652;;-52;0.0;-1092;-0.1;1122613
4905;Limburg (PV);2008 december;1122613;705;1011;3739;3005;734;3679;3076;603;237.0;-9;0.0;-1101;-0.1;1122604
4906;Limburg (PV);2008;1123705;9401;10578;48407;39423;8984;48568;40223;8345;237.0;-1101;-0.1;-1101;-0.1;1122604
4907;Limburg (PV);2009 januari;1122604;863;1072;3960;3201;759;4002;3302;700;;-251;-0.02;-251;-0.02;1122353
4908;Limburg (PV);2009 februari;1122353;723;958;3658;2857;801;3529;2914;615;;-106;-0.01;-357;-0.03;1122247
4909;Limburg (PV);2009 maart;1122247;796;947;3793;3088;705;3782;3205;577;;-140;-0.01;-497;-0.04;1122107
4910;Limburg (PV);2009 april;1122107;821;861;3346;2719;627;3331;2788;543;;-25;0.0;-522;-0.05;1122082
4911;Limburg (PV);2009 mei;1122082;801;857;3122;2538;584;2938;2568;370;;128;0.01;-394;-0.04;1122210
4912;Limburg (PV);2009 juni;1122210;814;803;3475;2763;712;3342;2827;515;;144;0.01;-250;-0.02;1122354
4913;Limburg (PV);2009 juli;1122354;872;805;4632;3679;953;4353;3613;740;;346;0.03;96;0.01;1122700
4914;Limburg (PV);2009 augustus;1122700;878;791;4568;3765;803;4631;3972;659;;24;0.0;120;0.01;1122724
4915;Limburg (PV);2009 september;1122724;863;793;4925;3587;1338;4744;4107;637;;251;0.02;371;0.03;1122975
4916;Limburg (PV);2009 oktober;1122975;772;865;3844;2934;910;3806;3172;634;;-55;0.0;316;0.03;1122920
4917;Limburg (PV);2009 november;1122920;767;823;3412;2739;673;3475;2979;496;;-119;-0.01;197;0.02;1122801
4918;Limburg (PV);2009 december;1122801;771;891;3260;2771;489;3437;2883;554;197.0;-100;-0.01;97;0.01;1122701
4919;Limburg (PV);2009;1122604;9741;10466;45995;36641;9354;45370;38330;7040;197.0;97;0.01;97;0.01;1122701
4920;Limburg (PV);2010 januari;1122701;777;973;3586;2913;673;3779;3111;668;;-389;-0.03;-389;-0.03;1122312
4921;Limburg (PV);2010 februari;1122312;725;868;3630;2801;829;3341;2826;515;;146;0.01;-243;-0.02;1122458
4922;Limburg (PV);2010 maart;1122458;779;981;3632;2857;775;3685;2914;771;;-255;-0.02;-498;-0.04;1122203
4923;Limburg (PV);2010 april;1122203;732;816;3132;2578;554;3281;2695;586;;-233;-0.02;-731;-0.07;1121970
4924;Limburg (PV);2010 mei;1121970;795;893;3098;2503;595;3009;2540;469;;-9;0.0;-740;-0.07;1121961
4925;Limburg (PV);2010 juni;1121961;834;808;3458;2677;781;3322;2718;604;;162;0.01;-578;-0.05;1122123
4926;Limburg (PV);2010 juli;1122123;829;916;4169;3304;865;4064;3341;723;;18;0.0;-560;-0.05;1122141
4927;Limburg (PV);2010 augustus;1122141;837;870;4519;3703;816;4812;4064;748;;-326;-0.03;-886;-0.08;1121815
4928;Limburg (PV);2010 september;1121815;882;857;4988;3400;1588;4565;3852;713;;448;0.04;-438;-0.04;1122263
4929;Limburg (PV);2010 oktober;1122263;838;875;4302;2771;1531;3750;3084;666;;515;0.05;77;0.01;1122778
4930;Limburg (PV);2010 november;1122778;781;884;3800;2802;998;3587;2971;616;;110;0.01;187;0.02;1122888
4931;Limburg (PV);2010 december;1122888;811;949;3369;2677;692;3444;2877;567;-48.0;-261;-0.02;-74;-0.01;1122627
4932;Limburg (PV);2010;1122701;9620;10690;45683;34986;10697;44639;36993;7646;-48.0;-74;-0.01;-74;-0.01;1122627
4933;Limburg (PV);2011 januari;1122627;802;926;3957;3190;767;3958;3302;656;;-125;-0.01;-125;-0.01;1122502
4934;Limburg (PV);2011 februari;1122502;715;849;3935;2888;1047;3453;2964;489;;348;0.03;223;0.02;1122850
4935;Limburg (PV);2011 maart;1122850;708;932;3556;2787;769;3583;2946;637;;-251;-0.02;-28;0.0;1122599
4936;Limburg (PV);2011 april;1122599;715;866;3273;2591;682;3368;2655;713;;-246;-0.02;-274;-0.02;1122353
4937;Limburg (PV);2011 mei;1122353;771;881;3460;2784;676;3444;2847;597;;-94;-0.01;-368;-0.03;1122259
4938;Limburg (PV);2011 juni;1122259;788;794;3281;2561;720;3281;2571;710;;-6;0.0;-374;-0.03;1122253
4939;Limburg (PV);2011 juli;1122253;826;775;4245;3446;799;4250;3441;809;;46;0.0;-328;-0.03;1122299
4940;Limburg (PV);2011 augustus;1122299;834;841;6007;4162;1845;5443;4451;992;;557;0.05;229;0.02;1122856
4941;Limburg (PV);2011 september;1122856;878;791;5695;3461;2234;4734;3886;848;;1048;0.09;1277;0.11;1123904
4942;Limburg (PV);2011 oktober;1123904;771;841;3711;2849;862;3796;3164;632;;-155;-0.01;1122;0.1;1123749
4943;Limburg (PV);2011 november;1123749;725;950;3746;2961;785;3825;3150;675;;-304;-0.03;818;0.07;1123445
4944;Limburg (PV);2011 december;1123445;755;996;3648;2959;689;3799;3109;690;22.0;-370;-0.03;448;0.04;1123075
4945;Limburg (PV);2011;1122627;9288;10442;48514;36639;11875;46934;38486;8448;22.0;448;0.04;448;0.04;1123075
4946;Limburg (PV);2012 januari;1123075;736;966;4260;3482;778;4427;3524;903;;-397;-0.04;-397;-0.04;1122678
4947;Limburg (PV);2012 februari;1122678;722;978;3837;2920;917;3605;3038;567;;-24;0.0;-421;-0.04;1122654
4948;Limburg (PV);2012 maart;1122654;734;1023;3643;2887;756;3651;2967;684;;-297;-0.03;-718;-0.06;1122357
4949;Limburg (PV);2012 april;1122357;758;919;3163;2498;665;3277;2635;642;;-275;-0.02;-993;-0.09;1122082
4950;Limburg (PV);2012 mei;1122082;794;961;3632;2904;728;3661;2963;698;;-196;-0.02;-1189;-0.11;1121886
4951;Limburg (PV);2012 juni;1121886;794;854;3775;3031;744;3813;3017;796;;-98;-0.01;-1287;-0.11;1121788
4952;Limburg (PV);2012 juli;1121788;785;755;4435;3554;881;4598;3666;932;;-133;-0.01;-1420;-0.13;1121655
4953;Limburg (PV);2012 augustus;1121655;796;890;5826;4138;1688;5449;4634;815;;283;0.03;-1137;-0.1;1121938
4954;Limburg (PV);2012 september;1121938;783;839;5667;3259;2408;4637;3826;811;;974;0.09;-163;-0.01;1122912
4955;Limburg (PV);2012 oktober;1122912;773;894;3903;2983;920;4029;3278;751;;-247;-0.02;-410;-0.04;1122665
4956;Limburg (PV);2012 november;1122665;753;931;3752;3008;744;3881;3215;666;;-307;-0.03;-717;-0.06;1122358
4957;Limburg (PV);2012 december;1122358;681;981;3390;2806;584;3537;2907;630;-20.0;-467;-0.04;-1184;-0.11;1121891
4958;Limburg (PV);2012;1123075;9109;10991;49283;37470;11813;48565;39670;8895;-20.0;-1184;-0.11;-1184;-0.11;1121891
4959;Limburg (PV);2013 januari;1121891;738;1034;4432;3535;897;4360;3511;849;;-224;-0.02;-224;-0.02;1121667
4960;Limburg (PV);2013 februari;1121667;662;994;3809;2891;918;3559;2972;587;;-82;-0.01;-306;-0.03;1121585
4961;Limburg (PV);2013 maart;1121585;698;1151;3525;2722;803;3605;2911;694;;-533;-0.05;-839;-0.07;1121052
4962;Limburg (PV);2013 april;1121052;726;954;3242;2549;693;3302;2606;696;;-288;-0.03;-1127;-0.1;1120764
4963;Limburg (PV);2013 mei;1120764;755;876;3554;2775;779;3592;2831;761;;-159;-0.01;-1286;-0.11;1120605
4964;Limburg (PV);2013 juni;1120605;750;846;3244;2576;668;3585;2719;866;;-437;-0.04;-1723;-0.15;1120168
4965;Limburg (PV);2013 juli;1120168;848;895;4442;3525;917;4740;3666;1074;;-345;-0.03;-2068;-0.18;1119823
4966;Limburg (PV);2013 augustus;1119823;812;828;5682;4090;1592;5405;4441;964;;261;0.02;-1807;-0.16;1120084
4967;Limburg (PV);2013 september;1120084;789;739;5839;3453;2386;4807;3985;822;;1082;0.1;-725;-0.06;1121166
4968;Limburg (PV);2013 oktober;1121166;781;897;3995;3004;991;4077;3327;750;;-198;-0.02;-923;-0.08;1120968
4969;Limburg (PV);2013 november;1120968;688;903;3529;2772;757;3846;3087;759;;-532;-0.05;-1455;-0.13;1120436
4970;Limburg (PV);2013 december;1120436;764;942;3511;2867;644;3767;3031;736;4.0;-430;-0.04;-1885;-0.17;1120006
4971;Limburg (PV);2013;1121891;9011;11059;48804;36759;12045;48645;39087;9558;4.0;-1885;-0.17;-1885;-0.17;1120006
4972;Limburg (PV);2014 januari;1120006;722;910;4476;3484;992;4504;3680;824;;-216;-0.02;-216;-0.02;1119790
4973;Limburg (PV);2014 februari;1119790;656;902;4240;3038;1202;3909;3205;704;;85;0.01;-131;-0.01;1119875
4974;Limburg (PV);2014 maart;1119875;722;950;3505;2737;768;3754;3018;736;;-477;-0.04;-608;-0.05;1119398
4975;Limburg (PV);2014 april;1119398;714;929;3728;2924;804;3838;3106;732;;-325;-0.03;-933;-0.08;1119073
4976;Limburg (PV);2014 mei;1119073;725;955;3166;2479;687;3264;2618;646;;-328;-0.03;-1261;-0.11;1118745
4977;Limburg (PV);2014 juni;1118745;770;849;3472;2650;822;3764;2791;973;;-371;-0.03;-1632;-0.15;1118374
4978;Limburg (PV);2014 juli;1118374;782;945;4809;3825;984;5072;3988;1084;;-426;-0.04;-2058;-0.18;1117948
4979;Limburg (PV);2014 augustus;1117948;769;863;5760;4292;1468;5584;4684;900;;82;0.01;-1976;-0.18;1118030
4980;Limburg (PV);2014 september;1118030;827;813;6460;3790;2670;5467;4449;1018;;1007;0.09;-969;-0.09;1119037
4981;Limburg (PV);2014 oktober;1119037;787;919;4281;3174;1107;4445;3501;944;;-296;-0.03;-1265;-0.11;1118741
4982;Limburg (PV);2014 november;1118741;658;886;3807;2913;894;3927;3176;751;;-348;-0.03;-1613;-0.14;1118393
4983;Limburg (PV);2014 december;1118393;709;1002;4120;3325;795;4251;3399;852;-28.0;-452;-0.04;-2065;-0.18;1117941
4984;Limburg (PV);2014;1120006;8841;10923;51824;38631;13193;51779;41615;10164;-28.0;-2065;-0.18;-2065;-0.18;1117941
4985;Limburg (PV);2015 januari;1117941;729;1168;4558;3596;962;4620;3655;965;;-501;-0.04;-501;-0.04;1117440
4986;Limburg (PV);2015 februari;1117440;595;1115;4257;3059;1198;3846;3242;604;;-109;-0.01;-610;-0.05;1117331
4987;Limburg (PV);2015 maart;1117331;674;1149;4317;3241;1076;4191;3369;822;;-349;-0.03;-959;-0.09;1116982
4988;Limburg (PV);2015 april;1116982;670;1010;3843;2917;926;3862;3140;722;;-359;-0.03;-1318;-0.12;1116623
4989;Limburg (PV);2015 mei;1116623;773;913;3474;2728;746;3644;2898;746;;-310;-0.03;-1628;-0.15;1116313
4990;Limburg (PV);2015 juni;1116313;775;874;3902;3077;825;4217;3173;1044;;-414;-0.04;-2042;-0.18;1115899
4991;Limburg (PV);2015 juli;1115899;801;954;5119;3950;1169;5269;4066;1203;;-303;-0.03;-2345;-0.21;1115596
4992;Limburg (PV);2015 augustus;1115596;837;916;5905;4365;1540;5728;4688;1040;;98;0.01;-2247;-0.2;1115694
4993;Limburg (PV);2015 september;1115694;749;866;6858;3784;3074;5234;4224;1010;;1507;0.14;-740;-0.07;1117201
4994;Limburg (PV);2015 oktober;1117201;743;977;4657;3514;1143;4867;3788;1079;;-444;-0.04;-1184;-0.11;1116757
4995;Limburg (PV);2015 november;1116757;694;896;4218;3151;1067;4047;3314;733;;-31;0.0;-1215;-0.11;1116726
4996;Limburg (PV);2015 december;1116726;699;976;4283;3417;866;4460;3578;882;-12.0;-466;-0.04;-1681;-0.15;1116260
4997;Limburg (PV);2015;1117941;8739;11814;55391;40799;14592;53985;43135;10850;-12.0;-1681;-0.15;-1681;-0.15;1116260
4998;Limburg (PV);2016 januari;1116260;741;996;4480;3484;996;4522;3642;880;;-297;-0.03;-297;-0.03;1115963
4999;Limburg (PV);2016 februari;1115963;704;1023;5094;3638;1456;4239;3548;691;;536;0.05;239;0.02;1116499
5000;Limburg (PV);2016 maart;1116499;735;1061;4589;3403;1186;4028;3369;659;;235;0.02;474;0.04;1116734
5001;Limburg (PV);2016 april;1116734;684;941;4271;3384;887;4025;3369;656;;-11;0.0;463;0.04;1116723
5002;Limburg (PV);2016 mei;1116723;706;990;4086;3351;735;4194;3422;772;;-392;-0.04;71;0.01;1116331
5003;Limburg (PV);2016 juni;1116331;766;857;4228;3371;857;4401;3431;970;;-264;-0.02;-193;-0.02;1116067
5004;Limburg (PV);2016 juli;1116067;835;938;5095;4204;891;5394;4141;1253;;-402;-0.04;-595;-0.05;1115665
5005;Limburg (PV);2016 augustus;1115665;803;864;6638;4840;1798;6162;5095;1067;;415;0.04;-180;-0.02;1116080
5006;Limburg (PV);2016 september;1116080;802;874;7028;4114;2914;5368;4455;913;;1588;0.14;1408;0.13;1117668
5007;Limburg (PV);2016 oktober;1117668;812;1016;4961;3591;1370;4508;3754;754;;249;0.02;1657;0.15;1117917
5008;Limburg (PV);2016 november;1117917;674;961;4761;3791;970;4491;3763;728;;-17;0.0;1640;0.15;1117900
5009;Limburg (PV);2016 december;1117900;732;1018;4621;3847;774;4655;3788;867;-34.0;-354;-0.03;1286;0.12;1117546
5010;Limburg (PV);2016;1116260;8994;11539;59852;45018;14834;55987;45777;10210;-34.0;1286;0.12;1286;0.12;1117546
5011;Limburg (PV);2017 januari;1117546;709;1224;4907;3937;970;4964;4064;900;;-572;-0.05;-572;-0.05;1116974
5012;Limburg (PV);2017 februari;1116974;648;1149;4783;3621;1162;4403;3707;696;;-121;-0.01;-693;-0.06;1116853
5013;Limburg (PV);2017 maart;1116853;697;1022;4980;3984;996;4915;4084;831;;-260;-0.02;-953;-0.09;1116593
5014;Limburg (PV);2017 april;1116593;687;904;3967;3260;707;3960;3242;718;;-210;-0.02;-1163;-0.1;1116383
5015;Limburg (PV);2017 mei;1116383;723;959;4283;3399;884;4218;3479;739;;-171;-0.02;-1334;-0.12;1116212
5016;Limburg (PV);2017 juni;1116212;671;908;4509;3742;767;4700;3666;1034;;-428;-0.04;-1762;-0.16;1115784
5017;Limburg (PV);2017 juli;1115784;780;906;5347;4342;1005;5525;4248;1277;;-304;-0.03;-2066;-0.18;1115480
5018;Limburg (PV);2017 augustus;1115480;844;891;6881;4989;1892;6111;4980;1131;;723;0.06;-1343;-0.12;1116203
5019;Limburg (PV);2017 september;1116203;831;912;7206;4154;3052;5535;4490;1045;;1590;0.14;247;0.02;1117793
5020;Limburg (PV);2017 oktober;1117793;817;971;5221;3926;1295;4913;4038;875;;154;0.01;401;0.04;1117947
5021;Limburg (PV);2017 november;1117947;705;936;4627;3674;953;4557;3746;811;;-161;-0.01;240;0.02;1117786
5022;Limburg (PV);2017 december;1117786;709;1063;4463;3755;708;4638;3639;999;-59.0;-588;-0.05;-348;-0.03;1117198
5023;Limburg (PV);2017;1117546;8821;11845;61174;46783;14391;58439;47383;11056;-59.0;-348;-0.03;-348;-0.03;1117198
5024;Limburg (PV);2018 januari;1117198;658;1091;5022;4024;998;5147;4102;1045;;-558;-0.05;-558;-0.05;1116640
5025;Limburg (PV);2018 februari;1116640;654;1140;4772;3460;1312;4277;3520;757;;9;0.0;-549;-0.05;1116649
5026;Limburg (PV);2018 maart;1116649;690;1300;4644;3733;911;4942;3942;1000;;-908;-0.08;-1457;-0.13;1115741
5027;Limburg (PV);2018 april;1115741;686;988;4112;3299;813;4265;3385;880;;-455;-0.04;-1912;-0.17;1115286
5028;Limburg (PV);2018 mei;1115286;723;876;4210;3367;843;4103;3400;703;;-46;0.0;-1958;-0.18;1115240
5029;Limburg (PV);2018 juni;1115240;738;838;4389;3546;843;4498;3423;1075;;-209;-0.02;-2167;-0.19;1115031
5030;Limburg (PV);2018 juli;1115031;830;923;5094;4004;1090;5726;4016;1710;;-725;-0.07;-2892;-0.26;1114306
5031;Limburg (PV);2018 augustus;1114306;789;965;6634;4739;1895;6156;4796;1360;;302;0.03;-2590;-0.23;1114608
5032;Limburg (PV);2018 september;1114608;815;899;6905;3973;2932;4957;4087;870;;1864;0.17;-726;-0.06;1116472
5033;Limburg (PV);2018 oktober;1116472;772;882;5108;3595;1513;4750;3775;975;;248;0.02;-478;-0.04;1116720
5034;Limburg (PV);2018 november;1116720;698;930;4756;3540;1216;4454;3613;841;;70;0.01;-408;-0.04;1116790
5035;Limburg (PV);2018 december;1116790;657;1084;4094;3312;782;4307;3376;931;-13.0;-653;-0.06;-1061;-0.09;1116137
5036;Limburg (PV);2018;1117198;8710;11916;59740;44592;15148;57582;45435;12147;-13.0;-1061;-0.09;-1061;-0.09;1116137
5037;Limburg (PV);2019 januari;1116137;747;1168;5042;3877;1165;4844;3869;975;;-223;-0.02;-223;-0.02;1115914
5038;Limburg (PV);2019 februari;1115914;634;1002;5142;3701;1441;4692;3745;947;;82;0.01;-141;-0.01;1115996
5039;Limburg (PV);2019 maart;1115996;691;1135;4411;3433;978;4296;3533;763;;-329;-0.03;-470;-0.04;1115667
5040;Limburg (PV);2019 april;1115667;659;1005;4656;3544;1112;4278;3497;781;;32;0.0;-438;-0.04;1115699
5041;Limburg (PV);2019 mei;1115699;727;934;4526;3470;1056;4243;3526;717;;76;0.01;-362;-0.03;1115775
5042;Limburg (PV);2019 juni;1115775;701;931;4142;3198;944;4088;3181;907;;-176;-0.02;-538;-0.05;1115599
5043;Limburg (PV);2019 juli;1115599;843;961;5623;4402;1221;5820;4356;1464;;-315;-0.03;-853;-0.08;1115284
5044;Limburg (PV);2019 augustus;1115284;824;886;6699;4520;2179;5668;4419;1249;;969;0.09;116;0.01;1116253
5045;Limburg (PV);2019 september;1116253;780;866;7286;3823;3463;5227;4052;1175;;1973;0.18;2089;0.19;1118226
5046;Limburg (PV);2019 oktober;1118226;743;941;5046;3613;1433;4722;3693;1029;;126;0.01;2215;0.2;1118352
5047;Limburg (PV);2019 november;1118352;703;1079;4519;3452;1067;4481;3538;943;;-338;-0.03;1877;0.17;1118014
5048;Limburg (PV);2019 december;1118014;616;1099;4498;3582;916;4781;3605;1176;-47.0;-813;-0.07;1064;0.1;1117201
5049;Limburg (PV);2019;1116137;8668;12007;61590;44615;16975;57140;45014;12126;-47.0;1064;0.1;1064;0.1;1117201
5050;Limburg (PV);2020 januari;1117201;701;1119;5154;3886;1268;5021;3838;1183;;-285;-0.03;-285;-0.03;1116916
5051;Limburg (PV);2020 februari;1116916;650;1004;5075;3638;1437;4389;3534;855;;332;0.03;47;0.0;1117248
5052;Limburg (PV);2020 maart;1117248;690;1562;4722;3675;1047;4491;3591;900;;-641;-0.06;-594;-0.05;1116607
5053;Limburg (PV);2020 april;1116607;708;1863;3909;3243;666;3853;3186;667;;-1099;-0.1;-1693;-0.15;1115508
5054;Limburg (PV);2020 mei;1115508;723;1068;4070;3476;594;4127;3393;734;;-402;-0.04;-2095;-0.19;1115106
5055;Limburg (PV);2020 juni;1115106;684;894;4480;3741;739;4669;3718;951;;-399;-0.04;-2494;-0.22;1114707
5056;Limburg (PV);2020 juli;1114707;839;918;5824;4686;1138;6658;4469;2189;;-913;-0.08;-3407;-0.3;1113794
5057;Limburg (PV);2020 augustus;1113794;795;933;7666;4979;2687;6100;4782;1318;;1428;0.13;-1979;-0.18;1115222
5058;Limburg (PV);2020 september;1115222;810;862;6454;4390;2064;5494;4483;1011;;908;0.08;-1071;-0.1;1116130
5059;Limburg (PV);2020 oktober;1116130;697;1040;5706;4361;1345;5239;4070;1169;;124;0.01;-947;-0.08;1116254
5060;Limburg (PV);2020 november;1116254;665;1098;4955;3858;1097;4506;3598;908;;16;0.0;-931;-0.08;1116270
5061;Limburg (PV);2020 december;1116270;690;1264;4680;3718;962;4457;3474;983;-47.0;-398;-0.04;-1329;-0.12;1115872
5062;Limburg (PV);2020;1117201;8652;13625;62695;47651;15044;59004;46136;12868;-47.0;-1329;-0.12;-1329;-0.12;1115872
5063;Limburg (PV);2021 januari;1115872;698;1478;5479;4411;1068;4975;4128;847;0.0;-276;-0.02;-276;-0.02;1115596
5064;Limburg (PV);2021 februari;1115596;748;1105;4788;3882;906;4407;3717;690;0.0;24;0.0;-252;-0.02;1115620
5065;Limburg (PV);2021 maart;1115620;768;1026;5166;4236;930;4824;3931;893;0.0;84;0.01;-168;-0.02;1115704
5066;Limburg (PV);2021 april;1115704;746;1066;4955;4012;943;4684;3852;832;0.0;-49;0.0;-217;-0.02;1115655
5067;Limburg (PV);2021 mei;1115655;783;1062;4570;3645;925;4332;3447;885;0.0;-41;0.0;-258;-0.02;1115614
5068;Limburg (PV);2021 juni;1115614;808;939;4809;3808;1001;4634;3532;1102;0.0;44;0.0;-214;-0.02;1115658
5069;Limburg (PV);2021 juli;1115658;884;1031;5734;4428;1306;5318;4018;1300;0.0;269;0.02;55;0.0;1115927
5070;Limburg (PV);2021 augustus;1115927;849;1005;8176;4725;3451;5657;4230;1427;0.0;2363;0.21;2418;0.22;1118290
5071;Limburg (PV);2021 september;1118290;882;952;6348;4177;2171;5200;4108;1092;0.0;1078;0.1;3496;0.31;1119368
5072;Limburg (PV);2021 oktober;1119368;779;1153;5076;3649;1427;4540;3489;1051;0.0;162;0.01;3658;0.33;1119530
5073;Limburg (PV);2021 november;1119530;786;1540;4711;3438;1273;4250;3342;908;0.0;-293;-0.03;3365;0.3;1119237
5074;Limburg (PV);2021 december;1119237;704;1568;4653;3698;955;4659;3363;1296;-65.0;-935;-0.08;2430;0.22;1118302
5075;Limburg (PV);2021;1115872;9435;13925;64465;48109;16356;57480;45157;12323;-65.0;2430;0.22;2430;0.22;1118302
5076;Limburg (PV);2022 januari;1118302;746;1122;5164;3866;1298;4717;3638;1079;;71;0.01;71;0.01;1118373
5077;Limburg (PV);2022 februari;1118373;689;997;4654;3503;1151;4420;3385;1035;;-74;-0.01;-3;0.0;1118299
5078;Limburg (PV);2022 maart;1118299;695;1257;6452;3798;2654;4690;3427;1263;;1200;0.11;1197;0.11;1119499
5079;Limburg (PV);2022 april;1119499;715;1151;5977;3576;2401;4138;3198;940;;1403;0.13;2600;0.23;1120902
5080;Limburg (PV);2022 mei;1120902;701;1017;5477;3489;1988;4098;3270;828;;1063;0.09;3663;0.33;1121965
5081;Limburg (PV);2022 juni;1121965;752;957;5252;3707;1545;4681;3368;1313;;366;0.03;4029;0.36;1122331
5082;Limburg (PV);2022 juli;1122331;797;1051;5875;4080;1795;5388;3767;1621;;233;0.02;4262;0.38;1122564
5083;Limburg (PV);2022 augustus;1122564;857;994;8484;4708;3776;5844;4325;1519;;2503;0.22;6765;0.6;1125067
5084;Limburg (PV);2022 september;1125067;786;979;7896;4466;3430;5753;4268;1485;;1950;0.17;8715;0.78;1127017
5085;Limburg (PV);2022 oktober;1127017;809;1055;5981;3974;2007;4683;3564;1119;;1052;0.09;9767;0.87;1128069
5086;Limburg (PV);2022 november;1128069;693;1079;5776;3908;1868;4692;3607;1085;;698;0.06;10465;0.94;1128767
5087;Limburg (PV);2022 december;1128767;683;1363;5113;3844;1269;4802;3570;1232;-31.0;-400;-0.04;10065;0.9;1128367
5088;Limburg (PV);2022;1118302;8923;13022;72101;46919;25182;57906;43387;14519;-31.0;10065;0.9;10065;0.9;1128367
5089;Limburg (PV);2023 januari;1128367;741;1334;5924;4126;1798;5222;4001;1221;0.0;109;0.01;109;0.01;1128476
5090;Limburg (PV);2023 februari;1128476;667;1116;5149;3549;1600;4491;3456;1035;0.0;209;0.02;318;0.03;1128685
5091;Limburg (PV);2023 maart;1128685;699;1337;5588;4050;1538;4737;3618;1119;0.0;213;0.02;531;0.05;1128898
5092;Limburg (PV);2023 april;1128898;680;1095;4650;3395;1255;4120;3141;979;0.0;115;0.01;646;0.06;1129013
5093;Limburg (PV);2023 mei;1129013;766;990;5082;3640;1442;4451;3313;1138;0.0;407;0.04;1053;0.09;1129420
5094;Limburg (PV);2023 juni;1129420;749;1019;5306;3877;1429;4918;3639;1279;0.0;118;0.01;1171;0.1;1129538
5095;Limburg (PV);2023 juli;1129538;854;983;6024;4387;1637;6076;4167;1909;0.0;-181;-0.02;990;0.09;1129357
5096;Limburg (PV);2023 augustus;1129357;787;1013;8771;4879;3892;6163;4611;1552;0.0;2382;0.21;3372;0.3;1131739
5097;Limburg (PV);2023 september;1131739;746;946;6965;4009;2956;5426;4049;1377;0.0;1339;0.12;4711;0.42;1133078
5098;Limburg (PV);2023 oktober;1133078;718;1031;5781;3903;1878;4950;3742;1208;0.0;518;0.05;5229;0.46;1133596
5099;Limburg (PV);2023 november;1133596;690;1123;4987;3605;1382;4371;3284;1087;0.0;183;0.02;5412;0.48;1133779
5100;Limburg (PV);2023 december;1133779;684;1247;4914;3766;1148;4841;3498;1343;-34.0;-524;-0.05;4888;0.43;1133255
5101;Limburg (PV);2023;1128367;8781;13234;69141;47186;21955;59766;44519;15247;-34.0;4888;0.43;4888;0.43;1133255
5102;Limburg (PV);2024 januari;1133255;727;1255;5786;4102;1684;5092;3814;1278;;166;0.01;166;0.01;1133421
5103;Limburg (PV);2024 februari;1133421;699;1243;5559;3795;1764;4791;3524;1267;;224;0.02;390;0.03;1133645
5104;Limburg (PV);2024 maart;1133645;702;1233;5627;4009;1618;4930;3469;1461;;166;0.01;556;0.05;1133811
5105;Limburg (PV);2024 april;1133811;665;1115;5073;3656;1417;4547;3437;1110;;76;0.01;632;0.06;1133887
5106;Limburg (PV);2024 mei;1133887;736;1097;4706;3383;1323;4237;3162;1075;;108;0.01;740;0.07;1133995
5107;Limburg (PV);2024 juni;1133995;701;983;4802;3562;1240;4776;3233;1543;;-256;-0.02;484;0.04;1133739
5108;Limburg (PV);2024 juli;1133739;781;1009;5824;4280;1544;6154;4058;2096;;-558;-0.05;-74;-0.01;1133181
5109;Limburg (PV);2024 augustus;1133181;767;1035;7495;4670;2825;6185;4440;1745;;1042;0.09;968;0.09;1134223
5110;Limburg (PV);2024 september;1134223;764;1039;7074;4039;3035;5221;3838;1383;;1578;0.14;2546;0.22;1135801
5111;Limburg (PV);2024 oktober;1135801;735;1162;6182;3898;2284;5281;3766;1515;;474;0.04;3020;0.27;1136275
5112;Limburg (PV);2024 november;1136275;659;1119;5190;3738;1452;4782;3412;1370;;-52;0.0;2968;0.26;1136223
5113;Limburg (PV);2024 december;1136223;640;1197;4682;3771;911;4842;3408;1434;0.0;-717;-0.06;2251;0.2;1135506
5114;Limburg (PV);2024;1133255;8576;13487;68000;46903;21097;60838;43561;17277;0.0;2251;0.2;2251;0.2;1135506
5115;Limburg (PV);2025 januari;1135506;691;1340;5868;4297;1571;5367;3810;1557;;-148;-0.01;-148;-0.01;1135358
5116;Limburg (PV);2025 februari;1135358;625;1253;5628;4025;1603;4999;3663;1336;;1;0.0;-147;-0.01;1135359
5117;Oost-Groningen (CR);2002 januari;154577;150;172;701;545;156;641;591;50;;38;0.02;38;0.02;154615
5118;Oost-Groningen (CR);2002 februari;154615;147;142;547;465;82;586;527;59;;-34;-0.02;4;0.0;154581
5119;Oost-Groningen (CR);2002 maart;154581;127;170;542;471;71;495;446;49;;4;0.0;8;0.01;154585
5120;Oost-Groningen (CR);2002 april;154585;125;152;607;496;111;570;538;32;;10;0.01;18;0.01;154595
5121;Oost-Groningen (CR);2002 mei;154595;140;147;586;523;63;550;525;25;;29;0.02;47;0.03;154624
5122;Oost-Groningen (CR);2002 juni;154624;130;139;610;529;81;624;554;70;;-23;-0.01;24;0.02;154601
5123;Oost-Groningen (CR);2002 juli;154601;154;144;758;696;62;693;662;31;;75;0.05;99;0.06;154676
5124;Oost-Groningen (CR);2002 augustus;154676;161;123;738;638;100;751;699;52;;25;0.02;124;0.08;154701
5125;Oost-Groningen (CR);2002 september;154701;142;126;667;572;95;656;599;57;;27;0.02;151;0.1;154728
5126;Oost-Groningen (CR);2002 oktober;154728;167;148;675;605;70;660;599;61;;34;0.02;185;0.12;154762
5127;Oost-Groningen (CR);2002 november;154762;130;140;601;539;62;672;609;63;;-81;-0.05;104;0.07;154681
5128;Oost-Groningen (CR);2002 december;154681;133;138;530;500;30;613;557;56;41.0;-47;-0.03;57;0.04;154634
5129;Oost-Groningen (CR);2002;154577;1706;1741;7562;6579;983;7511;6906;605;41.0;57;0.04;57;0.04;154634
5130;Oost-Groningen (CR);2003 januari;154634;131;190;747;650;97;691;655;36;;-3;0.0;-3;0.0;154631
5131;Oost-Groningen (CR);2003 februari;154631;116;147;617;544;73;628;594;34;;-42;-0.03;-45;-0.03;154589
5132;Oost-Groningen (CR);2003 maart;154589;142;183;546;489;57;567;506;61;;-62;-0.04;-107;-0.07;154527
5133;Oost-Groningen (CR);2003 april;154527;143;177;621;555;66;613;567;46;;-26;-0.02;-133;-0.09;154501
5134;Oost-Groningen (CR);2003 mei;154501;138;166;652;572;80;661;608;53;;-37;-0.02;-170;-0.11;154464
5135;Oost-Groningen (CR);2003 juni;154464;106;137;612;534;78;630;528;102;;-49;-0.03;-219;-0.14;154415
5136;Oost-Groningen (CR);2003 juli;154415;177;122;794;676;118;634;591;43;;215;0.14;-4;0.0;154630
5137;Oost-Groningen (CR);2003 augustus;154630;150;144;679;614;65;727;651;76;;-42;-0.03;-46;-0.03;154588
5138;Oost-Groningen (CR);2003 september;154588;140;135;701;633;68;753;715;38;;-47;-0.03;-93;-0.06;154541
5139;Oost-Groningen (CR);2003 oktober;154541;118;111;672;593;79;698;625;73;;-19;-0.01;-112;-0.07;154522
5140;Oost-Groningen (CR);2003 november;154522;111;153;592;524;68;523;492;31;;27;0.02;-85;-0.05;154549
5141;Oost-Groningen (CR);2003 december;154549;120;130;615;568;47;601;549;52;58.0;62;0.04;-23;-0.01;154611
5142;Oost-Groningen (CR);2003;154634;1592;1795;7848;6952;896;7726;7081;645;58.0;-23;-0.01;-23;-0.01;154611
5143;Oost-Groningen (CR);2004 januari;154611;123;174;623;582;41;661;569;92;;-89;-0.06;-89;-0.06;154522
5144;Oost-Groningen (CR);2004 februari;154522;144;140;569;511;58;602;498;104;;-29;-0.02;-118;-0.08;154493
5145;Oost-Groningen (CR);2004 maart;154493;142;132;588;513;75;573;512;61;;25;0.02;-93;-0.06;154518
5146;Oost-Groningen (CR);2004 april;154518;122;126;548;492;56;519;462;57;;25;0.02;-68;-0.04;154543
5147;Oost-Groningen (CR);2004 mei;154543;112;135;521;476;45;512;463;49;;-14;-0.01;-82;-0.05;154529
5148;Oost-Groningen (CR);2004 juni;154529;100;135;524;468;56;663;576;87;;-174;-0.11;-256;-0.17;154355
5149;Oost-Groningen (CR);2004 juli;154355;123;133;626;582;44;816;748;68;;-200;-0.13;-456;-0.29;154155
5150;Oost-Groningen (CR);2004 augustus;154155;144;137;623;584;39;724;669;55;;-94;-0.06;-550;-0.36;154061
5151;Oost-Groningen (CR);2004 september;154061;132;130;585;551;34;713;649;64;;-126;-0.08;-676;-0.44;153935
5152;Oost-Groningen (CR);2004 oktober;153935;131;96;536;499;37;539;476;63;;32;0.02;-644;-0.42;153967
5153;Oost-Groningen (CR);2004 november;153967;109;125;599;560;39;623;582;41;;-40;-0.03;-684;-0.44;153927
5154;Oost-Groningen (CR);2004 december;153927;127;170;572;536;36;571;513;58;27.0;-15;-0.01;-699;-0.45;153912
5155;Oost-Groningen (CR);2004;154611;1509;1633;6914;6354;560;7516;6717;799;27.0;-699;-0.45;-699;-0.45;153912
5156;Oost-Groningen (CR);2005 januari;153912;121;142;693;661;32;557;506;51;;115;0.07;115;0.07;154027
5157;Oost-Groningen (CR);2005 februari;154027;106;116;625;583;42;546;516;30;;69;0.04;184;0.12;154096
5158;Oost-Groningen (CR);2005 maart;154096;133;163;666;623;43;593;490;103;;43;0.03;227;0.15;154139
5159;Oost-Groningen (CR);2005 april;154139;121;164;641;619;22;629;532;97;;-31;-0.02;196;0.13;154108
5160;Oost-Groningen (CR);2005 mei;154108;124;157;659;620;39;583;511;72;;43;0.03;239;0.16;154151
5161;Oost-Groningen (CR);2005 juni;154151;99;125;631;577;54;558;526;32;;47;0.03;286;0.19;154198
5162;Oost-Groningen (CR);2005 juli;154198;124;120;802;744;58;726;655;71;;80;0.05;366;0.24;154278
5163;Oost-Groningen (CR);2005 augustus;154278;136;139;804;748;56;771;687;84;;30;0.02;396;0.26;154308
5164;Oost-Groningen (CR);2005 september;154308;131;123;777;747;30;826;769;57;;-41;-0.03;355;0.23;154267
5165;Oost-Groningen (CR);2005 oktober;154267;130;125;680;644;36;646;587;59;;39;0.03;394;0.26;154306
5166;Oost-Groningen (CR);2005 november;154306;137;133;663;625;38;652;582;70;;15;0.01;409;0.27;154321
5167;Oost-Groningen (CR);2005 december;154321;115;155;667;634;33;691;605;86;45.0;-19;-0.01;390;0.25;154302
5168;Oost-Groningen (CR);2005;153912;1477;1662;8308;7825;483;7778;6966;812;45.0;390;0.25;390;0.25;154302
5169;Oost-Groningen (CR);2006 januari;154302;117;173;714;673;41;720;661;59;;-62;-0.04;-62;-0.04;154240
5170;Oost-Groningen (CR);2006 februari;154240;126;144;621;593;28;654;602;52;;-51;-0.03;-113;-0.07;154189
5171;Oost-Groningen (CR);2006 maart;154189;155;167;646;610;36;727;637;90;;-93;-0.06;-206;-0.13;154096
5172;Oost-Groningen (CR);2006 april;154096;101;130;516;489;27;604;477;127;;-117;-0.08;-323;-0.21;153979
5173;Oost-Groningen (CR);2006 mei;153979;121;135;606;577;29;628;522;106;;-36;-0.02;-359;-0.23;153943
5174;Oost-Groningen (CR);2006 juni;153943;105;127;633;607;26;608;561;47;;3;0.0;-356;-0.23;153946
5175;Oost-Groningen (CR);2006 juli;153946;119;146;695;647;48;715;654;61;;-47;-0.03;-403;-0.26;153899
5176;Oost-Groningen (CR);2006 augustus;153899;138;116;680;645;35;766;713;53;;-64;-0.04;-467;-0.3;153835
5177;Oost-Groningen (CR);2006 september;153835;121;123;729;691;38;696;649;47;;31;0.02;-436;-0.28;153866
5178;Oost-Groningen (CR);2006 oktober;153866;106;138;705;654;51;745;616;129;;-72;-0.05;-508;-0.33;153794
5179;Oost-Groningen (CR);2006 november;153794;129;137;593;548;45;604;541;63;;-19;-0.01;-527;-0.34;153775
5180;Oost-Groningen (CR);2006 december;153775;105;123;556;537;19;557;505;52;53.0;34;0.02;-493;-0.32;153809
5181;Oost-Groningen (CR);2006;154302;1443;1659;7694;7271;423;8024;7138;886;53.0;-493;-0.32;-493;-0.32;153809
5182;Oost-Groningen (CR);2007 januari;153809;129;167;655;603;52;710;661;49;;-93;-0.06;-93;-0.06;153716
5183;Oost-Groningen (CR);2007 februari;153716;116;108;600;569;31;697;611;86;;-89;-0.06;-182;-0.12;153627
5184;Oost-Groningen (CR);2007 maart;153627;108;166;602;576;26;608;557;51;;-64;-0.04;-246;-0.16;153563
5185;Oost-Groningen (CR);2007 april;153563;102;136;559;525;34;550;521;29;;-25;-0.02;-271;-0.18;153538
5186;Oost-Groningen (CR);2007 mei;153538;132;123;594;554;40;568;535;33;;35;0.02;-236;-0.15;153573
5187;Oost-Groningen (CR);2007 juni;153573;96;128;548;516;32;517;497;20;;-1;0.0;-237;-0.15;153572
5188;Oost-Groningen (CR);2007 juli;153572;124;137;807;738;69;895;674;221;;-101;-0.07;-338;-0.22;153471
5189;Oost-Groningen (CR);2007 augustus;153471;127;135;901;833;68;860;812;48;;33;0.02;-305;-0.2;153504
5190;Oost-Groningen (CR);2007 september;153504;126;103;646;600;46;745;707;38;;-76;-0.05;-381;-0.25;153428
5191;Oost-Groningen (CR);2007 oktober;153428;108;124;686;635;51;762;713;49;;-92;-0.06;-473;-0.31;153336
5192;Oost-Groningen (CR);2007 november;153336;116;145;640;595;45;765;707;58;;-154;-0.1;-627;-0.41;153182
5193;Oost-Groningen (CR);2007 december;153182;112;148;554;526;28;676;637;39;39.0;-119;-0.08;-746;-0.49;153063
5194;Oost-Groningen (CR);2007;153809;1396;1620;7792;7270;522;8353;7632;721;39.0;-746;-0.49;-746;-0.49;153063
5195;Oost-Groningen (CR);2008 januari;153063;130;166;755;691;64;799;753;46;;-80;-0.05;-80;-0.05;152983
5196;Oost-Groningen (CR);2008 februari;152983;98;152;645;612;33;721;694;27;;-130;-0.08;-210;-0.14;152853
5197;Oost-Groningen (CR);2008 maart;152853;114;155;602;553;49;669;625;44;;-108;-0.07;-318;-0.21;152745
5198;Oost-Groningen (CR);2008 april;152745;121;151;640;590;50;695;635;60;;-85;-0.06;-403;-0.26;152660
5199;Oost-Groningen (CR);2008 mei;152660;113;152;556;497;59;622;554;68;;-105;-0.07;-508;-0.33;152555
5200;Oost-Groningen (CR);2008 juni;152555;121;132;656;597;59;729;686;43;;-84;-0.06;-592;-0.39;152471
5201;Oost-Groningen (CR);2008 juli;152471;129;133;818;760;58;834;734;100;;-20;-0.01;-612;-0.4;152451
5202;Oost-Groningen (CR);2008 augustus;152451;131;142;723;665;58;786;737;49;;-74;-0.05;-686;-0.45;152377
5203;Oost-Groningen (CR);2008 september;152377;120;125;681;631;50;777;726;51;;-101;-0.07;-787;-0.51;152276
5204;Oost-Groningen (CR);2008 oktober;152276;123;151;639;589;50;697;656;41;;-86;-0.06;-873;-0.57;152190
5205;Oost-Groningen (CR);2008 november;152190;119;141;642;576;66;642;586;56;;-22;-0.01;-895;-0.58;152168
5206;Oost-Groningen (CR);2008 december;152168;116;136;630;586;44;647;600;47;41.0;4;0.0;-891;-0.58;152172
5207;Oost-Groningen (CR);2008;153063;1435;1736;7987;7347;640;8618;7986;632;41.0;-891;-0.58;-891;-0.58;152172
5208;Oost-Groningen (CR);2009 januari;152172;119;178;672;636;36;715;672;43;;-102;-0.07;-102;-0.07;152070
5209;Oost-Groningen (CR);2009 februari;152070;106;144;542;495;47;566;535;31;;-62;-0.04;-164;-0.11;152008
5210;Oost-Groningen (CR);2009 maart;152008;134;166;641;560;81;698;636;62;;-89;-0.06;-253;-0.17;151919
5211;Oost-Groningen (CR);2009 april;151919;108;118;562;503;59;553;522;31;;-1;0.0;-254;-0.17;151918
5212;Oost-Groningen (CR);2009 mei;151918;124;128;550;485;65;495;471;24;;51;0.03;-203;-0.13;151969
5213;Oost-Groningen (CR);2009 juni;151969;120;124;603;537;66;552;510;42;;47;0.03;-156;-0.1;152016
5214;Oost-Groningen (CR);2009 juli;152016;160;118;719;667;52;681;611;70;;80;0.05;-76;-0.05;152096
5215;Oost-Groningen (CR);2009 augustus;152096;145;134;675;593;82;690;623;67;;-4;0.0;-80;-0.05;152092
5216;Oost-Groningen (CR);2009 september;152092;143;115;630;556;74;668;594;74;;-10;-0.01;-90;-0.06;152082
5217;Oost-Groningen (CR);2009 oktober;152082;121;129;622;549;73;610;580;30;;4;0.0;-86;-0.06;152086
5218;Oost-Groningen (CR);2009 november;152086;98;130;536;452;84;569;518;51;;-65;-0.04;-151;-0.1;152021
5219;Oost-Groningen (CR);2009 december;152021;122;141;456;397;59;506;460;46;52.0;-17;-0.01;-168;-0.11;152004
5220;Oost-Groningen (CR);2009;152172;1500;1625;7208;6430;778;7303;6732;571;52.0;-168;-0.11;-168;-0.11;152004
5221;Oost-Groningen (CR);2010 januari;152004;112;138;638;518;120;543;514;29;;69;0.05;69;0.05;152073
5222;Oost-Groningen (CR);2010 februari;152073;114;161;539;464;75;484;460;24;;8;0.01;77;0.05;152081
5223;Oost-Groningen (CR);2010 maart;152081;110;180;620;533;87;640;543;97;;-90;-0.06;-13;-0.01;151991
5224;Oost-Groningen (CR);2010 april;151991;107;137;488;430;58;503;459;44;;-45;-0.03;-58;-0.04;151946
5225;Oost-Groningen (CR);2010 mei;151946;94;133;527;436;91;464;419;45;;24;0.02;-34;-0.02;151970
5226;Oost-Groningen (CR);2010 juni;151970;112;138;596;481;115;565;513;52;;5;0.0;-29;-0.02;151975
5227;Oost-Groningen (CR);2010 juli;151975;126;162;668;581;87;698;624;74;;-66;-0.04;-95;-0.06;151909
5228;Oost-Groningen (CR);2010 augustus;151909;132;134;625;538;87;697;643;54;;-74;-0.05;-169;-0.11;151835
5229;Oost-Groningen (CR);2010 september;151835;113;133;523;464;59;642;603;39;;-139;-0.09;-308;-0.2;151696
5230;Oost-Groningen (CR);2010 oktober;151696;134;124;503;424;79;563;516;47;;-50;-0.03;-358;-0.24;151646
5231;Oost-Groningen (CR);2010 november;151646;122;160;476;428;48;528;465;63;;-90;-0.06;-448;-0.29;151556
5232;Oost-Groningen (CR);2010 december;151556;130;134;499;450;49;501;461;40;-20.0;-26;-0.02;-474;-0.31;151530
5233;Oost-Groningen (CR);2010;152004;1406;1734;6702;5747;955;6828;6220;608;-20.0;-474;-0.31;-474;-0.31;151530
5234;Oost-Groningen (CR);2011 januari;151530;111;144;561;509;52;674;537;137;;-146;-0.1;-146;-0.1;151384
5235;Oost-Groningen (CR);2011 februari;151384;103;142;526;471;55;543;494;49;;-56;-0.04;-202;-0.13;151328
5236;Oost-Groningen (CR);2011 maart;151328;135;154;575;490;85;611;533;78;;-55;-0.04;-257;-0.17;151273
5237;Oost-Groningen (CR);2011 april;151273;101;128;452;402;50;439;390;49;;-14;-0.01;-271;-0.18;151259
5238;Oost-Groningen (CR);2011 mei;151259;101;126;481;425;56;457;395;62;;-1;0.0;-272;-0.18;151258
5239;Oost-Groningen (CR);2011 juni;151258;130;124;498;452;46;508;471;37;;-4;0.0;-276;-0.18;151254
5240;Oost-Groningen (CR);2011 juli;151254;109;149;572;507;65;603;549;54;;-71;-0.05;-347;-0.23;151183
5241;Oost-Groningen (CR);2011 augustus;151183;126;121;619;535;84;734;690;44;;-110;-0.07;-457;-0.3;151073
5242;Oost-Groningen (CR);2011 september;151073;130;130;669;597;72;648;609;39;;21;0.01;-436;-0.29;151094
5243;Oost-Groningen (CR);2011 oktober;151094;111;130;535;486;49;594;547;47;;-78;-0.05;-514;-0.34;151016
5244;Oost-Groningen (CR);2011 november;151016;111;144;575;520;55;680;595;85;;-138;-0.09;-652;-0.43;150878
5245;Oost-Groningen (CR);2011 december;150878;114;159;513;464;49;552;526;26;-12.0;-96;-0.06;-748;-0.49;150782
5246;Oost-Groningen (CR);2011;151530;1382;1651;6576;5858;718;7043;6336;707;-12.0;-748;-0.49;-748;-0.49;150782
5247;Oost-Groningen (CR);2012 januari;150782;125;146;616;543;73;670;636;34;;-75;-0.05;-75;-0.05;150707
5248;Oost-Groningen (CR);2012 februari;150707;113;157;576;530;46;582;524;58;;-50;-0.03;-125;-0.08;150657
5249;Oost-Groningen (CR);2012 maart;150657;111;157;563;513;50;596;537;59;;-79;-0.05;-204;-0.14;150578
5250;Oost-Groningen (CR);2012 april;150578;111;123;455;411;44;488;460;28;;-45;-0.03;-249;-0.17;150533
5251;Oost-Groningen (CR);2012 mei;150533;110;151;512;469;43;564;522;42;;-93;-0.06;-342;-0.23;150440
5252;Oost-Groningen (CR);2012 juni;150440;101;144;570;536;34;624;560;64;;-97;-0.06;-439;-0.29;150343
5253;Oost-Groningen (CR);2012 juli;150343;116;140;597;539;58;651;552;99;;-78;-0.05;-517;-0.34;150265
5254;Oost-Groningen (CR);2012 augustus;150265;110;126;611;546;65;695;665;30;;-100;-0.07;-617;-0.41;150165
5255;Oost-Groningen (CR);2012 september;150165;101;100;490;446;44;568;510;58;;-77;-0.05;-694;-0.46;150088
5256;Oost-Groningen (CR);2012 oktober;150088;125;143;512;451;61;642;570;72;;-148;-0.1;-842;-0.56;149940
5257;Oost-Groningen (CR);2012 november;149940;115;159;528;472;56;544;482;62;;-60;-0.04;-902;-0.6;149880
5258;Oost-Groningen (CR);2012 december;149880;115;145;465;404;61;469;437;32;-8.0;-42;-0.03;-944;-0.63;149838
5259;Oost-Groningen (CR);2012;150782;1353;1691;6495;5860;635;7093;6455;638;-8.0;-944;-0.63;-944;-0.63;149838
5260;Oost-Groningen (CR);2013 januari;149838;129;185;569;496;73;607;518;89;;-94;-0.06;-94;-0.06;149744
5261;Oost-Groningen (CR);2013 februari;149744;105;165;495;443;52;519;457;62;;-84;-0.06;-178;-0.12;149660
5262;Oost-Groningen (CR);2013 maart;149660;87;162;545;484;61;529;519;10;;-59;-0.04;-237;-0.16;149601
5263;Oost-Groningen (CR);2013 april;149601;83;149;444;353;91;449;421;28;;-71;-0.05;-308;-0.21;149530
5264;Oost-Groningen (CR);2013 mei;149530;92;135;547;432;115;555;509;46;;-51;-0.03;-359;-0.24;149479
5265;Oost-Groningen (CR);2013 juni;149479;124;124;448;372;76;484;463;21;;-36;-0.02;-395;-0.26;149443
5266;Oost-Groningen (CR);2013 juli;149443;103;126;567;479;88;611;550;61;;-67;-0.04;-462;-0.31;149376
5267;Oost-Groningen (CR);2013 augustus;149376;106;123;603;521;82;668;631;37;;-82;-0.05;-544;-0.36;149294
5268;Oost-Groningen (CR);2013 september;149294;120;117;499;440;59;669;619;50;;-167;-0.11;-711;-0.47;149127
5269;Oost-Groningen (CR);2013 oktober;149127;96;154;556;466;90;607;551;56;;-109;-0.07;-820;-0.55;149018
5270;Oost-Groningen (CR);2013 november;149018;113;151;564;432;132;548;506;42;;-22;-0.01;-842;-0.56;148996
5271;Oost-Groningen (CR);2013 december;148996;111;139;513;434;79;538;484;54;1.0;-52;-0.03;-894;-0.6;148944
5272;Oost-Groningen (CR);2013;149838;1269;1730;6350;5352;998;6784;6228;556;1.0;-894;-0.6;-894;-0.6;148944
5273;Oost-Groningen (CR);2014 januari;148944;105;133;635;509;126;587;541;46;;20;0.01;20;0.01;148964
5274;Oost-Groningen (CR);2014 februari;148964;124;145;497;422;75;500;471;29;;-24;-0.02;-4;0.0;148940
5275;Oost-Groningen (CR);2014 maart;148940;88;143;551;443;108;594;520;74;;-98;-0.07;-102;-0.07;148842
5276;Oost-Groningen (CR);2014 april;148842;89;124;575;439;136;569;530;39;;-29;-0.02;-131;-0.09;148813
5277;Oost-Groningen (CR);2014 mei;148813;111;140;524;400;124;504;469;35;;-9;-0.01;-140;-0.09;148804
5278;Oost-Groningen (CR);2014 juni;148804;96;151;454;392;62;503;453;50;;-104;-0.07;-244;-0.16;148700
5279;Oost-Groningen (CR);2014 juli;148700;108;139;628;492;136;646;609;37;;-49;-0.03;-293;-0.2;148651
5280;Oost-Groningen (CR);2014 augustus;148651;113;125;707;520;187;677;613;64;;18;0.01;-275;-0.18;148669
5281;Oost-Groningen (CR);2014 september;148669;113;114;898;448;450;730;678;52;;167;0.11;-108;-0.07;148836
5282;Oost-Groningen (CR);2014 oktober;148836;114;134;1131;542;589;856;827;29;;255;0.17;147;0.1;149091
5283;Oost-Groningen (CR);2014 november;149091;96;149;857;417;440;832;789;43;;-28;-0.02;119;0.08;149063
5284;Oost-Groningen (CR);2014 december;149063;101;154;883;517;366;914;868;46;-13.0;-97;-0.07;22;0.01;148966
5285;Oost-Groningen (CR);2014;148944;1258;1651;8340;5541;2799;7912;7368;544;-13.0;22;0.01;22;0.01;148966
5286;Oost-Groningen (CR);2015 januari;148966;107;183;990;548;442;1026;971;55;;-112;-0.08;-112;-0.08;148854
5287;Oost-Groningen (CR);2015 februari;148854;88;134;911;489;422;922;872;50;;-57;-0.04;-169;-0.11;148797
5288;Oost-Groningen (CR);2015 maart;148797;79;172;891;507;384;938;890;48;;-140;-0.09;-309;-0.21;148657
5289;Oost-Groningen (CR);2015 april;148657;88;128;824;489;335;888;827;61;;-104;-0.07;-413;-0.28;148553
5290;Oost-Groningen (CR);2015 mei;148553;103;143;533;410;123;764;704;60;;-271;-0.18;-684;-0.46;148282
5291;Oost-Groningen (CR);2015 juni;148282;87;128;791;505;286;755;700;55;;-5;0.0;-689;-0.46;148277
5292;Oost-Groningen (CR);2015 juli;148277;114;136;870;531;339;900;832;68;;-52;-0.04;-741;-0.5;148225
5293;Oost-Groningen (CR);2015 augustus;148225;100;141;853;573;280;910;847;63;;-98;-0.07;-839;-0.56;148127
5294;Oost-Groningen (CR);2015 september;148127;134;121;1002;524;478;842;797;45;;173;0.12;-666;-0.45;148300
5295;Oost-Groningen (CR);2015 oktober;148300;111;137;1260;591;669;923;864;59;;311;0.21;-355;-0.24;148611
5296;Oost-Groningen (CR);2015 november;148611;101;120;1282;477;805;1105;1042;63;;158;0.11;-197;-0.13;148769
5297;Oost-Groningen (CR);2015 december;148769;112;146;1049;520;529;1202;1153;49;1.0;-186;-0.13;-383;-0.26;148583
5298;Oost-Groningen (CR);2015;148966;1224;1689;11256;6164;5092;11175;10499;676;1.0;-383;-0.26;-383;-0.26;148583
5299;Oost-Groningen (CR);2016 januari;148583;103;162;1125;513;612;1037;1007;30;;29;0.02;29;0.02;148612
5300;Oost-Groningen (CR);2016 februari;148612;127;181;1261;573;688;1211;1173;38;;-4;0.0;25;0.02;148608
5301;Oost-Groningen (CR);2016 maart;148608;125;168;1036;601;435;1378;1332;46;;-385;-0.26;-360;-0.24;148223
5302;Oost-Groningen (CR);2016 april;148223;79;145;979;565;414;1104;992;112;;-191;-0.13;-551;-0.37;148032
5303;Oost-Groningen (CR);2016 mei;148032;108;123;1053;507;546;1103;1067;36;;-65;-0.04;-616;-0.41;147967
5304;Oost-Groningen (CR);2016 juni;147967;106;148;1139;552;587;1030;983;47;;67;0.05;-549;-0.37;148034
5305;Oost-Groningen (CR);2016 juli;148034;108;132;1068;678;390;1197;1150;47;;-153;-0.1;-702;-0.47;147881
5306;Oost-Groningen (CR);2016 augustus;147881;129;136;1108;720;388;1226;1177;49;;-125;-0.08;-827;-0.56;147756
5307;Oost-Groningen (CR);2016 september;147756;111;148;860;616;244;949;916;33;;-126;-0.09;-953;-0.64;147630
5308;Oost-Groningen (CR);2016 oktober;147630;99;134;795;539;256;817;776;41;;-57;-0.04;-1010;-0.68;147573
5309;Oost-Groningen (CR);2016 november;147573;118;149;733;535;198;818;775;43;;-116;-0.08;-1126;-0.76;147457
5310;Oost-Groningen (CR);2016 december;147457;86;153;794;626;168;782;747;35;-9.0;-64;-0.04;-1190;-0.8;147393
5311;Oost-Groningen (CR);2016;148583;1299;1779;11951;7025;4926;12652;12095;557;-9.0;-1190;-0.8;-1190;-0.8;147393
5312;Oost-Groningen (CR);2017 januari;147393;97;189;771;634;137;770;724;46;;-91;-0.06;-91;-0.06;147302
5313;Oost-Groningen (CR);2017 februari;147302;90;174;695;577;118;691;664;27;;-80;-0.05;-171;-0.12;147222
5314;Oost-Groningen (CR);2017 maart;147222;88;162;893;689;204;833;804;29;;-14;-0.01;-185;-0.13;147208
5315;Oost-Groningen (CR);2017 april;147208;99;136;784;532;252;788;690;98;;-41;-0.03;-226;-0.15;147167
5316;Oost-Groningen (CR);2017 mei;147167;102;158;857;649;208;848;793;55;;-47;-0.03;-273;-0.19;147120
5317;Oost-Groningen (CR);2017 juni;147120;104;122;742;600;142;763;700;63;;-39;-0.03;-312;-0.21;147081
5318;Oost-Groningen (CR);2017 juli;147081;93;138;754;607;147;746;720;26;;-37;-0.03;-349;-0.24;147044
5319;Oost-Groningen (CR);2017 augustus;147044;93;122;964;733;231;1010;926;84;;-75;-0.05;-424;-0.29;146969
5320;Oost-Groningen (CR);2017 september;146969;98;109;885;605;280;945;889;56;;-71;-0.05;-495;-0.34;146898
5321;Oost-Groningen (CR);2017 oktober;146898;92;151;860;636;224;900;857;43;;-99;-0.07;-594;-0.4;146799
5322;Oost-Groningen (CR);2017 november;146799;101;144;760;595;165;768;708;60;;-51;-0.03;-645;-0.44;146748
5323;Oost-Groningen (CR);2017 december;146748;101;140;736;623;113;654;628;26;-8.0;35;0.02;-610;-0.41;146783
5324;Oost-Groningen (CR);2017;147393;1158;1745;9701;7480;2221;9716;9103;613;-8.0;-610;-0.41;-610;-0.41;146783
5325;Oost-Groningen (CR);2018 januari;134770;87;152;1363;549;814;756;744;12;;542;0.4;542;0.4;135312
5326;Oost-Groningen (CR);2018 februari;135312;79;177;1391;454;937;1124;1096;28;;169;0.12;711;0.53;135481
5327;Oost-Groningen (CR);2018 maart;135481;84;165;1618;579;1039;1476;1449;27;;61;0.05;772;0.57;135542
5328;Oost-Groningen (CR);2018 april;135542;73;143;1336;430;906;1287;1251;36;;-21;-0.02;751;0.56;135521
5329;Oost-Groningen (CR);2018 mei;135521;91;126;1559;465;1094;1318;1291;27;;206;0.15;957;0.71;135727
5330;Oost-Groningen (CR);2018 juni;135727;90;132;1213;475;738;1548;1520;28;;-377;-0.28;580;0.43;135350
5331;Oost-Groningen (CR);2018 juli;135350;91;154;1459;528;931;1381;1326;55;;15;0.01;595;0.44;135365
5332;Oost-Groningen (CR);2018 augustus;135365;91;124;1151;592;559;1522;1465;57;;-404;-0.3;191;0.14;134961
5333;Oost-Groningen (CR);2018 september;134961;94;113;1060;512;548;1145;1101;44;;-104;-0.08;87;0.06;134857
5334;Oost-Groningen (CR);2018 oktober;134857;95;123;1127;543;584;1209;1164;45;;-110;-0.08;-23;-0.02;134747
5335;Oost-Groningen (CR);2018 november;134747;79;151;1158;530;628;1144;1112;32;;-58;-0.04;-81;-0.06;134689
5336;Oost-Groningen (CR);2018 december;134689;77;139;1086;487;599;913;891;22;22.0;133;0.1;52;0.04;134822
5337;Oost-Groningen (CR);2018;134770;1031;1699;15521;6144;9377;14823;14410;413;22.0;52;0.04;52;0.04;134822
5338;Oost-Groningen (CR);2019 januari;134822;97;147;1084;536;548;1199;1185;14;;-165;-0.12;-165;-0.12;134657
5339;Oost-Groningen (CR);2019 februari;134657;75;138;1096;473;623;1033;999;34;;0;0.0;-165;-0.12;134657
5340;Oost-Groningen (CR);2019 maart;134657;94;155;1103;493;610;987;958;29;;55;0.04;-110;-0.08;134712
5341;Oost-Groningen (CR);2019 april;134712;92;137;1042;510;532;1044;1011;33;;-47;-0.03;-157;-0.12;134665
5342;Oost-Groningen (CR);2019 mei;134665;83;129;1080;541;539;1034;1007;27;;0;0.0;-157;-0.12;134665
5343;Oost-Groningen (CR);2019 juni;134665;86;133;1416;498;918;1072;1036;36;;297;0.22;140;0.1;134962
5344;Oost-Groningen (CR);2019 juli;134962;97;120;1571;618;953;1339;1298;41;;209;0.15;349;0.26;135171
5345;Oost-Groningen (CR);2019 augustus;135171;82;120;1242;631;611;1459;1429;30;;-255;-0.19;94;0.07;134916
5346;Oost-Groningen (CR);2019 september;134916;95;124;1309;562;747;1277;1144;133;;3;0.0;97;0.07;134919
5347;Oost-Groningen (CR);2019 oktober;134919;100;135;1359;610;749;1201;1158;43;;123;0.09;220;0.16;135042
5348;Oost-Groningen (CR);2019 november;135042;102;142;1302;651;651;1234;1196;38;;28;0.02;248;0.18;135070
5349;Oost-Groningen (CR);2019 december;135070;70;131;1352;572;780;1189;1157;32;36.0;138;0.1;386;0.29;135208
5350;Oost-Groningen (CR);2019;134822;1073;1611;14956;6695;8261;14068;13578;490;36.0;386;0.29;386;0.29;135208
5351;Oost-Groningen (CR);2020 januari;135208;94;161;1476;697;779;1416;1389;27;;-7;-0.01;-7;-0.01;135201
5352;Oost-Groningen (CR);2020 februari;135201;85;159;1799;800;999;1437;1408;29;;288;0.21;281;0.21;135489
5353;Oost-Groningen (CR);2020 maart;135489;97;158;902;604;298;1138;1050;88;;-297;-0.22;-16;-0.01;135192
5354;Oost-Groningen (CR);2020 april;135192;80;130;442;402;40;683;661;22;;-291;-0.22;-307;-0.23;134901
5355;Oost-Groningen (CR);2020 mei;134901;90;105;569;497;72;578;560;18;;-24;-0.02;-331;-0.24;134877
5356;Oost-Groningen (CR);2020 juni;134877;82;127;923;594;329;737;691;46;;141;0.1;-190;-0.14;135018
5357;Oost-Groningen (CR);2020 juli;135018;76;108;1212;730;482;1021;1004;17;;159;0.12;-31;-0.02;135177
5358;Oost-Groningen (CR);2020 augustus;135177;82;143;1025;518;507;1001;961;40;;-37;-0.03;-68;-0.05;135140
5359;Oost-Groningen (CR);2020 september;135140;108;122;803;572;231;901;876;25;;-112;-0.08;-180;-0.13;135028
5360;Oost-Groningen (CR);2020 oktober;135028;75;118;1595;662;933;1127;1058;69;;425;0.31;245;0.18;135453
5361;Oost-Groningen (CR);2020 november;135453;86;137;1801;572;1229;1444;1397;47;;306;0.23;551;0.41;135759
5362;Oost-Groningen (CR);2020 december;135759;76;194;1721;610;1111;1559;1533;26;36.0;80;0.06;631;0.47;135839
5363;Oost-Groningen (CR);2020;135208;1031;1662;14268;7258;7010;13042;12588;454;36.0;631;0.47;631;0.47;135839
5364;Oost-Groningen (CR);2021 januari;135839;88;245;1186;623;563;1301;1288;13;0.0;-272;-0.2;-272;-0.2;135567
5365;Oost-Groningen (CR);2021 februari;135567;85;181;1243;529;714;1223;1199;24;0.0;-76;-0.06;-348;-0.26;135491
5366;Oost-Groningen (CR);2021 maart;135491;89;148;1797;640;1157;1770;1741;29;0.0;-32;-0.02;-380;-0.28;135459
5367;Oost-Groningen (CR);2021 april;135459;71;161;1997;720;1277;1586;1586;0;0.0;321;0.24;-59;-0.04;135780
5368;Oost-Groningen (CR);2021 mei;135780;85;149;1740;598;1142;1577;1559;18;0.0;99;0.07;40;0.03;135879
5369;Oost-Groningen (CR);2021 juni;135879;90;115;1629;586;1043;1610;1577;33;0.0;-6;0.0;34;0.03;135873
5370;Oost-Groningen (CR);2021 juli;135873;87;122;2240;616;1624;1507;1469;38;0.0;698;0.51;732;0.54;136571
5371;Oost-Groningen (CR);2021 augustus;136571;102;137;1774;636;1138;1841;1807;34;0.0;-102;-0.07;630;0.46;136469
5372;Oost-Groningen (CR);2021 september;136469;87;139;2186;629;1557;1865;1850;15;0.0;269;0.2;899;0.66;136738
5373;Oost-Groningen (CR);2021 oktober;136738;85;155;2060;673;1387;1860;1818;42;0.0;130;0.1;1029;0.76;136868
5374;Oost-Groningen (CR);2021 november;136868;110;166;1990;522;1468;2081;2030;51;0.0;-147;-0.11;882;0.65;136721
5375;Oost-Groningen (CR);2021 december;136721;99;187;1772;560;1212;1889;1853;36;89.0;-116;-0.08;766;0.56;136605
5376;Oost-Groningen (CR);2021;135839;1078;1905;21614;7332;14282;20110;19777;333;89.0;766;0.56;766;0.56;136605
5377;Oost-Groningen (CR);2022 januari;136605;106;144;1756;586;1170;1568;1534;34;;150;0.11;150;0.11;136755
5378;Oost-Groningen (CR);2022 februari;136755;83;132;1764;471;1293;1782;1752;30;;-67;-0.05;83;0.06;136688
5379;Oost-Groningen (CR);2022 maart;136688;87;157;2413;569;1844;2217;2178;39;;126;0.09;209;0.15;136814
5380;Oost-Groningen (CR);2022 april;136814;90;168;2333;568;1765;1971;1914;57;;284;0.21;493;0.36;137098
5381;Oost-Groningen (CR);2022 mei;137098;97;142;2121;522;1599;1777;1737;40;;299;0.22;792;0.58;137397
5382;Oost-Groningen (CR);2022 juni;137397;86;133;2528;551;1977;1945;1875;70;;536;0.39;1328;0.97;137933
5383;Oost-Groningen (CR);2022 juli;137933;101;143;2570;631;1939;1647;1603;44;;881;0.64;2209;1.62;138814
5384;Oost-Groningen (CR);2022 augustus;138814;100;146;1917;671;1246;1971;1887;84;;-100;-0.07;2109;1.54;138714
5385;Oost-Groningen (CR);2022 september;138714;105;133;1584;603;981;2118;2039;79;;-562;-0.41;1547;1.13;138152
5386;Oost-Groningen (CR);2022 oktober;138152;98;145;1730;607;1123;1738;1697;41;;-55;-0.04;1492;1.09;138097
5387;Oost-Groningen (CR);2022 november;138097;88;163;1608;591;1017;1695;1651;44;;-162;-0.12;1330;0.97;137935
5388;Oost-Groningen (CR);2022 december;137935;89;169;1464;574;890;1622;1549;73;39.0;-199;-0.14;1131;0.83;137736
5389;Oost-Groningen (CR);2022;136605;1130;1775;23788;6944;16844;22051;21416;635;39.0;1131;0.83;1131;0.83;137736
5390;Oost-Groningen (CR);2023 januari;137736;89;184;1621;645;976;1681;1639;42;0.0;-155;-0.11;-155;-0.11;137581
5391;Oost-Groningen (CR);2023 februari;137581;86;144;1787;570;1217;1700;1614;86;0.0;29;0.02;-126;-0.09;137610
5392;Oost-Groningen (CR);2023 maart;137610;97;179;2122;504;1618;1817;1762;55;0.0;223;0.16;97;0.07;137833
5393;Oost-Groningen (CR);2023 april;137833;91;146;1881;512;1369;1674;1618;56;0.0;152;0.11;249;0.18;137985
5394;Oost-Groningen (CR);2023 mei;137985;83;116;2015;527;1488;2122;2011;111;0.0;-140;-0.1;109;0.08;137845
5395;Oost-Groningen (CR);2023 juni;137845;68;148;2027;538;1489;1870;1824;46;0.0;77;0.06;186;0.14;137922
5396;Oost-Groningen (CR);2023 juli;137922;80;129;2003;558;1445;2056;2006;50;0.0;-102;-0.07;84;0.06;137820
5397;Oost-Groningen (CR);2023 augustus;137820;84;126;1820;551;1269;2055;1993;62;0.0;-277;-0.2;-193;-0.14;137543
5398;Oost-Groningen (CR);2023 september;137543;88;152;1960;551;1409;1699;1661;38;0.0;197;0.14;4;0.0;137740
5399;Oost-Groningen (CR);2023 oktober;137740;84;159;2210;549;1661;2112;2019;93;0.0;23;0.02;27;0.02;137763
5400;Oost-Groningen (CR);2023 november;137763;88;166;2319;537;1782;2139;2075;64;0.0;102;0.07;129;0.09;137865
5401;Oost-Groningen (CR);2023 december;137865;67;194;2019;548;1471;1936;1871;65;99.0;55;0.04;184;0.13;137920
5402;Oost-Groningen (CR);2023;137736;1005;1843;23784;6590;17194;22861;22093;768;99.0;184;0.13;184;0.13;137920
5403;Oost-Groningen (CR);2024 januari;137920;99;185;1917;515;1402;1955;1905;50;;-124;-0.09;-124;-0.09;137796
5404;Oost-Groningen (CR);2024 februari;137796;69;163;2258;634;1624;2014;1945;69;;150;0.11;26;0.02;137946
5405;Oost-Groningen (CR);2024 maart;137946;79;182;2158;508;1650;2098;2032;66;;-43;-0.03;-17;-0.01;137903
5406;Oost-Groningen (CR);2024 april;137903;83;161;2369;516;1853;2037;1971;66;;254;0.18;237;0.17;138157
5407;Oost-Groningen (CR);2024 mei;138157;95;154;2102;464;1638;1967;1911;56;;76;0.06;313;0.23;138233
5408;Oost-Groningen (CR);2024 juni;138233;107;141;2310;547;1763;2056;2032;24;;220;0.16;533;0.39;138453
5409;Oost-Groningen (CR);2024 juli;138453;89;153;2410;613;1797;2363;2307;56;;-17;-0.01;516;0.37;138436
5410;Oost-Groningen (CR);2024 augustus;138436;83;125;2252;618;1634;1867;1797;70;;343;0.25;859;0.62;138779
5411;Oost-Groningen (CR);2024 september;138779;89;143;2622;642;1980;2203;2149;54;;365;0.26;1224;0.89;139144
5412;Oost-Groningen (CR);2024 oktober;139144;100;147;2359;578;1781;2242;2147;95;;70;0.05;1294;0.94;139214
5413;Oost-Groningen (CR);2024 november;139214;96;134;2426;687;1739;2188;2101;87;;200;0.14;1494;1.08;139414
5414;Oost-Groningen (CR);2024 december;139414;96;147;2051;637;1414;2176;2126;50;0.0;-176;-0.13;1318;0.96;139238
5415;Oost-Groningen (CR);2024;137920;1085;1835;27234;6959;20275;25166;24423;743;0.0;1318;0.96;1318;0.96;139238
5416;Oost-Groningen (CR);2025 januari;139238;91;206;2551;632;1919;2434;2360;74;;2;0.0;2;0.0;139240
5417;Oost-Groningen (CR);2025 februari;139240;80;197;2291;536;1755;2045;1994;51;;129;0.09;131;0.09;139369
5418;Delfzijl en omgeving (CR);2002 januari;52510;35;54;209;162;47;206;202;4;;-16;-0.03;-16;-0.03;52494
5419;Delfzijl en omgeving (CR);2002 februari;52494;45;38;206;168;38;176;173;3;;37;0.07;21;0.04;52531
5420;Delfzijl en omgeving (CR);2002 maart;52531;61;50;190;149;41;206;189;17;;-5;-0.01;16;0.03;52526
5421;Delfzijl en omgeving (CR);2002 april;52526;45;43;226;158;68;152;139;13;;76;0.14;92;0.18;52602
5422;Delfzijl en omgeving (CR);2002 mei;52602;36;48;248;222;26;208;186;22;;28;0.05;120;0.23;52630
5423;Delfzijl en omgeving (CR);2002 juni;52630;47;52;228;184;44;211;200;11;;12;0.02;132;0.25;52642
5424;Delfzijl en omgeving (CR);2002 juli;52642;47;40;271;244;27;233;223;10;;45;0.09;177;0.34;52687
5425;Delfzijl en omgeving (CR);2002 augustus;52687;63;56;283;239;44;309;296;13;;-19;-0.04;158;0.3;52668
5426;Delfzijl en omgeving (CR);2002 september;52668;45;37;244;214;30;267;261;6;;-15;-0.03;143;0.27;52653
5427;Delfzijl en omgeving (CR);2002 oktober;52653;48;40;210;190;20;233;215;18;;-15;-0.03;128;0.24;52638
5428;Delfzijl en omgeving (CR);2002 november;52638;48;33;205;188;17;266;233;33;;-46;-0.09;82;0.16;52592
5429;Delfzijl en omgeving (CR);2002 december;52592;38;59;167;146;21;146;140;6;-1.0;-1;0.0;81;0.15;52591
5430;Delfzijl en omgeving (CR);2002;52510;558;550;2687;2264;423;2613;2457;156;-1.0;81;0.15;81;0.15;52591
5431;Delfzijl en omgeving (CR);2003 januari;52591;47;39;209;193;16;216;200;16;;1;0.0;1;0.0;52592
5432;Delfzijl en omgeving (CR);2003 februari;52592;48;38;167;141;26;183;179;4;;-6;-0.01;-5;-0.01;52586
5433;Delfzijl en omgeving (CR);2003 maart;52586;48;46;141;128;13;178;163;15;;-35;-0.07;-40;-0.08;52551
5434;Delfzijl en omgeving (CR);2003 april;52551;48;41;183;172;11;252;206;46;;-62;-0.12;-102;-0.19;52489
5435;Delfzijl en omgeving (CR);2003 mei;52489;53;49;158;146;12;176;164;12;;-14;-0.03;-116;-0.22;52475
5436;Delfzijl en omgeving (CR);2003 juni;52475;34;47;172;151;21;221;200;21;;-62;-0.12;-178;-0.34;52413
5437;Delfzijl en omgeving (CR);2003 juli;52413;46;53;179;158;21;251;203;48;;-79;-0.15;-257;-0.49;52334
5438;Delfzijl en omgeving (CR);2003 augustus;52334;51;35;211;194;17;242;241;1;;-15;-0.03;-272;-0.52;52319
5439;Delfzijl en omgeving (CR);2003 september;52319;44;35;196;184;12;199;186;13;;6;0.01;-266;-0.51;52325
5440;Delfzijl en omgeving (CR);2003 oktober;52325;51;36;204;193;11;209;188;21;;10;0.02;-256;-0.49;52335
5441;Delfzijl en omgeving (CR);2003 november;52335;36;40;142;134;8;159;149;10;;-21;-0.04;-277;-0.53;52314
5442;Delfzijl en omgeving (CR);2003 december;52314;52;40;136;124;12;175;171;4;-2.0;-29;-0.06;-306;-0.58;52285
5443;Delfzijl en omgeving (CR);2003;52591;558;499;2098;1918;180;2461;2250;211;-2.0;-306;-0.58;-306;-0.58;52285
5444;Delfzijl en omgeving (CR);2004 januari;52285;45;45;213;192;21;204;204;0;;9;0.02;9;0.02;52294
5445;Delfzijl en omgeving (CR);2004 februari;52294;45;41;166;157;9;179;182;-3;;-9;-0.02;0;0.0;52285
5446;Delfzijl en omgeving (CR);2004 maart;52285;35;52;155;142;13;192;176;16;;-54;-0.1;-54;-0.1;52231
5447;Delfzijl en omgeving (CR);2004 april;52231;48;39;156;144;12;173;167;6;;-8;-0.02;-62;-0.12;52223
5448;Delfzijl en omgeving (CR);2004 mei;52223;39;33;118;105;13;165;152;13;;-41;-0.08;-103;-0.2;52182
5449;Delfzijl en omgeving (CR);2004 juni;52182;43;44;143;128;15;187;179;8;;-45;-0.09;-148;-0.28;52137
5450;Delfzijl en omgeving (CR);2004 juli;52137;41;35;154;143;11;207;204;3;;-47;-0.09;-195;-0.37;52090
5451;Delfzijl en omgeving (CR);2004 augustus;52090;51;50;224;205;19;253;242;11;;-28;-0.05;-223;-0.43;52062
5452;Delfzijl en omgeving (CR);2004 september;52062;41;33;217;201;16;289;265;24;;-64;-0.12;-287;-0.55;51998
5453;Delfzijl en omgeving (CR);2004 oktober;51998;43;45;165;155;10;201;195;6;;-38;-0.07;-325;-0.62;51960
5454;Delfzijl en omgeving (CR);2004 november;51960;45;52;150;137;13;197;192;5;;-54;-0.1;-379;-0.72;51906
5455;Delfzijl en omgeving (CR);2004 december;51906;65;54;175;158;17;179;157;22;2.0;9;0.02;-370;-0.71;51915
5456;Delfzijl en omgeving (CR);2004;52285;541;523;2036;1867;169;2426;2315;111;2.0;-370;-0.71;-370;-0.71;51915
5457;Delfzijl en omgeving (CR);2005 januari;51915;33;37;131;117;14;237;193;44;;-110;-0.21;-110;-0.21;51805
5458;Delfzijl en omgeving (CR);2005 februari;51805;44;41;167;147;20;199;187;12;;-29;-0.06;-139;-0.27;51776
5459;Delfzijl en omgeving (CR);2005 maart;51776;43;58;140;134;6;181;171;10;;-56;-0.11;-195;-0.38;51720
5460;Delfzijl en omgeving (CR);2005 april;51720;32;41;135;133;2;175;159;16;;-49;-0.09;-244;-0.47;51671
5461;Delfzijl en omgeving (CR);2005 mei;51671;38;39;125;118;7;143;138;5;;-19;-0.04;-263;-0.51;51652
5462;Delfzijl en omgeving (CR);2005 juni;51652;40;58;154;147;7;203;197;6;;-67;-0.13;-330;-0.64;51585
5463;Delfzijl en omgeving (CR);2005 juli;51585;33;37;153;140;13;238;218;20;;-89;-0.17;-419;-0.81;51496
5464;Delfzijl en omgeving (CR);2005 augustus;51496;43;37;170;164;6;251;234;17;;-75;-0.15;-494;-0.95;51421
5465;Delfzijl en omgeving (CR);2005 september;51421;40;35;184;177;7;275;262;13;;-86;-0.17;-580;-1.12;51335
5466;Delfzijl en omgeving (CR);2005 oktober;51335;42;49;194;177;17;225;221;4;;-38;-0.07;-618;-1.19;51297
5467;Delfzijl en omgeving (CR);2005 november;51297;33;43;140;132;8;168;155;13;;-38;-0.07;-656;-1.26;51259
5468;Delfzijl en omgeving (CR);2005 december;51259;38;29;127;113;14;186;175;11;-3.0;-53;-0.1;-709;-1.37;51206
5469;Delfzijl en omgeving (CR);2005;51915;459;504;1820;1699;121;2481;2310;171;-3.0;-709;-1.37;-709;-1.37;51206
5470;Delfzijl en omgeving (CR);2006 januari;51206;41;35;184;178;6;237;224;13;;-47;-0.09;-47;-0.09;51159
5471;Delfzijl en omgeving (CR);2006 februari;51159;48;42;193;179;14;238;213;25;;-39;-0.08;-86;-0.17;51120
5472;Delfzijl en omgeving (CR);2006 maart;51120;46;46;231;220;11;280;240;40;;-49;-0.1;-135;-0.26;51071
5473;Delfzijl en omgeving (CR);2006 april;51071;45;48;134;122;12;127;118;9;;4;0.01;-131;-0.26;51075
5474;Delfzijl en omgeving (CR);2006 mei;51075;50;42;156;145;11;154;143;11;;10;0.02;-121;-0.24;51085
5475;Delfzijl en omgeving (CR);2006 juni;51085;33;37;173;158;15;236;201;35;;-67;-0.13;-188;-0.37;51018
5476;Delfzijl en omgeving (CR);2006 juli;51018;42;49;185;162;23;224;205;19;;-46;-0.09;-234;-0.46;50972
5477;Delfzijl en omgeving (CR);2006 augustus;50972;32;44;196;187;9;299;276;23;;-115;-0.23;-349;-0.68;50857
5478;Delfzijl en omgeving (CR);2006 september;50857;40;31;206;203;3;261;258;3;;-46;-0.09;-395;-0.77;50811
5479;Delfzijl en omgeving (CR);2006 oktober;50811;38;31;122;111;11;189;165;24;;-60;-0.12;-455;-0.89;50751
5480;Delfzijl en omgeving (CR);2006 november;50751;42;35;174;170;4;242;222;20;;-61;-0.12;-516;-1.01;50690
5481;Delfzijl en omgeving (CR);2006 december;50690;37;44;128;119;9;172;149;23;-17.0;-68;-0.13;-584;-1.14;50622
5482;Delfzijl en omgeving (CR);2006;51206;494;484;2082;1954;128;2659;2414;245;-17.0;-584;-1.14;-584;-1.14;50622
5483;Delfzijl en omgeving (CR);2007 januari;50622;30;57;198;182;16;207;199;8;;-36;-0.07;-36;-0.07;50586
5484;Delfzijl en omgeving (CR);2007 februari;50586;30;42;153;147;6;159;159;0;;-18;-0.04;-54;-0.11;50568
5485;Delfzijl en omgeving (CR);2007 maart;50568;51;48;172;157;15;212;195;17;;-37;-0.07;-91;-0.18;50531
5486;Delfzijl en omgeving (CR);2007 april;50531;38;32;159;152;7;156;165;-9;;9;0.02;-82;-0.16;50540
5487;Delfzijl en omgeving (CR);2007 mei;50540;42;50;139;123;16;209;188;21;;-78;-0.15;-160;-0.32;50462
5488;Delfzijl en omgeving (CR);2007 juni;50462;23;47;195;187;8;197;204;-7;;-26;-0.05;-186;-0.37;50436
5489;Delfzijl en omgeving (CR);2007 juli;50436;42;43;210;202;8;219;191;28;;-10;-0.02;-196;-0.39;50426
5490;Delfzijl en omgeving (CR);2007 augustus;50426;38;38;223;205;18;290;271;19;;-67;-0.13;-263;-0.52;50359
5491;Delfzijl en omgeving (CR);2007 september;50359;54;46;158;140;18;229;209;20;;-63;-0.13;-326;-0.64;50296
5492;Delfzijl en omgeving (CR);2007 oktober;50296;48;41;178;167;11;239;221;18;;-54;-0.11;-380;-0.75;50242
5493;Delfzijl en omgeving (CR);2007 november;50242;44;44;139;121;18;183;173;10;;-44;-0.09;-424;-0.84;50198
5494;Delfzijl en omgeving (CR);2007 december;50198;41;38;113;112;1;193;184;9;26.0;-51;-0.1;-475;-0.94;50147
5495;Delfzijl en omgeving (CR);2007;50622;481;526;2037;1895;142;2493;2359;134;26.0;-475;-0.94;-475;-0.94;50147
5496;Delfzijl en omgeving (CR);2008 januari;50147;36;54;213;198;15;357;225;132;;-162;-0.32;-162;-0.32;49985
5497;Delfzijl en omgeving (CR);2008 februari;49985;33;32;168;154;14;232;225;7;;-63;-0.13;-225;-0.45;49922
5498;Delfzijl en omgeving (CR);2008 maart;49922;37;60;121;111;10;187;180;7;;-89;-0.18;-314;-0.63;49833
5499;Delfzijl en omgeving (CR);2008 april;49833;42;44;155;147;8;218;209;9;;-65;-0.13;-379;-0.76;49768
5500;Delfzijl en omgeving (CR);2008 mei;49768;41;32;156;146;10;165;162;3;;0;0.0;-379;-0.76;49768
5501;Delfzijl en omgeving (CR);2008 juni;49768;39;38;156;141;15;183;171;12;;-26;-0.05;-405;-0.81;49742
5502;Delfzijl en omgeving (CR);2008 juli;49742;37;33;201;190;11;234;220;14;;-29;-0.06;-434;-0.87;49713
5503;Delfzijl en omgeving (CR);2008 augustus;49713;41;41;210;192;18;275;266;9;;-65;-0.13;-499;-1.0;49648
5504;Delfzijl en omgeving (CR);2008 september;49648;39;41;202;172;30;246;227;19;;-46;-0.09;-545;-1.09;49602
5505;Delfzijl en omgeving (CR);2008 oktober;49602;41;50;150;120;30;235;226;9;;-94;-0.19;-639;-1.27;49508
5506;Delfzijl en omgeving (CR);2008 november;49508;37;36;173;155;18;240;247;-7;;-66;-0.13;-705;-1.41;49442
5507;Delfzijl en omgeving (CR);2008 december;49442;43;42;180;151;29;212;207;5;-10.0;-41;-0.08;-746;-1.49;49401
5508;Delfzijl en omgeving (CR);2008;50147;466;503;2085;1877;208;2784;2565;219;-10.0;-746;-1.49;-746;-1.49;49401
5509;Delfzijl en omgeving (CR);2009 januari;49401;41;60;170;135;35;192;185;7;;-41;-0.08;-41;-0.08;49360
5510;Delfzijl en omgeving (CR);2009 februari;49360;39;48;148;122;26;187;180;7;;-48;-0.1;-89;-0.18;49312
5511;Delfzijl en omgeving (CR);2009 maart;49312;35;50;248;159;89;216;200;16;;17;0.03;-72;-0.15;49329
5512;Delfzijl en omgeving (CR);2009 april;49329;29;46;142;87;55;162;145;17;;-37;-0.08;-109;-0.22;49292
5513;Delfzijl en omgeving (CR);2009 mei;49292;35;40;149;101;48;141;136;5;;3;0.01;-106;-0.21;49295
5514;Delfzijl en omgeving (CR);2009 juni;49295;48;57;163;141;22;160;155;5;;-6;-0.01;-112;-0.23;49289
5515;Delfzijl en omgeving (CR);2009 juli;49289;37;37;191;164;27;264;246;18;;-73;-0.15;-185;-0.37;49216
5516;Delfzijl en omgeving (CR);2009 augustus;49216;30;35;201;170;31;233;220;13;;-37;-0.08;-222;-0.45;49179
5517;Delfzijl en omgeving (CR);2009 september;49179;30;37;212;172;40;220;205;15;;-15;-0.03;-237;-0.48;49164
5518;Delfzijl en omgeving (CR);2009 oktober;49164;41;37;180;133;47;195;192;3;;-11;-0.02;-248;-0.5;49153
5519;Delfzijl en omgeving (CR);2009 november;49153;49;41;197;177;20;194;182;12;;11;0.02;-237;-0.48;49164
5520;Delfzijl en omgeving (CR);2009 december;49164;38;35;175;150;25;197;186;11;-26.0;-45;-0.09;-282;-0.57;49119
5521;Delfzijl en omgeving (CR);2009;49401;452;523;2176;1711;465;2361;2232;129;-26.0;-282;-0.57;-282;-0.57;49119
5522;Delfzijl en omgeving (CR);2010 januari;49119;38;54;167;138;29;190;181;9;;-39;-0.08;-39;-0.08;49080
5523;Delfzijl en omgeving (CR);2010 februari;49080;37;45;232;132;100;153;148;5;;71;0.14;32;0.07;49151
5524;Delfzijl en omgeving (CR);2010 maart;49151;38;50;211;170;41;195;187;8;;4;0.01;36;0.07;49155
5525;Delfzijl en omgeving (CR);2010 april;49155;38;41;252;122;130;150;142;8;;99;0.2;135;0.27;49254
5526;Delfzijl en omgeving (CR);2010 mei;49254;36;46;150;106;44;117;117;0;;23;0.05;158;0.32;49277
5527;Delfzijl en omgeving (CR);2010 juni;49277;32;52;177;157;20;183;177;6;;-26;-0.05;132;0.27;49251
5528;Delfzijl en omgeving (CR);2010 juli;49251;37;40;182;144;38;201;192;9;;-22;-0.04;110;0.22;49229
5529;Delfzijl en omgeving (CR);2010 augustus;49229;53;34;181;139;42;195;186;9;;5;0.01;115;0.23;49234
5530;Delfzijl en omgeving (CR);2010 september;49234;37;33;218;176;42;221;199;22;;1;0.0;116;0.24;49235
5531;Delfzijl en omgeving (CR);2010 oktober;49235;43;55;165;131;34;203;193;10;;-50;-0.1;66;0.13;49185
5532;Delfzijl en omgeving (CR);2010 november;49185;42;42;115;101;14;151;143;8;;-36;-0.07;30;0.06;49149
5533;Delfzijl en omgeving (CR);2010 december;49149;35;56;181;151;30;178;172;6;4.0;-14;-0.03;16;0.03;49135
5534;Delfzijl en omgeving (CR);2010;49119;466;548;2231;1667;564;2137;2037;100;4.0;16;0.03;16;0.03;49135
5535;Delfzijl en omgeving (CR);2011 januari;49135;32;51;192;144;48;177;181;-4;;-4;-0.01;-4;-0.01;49131
5536;Delfzijl en omgeving (CR);2011 februari;49131;21;34;161;146;15;172;169;3;;-24;-0.05;-28;-0.06;49107
5537;Delfzijl en omgeving (CR);2011 maart;49107;35;56;160;138;22;178;166;12;;-39;-0.08;-67;-0.14;49068
5538;Delfzijl en omgeving (CR);2011 april;49068;33;44;152;133;19;194;170;24;;-53;-0.11;-120;-0.24;49015
5539;Delfzijl en omgeving (CR);2011 mei;49015;31;46;185;161;24;191;170;21;;-21;-0.04;-141;-0.29;48994
5540;Delfzijl en omgeving (CR);2011 juni;48994;44;64;177;159;18;176;172;4;;-19;-0.04;-160;-0.33;48975
5541;Delfzijl en omgeving (CR);2011 juli;48975;33;55;226;195;31;208;173;35;;-4;-0.01;-164;-0.33;48971
5542;Delfzijl en omgeving (CR);2011 augustus;48971;46;43;201;170;31;231;205;26;;-27;-0.06;-191;-0.39;48944
5543;Delfzijl en omgeving (CR);2011 september;48944;38;38;181;150;31;225;213;12;;-44;-0.09;-235;-0.48;48900
5544;Delfzijl en omgeving (CR);2011 oktober;48900;44;43;190;159;31;227;196;31;;-36;-0.07;-271;-0.55;48864
5545;Delfzijl en omgeving (CR);2011 november;48864;30;43;169;147;22;288;172;116;;-132;-0.27;-403;-0.82;48732
5546;Delfzijl en omgeving (CR);2011 december;48732;35;50;176;149;27;174;151;23;5.0;-8;-0.02;-411;-0.84;48724
5547;Delfzijl en omgeving (CR);2011;49135;422;567;2170;1851;319;2441;2138;303;5.0;-411;-0.84;-411;-0.84;48724
5548;Delfzijl en omgeving (CR);2012 januari;48724;33;54;163;133;30;196;166;30;;-54;-0.11;-54;-0.11;48670
5549;Delfzijl en omgeving (CR);2012 februari;48670;33;42;188;156;32;283;222;61;;-104;-0.21;-158;-0.32;48566
5550;Delfzijl en omgeving (CR);2012 maart;48566;27;44;150;119;31;161;150;11;;-28;-0.06;-186;-0.38;48538
5551;Delfzijl en omgeving (CR);2012 april;48538;40;46;169;150;19;157;144;13;;6;0.01;-180;-0.37;48544
5552;Delfzijl en omgeving (CR);2012 mei;48544;33;48;164;133;31;174;150;24;;-25;-0.05;-205;-0.42;48519
5553;Delfzijl en omgeving (CR);2012 juni;48519;37;39;194;173;21;173;158;15;;19;0.04;-186;-0.38;48538
5554;Delfzijl en omgeving (CR);2012 juli;48538;35;52;214;173;41;200;191;9;;-3;-0.01;-189;-0.39;48535
5555;Delfzijl en omgeving (CR);2012 augustus;48535;50;65;179;164;15;224;178;46;;-60;-0.12;-249;-0.51;48475
5556;Delfzijl en omgeving (CR);2012 september;48475;38;35;185;157;28;209;178;31;;-21;-0.04;-270;-0.55;48454
5557;Delfzijl en omgeving (CR);2012 oktober;48454;31;34;219;177;42;256;204;52;;-40;-0.08;-310;-0.64;48414
5558;Delfzijl en omgeving (CR);2012 november;48414;35;46;138;99;39;150;146;4;;-23;-0.05;-333;-0.68;48391
5559;Delfzijl en omgeving (CR);2012 december;48391;40;52;168;137;31;185;182;3;8.0;-21;-0.04;-354;-0.73;48370
5560;Delfzijl en omgeving (CR);2012;48724;432;557;2131;1771;360;2368;2069;299;8.0;-354;-0.73;-354;-0.73;48370
5561;Delfzijl en omgeving (CR);2013 januari;48370;37;55;161;146;15;180;168;12;;-37;-0.08;-37;-0.08;48333
5562;Delfzijl en omgeving (CR);2013 februari;48333;32;64;155;136;19;162;157;5;;-39;-0.08;-76;-0.16;48294
5563;Delfzijl en omgeving (CR);2013 maart;48294;33;41;151;125;26;161;138;23;;-18;-0.04;-94;-0.19;48276
5564;Delfzijl en omgeving (CR);2013 april;48276;29;48;148;119;29;174;146;28;;-45;-0.09;-139;-0.29;48231
5565;Delfzijl en omgeving (CR);2013 mei;48231;38;38;180;143;37;185;169;16;;-5;-0.01;-144;-0.3;48226
5566;Delfzijl en omgeving (CR);2013 juni;48226;26;39;137;102;35;156;146;10;;-32;-0.07;-176;-0.36;48194
5567;Delfzijl en omgeving (CR);2013 juli;48194;34;48;215;177;38;217;205;12;;-16;-0.03;-192;-0.4;48178
5568;Delfzijl en omgeving (CR);2013 augustus;48178;28;39;186;157;29;267;221;46;;-92;-0.19;-284;-0.59;48086
5569;Delfzijl en omgeving (CR);2013 september;48086;39;42;204;166;38;219;205;14;;-18;-0.04;-302;-0.62;48068
5570;Delfzijl en omgeving (CR);2013 oktober;48068;29;59;167;139;28;210;175;35;;-73;-0.15;-375;-0.78;47995
5571;Delfzijl en omgeving (CR);2013 november;47995;26;41;171;133;38;174;162;12;;-18;-0.04;-393;-0.81;47977
5572;Delfzijl en omgeving (CR);2013 december;47977;33;49;192;162;30;195;168;27;0.0;-19;-0.04;-412;-0.85;47958
5573;Delfzijl en omgeving (CR);2013;48370;384;563;2067;1705;362;2300;2060;240;0.0;-412;-0.85;-412;-0.85;47958
5574;Delfzijl en omgeving (CR);2014 januari;47958;32;54;161;127;34;201;177;24;;-62;-0.13;-62;-0.13;47896
5575;Delfzijl en omgeving (CR);2014 februari;47896;32;39;192;156;36;184;175;9;;1;0.0;-61;-0.13;47897
5576;Delfzijl en omgeving (CR);2014 maart;47897;39;41;214;166;48;197;173;24;;15;0.03;-46;-0.1;47912
5577;Delfzijl en omgeving (CR);2014 april;47912;34;49;163;136;27;207;198;9;;-59;-0.12;-105;-0.22;47853
5578;Delfzijl en omgeving (CR);2014 mei;47853;37;52;183;135;48;209;200;9;;-41;-0.09;-146;-0.3;47812
5579;Delfzijl en omgeving (CR);2014 juni;47812;41;40;191;147;44;242;223;19;;-50;-0.1;-196;-0.41;47762
5580;Delfzijl en omgeving (CR);2014 juli;47762;41;40;249;194;55;253;225;28;;-3;-0.01;-199;-0.41;47759
5581;Delfzijl en omgeving (CR);2014 augustus;47759;21;37;217;173;44;286;263;23;;-85;-0.18;-284;-0.59;47674
5582;Delfzijl en omgeving (CR);2014 september;47674;39;43;210;155;55;234;206;28;;-28;-0.06;-312;-0.65;47646
5583;Delfzijl en omgeving (CR);2014 oktober;47646;29;49;189;134;55;206;186;20;;-37;-0.08;-349;-0.73;47609
5584;Delfzijl en omgeving (CR);2014 november;47609;26;48;237;150;87;222;201;21;;-7;-0.01;-356;-0.74;47602
5585;Delfzijl en omgeving (CR);2014 december;47602;30;67;238;157;81;244;229;15;1.0;-42;-0.09;-398;-0.83;47560
5586;Delfzijl en omgeving (CR);2014;47958;401;559;2444;1830;614;2685;2456;229;1.0;-398;-0.83;-398;-0.83;47560
5587;Delfzijl en omgeving (CR);2015 januari;47560;30;57;235;183;52;233;209;24;;-25;-0.05;-25;-0.05;47535
5588;Delfzijl en omgeving (CR);2015 februari;47535;20;62;203;159;44;233;212;21;;-72;-0.15;-97;-0.2;47463
5589;Delfzijl en omgeving (CR);2015 maart;47463;28;57;195;144;51;263;223;40;;-97;-0.2;-194;-0.41;47366
5590;Delfzijl en omgeving (CR);2015 april;47366;26;55;194;138;56;233;201;32;;-68;-0.14;-262;-0.55;47298
5591;Delfzijl en omgeving (CR);2015 mei;47298;27;42;148;123;25;202;193;9;;-69;-0.15;-331;-0.7;47229
5592;Delfzijl en omgeving (CR);2015 juni;47229;25;56;169;136;33;182;169;13;;-44;-0.09;-375;-0.79;47185
5593;Delfzijl en omgeving (CR);2015 juli;47185;27;38;213;185;28;231;222;9;;-29;-0.06;-404;-0.85;47156
5594;Delfzijl en omgeving (CR);2015 augustus;47156;30;40;253;202;51;264;241;23;;-21;-0.04;-425;-0.89;47135
5595;Delfzijl en omgeving (CR);2015 september;47135;44;46;223;157;66;257;235;22;;-36;-0.08;-461;-0.97;47099
5596;Delfzijl en omgeving (CR);2015 oktober;47099;44;47;249;206;43;245;243;2;;1;0.0;-460;-0.97;47100
5597;Delfzijl en omgeving (CR);2015 november;47100;37;48;259;166;93;226;210;16;;22;0.05;-438;-0.92;47122
5598;Delfzijl en omgeving (CR);2015 december;47122;33;36;230;174;56;242;233;9;4.0;-11;-0.02;-449;-0.94;47111
5599;Delfzijl en omgeving (CR);2015;47560;371;584;2571;1973;598;2811;2591;220;4.0;-449;-0.94;-449;-0.94;47111
5600;Delfzijl en omgeving (CR);2016 januari;47111;33;63;242;188;54;225;219;6;;-13;-0.03;-13;-0.03;47098
5601;Delfzijl en omgeving (CR);2016 februari;47098;31;62;174;148;26;211;184;27;;-68;-0.14;-81;-0.17;47030
5602;Delfzijl en omgeving (CR);2016 maart;47030;29;52;191;158;33;227;209;18;;-59;-0.13;-140;-0.3;46971
5603;Delfzijl en omgeving (CR);2016 april;46971;39;46;188;173;15;231;220;11;;-50;-0.11;-190;-0.4;46921
5604;Delfzijl en omgeving (CR);2016 mei;46921;26;49;192;167;25;168;150;18;;1;0.0;-189;-0.4;46922
5605;Delfzijl en omgeving (CR);2016 juni;46922;40;42;254;197;57;238;225;13;;14;0.03;-175;-0.37;46936
5606;Delfzijl en omgeving (CR);2016 juli;46936;43;54;292;218;74;230;225;5;;51;0.11;-124;-0.26;46987
5607;Delfzijl en omgeving (CR);2016 augustus;46987;52;46;347;310;37;293;259;34;;60;0.13;-64;-0.14;47047
5608;Delfzijl en omgeving (CR);2016 september;47047;30;33;272;227;45;297;282;15;;-28;-0.06;-92;-0.2;47019
5609;Delfzijl en omgeving (CR);2016 oktober;47019;39;42;223;183;40;314;294;20;;-94;-0.2;-186;-0.39;46925
5610;Delfzijl en omgeving (CR);2016 november;46925;38;57;291;261;30;300;288;12;;-28;-0.06;-214;-0.45;46897
5611;Delfzijl en omgeving (CR);2016 december;46897;25;44;254;233;21;280;270;10;-2.0;-47;-0.1;-261;-0.55;46850
5612;Delfzijl en omgeving (CR);2016;47111;425;590;2920;2463;457;3014;2825;189;-2.0;-261;-0.55;-261;-0.55;46850
5613;Delfzijl en omgeving (CR);2017 januari;46850;34;52;238;218;20;259;234;25;;-39;-0.08;-39;-0.08;46811
5614;Delfzijl en omgeving (CR);2017 februari;46811;34;56;206;191;15;256;228;28;;-72;-0.15;-111;-0.24;46739
5615;Delfzijl en omgeving (CR);2017 maart;46739;24;42;246;220;26;280;255;25;;-52;-0.11;-163;-0.35;46687
5616;Delfzijl en omgeving (CR);2017 april;46687;25;52;221;199;22;162;157;5;;32;0.07;-131;-0.28;46719
5617;Delfzijl en omgeving (CR);2017 mei;46719;38;41;220;196;24;217;209;8;;0;0.0;-131;-0.28;46719
5618;Delfzijl en omgeving (CR);2017 juni;46719;18;38;195;170;25;212;206;6;;-37;-0.08;-168;-0.36;46682
5619;Delfzijl en omgeving (CR);2017 juli;46682;39;40;189;162;27;250;241;9;;-62;-0.13;-230;-0.49;46620
5620;Delfzijl en omgeving (CR);2017 augustus;46620;38;53;244;227;17;279;254;25;;-50;-0.11;-280;-0.6;46570
5621;Delfzijl en omgeving (CR);2017 september;46570;25;38;184;176;8;222;208;14;;-51;-0.11;-331;-0.71;46519
5622;Delfzijl en omgeving (CR);2017 oktober;46519;28;44;206;186;20;227;208;19;;-37;-0.08;-368;-0.79;46482
5623;Delfzijl en omgeving (CR);2017 november;46482;37;46;200;182;18;229;222;7;;-38;-0.08;-406;-0.87;46444
5624;Delfzijl en omgeving (CR);2017 december;46444;40;56;207;193;14;238;221;17;-1.0;-48;-0.1;-454;-0.97;46396
5625;Delfzijl en omgeving (CR);2017;46850;380;558;2556;2320;236;2831;2643;188;-1.0;-454;-0.97;-454;-0.97;46396
5626;Delfzijl en omgeving (CR);2018 januari;46396;31;62;211;186;25;214;205;9;;-34;-0.07;-34;-0.07;46362
5627;Delfzijl en omgeving (CR);2018 februari;46362;27;54;178;156;22;212;199;13;;-61;-0.13;-95;-0.2;46301
5628;Delfzijl en omgeving (CR);2018 maart;46301;19;58;228;195;33;238;222;16;;-49;-0.11;-144;-0.31;46252
5629;Delfzijl en omgeving (CR);2018 april;46252;29;54;174;149;25;186;178;8;;-37;-0.08;-181;-0.39;46215
5630;Delfzijl en omgeving (CR);2018 mei;46215;30;40;196;177;19;197;184;13;;-11;-0.02;-192;-0.41;46204
5631;Delfzijl en omgeving (CR);2018 juni;46204;37;41;198;172;26;216;193;23;;-22;-0.05;-214;-0.46;46182
5632;Delfzijl en omgeving (CR);2018 juli;46182;28;35;243;188;55;232;213;19;;4;0.01;-210;-0.45;46186
5633;Delfzijl en omgeving (CR);2018 augustus;46186;21;39;260;225;35;231;220;11;;11;0.02;-199;-0.43;46197
5634;Delfzijl en omgeving (CR);2018 september;46197;33;43;219;197;22;237;227;10;;-28;-0.06;-227;-0.49;46169
5635;Delfzijl en omgeving (CR);2018 oktober;46169;25;53;232;199;33;291;272;19;;-87;-0.19;-314;-0.68;46082
5636;Delfzijl en omgeving (CR);2018 november;46082;32;43;233;206;27;236;229;7;;-14;-0.03;-328;-0.71;46068
5637;Delfzijl en omgeving (CR);2018 december;46068;31;52;183;148;35;182;164;18;3.0;-17;-0.04;-345;-0.74;46051
5638;Delfzijl en omgeving (CR);2018;46396;343;574;2555;2198;357;2672;2506;166;3.0;-345;-0.74;-345;-0.74;46051
5639;Delfzijl en omgeving (CR);2019 januari;46051;32;48;192;177;15;191;171;20;;-15;-0.03;-15;-0.03;46036
5640;Delfzijl en omgeving (CR);2019 februari;46036;30;36;205;183;22;214;203;11;;-15;-0.03;-30;-0.07;46021
5641;Delfzijl en omgeving (CR);2019 maart;46021;24;51;207;186;21;234;224;10;;-54;-0.12;-84;-0.18;45967
5642;Delfzijl en omgeving (CR);2019 april;45967;29;52;186;164;22;202;193;9;;-39;-0.08;-123;-0.27;45928
5643;Delfzijl en omgeving (CR);2019 mei;45928;35;41;186;162;24;202;195;7;;-22;-0.05;-145;-0.31;45906
5644;Delfzijl en omgeving (CR);2019 juni;45906;25;46;177;161;16;186;170;16;;-30;-0.07;-175;-0.38;45876
5645;Delfzijl en omgeving (CR);2019 juli;45876;36;48;291;255;36;286;256;30;;-7;-0.02;-182;-0.4;45869
5646;Delfzijl en omgeving (CR);2019 augustus;45869;38;41;301;253;48;294;279;15;;4;0.01;-178;-0.39;45873
5647;Delfzijl en omgeving (CR);2019 september;45873;41;41;243;201;42;225;206;19;;18;0.04;-160;-0.35;45891
5648;Delfzijl en omgeving (CR);2019 oktober;45891;43;41;222;167;55;183;165;18;;41;0.09;-119;-0.26;45932
5649;Delfzijl en omgeving (CR);2019 november;45932;22;48;214;166;48;234;213;21;;-46;-0.1;-165;-0.36;45886
5650;Delfzijl en omgeving (CR);2019 december;45886;28;58;195;151;44;200;192;8;6.0;-29;-0.06;-194;-0.42;45857
5651;Delfzijl en omgeving (CR);2019;46051;383;551;2619;2226;393;2651;2467;184;6.0;-194;-0.42;-194;-0.42;45857
5652;Delfzijl en omgeving (CR);2020 januari;45857;23;54;219;183;36;224;201;23;;-36;-0.08;-36;-0.08;45821
5653;Delfzijl en omgeving (CR);2020 februari;45821;39;44;212;182;30;217;208;9;;-10;-0.02;-46;-0.1;45811
5654;Delfzijl en omgeving (CR);2020 maart;45811;23;42;199;165;34;239;236;3;;-59;-0.13;-105;-0.23;45752
5655;Delfzijl en omgeving (CR);2020 april;45752;31;46;147;135;12;157;148;9;;-25;-0.05;-130;-0.28;45727
5656;Delfzijl en omgeving (CR);2020 mei;45727;24;47;200;176;24;227;227;0;;-50;-0.11;-180;-0.39;45677
5657;Delfzijl en omgeving (CR);2020 juni;45677;28;44;194;178;16;245;231;14;;-67;-0.15;-247;-0.54;45610
5658;Delfzijl en omgeving (CR);2020 juli;45610;28;39;239;201;38;220;208;12;;8;0.02;-239;-0.52;45618
5659;Delfzijl en omgeving (CR);2020 augustus;45618;20;38;222;184;38;197;186;11;;7;0.02;-232;-0.51;45625
5660;Delfzijl en omgeving (CR);2020 september;45625;33;39;241;190;51;204;160;44;;31;0.07;-201;-0.44;45656
5661;Delfzijl en omgeving (CR);2020 oktober;45656;34;59;213;186;27;239;229;10;;-51;-0.11;-252;-0.55;45605
5662;Delfzijl en omgeving (CR);2020 november;45605;32;44;197;170;27;166;156;10;;19;0.04;-233;-0.51;45624
5663;Delfzijl en omgeving (CR);2020 december;45624;29;61;184;167;17;193;190;3;4.0;-37;-0.08;-270;-0.59;45587
5664;Delfzijl en omgeving (CR);2020;45857;344;557;2467;2117;350;2528;2380;148;4.0;-270;-0.59;-270;-0.59;45587
5665;Delfzijl en omgeving (CR);2021 januari;45587;36;57;111;85;26;169;144;25;0.0;-79;-0.17;-79;-0.17;45508
5666;Delfzijl en omgeving (CR);2021 februari;45508;36;57;155;134;21;179;169;10;0.0;-45;-0.1;-124;-0.27;45463
5667;Delfzijl en omgeving (CR);2021 maart;45463;34;46;144;122;22;185;165;20;0.0;-53;-0.12;-177;-0.39;45410
5668;Delfzijl en omgeving (CR);2021 april;45410;21;52;209;196;13;193;183;10;0.0;-15;-0.03;-192;-0.42;45395
5669;Delfzijl en omgeving (CR);2021 mei;45395;30;54;101;86;15;160;146;14;0.0;-83;-0.18;-275;-0.6;45312
5670;Delfzijl en omgeving (CR);2021 juni;45312;34;58;203;171;32;143;131;12;0.0;36;0.08;-239;-0.52;45348
5671;Delfzijl en omgeving (CR);2021 juli;45348;38;45;148;122;26;154;142;12;0.0;-13;-0.03;-252;-0.55;45335
5672;Delfzijl en omgeving (CR);2021 augustus;45335;32;47;172;147;25;157;148;9;0.0;0;0.0;-252;-0.55;45335
5673;Delfzijl en omgeving (CR);2021 september;45335;51;46;161;125;36;174;145;29;0.0;-8;-0.02;-260;-0.57;45327
5674;Delfzijl en omgeving (CR);2021 oktober;45327;34;52;178;154;24;179;161;18;0.0;-19;-0.04;-279;-0.61;45308
5675;Delfzijl en omgeving (CR);2021 november;45308;37;59;251;225;26;183;164;19;0.0;46;0.1;-233;-0.51;45354
5676;Delfzijl en omgeving (CR);2021 december;45354;33;67;226;201;25;158;143;15;1.0;35;0.08;-198;-0.43;45389
5677;Delfzijl en omgeving (CR);2021;45587;416;640;2059;1768;291;2034;1841;193;1.0;-198;-0.43;-198;-0.43;45389
5678;Delfzijl en omgeving (CR);2022 januari;45389;37;40;268;245;23;143;134;9;;122;0.27;122;0.27;45511
5679;Delfzijl en omgeving (CR);2022 februari;45511;26;45;208;185;23;183;164;19;;6;0.01;128;0.28;45517
5680;Delfzijl en omgeving (CR);2022 maart;45517;31;57;305;178;127;194;174;20;;85;0.19;213;0.47;45602
5681;Delfzijl en omgeving (CR);2022 april;45602;32;49;259;199;60;216;204;12;;26;0.06;239;0.53;45628
5682;Delfzijl en omgeving (CR);2022 mei;45628;27;47;185;165;20;161;144;17;;4;0.01;243;0.54;45632
5683;Delfzijl en omgeving (CR);2022 juni;45632;29;47;154;131;23;198;181;17;;-62;-0.14;181;0.4;45570
5684;Delfzijl en omgeving (CR);2022 juli;45570;34;51;196;167;29;231;207;24;;-52;-0.11;129;0.28;45518
5685;Delfzijl en omgeving (CR);2022 augustus;45518;27;42;173;129;44;233;198;35;;-75;-0.16;54;0.12;45443
5686;Delfzijl en omgeving (CR);2022 september;45443;35;49;259;221;38;191;162;29;;54;0.12;108;0.24;45497
5687;Delfzijl en omgeving (CR);2022 oktober;45497;27;57;205;160;45;209;184;25;;-34;-0.07;74;0.16;45463
5688;Delfzijl en omgeving (CR);2022 november;45463;27;37;241;196;45;213;192;21;;18;0.04;92;0.2;45481
5689;Delfzijl en omgeving (CR);2022 december;45481;24;68;189;158;31;237;213;24;5.0;-87;-0.19;5;0.01;45394
5690;Delfzijl en omgeving (CR);2022;45389;356;589;2642;2134;508;2409;2157;252;5.0;5;0.01;5;0.01;45394
5691;Delfzijl en omgeving (CR);2023 januari;45394;25;48;150;126;24;207;189;18;0.0;-80;-0.18;-80;-0.18;45314
5692;Delfzijl en omgeving (CR);2023 februari;45314;30;54;219;188;31;200;183;17;0.0;-5;-0.01;-85;-0.19;45309
5693;Delfzijl en omgeving (CR);2023 maart;45309;25;63;164;142;22;208;193;15;0.0;-82;-0.18;-167;-0.37;45227
5694;Delfzijl en omgeving (CR);2023 april;45227;24;43;141;114;27;141;131;10;0.0;-19;-0.04;-186;-0.41;45208
5695;Delfzijl en omgeving (CR);2023 mei;45208;32;35;287;258;29;168;155;13;0.0;116;0.26;-70;-0.15;45324
5696;Delfzijl en omgeving (CR);2023 juni;45324;40;45;153;115;38;195;185;10;0.0;-47;-0.1;-117;-0.26;45277
5697;Delfzijl en omgeving (CR);2023 juli;45277;38;51;198;164;34;205;185;20;0.0;-20;-0.04;-137;-0.3;45257
5698;Delfzijl en omgeving (CR);2023 augustus;45257;35;42;187;167;20;221;196;25;0.0;-41;-0.09;-178;-0.39;45216
5699;Delfzijl en omgeving (CR);2023 september;45216;48;49;151;125;26;197;177;20;0.0;-47;-0.1;-225;-0.5;45169
5700;Delfzijl en omgeving (CR);2023 oktober;45169;37;53;207;179;28;190;175;15;0.0;1;0.0;-224;-0.49;45170
5701;Delfzijl en omgeving (CR);2023 november;45170;29;36;201;164;37;218;187;31;0.0;-24;-0.05;-248;-0.55;45146
5702;Delfzijl en omgeving (CR);2023 december;45146;29;60;161;147;14;173;154;19;3.0;-40;-0.09;-288;-0.63;45106
5703;Delfzijl en omgeving (CR);2023;45394;392;579;2219;1889;330;2323;2110;213;3.0;-288;-0.63;-288;-0.63;45106
5704;Delfzijl en omgeving (CR);2024 januari;45106;34;49;189;167;22;202;173;29;;-28;-0.06;-28;-0.06;45078
5705;Delfzijl en omgeving (CR);2024 februari;45078;28;57;204;170;34;169;156;13;;6;0.01;-22;-0.05;45084
5706;Delfzijl en omgeving (CR);2024 maart;45084;32;38;184;166;18;233;166;67;;-55;-0.12;-77;-0.17;45029
5707;Delfzijl en omgeving (CR);2024 april;45029;31;47;121;107;14;203;162;41;;-98;-0.22;-175;-0.39;44931
5708;Delfzijl en omgeving (CR);2024 mei;44931;27;55;166;147;19;233;215;18;;-95;-0.21;-270;-0.6;44836
5709;Delfzijl en omgeving (CR);2024 juni;44836;29;56;170;130;40;175;148;27;;-32;-0.07;-302;-0.67;44804
5710;Delfzijl en omgeving (CR);2024 juli;44804;31;46;208;169;39;192;164;28;;1;0.0;-301;-0.67;44805
5711;Delfzijl en omgeving (CR);2024 augustus;44805;35;43;218;172;46;150;139;11;;60;0.13;-241;-0.53;44865
5712;Delfzijl en omgeving (CR);2024 september;44865;32;47;223;192;31;164;152;12;;44;0.1;-197;-0.44;44909
5713;Delfzijl en omgeving (CR);2024 oktober;44909;35;43;235;202;33;185;156;29;;42;0.09;-155;-0.34;44951
5714;Delfzijl en omgeving (CR);2024 november;44951;30;51;174;154;20;225;202;23;;-72;-0.16;-227;-0.5;44879
5715;Delfzijl en omgeving (CR);2024 december;44879;29;45;149;135;14;199;178;21;0.0;-66;-0.15;-293;-0.65;44813
5716;Delfzijl en omgeving (CR);2024;45106;373;577;2241;1911;330;2330;2011;319;0.0;-293;-0.65;-293;-0.65;44813
5717;Delfzijl en omgeving (CR);2025 januari;44813;31;54;277;247;30;163;148;15;;91;0.2;91;0.2;44904
5718;Delfzijl en omgeving (CR);2025 februari;44904;30;67;174;155;19;181;154;27;;-44;-0.1;47;0.1;44860
5719;Overig Groningen (CR);2002 januari;363393;342;323;1837;1470;367;1870;1643;227;;-14;0.0;-14;0.0;363379
5720;Overig Groningen (CR);2002 februari;363379;344;228;1571;1326;245;1668;1502;166;;19;0.01;5;0.0;363398
5721;Overig Groningen (CR);2002 maart;363398;383;301;1600;1352;248;1733;1490;243;;-51;-0.01;-46;-0.01;363347
5722;Overig Groningen (CR);2002 april;363347;331;313;1551;1305;246;1748;1534;214;;-179;-0.05;-225;-0.06;363168
5723;Overig Groningen (CR);2002 mei;363168;364;265;1624;1380;244;1623;1524;99;;100;0.03;-125;-0.03;363268
5724;Overig Groningen (CR);2002 juni;363268;318;255;1636;1339;297;1658;1455;203;;41;0.01;-84;-0.02;363309
5725;Overig Groningen (CR);2002 juli;363309;359;238;2082;1702;380;2130;1891;239;;73;0.02;-11;0.0;363382
5726;Overig Groningen (CR);2002 augustus;363382;388;245;2870;2529;341;2077;1957;120;;936;0.26;925;0.25;364318
5727;Overig Groningen (CR);2002 september;364318;360;233;2751;2230;521;2001;1801;200;;877;0.24;1802;0.5;365195
5728;Overig Groningen (CR);2002 oktober;365195;370;260;2139;1724;415;1963;1728;235;;286;0.08;2088;0.57;365481
5729;Overig Groningen (CR);2002 november;365481;339;262;1901;1596;305;1673;1506;167;;305;0.08;2393;0.66;365786
5730;Overig Groningen (CR);2002 december;365786;361;336;1547;1360;187;1618;1449;169;32.0;-14;0.0;2379;0.65;365772
5731;Overig Groningen (CR);2002;363393;4259;3259;23109;19313;3796;21762;19480;2282;32.0;2379;0.65;2379;0.65;365772
5732;Overig Groningen (CR);2003 januari;365772;343;309;1911;1711;200;1886;1675;211;;59;0.02;59;0.02;365831
5733;Overig Groningen (CR);2003 februari;365831;321;246;1649;1454;195;1622;1467;155;;102;0.03;161;0.04;365933
5734;Overig Groningen (CR);2003 maart;365933;379;268;1550;1375;175;1670;1469;201;;-9;0.0;152;0.04;365924
5735;Overig Groningen (CR);2003 april;365924;363;274;1521;1372;149;1669;1410;259;;-59;-0.02;93;0.03;365865
5736;Overig Groningen (CR);2003 mei;365865;353;254;1380;1235;145;1671;1395;276;;-192;-0.05;-99;-0.03;365673
5737;Overig Groningen (CR);2003 juni;365673;339;259;1538;1381;157;1540;1374;166;;78;0.02;-21;-0.01;365751
5738;Overig Groningen (CR);2003 juli;365751;376;278;1906;1686;220;1998;1746;252;;6;0.0;-15;0.0;365757
5739;Overig Groningen (CR);2003 augustus;365757;401;312;2744;2457;287;2065;1909;156;;768;0.21;753;0.21;366525
5740;Overig Groningen (CR);2003 september;366525;381;235;2787;2346;441;2059;1903;156;;874;0.24;1627;0.44;367399
5741;Overig Groningen (CR);2003 oktober;367399;357;282;1885;1681;204;1960;1695;265;;0;0.0;1627;0.44;367399
5742;Overig Groningen (CR);2003 november;367399;347;236;1536;1394;142;1579;1420;159;;68;0.02;1695;0.46;367467
5743;Overig Groningen (CR);2003 december;367467;328;305;1485;1361;124;1644;1362;282;157.0;21;0.01;1716;0.47;367488
5744;Overig Groningen (CR);2003;365772;4288;3258;21892;19453;2439;21363;18825;2538;157.0;1716;0.47;1716;0.47;367488
5745;Overig Groningen (CR);2004 januari;367488;346;329;1615;1444;171;1726;1462;264;;-94;-0.03;-94;-0.03;367394
5746;Overig Groningen (CR);2004 februari;367394;322;250;1571;1398;173;1511;1341;170;;132;0.04;38;0.01;367526
5747;Overig Groningen (CR);2004 maart;367526;348;239;1645;1461;184;1912;1566;346;;-158;-0.04;-120;-0.03;367368
5748;Overig Groningen (CR);2004 april;367368;355;270;1347;1178;169;1666;1426;240;;-234;-0.06;-354;-0.1;367134
5749;Overig Groningen (CR);2004 mei;367134;313;273;1397;1230;167;1437;1263;174;;0;0.0;-354;-0.1;367134
5750;Overig Groningen (CR);2004 juni;367134;344;261;1520;1329;191;1697;1482;215;;-94;-0.03;-448;-0.12;367040
5751;Overig Groningen (CR);2004 juli;367040;349;257;1943;1769;174;1989;1763;226;;46;0.01;-402;-0.11;367086
5752;Overig Groningen (CR);2004 augustus;367086;348;246;2941;2608;333;2139;1933;206;;904;0.25;502;0.14;367990
5753;Overig Groningen (CR);2004 september;367990;347;246;2942;2323;619;2207;1922;285;;836;0.23;1338;0.36;368826
5754;Overig Groningen (CR);2004 oktober;368826;327;253;1894;1663;231;1855;1561;294;;113;0.03;1451;0.39;368939
5755;Overig Groningen (CR);2004 november;368939;337;234;1662;1487;175;1525;1356;169;;240;0.07;1691;0.46;369179
5756;Overig Groningen (CR);2004 december;369179;355;297;1659;1472;187;1801;1582;219;150.0;66;0.02;1757;0.48;369245
5757;Overig Groningen (CR);2004;367488;4091;3155;22136;19362;2774;21465;18657;2808;150.0;1757;0.48;1757;0.48;369245
5758;Overig Groningen (CR);2005 januari;369245;319;302;1675;1507;168;1968;1772;196;;-276;-0.07;-276;-0.07;368969
5759;Overig Groningen (CR);2005 februari;368969;309;259;1646;1342;304;1664;1465;199;;32;0.01;-244;-0.07;369001
5760;Overig Groningen (CR);2005 maart;369001;335;271;1443;1292;151;1681;1485;196;;-174;-0.05;-418;-0.11;368827
5761;Overig Groningen (CR);2005 april;368827;317;266;1349;1198;151;1897;1464;433;;-497;-0.13;-915;-0.25;368330
5762;Overig Groningen (CR);2005 mei;368330;327;260;1306;1188;118;1704;1425;279;;-331;-0.09;-1246;-0.34;367999
5763;Overig Groningen (CR);2005 juni;367999;301;245;1412;1242;170;1651;1387;264;;-183;-0.05;-1429;-0.39;367816
5764;Overig Groningen (CR);2005 juli;367816;371;252;1864;1686;178;2288;1848;440;;-305;-0.08;-1734;-0.47;367511
5765;Overig Groningen (CR);2005 augustus;367511;339;217;2724;2482;242;2519;2261;258;;327;0.09;-1407;-0.38;367838
5766;Overig Groningen (CR);2005 september;367838;384;228;3379;2647;732;2521;2208;313;;1014;0.28;-393;-0.11;368852
5767;Overig Groningen (CR);2005 oktober;368852;374;239;2052;1850;202;2210;1921;289;;-23;-0.01;-416;-0.11;368829
5768;Overig Groningen (CR);2005 november;368829;325;224;1726;1561;165;1879;1622;257;;-52;-0.01;-468;-0.13;368777
5769;Overig Groningen (CR);2005 december;368777;306;287;1584;1460;124;1878;1591;287;32.0;-243;-0.07;-711;-0.19;368534
5770;Overig Groningen (CR);2005;369245;4007;3050;22160;19455;2705;23860;20449;3411;32.0;-711;-0.19;-711;-0.19;368534
5771;Overig Groningen (CR);2006 januari;368534;322;298;1683;1563;120;1921;1670;251;;-214;-0.06;-214;-0.06;368320
5772;Overig Groningen (CR);2006 februari;368320;286;262;1836;1616;220;1755;1610;145;;105;0.03;-109;-0.03;368425
5773;Overig Groningen (CR);2006 maart;368425;322;301;1652;1510;142;2019;1736;283;;-346;-0.09;-455;-0.12;368079
5774;Overig Groningen (CR);2006 april;368079;324;260;1341;1238;103;1471;1310;161;;-66;-0.02;-521;-0.14;368013
5775;Overig Groningen (CR);2006 mei;368013;307;270;1406;1281;125;1667;1483;184;;-224;-0.06;-745;-0.2;367789
5776;Overig Groningen (CR);2006 juni;367789;299;279;1568;1439;129;1934;1681;253;;-346;-0.09;-1091;-0.3;367443
5777;Overig Groningen (CR);2006 juli;367443;310;237;1907;1732;175;2058;1796;262;;-78;-0.02;-1169;-0.32;367365
5778;Overig Groningen (CR);2006 augustus;367365;376;269;3174;2837;337;2596;2261;335;;685;0.19;-484;-0.13;368050
5779;Overig Groningen (CR);2006 september;368050;372;222;3186;2555;631;2585;2209;376;;751;0.2;267;0.07;368801
5780;Overig Groningen (CR);2006 oktober;368801;346;221;2186;1919;267;2021;1785;236;;290;0.08;557;0.15;369091
5781;Overig Groningen (CR);2006 november;369091;333;254;1804;1639;165;1871;1653;218;;12;0.0;569;0.15;369103
5782;Overig Groningen (CR);2006 december;369103;304;242;1546;1419;127;1670;1441;229;142.0;80;0.02;649;0.18;369183
5783;Overig Groningen (CR);2006;368534;3901;3115;23289;20748;2541;23568;20635;2933;142.0;649;0.18;649;0.18;369183
5784;Overig Groningen (CR);2007 januari;369183;294;252;1857;1661;196;2020;1728;292;;-121;-0.03;-121;-0.03;369062
5785;Overig Groningen (CR);2007 februari;369062;273;268;1695;1445;250;1807;1566;241;;-107;-0.03;-228;-0.06;368955
5786;Overig Groningen (CR);2007 maart;368955;310;248;1646;1492;154;1931;1719;212;;-223;-0.06;-451;-0.12;368732
5787;Overig Groningen (CR);2007 april;368732;320;247;1432;1320;112;1598;1412;186;;-93;-0.03;-544;-0.15;368639
5788;Overig Groningen (CR);2007 mei;368639;338;243;1537;1378;159;1804;1603;201;;-172;-0.05;-716;-0.19;368467
5789;Overig Groningen (CR);2007 juni;368467;319;221;1633;1458;175;1791;1573;218;;-60;-0.02;-776;-0.21;368407
5790;Overig Groningen (CR);2007 juli;368407;346;230;2159;1979;180;2334;2109;225;;-59;-0.02;-835;-0.23;368348
5791;Overig Groningen (CR);2007 augustus;368348;348;239;3315;2966;349;2676;2339;337;;748;0.2;-87;-0.02;369096
5792;Overig Groningen (CR);2007 september;369096;328;219;3230;2632;598;2203;1975;228;;1136;0.31;1049;0.28;370232
5793;Overig Groningen (CR);2007 oktober;370232;315;225;2166;1829;337;2044;1752;292;;212;0.06;1261;0.34;370444
5794;Overig Groningen (CR);2007 november;370444;313;215;1839;1622;217;1945;1623;322;;-8;0.0;1253;0.34;370436
5795;Overig Groningen (CR);2007 december;370436;296;267;1447;1308;139;1785;1372;413;122.0;-187;-0.05;1066;0.29;370249
5796;Overig Groningen (CR);2007;369183;3800;2874;23956;21090;2866;23938;20771;3167;122.0;1066;0.29;1066;0.29;370249
5797;Overig Groningen (CR);2008 januari;370249;366;269;1935;1699;236;2103;1836;267;;-71;-0.02;-71;-0.02;370178
5798;Overig Groningen (CR);2008 februari;370178;310;241;1820;1590;230;1943;1757;186;;-54;-0.01;-125;-0.03;370124
5799;Overig Groningen (CR);2008 maart;370124;325;290;1671;1429;242;1671;1521;150;;35;0.01;-90;-0.02;370159
5800;Overig Groningen (CR);2008 april;370159;308;250;1495;1308;187;1643;1515;128;;-90;-0.02;-180;-0.05;370069
5801;Overig Groningen (CR);2008 mei;370069;334;255;1509;1329;180;1626;1485;141;;-38;-0.01;-218;-0.06;370031
5802;Overig Groningen (CR);2008 juni;370031;323;258;1512;1330;182;1577;1380;197;;0;0.0;-218;-0.06;370031
5803;Overig Groningen (CR);2008 juli;370031;362;262;2174;1901;273;2341;2062;279;;-67;-0.02;-285;-0.08;369964
5804;Overig Groningen (CR);2008 augustus;369964;367;240;3162;2759;403;2409;2122;287;;880;0.24;595;0.16;370844
5805;Overig Groningen (CR);2008 september;370844;355;237;3797;2775;1022;2459;2177;282;;1456;0.39;2051;0.55;372300
5806;Overig Groningen (CR);2008 oktober;372300;322;252;2184;1798;386;1985;1639;346;;269;0.07;2320;0.63;372569
5807;Overig Groningen (CR);2008 november;372569;314;236;1726;1512;214;1804;1522;282;;0;0.0;2320;0.63;372569
5808;Overig Groningen (CR);2008 december;372569;321;249;1603;1450;153;1863;1597;266;138.0;-50;-0.01;2270;0.61;372519
5809;Overig Groningen (CR);2008;370249;4007;3039;24588;20880;3708;23424;20613;2811;138.0;2270;0.61;2270;0.61;372519
5810;Overig Groningen (CR);2009 januari;372519;330;347;1733;1524;209;1853;1629;224;;-137;-0.04;-137;-0.04;372382
5811;Overig Groningen (CR);2009 februari;372382;283;290;1877;1531;346;1756;1563;193;;114;0.03;-23;-0.01;372496
5812;Overig Groningen (CR);2009 maart;372496;334;277;1596;1297;299;1764;1479;285;;-111;-0.03;-134;-0.04;372385
5813;Overig Groningen (CR);2009 april;372385;333;216;1429;1251;178;1378;1224;154;;168;0.05;34;0.01;372553
5814;Overig Groningen (CR);2009 mei;372553;322;275;1372;1195;177;1405;1238;167;;14;0.0;48;0.01;372567
5815;Overig Groningen (CR);2009 juni;372567;365;238;1550;1367;183;1718;1423;295;;-41;-0.01;7;0.0;372526
5816;Overig Groningen (CR);2009 juli;372526;382;244;2180;1919;261;2201;1855;346;;117;0.03;124;0.03;372643
5817;Overig Groningen (CR);2009 augustus;372643;335;242;3163;2728;435;2181;1953;228;;1075;0.29;1199;0.32;373718
5818;Overig Groningen (CR);2009 september;373718;343;213;3806;2656;1150;2278;1962;316;;1658;0.44;2857;0.77;375376
5819;Overig Groningen (CR);2009 oktober;375376;312;254;2050;1645;405;1736;1559;177;;372;0.1;3229;0.87;375748
5820;Overig Groningen (CR);2009 november;375748;302;216;1606;1375;231;1994;1427;567;;-302;-0.08;2927;0.79;375446
5821;Overig Groningen (CR);2009 december;375446;317;271;1595;1381;214;1602;1417;185;60.0;99;0.03;3026;0.81;375545
5822;Overig Groningen (CR);2009;372519;3958;3083;23957;19869;4088;21866;18729;3137;60.0;3026;0.81;3026;0.81;375545
5823;Overig Groningen (CR);2010 januari;375545;343;270;1643;1418;225;1697;1469;228;;19;0.01;19;0.01;375564
5824;Overig Groningen (CR);2010 februari;375564;288;270;1840;1459;381;1719;1504;215;;139;0.04;158;0.04;375703
5825;Overig Groningen (CR);2010 maart;375703;291;260;1662;1428;234;1859;1522;337;;-166;-0.04;-8;0.0;375537
5826;Overig Groningen (CR);2010 april;375537;311;260;1317;1140;177;1387;1196;191;;-19;-0.01;-27;-0.01;375518
5827;Overig Groningen (CR);2010 mei;375518;318;252;1270;1123;147;1293;1173;120;;43;0.01;16;0.0;375561
5828;Overig Groningen (CR);2010 juni;375561;305;251;1441;1173;268;1571;1294;277;;-76;-0.02;-60;-0.02;375485
5829;Overig Groningen (CR);2010 juli;375485;347;253;2016;1746;270;2230;1864;366;;-120;-0.03;-180;-0.05;375365
5830;Overig Groningen (CR);2010 augustus;375365;348;237;3032;2550;482;2315;1996;319;;828;0.22;648;0.17;376193
5831;Overig Groningen (CR);2010 september;376193;328;229;3868;2636;1232;2385;2053;332;;1582;0.42;2230;0.59;377775
5832;Overig Groningen (CR);2010 oktober;377775;329;223;2204;1623;581;1673;1473;200;;637;0.17;2867;0.76;378412
5833;Overig Groningen (CR);2010 november;378412;317;244;1775;1418;357;1754;1357;397;;94;0.02;2961;0.79;378506
5834;Overig Groningen (CR);2010 december;378506;335;300;1596;1414;182;1781;1375;406;15.0;-135;-0.04;2826;0.75;378371
5835;Overig Groningen (CR);2010;375545;3860;3049;23664;19128;4536;21664;18276;3388;15.0;2826;0.75;2826;0.75;378371
5836;Overig Groningen (CR);2011 januari;378371;338;254;1769;1547;222;1796;1530;266;;57;0.02;57;0.02;378428
5837;Overig Groningen (CR);2011 februari;378428;318;235;2173;1676;497;1998;1702;296;;258;0.07;315;0.08;378686
5838;Overig Groningen (CR);2011 maart;378686;309;283;1740;1485;255;1838;1575;263;;-72;-0.02;243;0.06;378614
5839;Overig Groningen (CR);2011 april;378614;326;240;1468;1231;237;1469;1287;182;;85;0.02;328;0.09;378699
5840;Overig Groningen (CR);2011 mei;378699;364;228;1378;1162;216;1490;1261;229;;24;0.01;352;0.09;378723
5841;Overig Groningen (CR);2011 juni;378723;352;287;1371;1170;201;1712;1291;421;;-276;-0.07;76;0.02;378447
5842;Overig Groningen (CR);2011 juli;378447;352;236;1941;1690;251;2273;1802;471;;-216;-0.06;-140;-0.04;378231
5843;Overig Groningen (CR);2011 augustus;378231;390;218;3367;2750;617;2613;2175;438;;926;0.24;786;0.21;379157
5844;Overig Groningen (CR);2011 september;379157;380;250;4672;2828;1844;2479;2125;354;;2323;0.61;3109;0.82;381480
5845;Overig Groningen (CR);2011 oktober;381480;297;260;2046;1680;366;1880;1529;351;;203;0.05;3312;0.88;381683
5846;Overig Groningen (CR);2011 november;381683;306;252;1801;1560;241;1852;1439;413;;3;0.0;3315;0.88;381686
5847;Overig Groningen (CR);2011 december;381686;317;288;1619;1440;179;1975;1496;479;10.0;-317;-0.08;2998;0.79;381369
5848;Overig Groningen (CR);2011;378371;4049;3031;25345;20219;5126;23375;19212;4163;10.0;2998;0.79;2998;0.79;381369
5849;Overig Groningen (CR);2012 januari;381369;305;272;1867;1655;212;2013;1685;328;;-113;-0.03;-113;-0.03;381256
5850;Overig Groningen (CR);2012 februari;381256;294;275;2148;1551;597;2110;1669;441;;57;0.01;-56;-0.01;381313
5851;Overig Groningen (CR);2012 maart;381313;346;280;1724;1475;249;1801;1529;272;;-11;0.0;-67;-0.02;381302
5852;Overig Groningen (CR);2012 april;381302;299;284;1415;1233;182;1585;1344;241;;-155;-0.04;-222;-0.06;381147
5853;Overig Groningen (CR);2012 mei;381147;332;265;1333;1166;167;1520;1283;237;;-120;-0.03;-342;-0.09;381027
5854;Overig Groningen (CR);2012 juni;381027;295;251;1654;1448;206;1943;1545;398;;-245;-0.06;-587;-0.15;380782
5855;Overig Groningen (CR);2012 juli;380782;361;273;2200;1937;263;2540;1979;561;;-252;-0.07;-839;-0.22;380530
5856;Overig Groningen (CR);2012 augustus;380530;326;246;4023;3007;1016;2745;2321;424;;1358;0.36;519;0.14;381888
5857;Overig Groningen (CR);2012 september;381888;336;245;4483;2877;1606;2615;2204;411;;1959;0.51;2478;0.65;383847
5858;Overig Groningen (CR);2012 oktober;383847;329;253;1979;1606;373;2003;1617;386;;52;0.01;2530;0.66;383899
5859;Overig Groningen (CR);2012 november;383899;287;285;1691;1459;232;1919;1432;487;;-226;-0.06;2304;0.6;383673
5860;Overig Groningen (CR);2012 december;383673;309;283;1578;1429;149;1785;1450;335;5.0;-176;-0.05;2128;0.56;383497
5861;Overig Groningen (CR);2012;381369;3819;3212;26095;20843;5252;24579;20058;4521;5.0;2128;0.56;2128;0.56;383497
5862;Overig Groningen (CR);2013 januari;383497;318;265;1902;1583;319;2071;1685;386;;-116;-0.03;-116;-0.03;383381
5863;Overig Groningen (CR);2013 februari;383381;284;284;2114;1652;462;2191;1803;388;;-77;-0.02;-193;-0.05;383304
5864;Overig Groningen (CR);2013 maart;383304;285;330;1578;1400;178;1727;1517;210;;-194;-0.05;-387;-0.1;383110
5865;Overig Groningen (CR);2013 april;383110;286;276;1538;1285;253;1565;1368;197;;-17;0.0;-404;-0.11;383093
5866;Overig Groningen (CR);2013 mei;383093;297;251;1484;1277;207;1743;1309;434;;-213;-0.06;-617;-0.16;382880
5867;Overig Groningen (CR);2013 juni;382880;331;226;1458;1268;190;1795;1372;423;;-232;-0.06;-849;-0.22;382648
5868;Overig Groningen (CR);2013 juli;382648;336;239;2316;2070;246;2698;2101;597;;-285;-0.07;-1134;-0.3;382363
5869;Overig Groningen (CR);2013 augustus;382363;323;246;4080;3444;636;2915;2428;487;;1242;0.32;108;0.03;383605
5870;Overig Groningen (CR);2013 september;383605;303;224;4830;2891;1939;2752;2319;433;;2157;0.56;2265;0.59;385762
5871;Overig Groningen (CR);2013 oktober;385762;294;251;2028;1640;388;1962;1626;336;;109;0.03;2374;0.62;385871
5872;Overig Groningen (CR);2013 november;385871;315;245;1727;1485;242;1676;1432;244;;121;0.03;2495;0.65;385992
5873;Overig Groningen (CR);2013 december;385992;301;257;1648;1474;174;1863;1597;266;5.0;-166;-0.04;2329;0.61;385826
5874;Overig Groningen (CR);2013;383497;3673;3094;26703;21469;5234;24958;20557;4401;5.0;2329;0.61;2329;0.61;385826
5875;Overig Groningen (CR);2014 januari;385826;313;271;1978;1572;406;2144;1744;400;;-124;-0.03;-124;-0.03;385702
5876;Overig Groningen (CR);2014 februari;385702;300;249;2231;1678;553;2341;1873;468;;-59;-0.02;-183;-0.05;385643
5877;Overig Groningen (CR);2014 maart;385643;301;273;1701;1472;229;2024;1600;424;;-295;-0.08;-478;-0.12;385348
5878;Overig Groningen (CR);2014 april;385348;342;254;1578;1355;223;1765;1396;369;;-99;-0.03;-577;-0.15;385249
5879;Overig Groningen (CR);2014 mei;385249;326;230;1511;1273;238;1721;1358;363;;-114;-0.03;-691;-0.18;385135
5880;Overig Groningen (CR);2014 juni;385135;298;210;1568;1365;203;1971;1467;504;;-315;-0.08;-1006;-0.26;384820
5881;Overig Groningen (CR);2014 juli;384820;311;262;2496;2220;276;3003;2263;740;;-458;-0.12;-1464;-0.38;384362
5882;Overig Groningen (CR);2014 augustus;384362;357;255;4453;3547;906;3193;2624;569;;1362;0.35;-102;-0.03;385724
5883;Overig Groningen (CR);2014 september;385724;340;275;4532;2922;1610;2816;2368;448;;1781;0.46;1679;0.44;387505
5884;Overig Groningen (CR);2014 oktober;387505;324;241;2115;1694;421;2080;1786;294;;118;0.03;1797;0.47;387623
5885;Overig Groningen (CR);2014 november;387623;263;265;1804;1555;249;1856;1585;271;;-54;-0.01;1743;0.45;387569
5886;Overig Groningen (CR);2014 december;387569;280;330;1972;1722;250;2081;1769;312;6.0;-153;-0.04;1590;0.41;387416
5887;Overig Groningen (CR);2014;385826;3755;3115;27939;22375;5564;26995;21833;5162;6.0;1590;0.41;1590;0.41;387416
5888;Overig Groningen (CR);2015 januari;387416;312;325;2227;1779;448;2248;1776;472;;-34;-0.01;-34;-0.01;387382
5889;Overig Groningen (CR);2015 februari;387382;281;255;2505;1907;598;2420;1991;429;;111;0.03;77;0.02;387493
5890;Overig Groningen (CR);2015 maart;387493;306;293;1946;1657;289;2133;1779;354;;-174;-0.04;-97;-0.03;387319
5891;Overig Groningen (CR);2015 april;387319;330;238;1697;1498;199;1864;1570;294;;-75;-0.02;-172;-0.04;387244
5892;Overig Groningen (CR);2015 mei;387244;307;260;1562;1388;174;1739;1539;200;;-130;-0.03;-302;-0.08;387114
5893;Overig Groningen (CR);2015 juni;387114;308;236;1769;1519;250;2130;1655;475;;-289;-0.07;-591;-0.15;386825
5894;Overig Groningen (CR);2015 juli;386825;349;261;2433;2148;285;3124;2513;611;;-603;-0.16;-1194;-0.31;386222
5895;Overig Groningen (CR);2015 augustus;386222;297;252;4441;3189;1252;3290;2849;441;;1196;0.31;2;0.0;387418
5896;Overig Groningen (CR);2015 september;387418;306;245;3856;2608;1248;3107;2477;630;;810;0.21;812;0.21;388228
5897;Overig Groningen (CR);2015 oktober;388228;319;262;2273;1704;569;2280;1890;390;;50;0.01;862;0.22;388278
5898;Overig Groningen (CR);2015 november;388278;303;320;1845;1523;322;1857;1611;246;;-29;-0.01;833;0.22;388249
5899;Overig Groningen (CR);2015 december;388249;316;261;1982;1695;287;2276;1896;380;17.0;-222;-0.06;611;0.16;388027
5900;Overig Groningen (CR);2015;387416;3734;3208;28536;22615;5921;28468;23546;4922;17.0;611;0.16;611;0.16;388027
5901;Overig Groningen (CR);2016 januari;388027;297;308;2269;1671;598;2380;1805;575;;-122;-0.03;-122;-0.03;387905
5902;Overig Groningen (CR);2016 februari;387905;326;261;2441;1907;534;2700;2088;612;;-194;-0.05;-316;-0.08;387711
5903;Overig Groningen (CR);2016 maart;387711;289;292;1972;1680;292;2118;1757;361;;-149;-0.04;-465;-0.12;387562
5904;Overig Groningen (CR);2016 april;387562;296;238;1939;1706;233;2100;1788;312;;-103;-0.03;-568;-0.15;387459
5905;Overig Groningen (CR);2016 mei;387459;324;292;1870;1615;255;2023;1753;270;;-121;-0.03;-689;-0.18;387338
5906;Overig Groningen (CR);2016 juni;387338;276;253;1953;1694;259;2392;1876;516;;-416;-0.11;-1105;-0.28;386922
5907;Overig Groningen (CR);2016 juli;386922;310;262;2682;2366;316;3265;2638;627;;-535;-0.14;-1640;-0.42;386387
5908;Overig Groningen (CR);2016 augustus;386387;327;230;4441;3042;1399;3281;2824;457;;1257;0.33;-383;-0.1;387644
5909;Overig Groningen (CR);2016 september;387644;339;266;4918;3123;1795;3145;2686;459;;1846;0.48;1463;0.38;389490
5910;Overig Groningen (CR);2016 oktober;389490;327;278;2395;1906;489;2300;1913;387;;144;0.04;1607;0.41;389634
5911;Overig Groningen (CR);2016 november;389634;293;260;2191;1828;363;2196;1864;332;;28;0.01;1635;0.42;389662
5912;Overig Groningen (CR);2016 december;389662;278;274;1968;1728;240;2289;1968;321;-7.0;-324;-0.08;1311;0.34;389338
5913;Overig Groningen (CR);2016;388027;3682;3214;31039;24266;6773;30189;24960;5229;-7.0;1311;0.34;1311;0.34;389338
5914;Overig Groningen (CR);2017 januari;389338;270;320;2084;1799;285;2472;2084;388;;-438;-0.11;-438;-0.11;388900
5915;Overig Groningen (CR);2017 februari;388900;267;292;2968;2175;793;2688;2206;482;;255;0.07;-183;-0.05;389155
5916;Overig Groningen (CR);2017 maart;389155;287;293;2235;1965;270;2369;1958;411;;-140;-0.04;-323;-0.08;389015
5917;Overig Groningen (CR);2017 april;389015;308;294;1790;1596;194;1926;1661;265;;-122;-0.03;-445;-0.11;388893
5918;Overig Groningen (CR);2017 mei;388893;295;262;1824;1612;212;2020;1732;288;;-163;-0.04;-608;-0.16;388730
5919;Overig Groningen (CR);2017 juni;388730;301;263;1795;1576;219;2407;1727;680;;-574;-0.15;-1182;-0.3;388156
5920;Overig Groningen (CR);2017 juli;388156;299;275;2393;2098;295;3471;2588;883;;-1054;-0.27;-2236;-0.57;387102
5921;Overig Groningen (CR);2017 augustus;387102;335;253;4368;2781;1587;3294;2814;480;;1156;0.3;-1080;-0.28;388258
5922;Overig Groningen (CR);2017 september;388258;305;216;4510;3017;1493;3044;2601;443;;1555;0.4;475;0.12;389813
5923;Overig Groningen (CR);2017 oktober;389813;305;268;2659;2010;649;2493;2090;403;;203;0.05;678;0.17;390016
5924;Overig Groningen (CR);2017 november;390016;271;295;2126;1770;356;2190;1833;357;;-88;-0.02;590;0.15;389928
5925;Overig Groningen (CR);2017 december;389928;311;330;1968;1735;233;2101;1831;270;-11.0;-163;-0.04;427;0.11;389765
5926;Overig Groningen (CR);2017;389338;3554;3361;30720;24134;6586;30475;25125;5350;-11.0;427;0.11;427;0.11;389765
5927;Overig Groningen (CR);2018 januari;401778;302;340;2097;1799;298;2389;2014;375;;-330;-0.08;-330;-0.08;401448
5928;Overig Groningen (CR);2018 februari;401448;267;330;2670;1877;793;2482;2034;448;;125;0.03;-205;-0.05;401573
5929;Overig Groningen (CR);2018 maart;401573;268;370;2224;1907;317;2298;1959;339;;-176;-0.04;-381;-0.09;401397
5930;Overig Groningen (CR);2018 april;401397;300;261;1814;1562;252;1933;1642;291;;-80;-0.02;-461;-0.11;401317
5931;Overig Groningen (CR);2018 mei;401317;296;252;1804;1575;229;2048;1786;262;;-200;-0.05;-661;-0.16;401117
5932;Overig Groningen (CR);2018 juni;401117;278;233;1804;1567;237;2433;1812;621;;-584;-0.15;-1245;-0.31;400533
5933;Overig Groningen (CR);2018 juli;400533;317;279;2327;1995;332;3173;2386;787;;-808;-0.2;-2053;-0.51;399725
5934;Overig Groningen (CR);2018 augustus;399725;318;234;4639;2688;1951;3182;2691;491;;1541;0.39;-512;-0.13;401266
5935;Overig Groningen (CR);2018 september;401266;317;257;4424;2783;1641;2831;2406;425;;1653;0.41;1141;0.28;402919
5936;Overig Groningen (CR);2018 oktober;402919;306;252;2559;1925;634;2299;1969;330;;314;0.08;1455;0.36;403233
5937;Overig Groningen (CR);2018 november;403233;306;260;2210;1744;466;2177;1800;377;;79;0.02;1534;0.38;403312
5938;Overig Groningen (CR);2018 december;403312;284;309;1843;1629;214;2007;1723;284;-6.0;-195;-0.05;1339;0.33;403117
5939;Overig Groningen (CR);2018;401778;3559;3377;30415;23051;7364;29252;24222;5030;-6.0;1339;0.33;1339;0.33;403117
5940;Overig Groningen (CR);2019 januari;403117;298;295;1986;1613;373;2341;1679;662;;-352;-0.09;-352;-0.09;402765
5941;Overig Groningen (CR);2019 februari;402765;268;279;2611;1723;888;2248;1729;519;;352;0.09;0;0.0;403117
5942;Overig Groningen (CR);2019 maart;403117;290;320;2037;1710;327;1961;1609;352;;46;0.01;46;0.01;403163
5943;Overig Groningen (CR);2019 april;403163;277;289;1671;1435;236;1908;1583;325;;-249;-0.06;-203;-0.05;402914
5944;Overig Groningen (CR);2019 mei;402914;295;287;1675;1420;255;1851;1536;315;;-168;-0.04;-371;-0.09;402746
5945;Overig Groningen (CR);2019 juni;402746;313;258;1497;1242;255;2065;1447;618;;-513;-0.13;-884;-0.22;402233
5946;Overig Groningen (CR);2019 juli;402233;308;285;2147;1706;441;3111;2236;875;;-941;-0.23;-1825;-0.45;401292
5947;Overig Groningen (CR);2019 augustus;401292;339;283;4403;2351;2052;2925;2355;570;;1534;0.38;-291;-0.07;402826
5948;Overig Groningen (CR);2019 september;402826;306;240;4191;2310;1881;2471;2116;355;;1786;0.44;1495;0.37;404612
5949;Overig Groningen (CR);2019 oktober;404612;321;278;2211;1517;694;1945;1689;256;;309;0.08;1804;0.45;404921
5950;Overig Groningen (CR);2019 november;404921;296;246;1945;1573;372;1809;1488;321;;186;0.05;1990;0.49;405107
5951;Overig Groningen (CR);2019 december;405107;275;278;1714;1478;236;1996;1599;397;-21.0;-306;-0.08;1684;0.42;404801
5952;Overig Groningen (CR);2019;403117;3586;3338;28088;20078;8010;26631;21066;5565;-21.0;1684;0.42;1684;0.42;404801
5953;Overig Groningen (CR);2020 januari;404801;320;313;2182;1697;485;2255;1742;513;;-66;-0.02;-66;-0.02;404735
5954;Overig Groningen (CR);2020 februari;404735;269;255;2438;1645;793;2215;1708;507;;237;0.06;171;0.04;404972
5955;Overig Groningen (CR);2020 maart;404972;284;341;1872;1536;336;2008;1532;476;;-193;-0.05;-22;-0.01;404779
5956;Overig Groningen (CR);2020 april;404779;295;298;1471;1329;142;1821;1474;347;;-353;-0.09;-375;-0.09;404426
5957;Overig Groningen (CR);2020 mei;404426;279;267;1692;1551;141;2043;1635;408;;-339;-0.08;-714;-0.18;404087
5958;Overig Groningen (CR);2020 juni;404087;296;285;1760;1512;248;2035;1572;463;;-264;-0.07;-978;-0.24;403823
5959;Overig Groningen (CR);2020 juli;403823;356;264;2138;1806;332;2975;2040;935;;-745;-0.18;-1723;-0.43;403078
5960;Overig Groningen (CR);2020 augustus;403078;312;291;3730;2352;1378;2656;2141;515;;1095;0.27;-628;-0.16;404173
5961;Overig Groningen (CR);2020 september;404173;312;275;3728;2117;1611;2414;1984;430;;1351;0.33;723;0.18;405524
5962;Overig Groningen (CR);2020 oktober;405524;325;285;2524;1950;574;2255;1814;441;;309;0.08;1032;0.25;405833
5963;Overig Groningen (CR);2020 november;405833;271;266;1830;1460;370;1879;1500;379;;-44;-0.01;988;0.24;405789
5964;Overig Groningen (CR);2020 december;405789;262;357;1855;1582;273;2026;1636;390;-12.0;-278;-0.07;710;0.18;405511
5965;Overig Groningen (CR);2020;404801;3581;3497;27220;20537;6683;26582;20778;5804;-12.0;710;0.18;710;0.18;405511
5966;Overig Groningen (CR);2021 januari;405511;296;371;2031;1705;326;2031;1698;333;0.0;-75;-0.02;-75;-0.02;405436
5967;Overig Groningen (CR);2021 februari;405436;290;313;2003;1651;352;2047;1713;334;0.0;-67;-0.02;-142;-0.04;405369
5968;Overig Groningen (CR);2021 maart;405369;298;323;2152;1822;330;2103;1657;446;0.0;24;0.01;-118;-0.03;405393
5969;Overig Groningen (CR);2021 april;405393;312;249;1775;1530;245;1775;1498;277;0.0;63;0.02;-55;-0.01;405456
5970;Overig Groningen (CR);2021 mei;405456;349;283;1708;1512;196;1805;1415;390;0.0;-31;-0.01;-86;-0.02;405425
5971;Overig Groningen (CR);2021 juni;405425;324;283;1671;1428;243;1923;1519;404;0.0;-211;-0.05;-297;-0.07;405214
5972;Overig Groningen (CR);2021 juli;405214;350;263;2047;1712;335;2680;1990;690;0.0;-546;-0.13;-843;-0.21;404668
5973;Overig Groningen (CR);2021 augustus;404668;341;268;3529;1930;1599;2745;2146;599;0.0;857;0.21;14;0.0;405525
5974;Overig Groningen (CR);2021 september;405525;312;261;4937;2111;2826;2425;1934;491;0.0;2563;0.63;2577;0.64;408088
5975;Overig Groningen (CR);2021 oktober;408088;346;319;2409;1567;842;2050;1672;378;0.0;386;0.09;2963;0.73;408474
5976;Overig Groningen (CR);2021 november;408474;315;364;2013;1575;438;1955;1539;416;0.0;9;0.0;2972;0.73;408483
5977;Overig Groningen (CR);2021 december;408483;279;359;1692;1422;270;1898;1517;381;-21.0;-307;-0.08;2665;0.66;408176
5978;Overig Groningen (CR);2021;405511;3812;3656;27967;19965;8002;25437;20298;5139;-21.0;2665;0.66;2665;0.66;408176
5979;Overig Groningen (CR);2022 januari;408176;311;322;1800;1453;347;2118;1676;442;;-329;-0.08;-329;-0.08;407847
5980;Overig Groningen (CR);2022 februari;407847;263;300;2306;1337;969;1946;1461;485;;323;0.08;-6;0.0;408170
5981;Overig Groningen (CR);2022 maart;408170;275;351;2573;1469;1104;1799;1469;330;;698;0.17;692;0.17;408868
5982;Overig Groningen (CR);2022 april;408868;273;327;2302;1488;814;1705;1443;262;;543;0.13;1235;0.3;409411
5983;Overig Groningen (CR);2022 mei;409411;264;323;1893;1388;505;1747;1468;279;;87;0.02;1322;0.32;409498
5984;Overig Groningen (CR);2022 juni;409498;301;302;2004;1447;557;1950;1431;519;;53;0.01;1375;0.34;409551
5985;Overig Groningen (CR);2022 juli;409551;337;307;2220;1696;524;2758;1912;846;;-508;-0.12;867;0.21;409043
5986;Overig Groningen (CR);2022 augustus;409043;314;304;4621;1985;2636;2935;2183;752;;1696;0.41;2563;0.63;410739
5987;Overig Groningen (CR);2022 september;410739;318;287;4527;2094;2433;2689;2105;584;;1869;0.46;4432;1.09;412608
5988;Overig Groningen (CR);2022 oktober;412608;323;312;2305;1814;491;2210;1792;418;;106;0.03;4538;1.11;412714
5989;Overig Groningen (CR);2022 november;412714;251;298;2239;1652;587;1960;1598;362;;232;0.06;4770;1.17;412946
5990;Overig Groningen (CR);2022 december;412946;278;395;2070;1739;331;1935;1640;295;-19.0;-1;0.0;4769;1.17;412945
5991;Overig Groningen (CR);2022;408176;3508;3828;30860;19562;11298;25752;20178;5574;-19.0;4769;1.17;4769;1.17;412945
5992;Overig Groningen (CR);2023 januari;412945;272;362;2285;1759;526;2361;1718;643;0.0;-166;-0.04;-166;-0.04;412779
5993;Overig Groningen (CR);2023 februari;412779;249;318;2415;1470;945;2322;1602;720;0.0;24;0.01;-142;-0.03;412803
5994;Overig Groningen (CR);2023 maart;412803;265;358;2185;1740;445;1956;1499;457;0.0;136;0.03;-6;0.0;412939
5995;Overig Groningen (CR);2023 april;412939;277;283;1738;1456;282;1674;1339;335;0.0;58;0.01;52;0.01;412997
5996;Overig Groningen (CR);2023 mei;412997;316;310;1735;1437;298;1781;1426;355;0.0;-40;-0.01;12;0.0;412957
5997;Overig Groningen (CR);2023 juni;412957;326;306;2516;2172;344;2151;1618;533;0.0;385;0.09;397;0.1;413342
5998;Overig Groningen (CR);2023 juli;413342;303;289;3071;2579;492;3139;2109;1030;0.0;-54;-0.01;343;0.08;413288
5999;Overig Groningen (CR);2023 augustus;413288;302;251;5982;3460;2522;3045;2398;647;0.0;2988;0.72;3331;0.81;416276
6000;Overig Groningen (CR);2023 september;416276;294;274;4894;2880;2014;2546;2045;501;0.0;2368;0.57;5699;1.38;418644
6001;Overig Groningen (CR);2023 oktober;418644;259;324;2299;1739;560;2155;1703;452;0.0;79;0.02;5778;1.4;418723
6002;Overig Groningen (CR);2023 november;418723;276;318;2032;1567;465;2129;1727;402;0.0;-139;-0.03;5639;1.37;418584
6003;Overig Groningen (CR);2023 december;418584;307;364;1818;1519;299;2003;1595;408;-21.0;-263;-0.06;5376;1.3;418321
6004;Overig Groningen (CR);2023;412945;3446;3757;32970;23778;9192;27262;20779;6483;-21.0;5376;1.3;5376;1.3;418321
6005;Overig Groningen (CR);2024 januari;418321;255;383;2077;1638;439;2513;1772;741;;-564;-0.13;-564;-0.13;417757
6006;Overig Groningen (CR);2024 februari;417757;240;346;2408;1509;899;2313;1665;648;;-11;0.0;-575;-0.14;417746
6007;Overig Groningen (CR);2024 maart;417746;272;333;1948;1578;370;1990;1592;398;;-103;-0.02;-678;-0.16;417643
6008;Overig Groningen (CR);2024 april;417643;284;318;1736;1424;312;1855;1511;344;;-153;-0.04;-831;-0.2;417490
6009;Overig Groningen (CR);2024 mei;417490;309;318;1722;1439;283;1754;1425;329;;-41;-0.01;-872;-0.21;417449
6010;Overig Groningen (CR);2024 juni;417449;290;324;1631;1354;277;2119;1541;578;;-522;-0.13;-1394;-0.33;416927
6011;Overig Groningen (CR);2024 juli;416927;295;328;2374;1848;526;3145;2055;1090;;-804;-0.19;-2198;-0.53;416123
6012;Overig Groningen (CR);2024 augustus;416123;292;299;4761;2501;2260;2948;2329;619;;1806;0.43;-392;-0.09;417929
6013;Overig Groningen (CR);2024 september;417929;307;283;4418;2561;1857;2809;2235;574;;1633;0.39;1241;0.3;419562
6014;Overig Groningen (CR);2024 oktober;419562;273;313;2249;1732;517;2348;1818;530;;-139;-0.03;1102;0.26;419423
6015;Overig Groningen (CR);2024 november;419423;290;303;2030;1631;399;2002;1637;365;;15;0.0;1117;0.27;419438
6016;Overig Groningen (CR);2024 december;419438;267;330;1765;1481;284;1935;1580;355;0.0;-233;-0.06;884;0.21;419205
6017;Overig Groningen (CR);2024;418321;3374;3878;29119;20696;8423;27731;21160;6571;0.0;884;0.21;884;0.21;419205
6018;Overig Groningen (CR);2025 januari;419205;289;359;1961;1549;412;2471;1716;755;;-580;-0.14;-580;-0.14;418625
6019;Overig Groningen (CR);2025 februari;418625;239;360;2408;1581;827;2235;1657;578;;52;0.01;-528;-0.13;418677
6020;Noord-Friesland (CR);2002 januari;328543;327;306;1618;1322;296;1452;1373;79;;187;0.06;187;0.06;328730
6021;Noord-Friesland (CR);2002 februari;328730;306;227;1303;1079;224;1282;1217;65;;100;0.03;287;0.09;328830
6022;Noord-Friesland (CR);2002 maart;328830;339;287;1170;1030;140;1256;1133;123;;-34;-0.01;253;0.08;328796
6023;Noord-Friesland (CR);2002 april;328796;344;243;1221;982;239;1209;1134;75;;113;0.03;366;0.11;328909
6024;Noord-Friesland (CR);2002 mei;328909;331;253;1317;1128;189;1291;1226;65;;104;0.03;470;0.14;329013
6025;Noord-Friesland (CR);2002 juni;329013;292;224;1211;1061;150;1222;1123;99;;57;0.02;527;0.16;329070
6026;Noord-Friesland (CR);2002 juli;329070;391;255;1631;1389;242;1438;1339;99;;329;0.1;856;0.26;329399
6027;Noord-Friesland (CR);2002 augustus;329399;362;229;1795;1592;203;1635;1532;103;;293;0.09;1149;0.35;329692
6028;Noord-Friesland (CR);2002 september;329692;341;236;1562;1341;221;1470;1343;127;;197;0.06;1346;0.41;329889
6029;Noord-Friesland (CR);2002 oktober;329889;387;252;1274;1126;148;1339;1249;90;;70;0.02;1416;0.43;329959
6030;Noord-Friesland (CR);2002 november;329959;352;249;1263;1074;189;1208;1144;64;;158;0.05;1574;0.48;330117
6031;Noord-Friesland (CR);2002 december;330117;369;255;1124;982;142;1100;1039;61;-73.0;65;0.02;1639;0.5;330182
6032;Noord-Friesland (CR);2002;328543;4141;3016;16489;14106;2383;15902;14852;1050;-73.0;1639;0.5;1639;0.5;330182
6033;Noord-Friesland (CR);2003 januari;330182;389;288;1350;1234;116;1525;1411;114;;-74;-0.02;-74;-0.02;330108
6034;Noord-Friesland (CR);2003 februari;330108;316;215;1299;1155;144;1266;1202;64;;134;0.04;60;0.02;330242
6035;Noord-Friesland (CR);2003 maart;330242;361;266;1255;1133;122;1308;1169;139;;42;0.01;102;0.03;330284
6036;Noord-Friesland (CR);2003 april;330284;343;231;1140;994;146;1103;942;161;;149;0.05;251;0.08;330433
6037;Noord-Friesland (CR);2003 mei;330433;328;223;1117;996;121;1185;1055;130;;37;0.01;288;0.09;330470
6038;Noord-Friesland (CR);2003 juni;330470;327;236;1092;959;133;1226;1100;126;;-43;-0.01;245;0.07;330427
6039;Noord-Friesland (CR);2003 juli;330427;360;235;1402;1268;134;1580;1393;187;;-53;-0.02;192;0.06;330374
6040;Noord-Friesland (CR);2003 augustus;330374;337;250;1776;1647;129;1721;1595;126;;142;0.04;334;0.1;330516
6041;Noord-Friesland (CR);2003 september;330516;366;212;1542;1334;208;1569;1438;131;;127;0.04;461;0.14;330643
6042;Noord-Friesland (CR);2003 oktober;330643;364;237;1369;1184;185;1197;1134;63;;299;0.09;760;0.23;330942
6043;Noord-Friesland (CR);2003 november;330942;310;263;1121;1008;113;1088;1033;55;;80;0.02;840;0.25;331022
6044;Noord-Friesland (CR);2003 december;331022;349;272;1169;1092;77;1172;1107;65;102.0;176;0.05;1016;0.31;331198
6045;Noord-Friesland (CR);2003;330182;4150;2928;15632;14004;1628;15940;14579;1361;102.0;1016;0.31;1016;0.31;331198
6046;Noord-Friesland (CR);2004 januari;331198;366;273;1182;1090;92;1195;1108;87;;80;0.02;80;0.02;331278
6047;Noord-Friesland (CR);2004 februari;331278;326;237;1032;932;100;1099;1002;97;;22;0.01;102;0.03;331300
6048;Noord-Friesland (CR);2004 maart;331300;328;249;1211;1093;118;1280;1124;156;;10;0.0;112;0.03;331310
6049;Noord-Friesland (CR);2004 april;331310;333;232;1026;974;52;1180;1027;153;;-53;-0.02;59;0.02;331257
6050;Noord-Friesland (CR);2004 mei;331257;324;240;1047;946;101;1140;1017;123;;-9;0.0;50;0.02;331248
6051;Noord-Friesland (CR);2004 juni;331248;309;226;1233;1130;103;1236;1163;73;;80;0.02;130;0.04;331328
6052;Noord-Friesland (CR);2004 juli;331328;364;233;1439;1337;102;1551;1342;209;;19;0.01;149;0.04;331347
6053;Noord-Friesland (CR);2004 augustus;331347;330;225;1777;1603;174;1560;1448;112;;322;0.1;471;0.14;331669
6054;Noord-Friesland (CR);2004 september;331669;366;240;1543;1340;203;1633;1468;165;;36;0.01;507;0.15;331705
6055;Noord-Friesland (CR);2004 oktober;331705;307;235;1395;1257;138;1438;1296;142;;29;0.01;536;0.16;331734
6056;Noord-Friesland (CR);2004 november;331734;318;250;1166;1090;76;1245;1171;74;;-11;0.0;525;0.16;331723
6057;Noord-Friesland (CR);2004 december;331723;300;261;1138;1076;62;1286;1190;96;16.0;-93;-0.03;432;0.13;331630
6058;Noord-Friesland (CR);2004;331198;3971;2901;15189;13868;1321;15843;14356;1487;16.0;432;0.13;432;0.13;331630
6059;Noord-Friesland (CR);2005 januari;331630;336;229;1150;1068;82;1268;1171;97;;-11;0.0;-11;0.0;331619
6060;Noord-Friesland (CR);2005 februari;331619;300;248;1121;1017;104;1207;1100;107;;-34;-0.01;-45;-0.01;331585
6061;Noord-Friesland (CR);2005 maart;331585;319;276;1089;993;96;1227;1054;173;;-95;-0.03;-140;-0.04;331490
6062;Noord-Friesland (CR);2005 april;331490;299;217;1136;1085;51;1266;1161;105;;-48;-0.01;-188;-0.06;331442
6063;Noord-Friesland (CR);2005 mei;331442;332;242;1033;967;66;1237;1100;137;;-114;-0.03;-302;-0.09;331328
6064;Noord-Friesland (CR);2005 juni;331328;330;198;1171;1112;59;1358;1252;106;;-55;-0.02;-357;-0.11;331273
6065;Noord-Friesland (CR);2005 juli;331273;327;222;1374;1286;88;1616;1486;130;;-137;-0.04;-494;-0.15;331136
6066;Noord-Friesland (CR);2005 augustus;331136;352;206;1553;1456;97;1674;1585;89;;25;0.01;-469;-0.14;331161
6067;Noord-Friesland (CR);2005 september;331161;334;201;1864;1639;225;1866;1784;82;;131;0.04;-338;-0.1;331292
6068;Noord-Friesland (CR);2005 oktober;331292;312;248;1287;1166;121;1438;1267;171;;-87;-0.03;-425;-0.13;331205
6069;Noord-Friesland (CR);2005 november;331205;319;242;1401;1283;118;1456;1317;139;;22;0.01;-403;-0.12;331227
6070;Noord-Friesland (CR);2005 december;331227;288;229;1099;1046;53;1326;1167;159;77.0;-91;-0.03;-494;-0.15;331136
6071;Noord-Friesland (CR);2005;331630;3848;2758;15278;14118;1160;16939;15444;1495;77.0;-494;-0.15;-494;-0.15;331136
6072;Noord-Friesland (CR);2006 januari;331136;320;269;1215;1142;73;1464;1247;217;;-198;-0.06;-198;-0.06;330938
6073;Noord-Friesland (CR);2006 februari;330938;277;236;1104;1008;96;1399;1165;234;;-254;-0.08;-452;-0.14;330684
6074;Noord-Friesland (CR);2006 maart;330684;291;284;1237;1139;98;1419;1172;247;;-175;-0.05;-627;-0.19;330509
6075;Noord-Friesland (CR);2006 april;330509;333;286;1076;991;85;1072;977;95;;51;0.02;-576;-0.17;330560
6076;Noord-Friesland (CR);2006 mei;330560;294;225;1149;1048;101;1192;1102;90;;26;0.01;-550;-0.17;330586
6077;Noord-Friesland (CR);2006 juni;330586;314;225;1071;989;82;1158;1051;107;;2;0.0;-548;-0.17;330588
6078;Noord-Friesland (CR);2006 juli;330588;353;228;1344;1249;95;1554;1387;167;;-85;-0.03;-633;-0.19;330503
6079;Noord-Friesland (CR);2006 augustus;330503;319;215;1713;1550;163;1648;1521;127;;169;0.05;-464;-0.14;330672
6080;Noord-Friesland (CR);2006 september;330672;320;232;1741;1471;270;1632;1511;121;;197;0.06;-267;-0.08;330869
6081;Noord-Friesland (CR);2006 oktober;330869;303;245;1298;1184;114;1400;1304;96;;-44;-0.01;-311;-0.09;330825
6082;Noord-Friesland (CR);2006 november;330825;319;251;1270;1165;105;1276;1164;112;;62;0.02;-249;-0.08;330887
6083;Noord-Friesland (CR);2006 december;330887;306;260;1106;1042;64;1328;1099;229;73.0;-103;-0.03;-352;-0.11;330784
6084;Noord-Friesland (CR);2006;331136;3749;2956;15324;13978;1346;16542;14700;1842;73.0;-352;-0.11;-352;-0.11;330784
6085;Noord-Friesland (CR);2007 januari;330784;286;226;1243;1149;94;1371;1216;155;;-68;-0.02;-68;-0.02;330716
6086;Noord-Friesland (CR);2007 februari;330716;287;226;1196;1045;151;1289;1153;136;;-32;-0.01;-100;-0.03;330684
6087;Noord-Friesland (CR);2007 maart;330684;315;253;1144;1002;142;1218;1130;88;;-12;0.0;-112;-0.03;330672
6088;Noord-Friesland (CR);2007 april;330672;291;255;929;819;110;1029;965;64;;-64;-0.02;-176;-0.05;330608
6089;Noord-Friesland (CR);2007 mei;330608;285;223;1088;1001;87;1180;1123;57;;-30;-0.01;-206;-0.06;330578
6090;Noord-Friesland (CR);2007 juni;330578;299;218;1096;1015;81;1142;1057;85;;35;0.01;-171;-0.05;330613
6091;Noord-Friesland (CR);2007 juli;330613;306;200;1420;1301;119;1588;1458;130;;-62;-0.02;-233;-0.07;330551
6092;Noord-Friesland (CR);2007 augustus;330551;344;216;1695;1477;218;1739;1609;130;;84;0.03;-149;-0.05;330635
6093;Noord-Friesland (CR);2007 september;330635;351;187;1479;1312;167;1456;1362;94;;187;0.06;38;0.01;330822
6094;Noord-Friesland (CR);2007 oktober;330822;299;207;1519;1321;198;1477;1421;56;;134;0.04;172;0.05;330956
6095;Noord-Friesland (CR);2007 november;330956;303;217;1194;1066;128;1420;1198;222;;-140;-0.04;32;0.01;330816
6096;Noord-Friesland (CR);2007 december;330816;299;249;1042;974;68;1189;1107;82;45.0;-52;-0.02;-20;-0.01;330764
6097;Noord-Friesland (CR);2007;330784;3665;2677;15045;13482;1563;16098;14799;1299;45.0;-20;-0.01;-20;-0.01;330764
6098;Noord-Friesland (CR);2008 januari;330764;323;256;1432;1313;119;1586;1459;127;;-87;-0.03;-87;-0.03;330677
6099;Noord-Friesland (CR);2008 februari;330677;297;209;1275;1093;182;1422;1280;142;;-59;-0.02;-146;-0.04;330618
6100;Noord-Friesland (CR);2008 maart;330618;288;232;1182;1033;149;1204;1107;97;;34;0.01;-112;-0.03;330652
6101;Noord-Friesland (CR);2008 april;330652;302;205;1161;1008;153;1246;1113;133;;12;0.0;-100;-0.03;330664
6102;Noord-Friesland (CR);2008 mei;330664;328;246;1053;972;81;1199;1081;118;;-64;-0.02;-164;-0.05;330600
6103;Noord-Friesland (CR);2008 juni;330600;294;226;1126;1014;112;1251;1100;151;;-57;-0.02;-221;-0.07;330543
6104;Noord-Friesland (CR);2008 juli;330543;322;227;1598;1414;184;1617;1491;126;;76;0.02;-145;-0.04;330619
6105;Noord-Friesland (CR);2008 augustus;330619;346;212;1747;1455;292;1610;1478;132;;271;0.08;126;0.04;330890
6106;Noord-Friesland (CR);2008 september;330890;299;177;1793;1484;309;1434;1369;65;;481;0.15;607;0.18;331371
6107;Noord-Friesland (CR);2008 oktober;331371;326;204;1468;1192;276;1615;1320;295;;-25;-0.01;582;0.18;331346
6108;Noord-Friesland (CR);2008 november;331346;317;225;1199;969;230;1167;1060;107;;124;0.04;706;0.21;331470
6109;Noord-Friesland (CR);2008 december;331470;273;284;1211;1003;208;1261;1120;141;46.0;-15;0.0;691;0.21;331455
6110;Noord-Friesland (CR);2008;330764;3715;2703;16245;13950;2295;16612;14978;1634;46.0;691;0.21;691;0.21;331455
6111;Noord-Friesland (CR);2009 januari;331455;300;309;1206;1019;187;1344;1202;142;;-147;-0.04;-147;-0.04;331308
6112;Noord-Friesland (CR);2009 februari;331308;277;229;1132;932;200;1157;1036;121;;23;0.01;-124;-0.04;331331
6113;Noord-Friesland (CR);2009 maart;331331;334;258;1097;936;161;1125;1034;91;;48;0.01;-76;-0.02;331379
6114;Noord-Friesland (CR);2009 april;331379;279;225;1110;912;198;1195;1069;126;;-31;-0.01;-107;-0.03;331348
6115;Noord-Friesland (CR);2009 mei;331348;302;214;940;819;121;930;900;30;;98;0.03;-9;0.0;331446
6116;Noord-Friesland (CR);2009 juni;331446;300;199;1074;931;143;1116;1016;100;;59;0.02;50;0.02;331505
6117;Noord-Friesland (CR);2009 juli;331505;384;257;1447;1303;144;1662;1543;119;;-88;-0.03;-38;-0.01;331417
6118;Noord-Friesland (CR);2009 augustus;331417;306;213;1773;1500;273;1515;1399;116;;351;0.11;313;0.09;331768
6119;Noord-Friesland (CR);2009 september;331768;306;220;1592;1373;219;1518;1409;109;;160;0.05;473;0.14;331928
6120;Noord-Friesland (CR);2009 oktober;331928;356;252;1225;977;248;1206;1148;58;;123;0.04;596;0.18;332051
6121;Noord-Friesland (CR);2009 november;332051;292;228;1074;947;127;1178;1103;75;;-40;-0.01;556;0.17;332011
6122;Noord-Friesland (CR);2009 december;332011;326;247;1058;950;108;1139;1040;99;39.0;37;0.01;593;0.18;332048
6123;Noord-Friesland (CR);2009;331455;3762;2851;14728;12599;2129;15085;13899;1186;39.0;593;0.18;593;0.18;332048
6124;Noord-Friesland (CR);2010 januari;332048;286;245;1251;1089;162;1325;1131;194;;-33;-0.01;-33;-0.01;332015
6125;Noord-Friesland (CR);2010 februari;332015;275;226;1080;951;129;1188;1104;84;;-59;-0.02;-92;-0.03;331956
6126;Noord-Friesland (CR);2010 maart;331956;306;268;1199;996;203;1254;1126;128;;-17;-0.01;-109;-0.03;331939
6127;Noord-Friesland (CR);2010 april;331939;284;238;982;851;131;997;929;68;;31;0.01;-78;-0.02;331970
6128;Noord-Friesland (CR);2010 mei;331970;281;248;988;861;127;981;919;62;;40;0.01;-38;-0.01;332010
6129;Noord-Friesland (CR);2010 juni;332010;306;232;1103;945;158;1178;1057;121;;-1;0.0;-39;-0.01;332009
6130;Noord-Friesland (CR);2010 juli;332009;344;233;1438;1229;209;1413;1293;120;;136;0.04;97;0.03;332145
6131;Noord-Friesland (CR);2010 augustus;332145;352;202;1897;1524;373;1615;1480;135;;432;0.13;529;0.16;332577
6132;Noord-Friesland (CR);2010 september;332577;311;226;1723;1297;426;1501;1390;111;;307;0.09;836;0.25;332884
6133;Noord-Friesland (CR);2010 oktober;332884;341;267;1132;990;142;1211;1067;144;;-5;0.0;831;0.25;332879
6134;Noord-Friesland (CR);2010 november;332879;296;232;1227;1077;150;1241;1104;137;;50;0.02;881;0.27;332929
6135;Noord-Friesland (CR);2010 december;332929;296;255;1119;978;141;1198;1095;103;-7.0;-45;-0.01;836;0.25;332884
6136;Noord-Friesland (CR);2010;332048;3678;2872;15139;12788;2351;15102;13695;1407;-7.0;836;0.25;836;0.25;332884
6137;Noord-Friesland (CR);2011 januari;332884;291;273;1182;1038;144;1225;1134;91;;-25;-0.01;-25;-0.01;332859
6138;Noord-Friesland (CR);2011 februari;332859;280;216;1170;995;175;1321;1210;111;;-87;-0.03;-112;-0.03;332772
6139;Noord-Friesland (CR);2011 maart;332772;303;251;1189;1038;151;1231;1123;108;;10;0.0;-102;-0.03;332782
6140;Noord-Friesland (CR);2011 april;332782;284;222;949;841;108;988;898;90;;23;0.01;-79;-0.02;332805
6141;Noord-Friesland (CR);2011 mei;332805;281;239;972;875;97;1014;950;64;;0;0.0;-79;-0.02;332805
6142;Noord-Friesland (CR);2011 juni;332805;280;236;1087;967;120;1216;1074;142;;-85;-0.03;-164;-0.05;332720
6143;Noord-Friesland (CR);2011 juli;332720;291;211;1406;1207;199;1719;1407;312;;-233;-0.07;-397;-0.12;332487
6144;Noord-Friesland (CR);2011 augustus;332487;310;198;2068;1684;384;1789;1635;154;;391;0.12;-6;0.0;332878
6145;Noord-Friesland (CR);2011 september;332878;292;240;1783;1404;379;1606;1489;117;;229;0.07;223;0.07;333107
6146;Noord-Friesland (CR);2011 oktober;333107;263;218;1178;1002;176;1213;1078;135;;10;0.0;233;0.07;333117
6147;Noord-Friesland (CR);2011 november;333117;262;226;1186;1045;141;1359;1149;210;;-137;-0.04;96;0.03;332980
6148;Noord-Friesland (CR);2011 december;332980;280;267;946;849;97;1205;1024;181;8.0;-238;-0.07;-142;-0.04;332742
6149;Noord-Friesland (CR);2011;332884;3417;2797;15116;12945;2171;15886;14171;1715;8.0;-142;-0.04;-142;-0.04;332742
6150;Noord-Friesland (CR);2012 januari;332742;289;232;1230;1045;185;1389;1186;203;;-102;-0.03;-102;-0.03;332640
6151;Noord-Friesland (CR);2012 februari;332640;258;267;1205;1042;163;1223;1119;104;;-27;-0.01;-129;-0.04;332613
6152;Noord-Friesland (CR);2012 maart;332613;292;280;1082;943;139;1194;1069;125;;-100;-0.03;-229;-0.07;332513
6153;Noord-Friesland (CR);2012 april;332513;248;257;966;855;111;1034;950;84;;-77;-0.02;-306;-0.09;332436
6154;Noord-Friesland (CR);2012 mei;332436;304;226;1023;924;99;1081;969;112;;20;0.01;-286;-0.09;332456
6155;Noord-Friesland (CR);2012 juni;332456;288;250;1097;957;140;1150;1024;126;;-15;0.0;-301;-0.09;332441
6156;Noord-Friesland (CR);2012 juli;332441;304;232;1363;1222;141;1497;1339;158;;-62;-0.02;-363;-0.11;332379
6157;Noord-Friesland (CR);2012 augustus;332379;309;213;2144;1711;433;1628;1509;119;;612;0.18;249;0.07;332991
6158;Noord-Friesland (CR);2012 september;332991;309;234;1548;1273;275;1523;1316;207;;100;0.03;349;0.1;333091
6159;Noord-Friesland (CR);2012 oktober;333091;318;288;1286;1138;148;1322;1154;168;;-6;0.0;343;0.1;333085
6160;Noord-Friesland (CR);2012 november;333085;281;245;1131;991;140;1172;1050;122;;-5;0.0;338;0.1;333080
6161;Noord-Friesland (CR);2012 december;333080;284;255;922;857;65;1094;921;173;1.0;-142;-0.04;196;0.06;332938
6162;Noord-Friesland (CR);2012;332742;3484;2979;14997;12958;2039;15307;13606;1701;1.0;196;0.06;196;0.06;332938
6163;Noord-Friesland (CR);2013 januari;332938;292;297;1342;1168;174;1477;1287;190;;-140;-0.04;-140;-0.04;332798
6164;Noord-Friesland (CR);2013 februari;332798;231;296;1216;1076;140;1367;1175;192;;-216;-0.06;-356;-0.11;332582
6165;Noord-Friesland (CR);2013 maart;332582;288;290;1074;930;144;1138;1025;113;;-66;-0.02;-422;-0.13;332516
6166;Noord-Friesland (CR);2013 april;332516;229;250;1178;1048;130;1203;1062;141;;-46;-0.01;-468;-0.14;332470
6167;Noord-Friesland (CR);2013 mei;332470;272;250;1122;994;128;1059;1023;36;;85;0.03;-383;-0.12;332555
6168;Noord-Friesland (CR);2013 juni;332555;266;236;1021;858;163;1083;929;154;;-32;-0.01;-415;-0.12;332523
6169;Noord-Friesland (CR);2013 juli;332523;296;202;1476;1272;204;1529;1335;194;;41;0.01;-374;-0.11;332564
6170;Noord-Friesland (CR);2013 augustus;332564;281;213;2181;1740;441;1893;1603;290;;356;0.11;-18;-0.01;332920
6171;Noord-Friesland (CR);2013 september;332920;299;223;1687;1442;245;1628;1476;152;;135;0.04;117;0.04;333055
6172;Noord-Friesland (CR);2013 oktober;333055;275;258;1213;1081;132;1315;1210;105;;-85;-0.03;32;0.01;332970
6173;Noord-Friesland (CR);2013 november;332970;284;193;1051;965;86;1169;1086;83;;-27;-0.01;5;0.0;332943
6174;Noord-Friesland (CR);2013 december;332943;276;269;1068;951;117;1213;1082;131;17.0;-121;-0.04;-116;-0.03;332822
6175;Noord-Friesland (CR);2013;332938;3289;2977;15629;13525;2104;16074;14293;1781;17.0;-116;-0.03;-116;-0.03;332822
6176;Noord-Friesland (CR);2014 januari;324368;281;225;1315;1088;227;1405;1228;177;;-34;-0.01;-34;-0.01;324334
6177;Noord-Friesland (CR);2014 februari;324334;261;230;1215;1036;179;1304;1142;162;;-58;-0.02;-92;-0.03;324276
6178;Noord-Friesland (CR);2014 maart;324276;265;281;1125;976;149;1156;1069;87;;-47;-0.01;-139;-0.04;324229
6179;Noord-Friesland (CR);2014 april;324229;290;206;1014;900;114;1089;1042;47;;9;0.0;-130;-0.04;324238
6180;Noord-Friesland (CR);2014 mei;324238;263;227;986;878;108;1028;967;61;;-6;0.0;-136;-0.04;324232
6181;Noord-Friesland (CR);2014 juni;324232;275;226;1104;964;140;1293;1104;189;;-140;-0.04;-276;-0.09;324092
6182;Noord-Friesland (CR);2014 juli;324092;298;244;1439;1258;181;1679;1508;171;;-186;-0.06;-462;-0.14;323906
6183;Noord-Friesland (CR);2014 augustus;323906;278;271;2211;1732;479;1751;1622;129;;467;0.14;5;0.0;324373
6184;Noord-Friesland (CR);2014 september;324373;275;195;1748;1475;273;1654;1469;185;;174;0.05;179;0.06;324547
6185;Noord-Friesland (CR);2014 oktober;324547;253;246;1366;1172;194;1524;1228;296;;-151;-0.05;28;0.01;324396
6186;Noord-Friesland (CR);2014 november;324396;263;229;1113;949;164;1111;977;134;;36;0.01;64;0.02;324432
6187;Noord-Friesland (CR);2014 december;324432;242;283;1149;1047;102;1420;1140;280;-17.0;-329;-0.1;-265;-0.08;324103
6188;Noord-Friesland (CR);2014;324368;3244;2863;15785;13475;2310;16414;14496;1918;-17.0;-265;-0.08;-265;-0.08;324103
6189;Noord-Friesland (CR);2015 januari;324103;259;290;1426;1178;248;1475;1282;193;;-80;-0.02;-80;-0.02;324023
6190;Noord-Friesland (CR);2015 februari;324023;237;235;1312;1144;168;1258;1191;67;;56;0.02;-24;-0.01;324079
6191;Noord-Friesland (CR);2015 maart;324079;239;290;1163;1010;153;1248;1138;110;;-136;-0.04;-160;-0.05;323943
6192;Noord-Friesland (CR);2015 april;323943;247;256;1023;902;121;1127;1040;87;;-113;-0.03;-273;-0.08;323830
6193;Noord-Friesland (CR);2015 mei;323830;285;221;1054;942;112;1062;996;66;;56;0.02;-217;-0.07;323886
6194;Noord-Friesland (CR);2015 juni;323886;258;244;1065;929;136;1255;1066;189;;-176;-0.05;-393;-0.12;323710
6195;Noord-Friesland (CR);2015 juli;323710;268;251;1437;1258;179;1602;1407;195;;-148;-0.05;-541;-0.17;323562
6196;Noord-Friesland (CR);2015 augustus;323562;231;207;2232;1704;528;1825;1675;150;;431;0.13;-110;-0.03;323993
6197;Noord-Friesland (CR);2015 september;323993;283;229;1698;1445;253;1643;1475;168;;109;0.03;-1;0.0;324102
6198;Noord-Friesland (CR);2015 oktober;324102;245;224;1268;1120;148;1336;1221;115;;-47;-0.01;-48;-0.01;324055
6199;Noord-Friesland (CR);2015 november;324055;280;243;1122;998;124;1115;1023;92;;44;0.01;-4;0.0;324099
6200;Noord-Friesland (CR);2015 december;324099;254;244;1303;1174;129;1330;1224;106;-5.0;-22;-0.01;-26;-0.01;324077
6201;Noord-Friesland (CR);2015;324103;3086;2934;16103;13804;2299;16276;14738;1538;-5.0;-26;-0.01;-26;-0.01;324077
6202;Noord-Friesland (CR);2016 januari;324077;245;287;1392;1184;208;1501;1327;174;;-151;-0.05;-151;-0.05;323926
6203;Noord-Friesland (CR);2016 februari;323926;225;247;1419;1225;194;1431;1292;139;;-34;-0.01;-185;-0.06;323892
6204;Noord-Friesland (CR);2016 maart;323892;267;277;1162;1050;112;1208;1069;139;;-56;-0.02;-241;-0.07;323836
6205;Noord-Friesland (CR);2016 april;323836;222;264;1199;1103;96;1245;1157;88;;-88;-0.03;-329;-0.1;323748
6206;Noord-Friesland (CR);2016 mei;323748;270;248;1122;995;127;1216;1131;85;;-72;-0.02;-401;-0.12;323676
6207;Noord-Friesland (CR);2016 juni;323676;252;217;1237;1106;131;1349;1163;186;;-77;-0.02;-478;-0.15;323599
6208;Noord-Friesland (CR);2016 juli;323599;306;250;1631;1424;207;1655;1494;161;;32;0.01;-446;-0.14;323631
6209;Noord-Friesland (CR);2016 augustus;323631;308;236;2342;1869;473;1885;1720;165;;529;0.16;83;0.03;324160
6210;Noord-Friesland (CR);2016 september;324160;278;233;1969;1626;343;1718;1590;128;;296;0.09;379;0.12;324456
6211;Noord-Friesland (CR);2016 oktober;324456;273;235;1325;1179;146;1323;1230;93;;40;0.01;419;0.13;324496
6212;Noord-Friesland (CR);2016 november;324496;224;278;1340;1231;109;1348;1219;129;;-62;-0.02;357;0.11;324434
6213;Noord-Friesland (CR);2016 december;324434;248;280;1399;1283;116;1428;1289;139;-6.0;-67;-0.02;290;0.09;324367
6214;Noord-Friesland (CR);2016;324077;3118;3052;17537;15275;2262;17307;15681;1626;-6.0;290;0.09;290;0.09;324367
6215;Noord-Friesland (CR);2017 januari;324367;254;302;1417;1274;143;1516;1296;220;;-147;-0.05;-147;-0.05;324220
6216;Noord-Friesland (CR);2017 februari;324220;225;296;1541;1325;216;1445;1323;122;;25;0.01;-122;-0.04;324245
6217;Noord-Friesland (CR);2017 maart;324245;276;283;1331;1210;121;1412;1280;132;;-88;-0.03;-210;-0.06;324157
6218;Noord-Friesland (CR);2017 april;324157;238;249;1136;1040;96;1099;999;100;;26;0.01;-184;-0.06;324183
6219;Noord-Friesland (CR);2017 mei;324183;267;257;1417;1291;126;1337;1211;126;;90;0.03;-94;-0.03;324273
6220;Noord-Friesland (CR);2017 juni;324273;262;239;1311;1160;151;1362;1137;225;;-28;-0.01;-122;-0.04;324245
6221;Noord-Friesland (CR);2017 juli;324245;288;244;1670;1493;177;1833;1586;247;;-119;-0.04;-241;-0.07;324126
6222;Noord-Friesland (CR);2017 augustus;324126;264;233;2229;1669;560;1874;1682;192;;386;0.12;145;0.04;324512
6223;Noord-Friesland (CR);2017 september;324512;256;225;1946;1633;313;1790;1663;127;;187;0.06;332;0.1;324699
6224;Noord-Friesland (CR);2017 oktober;324699;242;256;1371;1261;110;1568;1374;194;;-211;-0.06;121;0.04;324488
6225;Noord-Friesland (CR);2017 november;324488;302;257;1317;1200;117;1384;1226;158;;-22;-0.01;99;0.03;324466
6226;Noord-Friesland (CR);2017 december;324466;227;292;1285;1181;104;1348;1229;119;-8.0;-136;-0.04;-37;-0.01;324330
6227;Noord-Friesland (CR);2017;324367;3101;3133;17971;15737;2234;17968;16006;1962;-8.0;-37;-0.01;-37;-0.01;324330
6228;Noord-Friesland (CR);2018 januari;318919;265;305;1373;1129;244;1541;1300;241;;-208;-0.07;-208;-0.07;318711
6229;Noord-Friesland (CR);2018 februari;318711;210;288;1332;1165;167;1373;1220;153;;-119;-0.04;-327;-0.1;318592
6230;Noord-Friesland (CR);2018 maart;318592;205;361;1274;1117;157;1264;1174;90;;-146;-0.05;-473;-0.15;318446
6231;Noord-Friesland (CR);2018 april;318446;258;264;1084;953;131;1064;977;87;;14;0.0;-459;-0.14;318460
6232;Noord-Friesland (CR);2018 mei;318460;272;246;1081;945;136;1052;955;97;;55;0.02;-404;-0.13;318515
6233;Noord-Friesland (CR);2018 juni;318515;210;222;1195;1044;151;1317;1109;208;;-134;-0.04;-538;-0.17;318381
6234;Noord-Friesland (CR);2018 juli;318381;271;232;1647;1421;226;1762;1479;283;;-76;-0.02;-614;-0.19;318305
6235;Noord-Friesland (CR);2018 augustus;318305;280;243;2469;1783;686;1694;1544;150;;812;0.26;198;0.06;319117
6236;Noord-Friesland (CR);2018 september;319117;251;243;1644;1344;300;1502;1347;155;;150;0.05;348;0.11;319267
6237;Noord-Friesland (CR);2018 oktober;319267;246;263;1374;1178;196;1355;1217;138;;2;0.0;350;0.11;319269
6238;Noord-Friesland (CR);2018 november;319269;229;208;1169;1023;146;1171;1069;102;;19;0.01;369;0.12;319288
6239;Noord-Friesland (CR);2018 december;319288;249;223;1117;1010;107;1156;1051;105;2.0;-11;0.0;358;0.11;319277
6240;Noord-Friesland (CR);2018;318919;2946;3098;16759;14112;2647;16251;14442;1809;2.0;358;0.11;358;0.11;319277
6241;Noord-Friesland (CR);2019 januari;319277;235;291;1415;1156;259;1469;1303;166;;-110;-0.03;-110;-0.03;319167
6242;Noord-Friesland (CR);2019 februari;319167;219;221;1311;1078;233;1277;1123;154;;32;0.01;-78;-0.02;319199
6243;Noord-Friesland (CR);2019 maart;319199;231;295;1191;1049;142;1181;1097;84;;-54;-0.02;-132;-0.04;319145
6244;Noord-Friesland (CR);2019 april;319145;239;247;1180;987;193;1098;1016;82;;74;0.02;-58;-0.02;319219
6245;Noord-Friesland (CR);2019 mei;319219;255;252;1129;1016;113;1129;1041;88;;3;0.0;-55;-0.02;319222
6246;Noord-Friesland (CR);2019 juni;319222;253;234;1196;1022;174;1174;990;184;;41;0.01;-14;0.0;319263
6247;Noord-Friesland (CR);2019 juli;319263;255;223;1777;1543;234;1771;1471;300;;38;0.01;24;0.01;319301
6248;Noord-Friesland (CR);2019 augustus;319301;299;245;2311;1669;642;1621;1468;153;;744;0.23;768;0.24;320045
6249;Noord-Friesland (CR);2019 september;320045;276;234;1909;1448;461;1358;1208;150;;593;0.19;1361;0.43;320638
6250;Noord-Friesland (CR);2019 oktober;320638;264;270;1381;1178;203;1268;1165;103;;107;0.03;1468;0.46;320745
6251;Noord-Friesland (CR);2019 november;320745;239;269;1258;1103;155;1248;1117;131;;-20;-0.01;1448;0.45;320725
6252;Noord-Friesland (CR);2019 december;320725;219;264;1088;957;131;1118;983;135;-3.0;-78;-0.02;1370;0.43;320647
6253;Noord-Friesland (CR);2019;319277;2984;3045;17146;14206;2940;15712;13982;1730;-3.0;1370;0.43;1370;0.43;320647
6254;Noord-Friesland (CR);2020 januari;320647;238;288;1481;1243;238;1548;1274;274;;-117;-0.04;-117;-0.04;320530
6255;Noord-Friesland (CR);2020 februari;320530;209;230;1367;1140;227;1237;1108;129;;109;0.03;-8;0.0;320639
6256;Noord-Friesland (CR);2020 maart;320639;216;288;1200;1033;167;1106;978;128;;22;0.01;14;0.0;320661
6257;Noord-Friesland (CR);2020 april;320661;254;267;1053;972;81;1024;974;50;;16;0.0;30;0.01;320677
6258;Noord-Friesland (CR);2020 mei;320677;236;256;1081;1024;57;1133;1034;99;;-72;-0.02;-42;-0.01;320605
6259;Noord-Friesland (CR);2020 juni;320605;254;236;1201;1091;110;1336;1127;209;;-117;-0.04;-159;-0.05;320488
6260;Noord-Friesland (CR);2020 juli;320488;241;214;1598;1406;192;1618;1342;276;;7;0.0;-152;-0.05;320495
6261;Noord-Friesland (CR);2020 augustus;320495;261;227;2008;1643;365;1491;1355;136;;551;0.17;399;0.12;321046
6262;Noord-Friesland (CR);2020 september;321046;273;243;1668;1213;455;1329;1196;133;;369;0.11;768;0.24;321415
6263;Noord-Friesland (CR);2020 oktober;321415;253;264;1431;1261;170;1404;1258;146;;16;0.0;784;0.24;321431
6264;Noord-Friesland (CR);2020 november;321431;251;277;1266;1136;130;1156;1042;114;;84;0.03;868;0.27;321515
6265;Noord-Friesland (CR);2020 december;321515;214;292;1342;1217;125;1206;1105;101;-11.0;47;0.01;915;0.29;321562
6266;Noord-Friesland (CR);2020;320647;2900;3082;16696;14379;2317;15588;13793;1795;-11.0;915;0.29;915;0.29;321562
6267;Noord-Friesland (CR);2021 januari;321562;282;367;1385;1278;107;1382;1214;168;0.0;-82;-0.03;-82;-0.03;321480
6268;Noord-Friesland (CR);2021 februari;321480;229;300;1291;1149;142;1223;1073;150;0.0;-3;0.0;-85;-0.03;321477
6269;Noord-Friesland (CR);2021 maart;321477;263;320;1325;1212;113;1238;1156;82;0.0;30;0.01;-55;-0.02;321507
6270;Noord-Friesland (CR);2021 april;321507;273;273;1340;1219;121;1143;1039;104;0.0;197;0.06;142;0.04;321704
6271;Noord-Friesland (CR);2021 mei;321704;249;243;1232;1091;141;1056;966;90;0.0;182;0.06;324;0.1;321886
6272;Noord-Friesland (CR);2021 juni;321886;264;251;1350;1207;143;1152;996;156;0.0;211;0.07;535;0.17;322097
6273;Noord-Friesland (CR);2021 juli;322097;301;244;1575;1371;204;1433;1249;184;0.0;199;0.06;734;0.23;322296
6274;Noord-Friesland (CR);2021 augustus;322296;252;260;2159;1649;510;1527;1341;186;0.0;624;0.19;1358;0.42;322920
6275;Noord-Friesland (CR);2021 september;322920;278;261;1572;1191;381;1227;1139;88;0.0;362;0.11;1720;0.53;323282
6276;Noord-Friesland (CR);2021 oktober;323282;289;298;1415;1227;188;1219;1061;158;0.0;187;0.06;1907;0.59;323469
6277;Noord-Friesland (CR);2021 november;323469;272;315;1275;1121;154;1248;1115;133;0.0;-16;0.0;1891;0.59;323453
6278;Noord-Friesland (CR);2021 december;323453;268;408;1168;1063;105;1111;951;160;-11.0;-94;-0.03;1797;0.56;323359
6279;Noord-Friesland (CR);2021;321562;3220;3540;17087;14778;2309;14959;13300;1659;-11.0;1797;0.56;1797;0.56;323359
6280;Noord-Friesland (CR);2022 januari;323359;233;308;1313;1121;192;1234;1035;199;;4;0.0;4;0.0;323363
6281;Noord-Friesland (CR);2022 februari;323363;205;251;1359;1067;292;1083;952;131;;230;0.07;234;0.07;323593
6282;Noord-Friesland (CR);2022 maart;323593;227;320;1665;1123;542;1171;1059;112;;401;0.12;635;0.2;323994
6283;Noord-Friesland (CR);2022 april;323994;243;307;1886;1133;753;1125;1011;114;;697;0.22;1332;0.41;324691
6284;Noord-Friesland (CR);2022 mei;324691;245;254;1406;1034;372;1035;893;142;;362;0.11;1694;0.52;325053
6285;Noord-Friesland (CR);2022 juni;325053;230;258;1386;1029;357;1302;1052;250;;56;0.02;1750;0.54;325109
6286;Noord-Friesland (CR);2022 juli;325109;264;267;1532;1225;307;1490;1191;299;;39;0.01;1789;0.55;325148
6287;Noord-Friesland (CR);2022 augustus;325148;243;250;2195;1490;705;1487;1292;195;;701;0.22;2490;0.77;325849
6288;Noord-Friesland (CR);2022 september;325849;299;259;1891;1326;565;1388;1164;224;;543;0.17;3033;0.94;326392
6289;Noord-Friesland (CR);2022 oktober;326392;263;268;1471;1127;344;1248;1091;157;;218;0.07;3251;1.01;326610
6290;Noord-Friesland (CR);2022 november;326610;241;293;1438;1115;323;1327;1022;305;;59;0.02;3310;1.02;326669
6291;Noord-Friesland (CR);2022 december;326669;246;343;1341;1108;233;1320;1095;225;-10.0;-86;-0.03;3224;1.0;326583
6292;Noord-Friesland (CR);2022;323359;2939;3378;18883;13898;4985;15210;12857;2353;-10.0;3224;1.0;3224;1.0;326583
6293;Noord-Friesland (CR);2023 januari;326583;240;315;1554;1206;348;1543;1241;302;0.0;-64;-0.02;-64;-0.02;326519
6294;Noord-Friesland (CR);2023 februari;326519;204;269;1644;1240;404;1316;1118;198;0.0;263;0.08;199;0.06;326782
6295;Noord-Friesland (CR);2023 maart;326782;226;285;1540;1201;339;1285;1063;222;0.0;196;0.06;395;0.12;326978
6296;Noord-Friesland (CR);2023 april;326978;237;280;1265;1051;214;1106;986;120;0.0;116;0.04;511;0.16;327094
6297;Noord-Friesland (CR);2023 mei;327094;275;254;1241;1052;189;1152;1000;152;0.0;110;0.03;621;0.19;327204
6298;Noord-Friesland (CR);2023 juni;327204;250;244;1418;1175;243;1328;1046;282;0.0;96;0.03;717;0.22;327300
6299;Noord-Friesland (CR);2023 juli;327300;292;295;1881;1575;306;1769;1328;441;0.0;109;0.03;826;0.25;327409
6300;Noord-Friesland (CR);2023 augustus;327409;271;237;2354;1722;632;1760;1409;351;0.0;628;0.19;1454;0.45;328037
6301;Noord-Friesland (CR);2023 september;328037;237;258;2192;1441;751;1562;1345;217;0.0;609;0.19;2063;0.63;328646
6302;Noord-Friesland (CR);2023 oktober;328646;226;295;1489;1188;301;1358;1214;144;0.0;62;0.02;2125;0.65;328708
6303;Noord-Friesland (CR);2023 november;328708;247;272;1435;1142;293;1326;1105;221;0.0;84;0.03;2209;0.68;328792
6304;Noord-Friesland (CR);2023 december;328792;242;316;1276;1132;144;1243;1018;225;-15.0;-56;-0.02;2153;0.66;328736
6305;Noord-Friesland (CR);2023;326583;2947;3320;19289;15125;4164;16748;13873;2875;-15.0;2153;0.66;2153;0.66;328736
6306;Noord-Friesland (CR);2024 januari;328736;217;289;1440;1136;304;1354;1071;283;;14;0.0;14;0.0;328750
6307;Noord-Friesland (CR);2024 februari;328750;223;288;1643;1255;388;1319;1101;218;;259;0.08;273;0.08;329009
6308;Noord-Friesland (CR);2024 maart;329009;208;301;1338;1124;214;1202;1024;178;;43;0.01;316;0.1;329052
6309;Noord-Friesland (CR);2024 april;329052;224;316;1234;1032;202;1165;1024;141;;-23;-0.01;293;0.09;329029
6310;Noord-Friesland (CR);2024 mei;329029;259;266;1217;1007;210;1194;1082;112;;16;0.0;309;0.09;329045
6311;Noord-Friesland (CR);2024 juni;329045;221;279;1239;1003;236;1244;972;272;;-63;-0.02;246;0.07;328982
6312;Noord-Friesland (CR);2024 juli;328982;270;279;1617;1320;297;1678;1259;419;;-70;-0.02;176;0.05;328912
6313;Noord-Friesland (CR);2024 augustus;328912;251;284;1988;1405;583;1629;1357;272;;326;0.1;502;0.15;329238
6314;Noord-Friesland (CR);2024 september;329238;240;267;1977;1320;657;1450;1227;223;;500;0.15;1002;0.3;329738
6315;Noord-Friesland (CR);2024 oktober;329738;224;289;1522;1176;346;1311;1144;167;;146;0.04;1148;0.35;329884
6316;Noord-Friesland (CR);2024 november;329884;235;242;1343;1145;198;1229;1086;143;;107;0.03;1255;0.38;329991
6317;Noord-Friesland (CR);2024 december;329991;235;298;1267;1101;166;1207;1039;168;0.0;-3;0.0;1252;0.38;329988
6318;Noord-Friesland (CR);2024;328736;2807;3398;17825;14024;3801;15982;13386;2596;0.0;1252;0.38;1252;0.38;329988
6319;Noord-Friesland (CR);2025 januari;329988;237;350;1449;1235;214;1443;1188;255;;-107;-0.03;-107;-0.03;329881
6320;Noord-Friesland (CR);2025 februari;329881;225;295;1522;1186;336;1406;1115;291;;46;0.01;-61;-0.02;329927
6321;Zuidwest-Friesland (CR);2002 januari;104168;99;88;444;369;75;386;364;22;;69;0.07;69;0.07;104237
6322;Zuidwest-Friesland (CR);2002 februari;104237;116;76;371;298;73;337;319;18;;74;0.07;143;0.14;104311
6323;Zuidwest-Friesland (CR);2002 maart;104311;111;89;410;327;83;377;331;46;;55;0.05;198;0.19;104366
6324;Zuidwest-Friesland (CR);2002 april;104366;110;102;332;309;23;320;302;18;;20;0.02;218;0.21;104386
6325;Zuidwest-Friesland (CR);2002 mei;104386;101;66;394;353;41;377;357;20;;52;0.05;270;0.26;104438
6326;Zuidwest-Friesland (CR);2002 juni;104438;107;77;368;318;50;318;292;26;;80;0.08;350;0.34;104518
6327;Zuidwest-Friesland (CR);2002 juli;104518;127;83;450;422;28;429;411;18;;65;0.06;415;0.4;104583
6328;Zuidwest-Friesland (CR);2002 augustus;104583;129;84;470;422;48;479;463;16;;36;0.03;451;0.43;104619
6329;Zuidwest-Friesland (CR);2002 september;104619;131;81;360;312;48;429;410;19;;-19;-0.02;432;0.41;104600
6330;Zuidwest-Friesland (CR);2002 oktober;104600;108;76;413;381;32;426;401;25;;19;0.02;451;0.43;104619
6331;Zuidwest-Friesland (CR);2002 november;104619;81;85;375;348;27;403;377;26;;-32;-0.03;419;0.4;104587
6332;Zuidwest-Friesland (CR);2002 december;104587;127;82;545;443;102;342;308;34;19.0;267;0.26;686;0.66;104854
6333;Zuidwest-Friesland (CR);2002;104168;1347;989;4932;4302;630;4623;4335;288;19.0;686;0.66;686;0.66;104854
6334;Zuidwest-Friesland (CR);2003 januari;104854;145;110;431;404;27;427;387;40;;39;0.04;39;0.04;104893
6335;Zuidwest-Friesland (CR);2003 februari;104893;96;62;359;328;31;331;296;35;;62;0.06;101;0.1;104955
6336;Zuidwest-Friesland (CR);2003 maart;104955;114;78;374;341;33;409;343;66;;1;0.0;102;0.1;104956
6337;Zuidwest-Friesland (CR);2003 april;104956;113;85;329;295;34;351;307;44;;6;0.01;108;0.1;104962
6338;Zuidwest-Friesland (CR);2003 mei;104962;118;70;326;288;38;339;300;39;;35;0.03;143;0.14;104997
6339;Zuidwest-Friesland (CR);2003 juni;104997;126;81;379;357;22;378;348;30;;46;0.04;189;0.18;105043
6340;Zuidwest-Friesland (CR);2003 juli;105043;114;77;447;405;42;414;387;27;;70;0.07;259;0.25;105113
6341;Zuidwest-Friesland (CR);2003 augustus;105113;115;86;346;321;25;553;496;57;;-178;-0.17;81;0.08;104935
6342;Zuidwest-Friesland (CR);2003 september;104935;115;80;429;411;18;491;460;31;;-27;-0.03;54;0.05;104908
6343;Zuidwest-Friesland (CR);2003 oktober;104908;108;74;392;363;29;347;320;27;;79;0.08;133;0.13;104987
6344;Zuidwest-Friesland (CR);2003 november;104987;102;71;278;260;18;344;316;28;;-35;-0.03;98;0.09;104952
6345;Zuidwest-Friesland (CR);2003 december;104952;98;83;354;332;22;370;362;8;17.0;16;0.02;114;0.11;104968
6346;Zuidwest-Friesland (CR);2003;104854;1364;957;4444;4105;339;4754;4322;432;17.0;114;0.11;114;0.11;104968
6347;Zuidwest-Friesland (CR);2004 januari;104968;123;95;364;348;16;356;336;20;;36;0.03;36;0.03;105004
6348;Zuidwest-Friesland (CR);2004 februari;105004;111;80;286;267;19;321;298;23;;-4;0.0;32;0.03;105000
6349;Zuidwest-Friesland (CR);2004 maart;105000;116;69;312;280;32;355;311;44;;4;0.0;36;0.03;105004
6350;Zuidwest-Friesland (CR);2004 april;105004;111;76;332;320;12;367;323;44;;0;0.0;36;0.03;105004
6351;Zuidwest-Friesland (CR);2004 mei;105004;91;72;317;301;16;283;272;11;;53;0.05;89;0.08;105057
6352;Zuidwest-Friesland (CR);2004 juni;105057;116;70;356;323;33;348;332;16;;54;0.05;143;0.14;105111
6353;Zuidwest-Friesland (CR);2004 juli;105111;107;71;412;385;27;414;402;12;;34;0.03;177;0.17;105145
6354;Zuidwest-Friesland (CR);2004 augustus;105145;108;62;361;342;19;475;423;52;;-68;-0.06;109;0.1;105077
6355;Zuidwest-Friesland (CR);2004 september;105077;111;76;405;380;25;454;432;22;;-14;-0.01;95;0.09;105063
6356;Zuidwest-Friesland (CR);2004 oktober;105063;87;84;297;280;17;339;304;35;;-39;-0.04;56;0.05;105024
6357;Zuidwest-Friesland (CR);2004 november;105024;94;81;356;342;14;372;351;21;;-3;0.0;53;0.05;105021
6358;Zuidwest-Friesland (CR);2004 december;105021;114;73;370;359;11;320;298;22;-1.0;90;0.09;143;0.14;105111
6359;Zuidwest-Friesland (CR);2004;104968;1289;909;4168;3927;241;4404;4082;322;-1.0;143;0.14;143;0.14;105111
6360;Zuidwest-Friesland (CR);2005 januari;105111;108;87;362;331;31;414;360;54;;-31;-0.03;-31;-0.03;105080
6361;Zuidwest-Friesland (CR);2005 februari;105080;83;77;332;310;22;313;286;27;;25;0.02;-6;-0.01;105105
6362;Zuidwest-Friesland (CR);2005 maart;105105;93;112;304;286;18;363;293;70;;-78;-0.07;-84;-0.08;105027
6363;Zuidwest-Friesland (CR);2005 april;105027;99;64;324;306;18;365;332;33;;-6;-0.01;-90;-0.09;105021
6364;Zuidwest-Friesland (CR);2005 mei;105021;120;64;336;313;23;290;266;24;;102;0.1;12;0.01;105123
6365;Zuidwest-Friesland (CR);2005 juni;105123;109;80;364;347;17;353;305;48;;40;0.04;52;0.05;105163
6366;Zuidwest-Friesland (CR);2005 juli;105163;112;81;487;459;28;428;394;34;;90;0.09;142;0.14;105253
6367;Zuidwest-Friesland (CR);2005 augustus;105253;108;64;469;448;21;518;494;24;;-5;0.0;137;0.13;105248
6368;Zuidwest-Friesland (CR);2005 september;105248;78;62;429;399;30;544;499;45;;-99;-0.09;38;0.04;105149
6369;Zuidwest-Friesland (CR);2005 oktober;105149;124;74;358;346;12;389;362;27;;19;0.02;57;0.05;105168
6370;Zuidwest-Friesland (CR);2005 november;105168;112;90;400;387;13;385;362;23;;37;0.04;94;0.09;105205
6371;Zuidwest-Friesland (CR);2005 december;105205;93;80;363;347;16;387;324;63;20.0;9;0.01;103;0.1;105214
6372;Zuidwest-Friesland (CR);2005;105111;1239;935;4528;4279;249;4749;4277;472;20.0;103;0.1;103;0.1;105214
6373;Zuidwest-Friesland (CR);2006 januari;105214;114;80;371;353;18;374;359;15;;31;0.03;31;0.03;105245
6374;Zuidwest-Friesland (CR);2006 februari;105245;102;84;345;320;25;321;291;30;;42;0.04;73;0.07;105287
6375;Zuidwest-Friesland (CR);2006 maart;105287;89;99;348;333;15;394;362;32;;-56;-0.05;17;0.02;105231
6376;Zuidwest-Friesland (CR);2006 april;105231;92;83;299;279;20;324;290;34;;-16;-0.02;1;0.0;105215
6377;Zuidwest-Friesland (CR);2006 mei;105215;93;78;380;355;25;345;318;27;;50;0.05;51;0.05;105265
6378;Zuidwest-Friesland (CR);2006 juni;105265;99;75;323;302;21;312;275;37;;35;0.03;86;0.08;105300
6379;Zuidwest-Friesland (CR);2006 juli;105300;111;75;444;418;26;443;393;50;;37;0.04;123;0.12;105337
6380;Zuidwest-Friesland (CR);2006 augustus;105337;101;84;534;508;26;516;492;24;;35;0.03;158;0.15;105372
6381;Zuidwest-Friesland (CR);2006 september;105372;104;65;412;393;19;482;460;22;;-31;-0.03;127;0.12;105341
6382;Zuidwest-Friesland (CR);2006 oktober;105341;107;78;364;340;24;396;368;28;;-3;0.0;124;0.12;105338
6383;Zuidwest-Friesland (CR);2006 november;105338;93;86;372;357;15;418;405;13;;-39;-0.04;85;0.08;105299
6384;Zuidwest-Friesland (CR);2006 december;105299;104;86;381;365;16;382;351;31;19.0;36;0.03;121;0.12;105335
6385;Zuidwest-Friesland (CR);2006;105214;1209;973;4573;4323;250;4707;4364;343;19.0;121;0.12;121;0.12;105335
6386;Zuidwest-Friesland (CR);2007 januari;105335;110;106;406;384;22;433;413;20;;-23;-0.02;-23;-0.02;105312
6387;Zuidwest-Friesland (CR);2007 februari;105312;103;84;341;330;11;316;286;30;;44;0.04;21;0.02;105356
6388;Zuidwest-Friesland (CR);2007 maart;105356;102;97;413;387;26;392;352;40;;26;0.02;47;0.04;105382
6389;Zuidwest-Friesland (CR);2007 april;105382;103;67;280;265;15;257;233;24;;59;0.06;106;0.1;105441
6390;Zuidwest-Friesland (CR);2007 mei;105441;102;89;384;363;21;331;306;25;;66;0.06;172;0.16;105507
6391;Zuidwest-Friesland (CR);2007 juni;105507;86;71;372;348;24;334;305;29;;53;0.05;225;0.21;105560
6392;Zuidwest-Friesland (CR);2007 juli;105560;126;66;413;387;26;433;398;35;;40;0.04;265;0.25;105600
6393;Zuidwest-Friesland (CR);2007 augustus;105600;105;68;457;426;31;508;474;34;;-14;-0.01;251;0.24;105586
6394;Zuidwest-Friesland (CR);2007 september;105586;95;69;355;326;29;456;431;25;;-75;-0.07;176;0.17;105511
6395;Zuidwest-Friesland (CR);2007 oktober;105511;88;57;396;369;27;370;357;13;;57;0.05;233;0.22;105568
6396;Zuidwest-Friesland (CR);2007 november;105568;106;67;372;336;36;396;364;32;;15;0.01;248;0.24;105583
6397;Zuidwest-Friesland (CR);2007 december;105583;76;74;343;321;22;376;365;11;12.0;-19;-0.02;229;0.22;105564
6398;Zuidwest-Friesland (CR);2007;105335;1202;915;4532;4242;290;4602;4284;318;12.0;229;0.22;229;0.22;105564
6399;Zuidwest-Friesland (CR);2008 januari;105564;94;99;491;462;29;431;414;17;;55;0.05;55;0.05;105619
6400;Zuidwest-Friesland (CR);2008 februari;105619;74;90;363;340;23;358;333;25;;-11;-0.01;44;0.04;105608
6401;Zuidwest-Friesland (CR);2008 maart;105608;83;83;354;331;23;326;300;26;;28;0.03;72;0.07;105636
6402;Zuidwest-Friesland (CR);2008 april;105636;100;79;331;306;25;307;280;27;;45;0.04;117;0.11;105681
6403;Zuidwest-Friesland (CR);2008 mei;105681;95;86;279;261;18;277;264;13;;11;0.01;128;0.12;105692
6404;Zuidwest-Friesland (CR);2008 juni;105692;100;74;376;361;15;354;310;44;;48;0.05;176;0.17;105740
6405;Zuidwest-Friesland (CR);2008 juli;105740;102;91;459;428;31;441;399;42;;29;0.03;205;0.19;105769
6406;Zuidwest-Friesland (CR);2008 augustus;105769;91;65;437;403;34;493;455;38;;-30;-0.03;175;0.17;105739
6407;Zuidwest-Friesland (CR);2008 september;105739;100;76;458;408;50;491;465;26;;-9;-0.01;166;0.16;105730
6408;Zuidwest-Friesland (CR);2008 oktober;105730;96;68;381;364;17;390;365;25;;19;0.02;185;0.18;105749
6409;Zuidwest-Friesland (CR);2008 november;105749;91;78;320;309;11;358;316;42;;-25;-0.02;160;0.15;105724
6410;Zuidwest-Friesland (CR);2008 december;105724;94;92;421;394;27;362;341;21;17.0;78;0.07;238;0.23;105802
6411;Zuidwest-Friesland (CR);2008;105564;1120;981;4670;4367;303;4588;4242;346;17.0;238;0.23;238;0.23;105802
6412;Zuidwest-Friesland (CR);2009 januari;105802;98;111;415;375;40;348;331;17;;54;0.05;54;0.05;105856
6413;Zuidwest-Friesland (CR);2009 februari;105856;95;82;364;342;22;374;350;24;;3;0.0;57;0.05;105859
6414;Zuidwest-Friesland (CR);2009 maart;105859;119;75;350;314;36;312;295;17;;82;0.08;139;0.13;105941
6415;Zuidwest-Friesland (CR);2009 april;105941;93;65;289;268;21;256;239;17;;61;0.06;200;0.19;106002
6416;Zuidwest-Friesland (CR);2009 mei;106002;84;70;230;222;8;261;247;14;;-17;-0.02;183;0.17;105985
6417;Zuidwest-Friesland (CR);2009 juni;105985;94;62;357;326;31;298;284;14;;91;0.09;274;0.26;106076
6418;Zuidwest-Friesland (CR);2009 juli;106076;118;80;472;420;52;391;338;53;;119;0.11;393;0.37;106195
6419;Zuidwest-Friesland (CR);2009 augustus;106195;104;73;361;321;40;443;409;34;;-51;-0.05;342;0.32;106144
6420;Zuidwest-Friesland (CR);2009 september;106144;100;62;347;310;37;465;430;35;;-80;-0.08;262;0.25;106064
6421;Zuidwest-Friesland (CR);2009 oktober;106064;118;77;371;337;34;371;348;23;;41;0.04;303;0.29;106105
6422;Zuidwest-Friesland (CR);2009 november;106105;108;60;302;283;19;279;255;24;;71;0.07;374;0.35;106176
6423;Zuidwest-Friesland (CR);2009 december;106176;99;76;244;226;18;275;250;25;8.0;0;0.0;374;0.35;106176
6424;Zuidwest-Friesland (CR);2009;105802;1230;893;4102;3744;358;4073;3776;297;8.0;374;0.35;374;0.35;106176
6425;Zuidwest-Friesland (CR);2010 januari;106176;93;75;300;274;26;292;265;27;;26;0.02;26;0.02;106202
6426;Zuidwest-Friesland (CR);2010 februari;106202;99;75;314;299;15;289;267;22;;49;0.05;75;0.07;106251
6427;Zuidwest-Friesland (CR);2010 maart;106251;81;72;293;275;18;313;289;24;;-11;-0.01;64;0.06;106240
6428;Zuidwest-Friesland (CR);2010 april;106240;66;58;268;233;35;252;244;8;;24;0.02;88;0.08;106264
6429;Zuidwest-Friesland (CR);2010 mei;106264;90;80;269;258;11;265;249;16;;14;0.01;102;0.1;106278
6430;Zuidwest-Friesland (CR);2010 juni;106278;109;74;267;238;29;274;242;32;;28;0.03;130;0.12;106306
6431;Zuidwest-Friesland (CR);2010 juli;106306;96;75;387;353;34;357;333;24;;51;0.05;181;0.17;106357
6432;Zuidwest-Friesland (CR);2010 augustus;106357;109;55;337;314;23;431;405;26;;-40;-0.04;141;0.13;106317
6433;Zuidwest-Friesland (CR);2010 september;106317;93;70;336;292;44;396;377;19;;-37;-0.03;104;0.1;106280
6434;Zuidwest-Friesland (CR);2010 oktober;106280;78;85;318;298;20;294;278;16;;17;0.02;121;0.11;106297
6435;Zuidwest-Friesland (CR);2010 november;106297;76;67;333;303;30;374;343;31;;-32;-0.03;89;0.08;106265
6436;Zuidwest-Friesland (CR);2010 december;106265;108;93;270;252;18;297;275;22;38.0;26;0.02;115;0.11;106291
6437;Zuidwest-Friesland (CR);2010;106176;1098;879;3692;3389;303;3834;3567;267;38.0;115;0.11;115;0.11;106291
6438;Zuidwest-Friesland (CR);2011 januari;106291;94;68;249;215;34;228;215;13;;47;0.04;47;0.04;106338
6439;Zuidwest-Friesland (CR);2011 februari;106338;90;81;234;208;26;226;211;15;;17;0.02;64;0.06;106355
6440;Zuidwest-Friesland (CR);2011 maart;106355;100;66;249;229;20;235;221;14;;48;0.05;112;0.11;106403
6441;Zuidwest-Friesland (CR);2011 april;106403;106;66;193;184;9;228;210;18;;5;0.0;117;0.11;106408
6442;Zuidwest-Friesland (CR);2011 mei;106408;89;86;291;255;36;244;231;13;;50;0.05;167;0.16;106458
6443;Zuidwest-Friesland (CR);2011 juni;106458;99;57;223;199;24;223;202;21;;42;0.04;209;0.2;106500
6444;Zuidwest-Friesland (CR);2011 juli;106500;79;72;257;225;32;271;235;36;;-7;-0.01;202;0.19;106493
6445;Zuidwest-Friesland (CR);2011 augustus;106493;118;68;283;260;23;376;345;31;;-43;-0.04;159;0.15;106450
6446;Zuidwest-Friesland (CR);2011 september;106450;107;72;301;248;53;394;365;29;;-58;-0.05;101;0.1;106392
6447;Zuidwest-Friesland (CR);2011 oktober;106392;88;61;237;213;24;238;205;33;;26;0.02;127;0.12;106418
6448;Zuidwest-Friesland (CR);2011 november;106418;88;78;196;171;25;207;203;4;;-1;0.0;126;0.12;106417
6449;Zuidwest-Friesland (CR);2011 december;106417;89;88;228;199;29;218;198;20;-36.0;-25;-0.02;101;0.1;106392
6450;Zuidwest-Friesland (CR);2011;106291;1147;863;2941;2606;335;3088;2841;247;-36.0;101;0.1;101;0.1;106392
6451;Zuidwest-Friesland (CR);2012 januari;106392;82;97;284;253;31;274;240;34;;-5;0.0;-5;0.0;106387
6452;Zuidwest-Friesland (CR);2012 februari;106387;83;78;255;233;22;263;235;28;;-3;0.0;-8;-0.01;106384
6453;Zuidwest-Friesland (CR);2012 maart;106384;96;94;212;201;11;212;192;20;;2;0.0;-6;-0.01;106386
6454;Zuidwest-Friesland (CR);2012 april;106386;81;84;196;175;21;180;156;24;;13;0.01;7;0.01;106399
6455;Zuidwest-Friesland (CR);2012 mei;106399;103;74;224;200;24;196;176;20;;57;0.05;64;0.06;106456
6456;Zuidwest-Friesland (CR);2012 juni;106456;88;73;269;244;25;234;196;38;;50;0.05;114;0.11;106506
6457;Zuidwest-Friesland (CR);2012 juli;106506;80;74;338;303;35;317;276;41;;27;0.03;141;0.13;106533
6458;Zuidwest-Friesland (CR);2012 augustus;106533;95;91;319;286;33;420;383;37;;-97;-0.09;44;0.04;106436
6459;Zuidwest-Friesland (CR);2012 september;106436;91;76;286;260;26;382;349;33;;-81;-0.08;-37;-0.03;106355
6460;Zuidwest-Friesland (CR);2012 oktober;106355;82;81;269;234;35;249;224;25;;21;0.02;-16;-0.02;106376
6461;Zuidwest-Friesland (CR);2012 november;106376;73;88;254;186;68;229;204;25;;10;0.01;-6;-0.01;106386
6462;Zuidwest-Friesland (CR);2012 december;106386;94;80;205;188;17;201;184;17;-3.0;15;0.01;9;0.01;106401
6463;Zuidwest-Friesland (CR);2012;106392;1048;990;3111;2763;348;3157;2815;342;-3.0;9;0.01;9;0.01;106401
6464;Zuidwest-Friesland (CR);2013 januari;106401;90;90;295;269;26;266;249;17;;29;0.03;29;0.03;106430
6465;Zuidwest-Friesland (CR);2013 februari;106430;84;98;246;232;14;279;264;15;;-47;-0.04;-18;-0.02;106383
6466;Zuidwest-Friesland (CR);2013 maart;106383;104;95;261;240;21;246;228;18;;24;0.02;6;0.01;106407
6467;Zuidwest-Friesland (CR);2013 april;106407;74;83;234;211;23;238;219;19;;-13;-0.01;-7;-0.01;106394
6468;Zuidwest-Friesland (CR);2013 mei;106394;79;72;243;222;21;223;195;28;;27;0.03;20;0.02;106421
6469;Zuidwest-Friesland (CR);2013 juni;106421;93;86;212;183;29;201;172;29;;18;0.02;38;0.04;106439
6470;Zuidwest-Friesland (CR);2013 juli;106439;104;91;385;341;44;336;307;29;;62;0.06;100;0.09;106501
6471;Zuidwest-Friesland (CR);2013 augustus;106501;78;86;266;239;27;436;404;32;;-178;-0.17;-78;-0.07;106323
6472;Zuidwest-Friesland (CR);2013 september;106323;90;87;267;224;43;397;365;32;;-127;-0.12;-205;-0.19;106196
6473;Zuidwest-Friesland (CR);2013 oktober;106196;97;87;298;271;27;271;229;42;;37;0.03;-168;-0.16;106233
6474;Zuidwest-Friesland (CR);2013 november;106233;83;84;236;208;28;246;219;27;;-11;-0.01;-179;-0.17;106222
6475;Zuidwest-Friesland (CR);2013 december;106222;72;82;214;184;30;177;153;24;-12.0;15;0.01;-164;-0.15;106237
6476;Zuidwest-Friesland (CR);2013;106401;1048;1041;3157;2824;333;3316;3004;312;-12.0;-164;-0.15;-164;-0.15;106237
6477;Zuidwest-Friesland (CR);2014 januari;135594;106;89;397;361;36;341;311;30;;73;0.05;73;0.05;135667
6478;Zuidwest-Friesland (CR);2014 februari;135667;89;88;299;267;32;271;264;7;;29;0.02;102;0.08;135696
6479;Zuidwest-Friesland (CR);2014 maart;135696;99;106;341;294;47;300;282;18;;34;0.03;136;0.1;135730
6480;Zuidwest-Friesland (CR);2014 april;135730;102;95;297;246;51;299;277;22;;5;0.0;141;0.1;135735
6481;Zuidwest-Friesland (CR);2014 mei;135735;109;85;286;267;19;276;254;22;;34;0.03;175;0.13;135769
6482;Zuidwest-Friesland (CR);2014 juni;135769;95;72;338;306;32;318;294;24;;43;0.03;218;0.16;135812
6483;Zuidwest-Friesland (CR);2014 juli;135812;104;125;422;372;50;375;335;40;;26;0.02;244;0.18;135838
6484;Zuidwest-Friesland (CR);2014 augustus;135838;96;112;353;308;45;580;536;44;;-243;-0.18;1;0.0;135595
6485;Zuidwest-Friesland (CR);2014 september;135595;112;77;346;313;33;528;459;69;;-147;-0.11;-146;-0.11;135448
6486;Zuidwest-Friesland (CR);2014 oktober;135448;109;94;345;312;33;377;333;44;;-17;-0.01;-163;-0.12;135431
6487;Zuidwest-Friesland (CR);2014 november;135431;98;105;274;262;12;298;276;22;;-31;-0.02;-194;-0.14;135400
6488;Zuidwest-Friesland (CR);2014 december;135400;95;119;388;346;42;368;313;55;-19.0;-23;-0.02;-217;-0.16;135377
6489;Zuidwest-Friesland (CR);2014;135594;1214;1167;4086;3654;432;4331;3934;397;-19.0;-217;-0.16;-217;-0.16;135377
6490;Zuidwest-Friesland (CR);2015 januari;135377;94;121;353;320;33;351;332;19;;-25;-0.02;-25;-0.02;135352
6491;Zuidwest-Friesland (CR);2015 februari;135352;93;113;285;252;33;314;296;18;;-49;-0.04;-74;-0.05;135303
6492;Zuidwest-Friesland (CR);2015 maart;135303;98;101;367;340;27;289;269;20;;75;0.06;1;0.0;135378
6493;Zuidwest-Friesland (CR);2015 april;135378;96;102;294;254;40;291;258;33;;-3;0.0;-2;0.0;135375
6494;Zuidwest-Friesland (CR);2015 mei;135375;96;103;281;267;14;259;240;19;;15;0.01;13;0.01;135390
6495;Zuidwest-Friesland (CR);2015 juni;135390;111;87;350;310;40;295;274;21;;79;0.06;92;0.07;135469
6496;Zuidwest-Friesland (CR);2015 juli;135469;104;98;478;446;32;415;376;39;;69;0.05;161;0.12;135538
6497;Zuidwest-Friesland (CR);2015 augustus;135538;92;111;416;370;46;503;460;43;;-106;-0.08;55;0.04;135432
6498;Zuidwest-Friesland (CR);2015 september;135432;111;126;392;361;31;473;434;39;;-96;-0.07;-41;-0.03;135336
6499;Zuidwest-Friesland (CR);2015 oktober;135336;98;115;332;300;32;368;339;29;;-53;-0.04;-94;-0.07;135283
6500;Zuidwest-Friesland (CR);2015 november;135283;84;92;327;287;40;335;305;30;;-16;-0.01;-110;-0.08;135267
6501;Zuidwest-Friesland (CR);2015 december;135267;111;103;363;333;30;333;310;23;8.0;46;0.03;-64;-0.05;135313
6502;Zuidwest-Friesland (CR);2015;135377;1188;1272;4238;3840;398;4226;3893;333;8.0;-64;-0.05;-64;-0.05;135313
6503;Zuidwest-Friesland (CR);2016 januari;135313;92;111;347;307;40;390;359;31;;-62;-0.05;-62;-0.05;135251
6504;Zuidwest-Friesland (CR);2016 februari;135251;109;122;354;325;29;386;351;35;;-45;-0.03;-107;-0.08;135206
6505;Zuidwest-Friesland (CR);2016 maart;135206;91;113;352;309;43;267;246;21;;63;0.05;-44;-0.03;135269
6506;Zuidwest-Friesland (CR);2016 april;135269;97;96;335;303;32;320;290;30;;16;0.01;-28;-0.02;135285
6507;Zuidwest-Friesland (CR);2016 mei;135285;116;109;354;316;38;316;286;30;;45;0.03;17;0.01;135330
6508;Zuidwest-Friesland (CR);2016 juni;135330;83;84;344;308;36;314;285;29;;29;0.02;46;0.03;135359
6509;Zuidwest-Friesland (CR);2016 juli;135359;122;98;429;382;47;387;353;34;;66;0.05;112;0.08;135425
6510;Zuidwest-Friesland (CR);2016 augustus;135425;110;98;456;407;49;548;503;45;;-80;-0.06;32;0.02;135345
6511;Zuidwest-Friesland (CR);2016 september;135345;121;97;583;546;37;522;493;29;;85;0.06;117;0.09;135430
6512;Zuidwest-Friesland (CR);2016 oktober;135430;107;120;478;430;48;377;345;32;;88;0.06;205;0.15;135518
6513;Zuidwest-Friesland (CR);2016 november;135518;117;97;418;362;56;391;371;20;;47;0.03;252;0.19;135565
6514;Zuidwest-Friesland (CR);2016 december;135565;108;118;614;578;36;421;392;29;-5.0;178;0.13;430;0.32;135743
6515;Zuidwest-Friesland (CR);2016;135313;1273;1263;5064;4573;491;4639;4274;365;-5.0;430;0.32;430;0.32;135743
6516;Zuidwest-Friesland (CR);2017 januari;135743;92;170;532;491;41;453;423;30;;1;0.0;1;0.0;135744
6517;Zuidwest-Friesland (CR);2017 februari;135744;73;107;420;384;36;459;435;24;;-73;-0.05;-72;-0.05;135671
6518;Zuidwest-Friesland (CR);2017 maart;135671;107;135;417;385;32;471;436;35;;-82;-0.06;-154;-0.11;135589
6519;Zuidwest-Friesland (CR);2017 april;135589;103;89;374;339;35;374;356;18;;14;0.01;-140;-0.1;135603
6520;Zuidwest-Friesland (CR);2017 mei;135603;101;81;474;424;50;384;346;38;;110;0.08;-30;-0.02;135713
6521;Zuidwest-Friesland (CR);2017 juni;135713;102;101;507;458;49;407;355;52;;101;0.07;71;0.05;135814
6522;Zuidwest-Friesland (CR);2017 juli;135814;103;94;524;460;64;473;431;42;;60;0.04;131;0.1;135874
6523;Zuidwest-Friesland (CR);2017 augustus;135874;103;78;503;457;46;579;545;34;;-51;-0.04;80;0.06;135823
6524;Zuidwest-Friesland (CR);2017 september;135823;108;89;591;543;48;567;531;36;;43;0.03;123;0.09;135866
6525;Zuidwest-Friesland (CR);2017 oktober;135866;111;83;521;444;77;448;408;40;;101;0.07;224;0.17;135967
6526;Zuidwest-Friesland (CR);2017 november;135967;93;103;421;376;45;433;412;21;;-22;-0.02;202;0.15;135945
6527;Zuidwest-Friesland (CR);2017 december;135945;92;96;410;366;44;433;393;40;7.0;-20;-0.01;182;0.13;135925
6528;Zuidwest-Friesland (CR);2017;135743;1188;1226;5694;5127;567;5481;5071;410;7.0;182;0.13;182;0.13;135925
6529;Zuidwest-Friesland (CR);2018 januari;141336;118;125;463;398;65;439;398;41;;17;0.01;17;0.01;141353
6530;Zuidwest-Friesland (CR);2018 februari;141353;85;125;365;324;41;352;312;40;;-27;-0.02;-10;-0.01;141326
6531;Zuidwest-Friesland (CR);2018 maart;141326;100;154;444;391;53;444;417;27;;-54;-0.04;-64;-0.05;141272
6532;Zuidwest-Friesland (CR);2018 april;141272;99;122;368;314;54;401;353;48;;-56;-0.04;-120;-0.08;141216
6533;Zuidwest-Friesland (CR);2018 mei;141216;122;140;404;340;64;370;327;43;;16;0.01;-104;-0.07;141232
6534;Zuidwest-Friesland (CR);2018 juni;141232;93;100;379;326;53;320;291;29;;52;0.04;-52;-0.04;141284
6535;Zuidwest-Friesland (CR);2018 juli;141284;115;108;592;503;89;519;484;35;;80;0.06;28;0.02;141364
6536;Zuidwest-Friesland (CR);2018 augustus;141364;109;115;573;507;66;613;578;35;;-46;-0.03;-18;-0.01;141318
6537;Zuidwest-Friesland (CR);2018 september;141318;99;93;460;395;65;553;515;38;;-87;-0.06;-105;-0.07;141231
6538;Zuidwest-Friesland (CR);2018 oktober;141231;98;110;451;386;65;461;421;40;;-22;-0.02;-127;-0.09;141209
6539;Zuidwest-Friesland (CR);2018 november;141209;88;114;400;369;31;438;386;52;;-64;-0.05;-191;-0.14;141145
6540;Zuidwest-Friesland (CR);2018 december;141145;82;110;399;352;47;376;337;39;0.0;-5;0.0;-196;-0.14;141140
6541;Zuidwest-Friesland (CR);2018;141336;1208;1416;5298;4605;693;5286;4819;467;0.0;-196;-0.14;-196;-0.14;141140
6542;Zuidwest-Friesland (CR);2019 januari;141140;106;131;433;365;68;355;328;27;;53;0.04;53;0.04;141193
6543;Zuidwest-Friesland (CR);2019 februari;141193;105;95;410;359;51;357;336;21;;63;0.04;116;0.08;141256
6544;Zuidwest-Friesland (CR);2019 maart;141256;114;124;399;346;53;442;391;51;;-53;-0.04;63;0.04;141203
6545;Zuidwest-Friesland (CR);2019 april;141203;94;115;384;340;44;391;343;48;;-28;-0.02;35;0.02;141175
6546;Zuidwest-Friesland (CR);2019 mei;141175;112;92;421;388;33;358;331;27;;83;0.06;118;0.08;141258
6547;Zuidwest-Friesland (CR);2019 juni;141258;125;122;459;411;48;308;283;25;;154;0.11;272;0.19;141412
6548;Zuidwest-Friesland (CR);2019 juli;141412;119;126;547;480;67;466;406;60;;74;0.05;346;0.25;141486
6549;Zuidwest-Friesland (CR);2019 augustus;141486;124;119;594;526;68;509;464;45;;90;0.06;436;0.31;141576
6550;Zuidwest-Friesland (CR);2019 september;141576;124;80;421;365;56;469;446;23;;-4;0.0;432;0.31;141572
6551;Zuidwest-Friesland (CR);2019 oktober;141572;91;107;474;437;37;479;449;30;;-21;-0.01;411;0.29;141551
6552;Zuidwest-Friesland (CR);2019 november;141551;99;123;407;347;60;420;376;44;;-37;-0.03;374;0.26;141514
6553;Zuidwest-Friesland (CR);2019 december;141514;106;118;442;387;55;396;357;39;3.0;37;0.03;411;0.29;141551
6554;Zuidwest-Friesland (CR);2019;141140;1319;1352;5391;4751;640;4950;4510;440;3.0;411;0.29;411;0.29;141551
6555;Zuidwest-Friesland (CR);2020 januari;141551;85;131;495;437;58;482;443;39;;-33;-0.02;-33;-0.02;141518
6556;Zuidwest-Friesland (CR);2020 februari;141518;94;117;419;377;42;440;419;21;;-44;-0.03;-77;-0.05;141474
6557;Zuidwest-Friesland (CR);2020 maart;141474;111;116;371;344;27;393;339;54;;-27;-0.02;-104;-0.07;141447
6558;Zuidwest-Friesland (CR);2020 april;141447;102;141;361;321;40;307;300;7;;15;0.01;-89;-0.06;141462
6559;Zuidwest-Friesland (CR);2020 mei;141462;105;100;417;376;41;339;325;14;;83;0.06;-6;0.0;141545
6560;Zuidwest-Friesland (CR);2020 juni;141545;114;97;359;315;44;359;325;34;;17;0.01;11;0.01;141562
6561;Zuidwest-Friesland (CR);2020 juli;141562;117;116;552;494;58;460;429;31;;93;0.07;104;0.07;141655
6562;Zuidwest-Friesland (CR);2020 augustus;141655;108;100;493;447;46;573;532;41;;-72;-0.05;32;0.02;141583
6563;Zuidwest-Friesland (CR);2020 september;141583;100;101;425;387;38;427;399;28;;-3;0.0;29;0.02;141580
6564;Zuidwest-Friesland (CR);2020 oktober;141580;123;132;521;486;35;488;457;31;;24;0.02;53;0.04;141604
6565;Zuidwest-Friesland (CR);2020 november;141604;116;131;499;463;36;432;412;20;;52;0.04;105;0.07;141656
6566;Zuidwest-Friesland (CR);2020 december;141656;117;128;586;553;33;453;437;16;-1.0;121;0.09;226;0.16;141777
6567;Zuidwest-Friesland (CR);2020;141551;1292;1410;5498;5000;498;5153;4817;336;-1.0;226;0.16;226;0.16;141777
6568;Zuidwest-Friesland (CR);2021 januari;141777;98;129;467;433;34;473;448;25;0.0;-37;-0.03;-37;-0.03;141740
6569;Zuidwest-Friesland (CR);2021 februari;141740;100;157;457;422;35;445;425;20;0.0;-45;-0.03;-82;-0.06;141695
6570;Zuidwest-Friesland (CR);2021 maart;141695;120;112;637;598;39;443;414;29;0.0;202;0.14;120;0.08;141897
6571;Zuidwest-Friesland (CR);2021 april;141897;107;108;437;400;37;430;407;23;0.0;6;0.0;126;0.09;141903
6572;Zuidwest-Friesland (CR);2021 mei;141903;107;119;490;462;28;437;422;15;0.0;41;0.03;167;0.12;141944
6573;Zuidwest-Friesland (CR);2021 juni;141944;97;123;477;432;45;398;368;30;0.0;53;0.04;220;0.16;141997
6574;Zuidwest-Friesland (CR);2021 juli;141997;130;114;639;576;63;544;509;35;0.0;111;0.08;331;0.23;142108
6575;Zuidwest-Friesland (CR);2021 augustus;142108;127;120;544;468;76;597;551;46;0.0;-46;-0.03;285;0.2;142062
6576;Zuidwest-Friesland (CR);2021 september;142062;131;120;458;404;54;524;515;9;0.0;-55;-0.04;230;0.16;142007
6577;Zuidwest-Friesland (CR);2021 oktober;142007;118;149;467;439;28;456;418;38;0.0;-20;-0.01;210;0.15;141987
6578;Zuidwest-Friesland (CR);2021 november;141987;113;141;393;369;24;493;448;45;0.0;-128;-0.09;82;0.06;141859
6579;Zuidwest-Friesland (CR);2021 december;141859;84;138;565;521;44;473;432;41;0.0;38;0.03;120;0.08;141897
6580;Zuidwest-Friesland (CR);2021;141777;1332;1530;6031;5524;507;5713;5357;356;0.0;120;0.08;120;0.08;141897
6581;Zuidwest-Friesland (CR);2022 januari;141897;109;140;442;395;47;379;350;29;;32;0.02;32;0.02;141929
6582;Zuidwest-Friesland (CR);2022 februari;141929;91;100;409;382;27;352;317;35;;48;0.03;80;0.06;141977
6583;Zuidwest-Friesland (CR);2022 maart;141977;115;135;696;441;255;408;386;22;;268;0.19;348;0.25;142245
6584;Zuidwest-Friesland (CR);2022 april;142245;102;138;953;462;491;496;451;45;;421;0.3;769;0.54;142666
6585;Zuidwest-Friesland (CR);2022 mei;142666;102;137;648;485;163;499;424;75;;114;0.08;883;0.62;142780
6586;Zuidwest-Friesland (CR);2022 juni;142780;90;106;462;398;64;429;374;55;;17;0.01;900;0.63;142797
6587;Zuidwest-Friesland (CR);2022 juli;142797;116;138;636;514;122;447;385;62;;167;0.12;1067;0.75;142964
6588;Zuidwest-Friesland (CR);2022 augustus;142964;103;114;579;465;114;558;464;94;;10;0.01;1077;0.76;142974
6589;Zuidwest-Friesland (CR);2022 september;142974;118;124;512;431;81;567;522;45;;-61;-0.04;1016;0.72;142913
6590;Zuidwest-Friesland (CR);2022 oktober;142913;111;133;578;510;68;505;442;63;;51;0.04;1067;0.75;142964
6591;Zuidwest-Friesland (CR);2022 november;142964;92;141;503;436;67;499;447;52;;-45;-0.03;1022;0.72;142919
6592;Zuidwest-Friesland (CR);2022 december;142919;81;164;514;457;57;474;421;53;-1.0;-44;-0.03;978;0.69;142875
6593;Zuidwest-Friesland (CR);2022;141897;1230;1570;6932;5376;1556;5613;4983;630;-1.0;978;0.69;978;0.69;142875
6594;Zuidwest-Friesland (CR);2023 januari;142875;91;151;558;470;88;518;469;49;0.0;-20;-0.01;-20;-0.01;142855
6595;Zuidwest-Friesland (CR);2023 februari;142855;77;114;588;504;84;453;393;60;0.0;98;0.07;78;0.05;142953
6596;Zuidwest-Friesland (CR);2023 maart;142953;114;150;519;460;59;579;513;66;0.0;-96;-0.07;-18;-0.01;142857
6597;Zuidwest-Friesland (CR);2023 april;142857;94;121;380;336;44;426;370;56;0.0;-73;-0.05;-91;-0.06;142784
6598;Zuidwest-Friesland (CR);2023 mei;142784;84;113;455;405;50;469;406;63;0.0;-43;-0.03;-134;-0.09;142741
6599;Zuidwest-Friesland (CR);2023 juni;142741;89;150;394;328;66;455;423;32;0.0;-122;-0.09;-256;-0.18;142619
6600;Zuidwest-Friesland (CR);2023 juli;142619;116;103;525;456;69;573;516;57;0.0;-35;-0.02;-291;-0.2;142584
6601;Zuidwest-Friesland (CR);2023 augustus;142584;110;124;491;419;72;640;591;49;0.0;-163;-0.11;-454;-0.32;142421
6602;Zuidwest-Friesland (CR);2023 september;142421;118;124;491;436;55;564;527;37;0.0;-79;-0.06;-533;-0.37;142342
6603;Zuidwest-Friesland (CR);2023 oktober;142342;110;143;485;430;55;487;432;55;0.0;-35;-0.02;-568;-0.4;142307
6604;Zuidwest-Friesland (CR);2023 november;142307;88;120;471;424;47;412;347;65;0.0;27;0.02;-541;-0.38;142334
6605;Zuidwest-Friesland (CR);2023 december;142334;94;160;498;450;48;420;369;51;4.0;16;0.01;-525;-0.37;142350
6606;Zuidwest-Friesland (CR);2023;142875;1185;1573;5855;5118;737;5996;5356;640;4.0;-525;-0.37;-525;-0.37;142350
6607;Zuidwest-Friesland (CR);2024 januari;142350;90;158;527;462;65;448;399;49;;11;0.01;11;0.01;142361
6608;Zuidwest-Friesland (CR);2024 februari;142361;86;121;408;368;40;427;384;43;;-54;-0.04;-43;-0.03;142307
6609;Zuidwest-Friesland (CR);2024 maart;142307;101;119;513;451;62;401;348;53;;94;0.07;51;0.04;142401
6610;Zuidwest-Friesland (CR);2024 april;142401;100;120;412;375;37;402;351;51;;-10;-0.01;41;0.03;142391
6611;Zuidwest-Friesland (CR);2024 mei;142391;97;118;405;362;43;401;357;44;;-17;-0.01;24;0.02;142374
6612;Zuidwest-Friesland (CR);2024 juni;142374;100;133;391;360;31;365;344;21;;-7;0.0;17;0.01;142367
6613;Zuidwest-Friesland (CR);2024 juli;142367;101;136;626;566;60;461;424;37;;130;0.09;147;0.1;142497
6614;Zuidwest-Friesland (CR);2024 augustus;142497;117;111;643;575;68;486;424;62;;163;0.11;310;0.22;142660
6615;Zuidwest-Friesland (CR);2024 september;142660;112;127;543;490;53;542;465;77;;-14;-0.01;296;0.21;142646
6616;Zuidwest-Friesland (CR);2024 oktober;142646;109;113;536;450;86;434;387;47;;98;0.07;394;0.28;142744
6617;Zuidwest-Friesland (CR);2024 november;142744;87;142;489;449;40;429;388;41;;5;0.0;399;0.28;142749
6618;Zuidwest-Friesland (CR);2024 december;142749;97;124;477;433;44;433;400;33;0.0;17;0.01;416;0.29;142766
6619;Zuidwest-Friesland (CR);2024;142350;1197;1522;5970;5341;629;5229;4671;558;0.0;416;0.29;416;0.29;142766
6620;Zuidwest-Friesland (CR);2025 januari;142766;109;163;537;487;50;416;378;38;;67;0.05;67;0.05;142833
6621;Zuidwest-Friesland (CR);2025 februari;142833;73;151;483;428;55;372;342;30;;33;0.02;100;0.07;142866
6622;Zuidoost-Friesland (CR);2002 januari;203473;212;158;791;646;145;697;678;19;;148;0.07;148;0.07;203621
6623;Zuidoost-Friesland (CR);2002 februari;203621;190;161;724;616;108;623;602;21;;130;0.06;278;0.14;203751
6624;Zuidoost-Friesland (CR);2002 maart;203751;204;156;714;573;141;659;607;52;;103;0.05;381;0.19;203854
6625;Zuidoost-Friesland (CR);2002 april;203854;193;164;641;522;119;643;556;87;;27;0.01;408;0.2;203881
6626;Zuidoost-Friesland (CR);2002 mei;203881;206;154;687;561;126;668;635;33;;71;0.03;479;0.24;203952
6627;Zuidoost-Friesland (CR);2002 juni;203952;204;156;677;580;97;640;599;41;;85;0.04;564;0.28;204037
6628;Zuidoost-Friesland (CR);2002 juli;204037;233;154;962;863;99;843;762;81;;198;0.1;762;0.37;204235
6629;Zuidoost-Friesland (CR);2002 augustus;204235;235;162;887;793;94;851;759;92;;109;0.05;871;0.43;204344
6630;Zuidoost-Friesland (CR);2002 september;204344;211;130;829;698;131;848;786;62;;62;0.03;933;0.46;204406
6631;Zuidoost-Friesland (CR);2002 oktober;204406;231;170;819;682;137;660;591;69;;220;0.11;1153;0.57;204626
6632;Zuidoost-Friesland (CR);2002 november;204626;197;165;696;577;119;645;588;57;;83;0.04;1236;0.61;204709
6633;Zuidoost-Friesland (CR);2002 december;204709;183;169;649;580;69;637;604;33;16.0;42;0.02;1278;0.63;204751
6634;Zuidoost-Friesland (CR);2002;203473;2499;1899;9076;7691;1385;8414;7767;647;16.0;1278;0.63;1278;0.63;204751
6635;Zuidoost-Friesland (CR);2003 januari;204751;196;198;820;709;111;761;711;50;;57;0.03;57;0.03;204808
6636;Zuidoost-Friesland (CR);2003 februari;204808;175;171;697;589;108;634;545;89;;67;0.03;124;0.06;204875
6637;Zuidoost-Friesland (CR);2003 maart;204875;216;172;765;670;95;653;586;67;;156;0.08;280;0.14;205031
6638;Zuidoost-Friesland (CR);2003 april;205031;237;160;755;644;111;707;624;83;;125;0.06;405;0.2;205156
6639;Zuidoost-Friesland (CR);2003 mei;205156;197;158;752;656;96;665;627;38;;126;0.06;531;0.26;205282
6640;Zuidoost-Friesland (CR);2003 juni;205282;219;136;758;700;58;736;661;75;;105;0.05;636;0.31;205387
6641;Zuidoost-Friesland (CR);2003 juli;205387;211;143;872;810;62;743;678;65;;197;0.1;833;0.41;205584
6642;Zuidoost-Friesland (CR);2003 augustus;205584;213;143;860;786;74;809;748;61;;121;0.06;954;0.47;205705
6643;Zuidoost-Friesland (CR);2003 september;205705;202;144;739;624;115;777;723;54;;20;0.01;974;0.48;205725
6644;Zuidoost-Friesland (CR);2003 oktober;205725;180;164;689;607;82;698;632;66;;7;0.0;981;0.48;205732
6645;Zuidoost-Friesland (CR);2003 november;205732;169;132;652;592;60;623;583;40;;66;0.03;1047;0.51;205798
6646;Zuidoost-Friesland (CR);2003 december;205798;203;187;691;640;51;628;613;15;23.0;102;0.05;1149;0.56;205900
6647;Zuidoost-Friesland (CR);2003;204751;2418;1908;9050;8027;1023;8434;7731;703;23.0;1149;0.56;1149;0.56;205900
6648;Zuidoost-Friesland (CR);2004 januari;205900;197;191;650;593;57;721;640;81;;-65;-0.03;-65;-0.03;205835
6649;Zuidoost-Friesland (CR);2004 februari;205835;184;159;573;528;45;705;595;110;;-107;-0.05;-172;-0.08;205728
6650;Zuidoost-Friesland (CR);2004 maart;205728;204;164;744;661;83;642;602;40;;142;0.07;-30;-0.01;205870
6651;Zuidoost-Friesland (CR);2004 april;205870;182;147;624;578;46;553;530;23;;106;0.05;76;0.04;205976
6652;Zuidoost-Friesland (CR);2004 mei;205976;162;143;638;582;56;662;621;41;;-5;0.0;71;0.03;205971
6653;Zuidoost-Friesland (CR);2004 juni;205971;205;146;654;615;39;677;658;19;;36;0.02;107;0.05;206007
6654;Zuidoost-Friesland (CR);2004 juli;206007;211;160;967;898;69;898;803;95;;120;0.06;227;0.11;206127
6655;Zuidoost-Friesland (CR);2004 augustus;206127;193;128;790;719;71;928;854;74;;-73;-0.04;154;0.07;206054
6656;Zuidoost-Friesland (CR);2004 september;206054;184;149;806;734;72;824;764;60;;17;0.01;171;0.08;206071
6657;Zuidoost-Friesland (CR);2004 oktober;206071;203;138;729;671;58;703;668;35;;91;0.04;262;0.13;206162
6658;Zuidoost-Friesland (CR);2004 november;206162;175;152;725;650;75;705;663;42;;43;0.02;305;0.15;206205
6659;Zuidoost-Friesland (CR);2004 december;206205;191;151;647;607;40;685;572;113;29.0;31;0.02;336;0.16;206236
6660;Zuidoost-Friesland (CR);2004;205900;2291;1828;8547;7836;711;8703;7970;733;29.0;336;0.16;336;0.16;206236
6661;Zuidoost-Friesland (CR);2005 januari;206236;214;187;661;625;36;620;600;20;;68;0.03;68;0.03;206304
6662;Zuidoost-Friesland (CR);2005 februari;206304;193;174;670;610;60;631;579;52;;58;0.03;126;0.06;206362
6663;Zuidoost-Friesland (CR);2005 maart;206362;184;193;652;623;29;769;534;235;;-126;-0.06;0;0.0;206236
6664;Zuidoost-Friesland (CR);2005 april;206236;182;162;663;633;30;636;580;56;;47;0.02;47;0.02;206283
6665;Zuidoost-Friesland (CR);2005 mei;206283;195;153;593;569;24;697;667;30;;-62;-0.03;-15;-0.01;206221
6666;Zuidoost-Friesland (CR);2005 juni;206221;174;147;654;632;22;716;667;49;;-35;-0.02;-50;-0.02;206186
6667;Zuidoost-Friesland (CR);2005 juli;206186;201;138;809;762;47;849;783;66;;23;0.01;-27;-0.01;206209
6668;Zuidoost-Friesland (CR);2005 augustus;206209;218;153;845;790;55;982;901;81;;-72;-0.03;-99;-0.05;206137
6669;Zuidoost-Friesland (CR);2005 september;206137;175;135;923;834;89;1002;965;37;;-39;-0.02;-138;-0.07;206098
6670;Zuidoost-Friesland (CR);2005 oktober;206098;174;170;736;701;35;754;677;77;;-14;-0.01;-152;-0.07;206084
6671;Zuidoost-Friesland (CR);2005 november;206084;187;157;682;642;40;938;679;259;;-226;-0.11;-378;-0.18;205858
6672;Zuidoost-Friesland (CR);2005 december;205858;193;144;677;639;38;693;594;99;-11.0;22;0.01;-356;-0.17;205880
6673;Zuidoost-Friesland (CR);2005;206236;2290;1913;8565;8060;505;9287;8226;1061;-11.0;-356;-0.17;-356;-0.17;205880
6674;Zuidoost-Friesland (CR);2006 januari;205880;196;172;728;675;53;865;653;212;;-113;-0.05;-113;-0.05;205767
6675;Zuidoost-Friesland (CR);2006 februari;205767;171;168;633;600;33;690;599;91;;-54;-0.03;-167;-0.08;205713
6676;Zuidoost-Friesland (CR);2006 maart;205713;223;189;660;612;48;663;595;68;;31;0.02;-136;-0.07;205744
6677;Zuidoost-Friesland (CR);2006 april;205744;178;160;555;528;27;594;523;71;;-21;-0.01;-157;-0.08;205723
6678;Zuidoost-Friesland (CR);2006 mei;205723;197;152;708;640;68;606;576;30;;147;0.07;-10;0.0;205870
6679;Zuidoost-Friesland (CR);2006 juni;205870;187;170;670;601;69;639;598;41;;48;0.02;38;0.02;205918
6680;Zuidoost-Friesland (CR);2006 juli;205918;191;188;841;758;83;755;659;96;;89;0.04;127;0.06;206007
6681;Zuidoost-Friesland (CR);2006 augustus;206007;187;159;919;846;73;948;869;79;;-1;0.0;126;0.06;206006
6682;Zuidoost-Friesland (CR);2006 september;206006;171;162;829;750;79;867;799;68;;-29;-0.01;97;0.05;205977
6683;Zuidoost-Friesland (CR);2006 oktober;205977;206;165;767;721;46;838;767;71;;-30;-0.01;67;0.03;205947
6684;Zuidoost-Friesland (CR);2006 november;205947;200;146;715;670;45;767;674;93;;2;0.0;69;0.03;205949
6685;Zuidoost-Friesland (CR);2006 december;205949;168;163;691;655;36;567;517;50;12.0;141;0.07;210;0.1;206090
6686;Zuidoost-Friesland (CR);2006;205880;2275;1994;8716;8056;660;8799;7829;970;12.0;210;0.1;210;0.1;206090
6687;Zuidoost-Friesland (CR);2007 januari;206090;208;153;742;677;65;759;691;68;;38;0.02;38;0.02;206128
6688;Zuidoost-Friesland (CR);2007 februari;206128;175;154;685;634;51;654;617;37;;52;0.03;90;0.04;206180
6689;Zuidoost-Friesland (CR);2007 maart;206180;185;189;627;576;51;648;589;59;;-25;-0.01;65;0.03;206155
6690;Zuidoost-Friesland (CR);2007 april;206155;168;143;597;556;41;598;547;51;;24;0.01;89;0.04;206179
6691;Zuidoost-Friesland (CR);2007 mei;206179;177;161;617;570;47;611;567;44;;22;0.01;111;0.05;206201
6692;Zuidoost-Friesland (CR);2007 juni;206201;166;139;748;655;93;650;591;59;;125;0.06;236;0.11;206326
6693;Zuidoost-Friesland (CR);2007 juli;206326;173;155;949;825;124;866;773;93;;101;0.05;337;0.16;206427
6694;Zuidoost-Friesland (CR);2007 augustus;206427;192;142;955;844;111;859;807;52;;146;0.07;483;0.23;206573
6695;Zuidoost-Friesland (CR);2007 september;206573;190;145;755;674;81;800;749;51;;0;0.0;483;0.23;206573
6696;Zuidoost-Friesland (CR);2007 oktober;206573;180;146;781;717;64;707;677;30;;108;0.05;591;0.29;206681
6697;Zuidoost-Friesland (CR);2007 november;206681;190;162;672;617;55;611;612;-1;;89;0.04;680;0.33;206770
6698;Zuidoost-Friesland (CR);2007 december;206770;188;167;685;579;106;607;563;44;-8.0;91;0.04;771;0.37;206861
6699;Zuidoost-Friesland (CR);2007;206090;2192;1856;8813;7924;889;8370;7783;587;-8.0;771;0.37;771;0.37;206861
6700;Zuidoost-Friesland (CR);2008 januari;206861;179;146;825;748;77;800;759;41;;58;0.03;58;0.03;206919
6701;Zuidoost-Friesland (CR);2008 februari;206919;155;168;654;586;68;645;619;26;;-4;0.0;54;0.03;206915
6702;Zuidoost-Friesland (CR);2008 maart;206915;174;163;547;501;46;675;609;66;;-117;-0.06;-63;-0.03;206798
6703;Zuidoost-Friesland (CR);2008 april;206798;172;177;664;590;74;613;561;52;;46;0.02;-17;-0.01;206844
6704;Zuidoost-Friesland (CR);2008 mei;206844;182;156;656;557;99;602;549;53;;80;0.04;63;0.03;206924
6705;Zuidoost-Friesland (CR);2008 juni;206924;200;141;682;591;91;598;552;46;;143;0.07;206;0.1;207067
6706;Zuidoost-Friesland (CR);2008 juli;207067;219;159;923;827;96;720;654;66;;263;0.13;469;0.23;207330
6707;Zuidoost-Friesland (CR);2008 augustus;207330;187;135;917;794;123;872;809;63;;97;0.05;566;0.27;207427
6708;Zuidoost-Friesland (CR);2008 september;207427;207;151;787;639;148;807;759;48;;36;0.02;602;0.29;207463
6709;Zuidoost-Friesland (CR);2008 oktober;207463;192;172;835;741;94;756;696;60;;99;0.05;701;0.34;207562
6710;Zuidoost-Friesland (CR);2008 november;207562;171;154;603;549;54;631;576;55;;-11;-0.01;690;0.33;207551
6711;Zuidoost-Friesland (CR);2008 december;207551;153;168;628;525;103;642;590;52;32.0;3;0.0;693;0.34;207554
6712;Zuidoost-Friesland (CR);2008;206861;2191;1890;8721;7648;1073;8361;7733;628;32.0;693;0.34;693;0.34;207554
6713;Zuidoost-Friesland (CR);2009 januari;207554;170;164;693;609;84;566;537;29;;133;0.06;133;0.06;207687
6714;Zuidoost-Friesland (CR);2009 februari;207687;159;169;627;545;82;660;635;25;;-43;-0.02;90;0.04;207644
6715;Zuidoost-Friesland (CR);2009 maart;207644;175;165;655;581;74;656;606;50;;9;0.0;99;0.05;207653
6716;Zuidoost-Friesland (CR);2009 april;207653;176;174;588;508;80;628;585;43;;-38;-0.02;61;0.03;207615
6717;Zuidoost-Friesland (CR);2009 mei;207615;162;148;560;489;71;507;489;18;;67;0.03;128;0.06;207682
6718;Zuidoost-Friesland (CR);2009 juni;207682;199;148;618;513;105;678;618;60;;-9;0.0;119;0.06;207673
6719;Zuidoost-Friesland (CR);2009 juli;207673;169;123;800;732;68;698;647;51;;148;0.07;267;0.13;207821
6720;Zuidoost-Friesland (CR);2009 augustus;207821;184;153;734;661;73;722;682;40;;43;0.02;310;0.15;207864
6721;Zuidoost-Friesland (CR);2009 september;207864;209;151;793;675;118;771;707;64;;80;0.04;390;0.19;207944
6722;Zuidoost-Friesland (CR);2009 oktober;207944;188;174;701;594;107;594;548;46;;121;0.06;511;0.25;208065
6723;Zuidoost-Friesland (CR);2009 november;208065;151;140;604;525;79;574;524;50;;41;0.02;552;0.27;208106
6724;Zuidoost-Friesland (CR);2009 december;208106;175;171;584;488;96;591;548;43;-22.0;-25;-0.01;527;0.25;208081
6725;Zuidoost-Friesland (CR);2009;207554;2117;1880;7957;6920;1037;7645;7126;519;-22.0;527;0.25;527;0.25;208081
6726;Zuidoost-Friesland (CR);2010 januari;208081;172;152;636;553;83;605;552;53;;51;0.02;51;0.02;208132
6727;Zuidoost-Friesland (CR);2010 februari;208132;182;152;622;514;108;615;576;39;;37;0.02;88;0.04;208169
6728;Zuidoost-Friesland (CR);2010 maart;208169;177;167;702;601;101;657;607;50;;55;0.03;143;0.07;208224
6729;Zuidoost-Friesland (CR);2010 april;208224;190;145;569;508;61;582;535;47;;32;0.02;175;0.08;208256
6730;Zuidoost-Friesland (CR);2010 mei;208256;166;154;522;467;55;522;464;58;;12;0.01;187;0.09;208268
6731;Zuidoost-Friesland (CR);2010 juni;208268;199;143;653;580;73;650;603;47;;59;0.03;246;0.12;208327
6732;Zuidoost-Friesland (CR);2010 juli;208327;211;162;817;732;85;794;734;60;;72;0.03;318;0.15;208399
6733;Zuidoost-Friesland (CR);2010 augustus;208399;173;153;730;665;65;875;797;78;;-125;-0.06;193;0.09;208274
6734;Zuidoost-Friesland (CR);2010 september;208274;216;137;695;605;90;814;765;49;;-40;-0.02;153;0.07;208234
6735;Zuidoost-Friesland (CR);2010 oktober;208234;181;158;612;563;49;743;684;59;;-108;-0.05;45;0.02;208126
6736;Zuidoost-Friesland (CR);2010 november;208126;177;123;618;558;60;634;610;24;;38;0.02;83;0.04;208164
6737;Zuidoost-Friesland (CR);2010 december;208164;192;191;575;534;41;633;586;47;0.0;-57;-0.03;26;0.01;208107
6738;Zuidoost-Friesland (CR);2010;208081;2236;1837;7751;6880;871;8124;7513;611;0.0;26;0.01;26;0.01;208107
6739;Zuidoost-Friesland (CR);2011 januari;208107;168;169;645;571;74;729;617;112;;-85;-0.04;-85;-0.04;208022
6740;Zuidoost-Friesland (CR);2011 februari;208022;174;158;669;613;56;593;555;38;;92;0.04;7;0.0;208114
6741;Zuidoost-Friesland (CR);2011 maart;208114;180;168;685;638;47;683;636;47;;14;0.01;21;0.01;208128
6742;Zuidoost-Friesland (CR);2011 april;208128;156;165;550;504;46;613;570;43;;-72;-0.03;-51;-0.02;208056
6743;Zuidoost-Friesland (CR);2011 mei;208056;188;166;593;541;52;592;540;52;;23;0.01;-28;-0.01;208079
6744;Zuidoost-Friesland (CR);2011 juni;208079;179;138;594;540;54;627;551;76;;8;0.0;-20;-0.01;208087
6745;Zuidoost-Friesland (CR);2011 juli;208087;165;151;730;644;86;641;579;62;;103;0.05;83;0.04;208190
6746;Zuidoost-Friesland (CR);2011 augustus;208190;207;143;860;772;88;830;770;60;;94;0.05;177;0.09;208284
6747;Zuidoost-Friesland (CR);2011 september;208284;186;165;683;585;98;781;695;86;;-77;-0.04;100;0.05;208207
6748;Zuidoost-Friesland (CR);2011 oktober;208207;160;177;585;510;75;619;544;75;;-51;-0.02;49;0.02;208156
6749;Zuidoost-Friesland (CR);2011 november;208156;165;167;635;566;69;657;605;52;;-24;-0.01;25;0.01;208132
6750;Zuidoost-Friesland (CR);2011 december;208132;163;179;597;524;73;602;558;44;-31.0;-52;-0.02;-27;-0.01;208080
6751;Zuidoost-Friesland (CR);2011;208107;2091;1946;7826;7008;818;7967;7220;747;-31.0;-27;-0.01;-27;-0.01;208080
6752;Zuidoost-Friesland (CR);2012 januari;208080;183;143;650;604;46;641;586;55;;49;0.02;49;0.02;208129
6753;Zuidoost-Friesland (CR);2012 februari;208129;150;158;607;543;64;699;651;48;;-100;-0.05;-51;-0.02;208029
6754;Zuidoost-Friesland (CR);2012 maart;208029;177;164;576;518;58;681;644;37;;-92;-0.04;-143;-0.07;207937
6755;Zuidoost-Friesland (CR);2012 april;207937;135;142;536;493;43;517;470;47;;12;0.01;-131;-0.06;207949
6756;Zuidoost-Friesland (CR);2012 mei;207949;186;165;631;556;75;625;587;38;;27;0.01;-104;-0.05;207976
6757;Zuidoost-Friesland (CR);2012 juni;207976;159;161;667;612;55;702;638;64;;-37;-0.02;-141;-0.07;207939
6758;Zuidoost-Friesland (CR);2012 juli;207939;164;153;722;651;71;682;609;73;;51;0.02;-90;-0.04;207990
6759;Zuidoost-Friesland (CR);2012 augustus;207990;170;153;776;699;77;914;846;68;;-121;-0.06;-211;-0.1;207869
6760;Zuidoost-Friesland (CR);2012 september;207869;167;151;627;569;58;787;707;80;;-144;-0.07;-355;-0.17;207725
6761;Zuidoost-Friesland (CR);2012 oktober;207725;187;174;580;502;78;671;612;59;;-78;-0.04;-433;-0.21;207647
6762;Zuidoost-Friesland (CR);2012 november;207647;153;160;625;537;88;657;605;52;;-39;-0.02;-472;-0.23;207608
6763;Zuidoost-Friesland (CR);2012 december;207608;139;189;547;501;46;591;549;42;9.0;-85;-0.04;-557;-0.27;207523
6764;Zuidoost-Friesland (CR);2012;208080;1970;1913;7544;6785;759;8167;7504;663;9.0;-557;-0.27;-557;-0.27;207523
6765;Zuidoost-Friesland (CR);2013 januari;207523;162;215;681;620;61;656;624;32;;-28;-0.01;-28;-0.01;207495
6766;Zuidoost-Friesland (CR);2013 februari;207495;138;170;559;517;42;628;592;36;;-101;-0.05;-129;-0.06;207394
6767;Zuidoost-Friesland (CR);2013 maart;207394;145;186;615;553;62;616;574;42;;-42;-0.02;-171;-0.08;207352
6768;Zuidoost-Friesland (CR);2013 april;207352;173;162;499;442;57;570;517;53;;-60;-0.03;-231;-0.11;207292
6769;Zuidoost-Friesland (CR);2013 mei;207292;160;152;612;538;74;560;534;26;;60;0.03;-171;-0.08;207352
6770;Zuidoost-Friesland (CR);2013 juni;207352;169;139;561;519;42;547;503;44;;44;0.02;-127;-0.06;207396
6771;Zuidoost-Friesland (CR);2013 juli;207396;184;162;752;633;119;732;669;63;;42;0.02;-85;-0.04;207438
6772;Zuidoost-Friesland (CR);2013 augustus;207438;164;161;688;622;66;964;910;54;;-273;-0.13;-358;-0.17;207165
6773;Zuidoost-Friesland (CR);2013 september;207165;163;127;731;638;93;755;721;34;;12;0.01;-346;-0.17;207177
6774;Zuidoost-Friesland (CR);2013 oktober;207177;151;151;694;618;76;683;625;58;;11;0.01;-335;-0.16;207188
6775;Zuidoost-Friesland (CR);2013 november;207188;164;134;681;602;79;690;651;39;;21;0.01;-314;-0.15;207209
6776;Zuidoost-Friesland (CR);2013 december;207209;153;160;692;641;51;679;632;47;43.0;49;0.02;-265;-0.13;207258
6777;Zuidoost-Friesland (CR);2013;207523;1926;1919;7765;6943;822;8080;7552;528;43.0;-265;-0.13;-265;-0.13;207258
6778;Zuidoost-Friesland (CR);2014 januari;186355;163;145;730;610;120;626;578;48;;122;0.07;122;0.07;186477
6779;Zuidoost-Friesland (CR);2014 februari;186477;135;136;603;560;43;629;594;35;;-27;-0.01;95;0.05;186450
6780;Zuidoost-Friesland (CR);2014 maart;186450;143;159;626;570;56;521;481;40;;89;0.05;184;0.1;186539
6781;Zuidoost-Friesland (CR);2014 april;186539;151;152;592;536;56;549;514;35;;42;0.02;226;0.12;186581
6782;Zuidoost-Friesland (CR);2014 mei;186581;150;145;605;536;69;539;494;45;;71;0.04;297;0.16;186652
6783;Zuidoost-Friesland (CR);2014 juni;186652;152;144;630;563;67;577;531;46;;61;0.03;358;0.19;186713
6784;Zuidoost-Friesland (CR);2014 juli;186713;174;143;857;734;123;684;625;59;;204;0.11;562;0.3;186917
6785;Zuidoost-Friesland (CR);2014 augustus;186917;156;127;748;657;91;860;788;72;;-83;-0.04;479;0.26;186834
6786;Zuidoost-Friesland (CR);2014 september;186834;158;130;754;609;145;816;766;50;;-34;-0.02;445;0.24;186800
6787;Zuidoost-Friesland (CR);2014 oktober;186800;150;155;695;606;89;673;627;46;;17;0.01;462;0.25;186817
6788;Zuidoost-Friesland (CR);2014 november;186817;153;138;590;518;72;658;620;38;;-53;-0.03;409;0.22;186764
6789;Zuidoost-Friesland (CR);2014 december;186764;167;179;668;598;70;655;617;38;12.0;13;0.01;422;0.23;186777
6790;Zuidoost-Friesland (CR);2014;186355;1852;1753;8098;7097;1001;7787;7235;552;12.0;422;0.23;422;0.23;186777
6791;Zuidoost-Friesland (CR);2015 januari;186777;195;158;592;502;90;617;576;41;;12;0.01;12;0.01;186789
6792;Zuidoost-Friesland (CR);2015 februari;186789;118;185;664;590;74;674;628;46;;-77;-0.04;-65;-0.03;186712
6793;Zuidoost-Friesland (CR);2015 maart;186712;152;164;584;518;66;627;589;38;;-55;-0.03;-120;-0.06;186657
6794;Zuidoost-Friesland (CR);2015 april;186657;127;182;561;517;44;522;507;15;;-16;-0.01;-136;-0.07;186641
6795;Zuidoost-Friesland (CR);2015 mei;186641;137;152;548;480;68;492;474;18;;41;0.02;-95;-0.05;186682
6796;Zuidoost-Friesland (CR);2015 juni;186682;132;153;622;552;70;641;582;59;;-40;-0.02;-135;-0.07;186642
6797;Zuidoost-Friesland (CR);2015 juli;186642;138;131;841;740;101;730;677;53;;118;0.06;-17;-0.01;186760
6798;Zuidoost-Friesland (CR);2015 augustus;186760;166;151;825;714;111;894;822;72;;-54;-0.03;-71;-0.04;186706
6799;Zuidoost-Friesland (CR);2015 september;186706;156;128;761;688;73;847;787;60;;-58;-0.03;-129;-0.07;186648
6800;Zuidoost-Friesland (CR);2015 oktober;186648;143;137;768;690;78;705;651;54;;69;0.04;-60;-0.03;186717
6801;Zuidoost-Friesland (CR);2015 november;186717;132;147;650;583;67;623;577;46;;12;0.01;-48;-0.03;186729
6802;Zuidoost-Friesland (CR);2015 december;186729;141;165;672;621;51;728;666;62;1.0;-79;-0.04;-127;-0.07;186650
6803;Zuidoost-Friesland (CR);2015;186777;1737;1853;8088;7195;893;8100;7536;564;1.0;-127;-0.07;-127;-0.07;186650
6804;Zuidoost-Friesland (CR);2016 januari;186650;132;193;730;644;86;633;576;57;;36;0.02;36;0.02;186686
6805;Zuidoost-Friesland (CR);2016 februari;186686;112;182;709;641;68;701;649;52;;-62;-0.03;-26;-0.01;186624
6806;Zuidoost-Friesland (CR);2016 maart;186624;139;173;641;570;71;681;627;54;;-74;-0.04;-100;-0.05;186550
6807;Zuidoost-Friesland (CR);2016 april;186550;127;172;601;564;37;682;633;49;;-126;-0.07;-226;-0.12;186424
6808;Zuidoost-Friesland (CR);2016 mei;186424;130;164;682;612;70;577;518;59;;71;0.04;-155;-0.08;186495
6809;Zuidoost-Friesland (CR);2016 juni;186495;130;130;715;633;82;635;579;56;;80;0.04;-75;-0.04;186575
6810;Zuidoost-Friesland (CR);2016 juli;186575;151;153;849;776;73;748;667;81;;99;0.05;24;0.01;186674
6811;Zuidoost-Friesland (CR);2016 augustus;186674;169;144;960;865;95;907;847;60;;78;0.04;102;0.05;186752
6812;Zuidoost-Friesland (CR);2016 september;186752;144;150;764;693;71;858;816;42;;-100;-0.05;2;0.0;186652
6813;Zuidoost-Friesland (CR);2016 oktober;186652;145;171;799;736;63;679;639;40;;94;0.05;96;0.05;186746
6814;Zuidoost-Friesland (CR);2016 november;186746;122;164;689;620;69;614;573;41;;33;0.02;129;0.07;186779
6815;Zuidoost-Friesland (CR);2016 december;186779;125;175;751;706;45;713;668;45;-3.0;-15;-0.01;114;0.06;186764
6816;Zuidoost-Friesland (CR);2016;186650;1626;1971;8890;8060;830;8428;7792;636;-3.0;114;0.06;114;0.06;186764
6817;Zuidoost-Friesland (CR);2017 januari;186764;160;203;750;692;58;656;604;52;;51;0.03;51;0.03;186815
6818;Zuidoost-Friesland (CR);2017 februari;186815;120;145;701;657;44;654;615;39;;22;0.01;73;0.04;186837
6819;Zuidoost-Friesland (CR);2017 maart;186837;145;177;801;743;58;696;664;32;;73;0.04;146;0.08;186910
6820;Zuidoost-Friesland (CR);2017 april;186910;140;135;608;564;44;560;512;48;;53;0.03;199;0.11;186963
6821;Zuidoost-Friesland (CR);2017 mei;186963;154;159;646;594;52;657;616;41;;-16;-0.01;183;0.1;186947
6822;Zuidoost-Friesland (CR);2017 juni;186947;125;157;652;590;62;633;586;47;;-13;-0.01;170;0.09;186934
6823;Zuidoost-Friesland (CR);2017 juli;186934;145;149;924;849;75;830;783;47;;90;0.05;260;0.14;187024
6824;Zuidoost-Friesland (CR);2017 augustus;187024;147;144;931;843;88;926;874;52;;8;0.0;268;0.14;187032
6825;Zuidoost-Friesland (CR);2017 september;187032;132;140;799;754;45;813;751;62;;-22;-0.01;246;0.13;187010
6826;Zuidoost-Friesland (CR);2017 oktober;187010;156;152;712;647;65;673;639;34;;43;0.02;289;0.15;187053
6827;Zuidoost-Friesland (CR);2017 november;187053;121;169;699;658;41;661;610;51;;-10;-0.01;279;0.15;187043
6828;Zuidoost-Friesland (CR);2017 december;187043;133;175;799;763;36;783;736;47;-4.0;-30;-0.02;249;0.13;187013
6829;Zuidoost-Friesland (CR);2017;186764;1678;1905;9022;8354;668;8542;7990;552;-4.0;249;0.13;249;0.13;187013
6830;Zuidoost-Friesland (CR);2018 januari;187013;125;199;782;729;53;661;615;46;;47;0.03;47;0.03;187060
6831;Zuidoost-Friesland (CR);2018 februari;187060;145;177;685;644;41;654;619;35;;-1;0.0;46;0.02;187059
6832;Zuidoost-Friesland (CR);2018 maart;187059;135;217;702;650;52;730;699;31;;-110;-0.06;-64;-0.03;186949
6833;Zuidoost-Friesland (CR);2018 april;186949;128;149;616;555;61;605;574;31;;-10;-0.01;-74;-0.04;186939
6834;Zuidoost-Friesland (CR);2018 mei;186939;145;138;692;643;49;611;558;53;;88;0.05;14;0.01;187027
6835;Zuidoost-Friesland (CR);2018 juni;187027;129;120;709;640;69;708;660;48;;10;0.01;24;0.01;187037
6836;Zuidoost-Friesland (CR);2018 juli;187037;157;166;876;813;63;767;711;56;;100;0.05;124;0.07;187137
6837;Zuidoost-Friesland (CR);2018 augustus;187137;135;153;957;870;87;912;855;57;;27;0.01;151;0.08;187164
6838;Zuidoost-Friesland (CR);2018 september;187164;138;128;714;650;64;705;654;51;;19;0.01;170;0.09;187183
6839;Zuidoost-Friesland (CR);2018 oktober;187183;148;161;757;712;45;685;627;58;;59;0.03;229;0.12;187242
6840;Zuidoost-Friesland (CR);2018 november;187242;121;152;700;636;64;677;648;29;;-8;0.0;221;0.12;187234
6841;Zuidoost-Friesland (CR);2018 december;187234;119;152;722;670;52;668;626;42;0.0;21;0.01;242;0.13;187255
6842;Zuidoost-Friesland (CR);2018;187013;1625;1912;8912;8212;700;8383;7846;537;0.0;242;0.13;242;0.13;187255
6843;Zuidoost-Friesland (CR);2019 januari;187255;140;160;771;716;55;716;679;37;;35;0.02;35;0.02;187290
6844;Zuidoost-Friesland (CR);2019 februari;187290;113;154;613;546;67;567;529;38;;5;0.0;40;0.02;187295
6845;Zuidoost-Friesland (CR);2019 maart;187295;139;175;740;659;81;654;603;51;;50;0.03;90;0.05;187345
6846;Zuidoost-Friesland (CR);2019 april;187345;128;150;700;635;65;640;626;14;;38;0.02;128;0.07;187383
6847;Zuidoost-Friesland (CR);2019 mei;187383;144;146;701;642;59;670;622;48;;29;0.02;157;0.08;187412
6848;Zuidoost-Friesland (CR);2019 juni;187412;131;169;682;625;57;588;541;47;;56;0.03;213;0.11;187468
6849;Zuidoost-Friesland (CR);2019 juli;187468;178;150;866;762;104;744;703;41;;150;0.08;363;0.19;187618
6850;Zuidoost-Friesland (CR);2019 augustus;187618;161;136;843;732;111;829;745;84;;39;0.02;402;0.21;187657
6851;Zuidoost-Friesland (CR);2019 september;187657;132;129;768;665;103;812;766;46;;-41;-0.02;361;0.19;187616
6852;Zuidoost-Friesland (CR);2019 oktober;187616;146;161;797;708;89;688;659;29;;94;0.05;455;0.24;187710
6853;Zuidoost-Friesland (CR);2019 november;187710;117;174;644;571;73;561;516;45;;26;0.01;481;0.26;187736
6854;Zuidoost-Friesland (CR);2019 december;187736;125;155;740;687;53;685;659;26;-2.0;23;0.01;504;0.27;187759
6855;Zuidoost-Friesland (CR);2019;187255;1654;1859;8865;7948;917;8154;7648;506;-2.0;504;0.27;504;0.27;187759
6856;Zuidoost-Friesland (CR);2020 januari;187759;135;180;792;708;84;725;672;53;;22;0.01;22;0.01;187781
6857;Zuidoost-Friesland (CR);2020 februari;187781;117;168;654;589;65;699;668;31;;-96;-0.05;-74;-0.04;187685
6858;Zuidoost-Friesland (CR);2020 maart;187685;116;167;701;645;56;653;625;28;;-3;0.0;-77;-0.04;187682
6859;Zuidoost-Friesland (CR);2020 april;187682;130;209;667;642;25;640;599;41;;-52;-0.03;-129;-0.07;187630
6860;Zuidoost-Friesland (CR);2020 mei;187630;111;134;663;625;38;647;637;10;;-7;0.0;-136;-0.07;187623
6861;Zuidoost-Friesland (CR);2020 juni;187623;138;153;629;570;59;574;554;20;;40;0.02;-96;-0.05;187663
6862;Zuidoost-Friesland (CR);2020 juli;187663;146;138;857;770;87;754;696;58;;111;0.06;15;0.01;187774
6863;Zuidoost-Friesland (CR);2020 augustus;187774;165;159;844;759;85;771;724;47;;79;0.04;94;0.05;187853
6864;Zuidoost-Friesland (CR);2020 september;187853;150;131;716;662;54;685;659;26;;50;0.03;144;0.08;187903
6865;Zuidoost-Friesland (CR);2020 oktober;187903;151;176;804;746;58;691;663;28;;88;0.05;232;0.12;187991
6866;Zuidoost-Friesland (CR);2020 november;187991;161;173;670;637;33;592;570;22;;66;0.04;298;0.16;188057
6867;Zuidoost-Friesland (CR);2020 december;188057;129;173;764;710;54;676;639;37;-5.0;39;0.02;337;0.18;188096
6868;Zuidoost-Friesland (CR);2020;187759;1649;1961;8761;8063;698;8107;7706;401;-5.0;337;0.18;337;0.18;188096
6869;Zuidoost-Friesland (CR);2021 januari;188096;139;198;879;833;46;758;723;35;0.0;62;0.03;62;0.03;188158
6870;Zuidoost-Friesland (CR);2021 februari;188158;129;167;693;658;35;668;608;60;0.0;-13;-0.01;49;0.03;188145
6871;Zuidoost-Friesland (CR);2021 maart;188145;129;150;815;783;32;773;687;86;0.0;21;0.01;70;0.04;188166
6872;Zuidoost-Friesland (CR);2021 april;188166;168;154;712;680;32;693;633;60;0.0;33;0.02;103;0.05;188199
6873;Zuidoost-Friesland (CR);2021 mei;188199;155;143;685;648;37;544;529;15;0.0;153;0.08;256;0.14;188352
6874;Zuidoost-Friesland (CR);2021 juni;188352;148;168;667;612;55;617;581;36;0.0;30;0.02;286;0.15;188382
6875;Zuidoost-Friesland (CR);2021 juli;188382;171;132;798;735;63;686;650;36;0.0;151;0.08;437;0.23;188533
6876;Zuidoost-Friesland (CR);2021 augustus;188533;150;162;813;756;57;686;650;36;0.0;115;0.06;552;0.29;188648
6877;Zuidoost-Friesland (CR);2021 september;188648;152;161;689;626;63;714;673;41;0.0;-34;-0.02;518;0.28;188614
6878;Zuidoost-Friesland (CR);2021 oktober;188614;150;157;809;764;45;615;580;35;0.0;187;0.1;705;0.37;188801
6879;Zuidoost-Friesland (CR);2021 november;188801;156;197;677;644;33;594;571;23;0.0;42;0.02;747;0.4;188843
6880;Zuidoost-Friesland (CR);2021 december;188843;120;210;673;638;35;656;614;42;-7.0;-80;-0.04;667;0.35;188763
6881;Zuidoost-Friesland (CR);2021;188096;1767;1999;8910;8377;533;8004;7499;505;-7.0;667;0.35;667;0.35;188763
6882;Zuidoost-Friesland (CR);2022 januari;188763;130;193;690;637;53;637;608;29;;-10;-0.01;-10;-0.01;188753
6883;Zuidoost-Friesland (CR);2022 februari;188753;149;161;652;603;49;612;574;38;;28;0.01;18;0.01;188781
6884;Zuidoost-Friesland (CR);2022 maart;188781;137;205;911;625;286;616;555;61;;227;0.12;245;0.13;189008
6885;Zuidoost-Friesland (CR);2022 april;189008;134;171;1041;734;307;610;554;56;;394;0.21;639;0.34;189402
6886;Zuidoost-Friesland (CR);2022 mei;189402;120;188;808;658;150;613;565;48;;127;0.07;766;0.41;189529
6887;Zuidoost-Friesland (CR);2022 juni;189529;145;167;686;590;96;605;541;64;;59;0.03;825;0.44;189588
6888;Zuidoost-Friesland (CR);2022 juli;189588;140;161;872;703;169;682;596;86;;169;0.09;994;0.53;189757
6889;Zuidoost-Friesland (CR);2022 augustus;189757;131;170;977;823;154;826;749;77;;112;0.06;1106;0.59;189869
6890;Zuidoost-Friesland (CR);2022 september;189869;152;140;824;688;136;721;626;95;;115;0.06;1221;0.65;189984
6891;Zuidoost-Friesland (CR);2022 oktober;189984;140;202;792;679;113;687;622;65;;43;0.02;1264;0.67;190027
6892;Zuidoost-Friesland (CR);2022 november;190027;142;174;756;638;118;663;586;77;;61;0.03;1325;0.7;190088
6893;Zuidoost-Friesland (CR);2022 december;190088;112;218;748;672;76;627;570;57;-10.0;5;0.0;1330;0.7;190093
6894;Zuidoost-Friesland (CR);2022;188763;1632;2150;9757;8050;1707;7899;7146;753;-10.0;1330;0.7;1330;0.7;190093
6895;Zuidoost-Friesland (CR);2023 januari;190093;150;205;879;779;100;675;595;80;0.0;149;0.08;149;0.08;190242
6896;Zuidoost-Friesland (CR);2023 februari;190242;128;168;706;584;122;599;545;54;0.0;67;0.04;216;0.11;190309
6897;Zuidoost-Friesland (CR);2023 maart;190309;128;191;744;681;63;639;577;62;0.0;42;0.02;258;0.14;190351
6898;Zuidoost-Friesland (CR);2023 april;190351;126;180;648;598;50;591;524;67;0.0;3;0.0;261;0.14;190354
6899;Zuidoost-Friesland (CR);2023 mei;190354;132;177;848;732;116;644;584;60;0.0;159;0.08;420;0.22;190513
6900;Zuidoost-Friesland (CR);2023 juni;190513;112;175;743;647;96;653;613;40;0.0;27;0.01;447;0.24;190540
6901;Zuidoost-Friesland (CR);2023 juli;190540;144;180;944;773;171;776;722;54;0.0;132;0.07;579;0.3;190672
6902;Zuidoost-Friesland (CR);2023 augustus;190672;122;142;892;783;109;916;848;68;0.0;-44;-0.02;535;0.28;190628
6903;Zuidoost-Friesland (CR);2023 september;190628;127;150;861;728;133;823;749;74;0.0;15;0.01;550;0.29;190643
6904;Zuidoost-Friesland (CR);2023 oktober;190643;133;173;873;732;141;677;612;65;0.0;156;0.08;706;0.37;190799
6905;Zuidoost-Friesland (CR);2023 november;190799;135;206;738;615;123;637;551;86;0.0;30;0.02;736;0.39;190829
6906;Zuidoost-Friesland (CR);2023 december;190829;129;193;674;595;79;608;545;63;-13.0;-11;-0.01;725;0.38;190818
6907;Zuidoost-Friesland (CR);2023;190093;1566;2140;9550;8247;1303;8238;7465;773;-13.0;725;0.38;725;0.38;190818
6908;Zuidoost-Friesland (CR);2024 januari;190818;138;219;861;785;76;704;605;99;;76;0.04;76;0.04;190894
6909;Zuidoost-Friesland (CR);2024 februari;190894;148;168;737;642;95;635;568;67;;82;0.04;158;0.08;190976
6910;Zuidoost-Friesland (CR);2024 maart;190976;109;185;598;554;44;666;569;97;;-144;-0.08;14;0.01;190832
6911;Zuidoost-Friesland (CR);2024 april;190832;137;182;631;559;72;639;551;88;;-53;-0.03;-39;-0.02;190779
6912;Zuidoost-Friesland (CR);2024 mei;190779;150;170;706;614;92;606;555;51;;80;0.04;41;0.02;190859
6913;Zuidoost-Friesland (CR);2024 juni;190859;141;188;866;793;73;648;573;75;;171;0.09;212;0.11;191030
6914;Zuidoost-Friesland (CR);2024 juli;191030;146;188;942;817;125;760;685;75;;140;0.07;352;0.18;191170
6915;Zuidoost-Friesland (CR);2024 augustus;191170;134;179;866;778;88;808;734;74;;13;0.01;365;0.19;191183
6916;Zuidoost-Friesland (CR);2024 september;191183;147;184;949;783;166;752;675;77;;160;0.08;525;0.28;191343
6917;Zuidoost-Friesland (CR);2024 oktober;191343;137;191;799;712;87;673;609;64;;72;0.04;597;0.31;191415
6918;Zuidoost-Friesland (CR);2024 november;191415;134;187;784;709;75;729;661;68;;2;0.0;599;0.31;191417
6919;Zuidoost-Friesland (CR);2024 december;191417;136;180;801;731;70;694;623;71;0.0;63;0.03;662;0.35;191480
6920;Zuidoost-Friesland (CR);2024;190818;1657;2221;9540;8477;1063;8314;7408;906;0.0;662;0.35;662;0.35;191480
6921;Zuidoost-Friesland (CR);2025 januari;191480;151;213;959;856;103;809;748;61;;88;0.05;88;0.05;191568
6922;Zuidoost-Friesland (CR);2025 februari;191568;106;201;750;656;94;641;571;70;;14;0.01;102;0.05;191582
6923;Noord-Drenthe (CR);2002 januari;181903;183;154;932;738;194;752;690;62;;209;0.11;209;0.11;182112
6924;Noord-Drenthe (CR);2002 februari;182112;156;147;712;580;132;633;605;28;;88;0.05;297;0.16;182200
6925;Noord-Drenthe (CR);2002 maart;182200;190;161;803;697;106;720;671;49;;112;0.06;409;0.22;182312
6926;Noord-Drenthe (CR);2002 april;182312;182;133;758;647;111;615;582;33;;192;0.11;601;0.33;182504
6927;Noord-Drenthe (CR);2002 mei;182504;183;149;857;760;97;707;681;26;;184;0.1;785;0.43;182688
6928;Noord-Drenthe (CR);2002 juni;182688;173;140;869;757;112;594;543;51;;308;0.17;1093;0.6;182996
6929;Noord-Drenthe (CR);2002 juli;182996;181;158;1022;930;92;869;814;55;;176;0.1;1269;0.7;183172
6930;Noord-Drenthe (CR);2002 augustus;183172;206;135;976;835;141;884;781;103;;163;0.09;1432;0.79;183335
6931;Noord-Drenthe (CR);2002 september;183335;188;135;754;658;96;780;763;17;;27;0.01;1459;0.8;183362
6932;Noord-Drenthe (CR);2002 oktober;183362;202;159;737;641;96;768;716;52;;12;0.01;1471;0.81;183374
6933;Noord-Drenthe (CR);2002 november;183374;193;145;686;612;74;614;581;33;;120;0.07;1591;0.87;183494
6934;Noord-Drenthe (CR);2002 december;183494;166;150;727;675;52;566;544;22;-29.0;148;0.08;1739;0.96;183642
6935;Noord-Drenthe (CR);2002;181903;2203;1766;9833;8530;1303;8502;7971;531;-29.0;1739;0.96;1739;0.96;183642
6936;Noord-Drenthe (CR);2003 januari;183642;165;181;855;746;109;699;628;71;;140;0.08;140;0.08;183782
6937;Noord-Drenthe (CR);2003 februari;183782;170;142;627;555;72;637;589;48;;18;0.01;158;0.09;183800
6938;Noord-Drenthe (CR);2003 maart;183800;191;153;644;564;80;728;671;57;;-46;-0.03;112;0.06;183754
6939;Noord-Drenthe (CR);2003 april;183754;175;156;715;621;94;786;626;160;;-52;-0.03;60;0.03;183702
6940;Noord-Drenthe (CR);2003 mei;183702;166;151;606;543;63;574;544;30;;47;0.03;107;0.06;183749
6941;Noord-Drenthe (CR);2003 juni;183749;195;138;714;663;51;658;627;31;;113;0.06;220;0.12;183862
6942;Noord-Drenthe (CR);2003 juli;183862;189;133;874;814;60;758;687;71;;172;0.09;392;0.21;184034
6943;Noord-Drenthe (CR);2003 augustus;184034;182;140;739;702;37;802;742;60;;-21;-0.01;371;0.2;184013
6944;Noord-Drenthe (CR);2003 september;184013;159;127;697;621;76;794;711;83;;-65;-0.04;306;0.17;183948
6945;Noord-Drenthe (CR);2003 oktober;183948;200;134;767;709;58;684;630;54;;149;0.08;455;0.25;184097
6946;Noord-Drenthe (CR);2003 november;184097;168;125;597;544;53;584;537;47;;56;0.03;511;0.28;184153
6947;Noord-Drenthe (CR);2003 december;184153;170;160;687;640;47;616;552;64;47.0;128;0.07;639;0.35;184281
6948;Noord-Drenthe (CR);2003;183642;2130;1740;8522;7722;800;8320;7544;776;47.0;639;0.35;639;0.35;184281
6949;Noord-Drenthe (CR);2004 januari;184281;160;165;727;645;82;673;634;39;;49;0.03;49;0.03;184330
6950;Noord-Drenthe (CR);2004 februari;184330;158;105;683;607;76;566;532;34;;170;0.09;219;0.12;184500
6951;Noord-Drenthe (CR);2004 maart;184500;172;142;687;624;63;686;644;42;;31;0.02;250;0.14;184531
6952;Noord-Drenthe (CR);2004 april;184531;146;129;702;657;45;768;696;72;;-49;-0.03;201;0.11;184482
6953;Noord-Drenthe (CR);2004 mei;184482;150;148;642;597;45;683;677;6;;-39;-0.02;162;0.09;184443
6954;Noord-Drenthe (CR);2004 juni;184443;158;113;673;618;55;607;552;55;;111;0.06;273;0.15;184554
6955;Noord-Drenthe (CR);2004 juli;184554;169;150;831;792;39;736;693;43;;114;0.06;387;0.21;184668
6956;Noord-Drenthe (CR);2004 augustus;184668;166;139;751;687;64;764;726;38;;14;0.01;401;0.22;184682
6957;Noord-Drenthe (CR);2004 september;184682;161;139;738;664;74;688;689;-1;;72;0.04;473;0.26;184754
6958;Noord-Drenthe (CR);2004 oktober;184754;196;120;692;648;44;611;586;25;;157;0.08;630;0.34;184911
6959;Noord-Drenthe (CR);2004 november;184911;194;143;650;601;49;611;570;41;;90;0.05;720;0.39;185001
6960;Noord-Drenthe (CR);2004 december;185001;171;153;631;598;33;623;555;68;54.0;80;0.04;800;0.43;185081
6961;Noord-Drenthe (CR);2004;184281;2001;1646;8407;7738;669;8016;7554;462;54.0;800;0.43;800;0.43;185081
6962;Noord-Drenthe (CR);2005 januari;185081;175;180;661;622;39;588;574;14;;68;0.04;68;0.04;185149
6963;Noord-Drenthe (CR);2005 februari;185149;138;129;700;650;50;610;567;43;;99;0.05;167;0.09;185248
6964;Noord-Drenthe (CR);2005 maart;185248;166;172;636;603;33;715;620;95;;-85;-0.05;82;0.04;185163
6965;Noord-Drenthe (CR);2005 april;185163;178;126;702;673;29;583;555;28;;171;0.09;253;0.14;185334
6966;Noord-Drenthe (CR);2005 mei;185334;162;131;677;642;35;545;512;33;;163;0.09;416;0.22;185497
6967;Noord-Drenthe (CR);2005 juni;185497;157;138;724;656;68;588;556;32;;155;0.08;571;0.31;185652
6968;Noord-Drenthe (CR);2005 juli;185652;177;126;872;817;55;765;702;63;;158;0.09;729;0.39;185810
6969;Noord-Drenthe (CR);2005 augustus;185810;163;132;984;926;58;869;793;76;;146;0.08;875;0.47;185956
6970;Noord-Drenthe (CR);2005 september;185956;176;111;814;767;47;862;815;47;;17;0.01;892;0.48;185973
6971;Noord-Drenthe (CR);2005 oktober;185973;150;139;776;732;44;843;708;135;;-56;-0.03;836;0.45;185917
6972;Noord-Drenthe (CR);2005 november;185917;149;118;701;660;41;981;727;254;;-249;-0.13;587;0.32;185668
6973;Noord-Drenthe (CR);2005 december;185668;174;160;772;728;44;749;698;51;17.0;54;0.03;641;0.35;185722
6974;Noord-Drenthe (CR);2005;185081;1965;1662;9019;8476;543;8698;7827;871;17.0;641;0.35;641;0.35;185722
6975;Noord-Drenthe (CR);2006 januari;185722;159;147;749;691;58;760;747;13;;1;0.0;1;0.0;185723
6976;Noord-Drenthe (CR);2006 februari;185723;132;135;622;588;34;605;568;37;;14;0.01;15;0.01;185737
6977;Noord-Drenthe (CR);2006 maart;185737;181;147;721;686;35;640;607;33;;115;0.06;130;0.07;185852
6978;Noord-Drenthe (CR);2006 april;185852;149;149;576;548;28;576;563;13;;0;0.0;130;0.07;185852
6979;Noord-Drenthe (CR);2006 mei;185852;167;151;658;616;42;592;586;6;;82;0.04;212;0.11;185934
6980;Noord-Drenthe (CR);2006 juni;185934;153;138;686;650;36;644;619;25;;57;0.03;269;0.14;185991
6981;Noord-Drenthe (CR);2006 juli;185991;159;124;906;827;79;681;618;63;;260;0.14;529;0.28;186251
6982;Noord-Drenthe (CR);2006 augustus;186251;167;113;997;903;94;979;900;79;;72;0.04;601;0.32;186323
6983;Noord-Drenthe (CR);2006 september;186323;157;134;840;777;63;902;822;80;;-39;-0.02;562;0.3;186284
6984;Noord-Drenthe (CR);2006 oktober;186284;166;149;833;775;58;737;690;47;;113;0.06;675;0.36;186397
6985;Noord-Drenthe (CR);2006 november;186397;172;138;731;678;53;620;585;35;;145;0.08;820;0.44;186542
6986;Noord-Drenthe (CR);2006 december;186542;155;127;731;689;42;671;613;58;39.0;127;0.07;947;0.51;186669
6987;Noord-Drenthe (CR);2006;185722;1917;1652;9050;8428;622;8407;7918;489;39.0;947;0.51;947;0.51;186669
6988;Noord-Drenthe (CR);2007 januari;186669;174;141;748;695;53;723;677;46;;58;0.03;58;0.03;186727
6989;Noord-Drenthe (CR);2007 februari;186727;148;125;700;667;33;702;654;48;;21;0.01;79;0.04;186748
6990;Noord-Drenthe (CR);2007 maart;186748;150;160;761;728;33;639;615;24;;112;0.06;191;0.1;186860
6991;Noord-Drenthe (CR);2007 april;186860;120;111;625;585;40;572;557;15;;62;0.03;253;0.14;186922
6992;Noord-Drenthe (CR);2007 mei;186922;170;142;754;706;48;649;597;52;;133;0.07;386;0.21;187055
6993;Noord-Drenthe (CR);2007 juni;187055;133;124;659;608;51;620;596;24;;48;0.03;434;0.23;187103
6994;Noord-Drenthe (CR);2007 juli;187103;158;148;988;928;60;812;715;97;;186;0.1;620;0.33;187289
6995;Noord-Drenthe (CR);2007 augustus;187289;169;137;989;919;70;842;799;43;;179;0.1;799;0.43;187468
6996;Noord-Drenthe (CR);2007 september;187468;163;128;764;705;59;718;687;31;;81;0.04;880;0.47;187549
6997;Noord-Drenthe (CR);2007 oktober;187549;164;137;895;847;48;801;763;38;;121;0.06;1001;0.54;187670
6998;Noord-Drenthe (CR);2007 november;187670;153;166;727;698;29;674;614;60;;40;0.02;1041;0.56;187710
6999;Noord-Drenthe (CR);2007 december;187710;150;176;748;709;39;586;538;48;53.0;189;0.1;1230;0.66;187899
7000;Noord-Drenthe (CR);2007;186669;1852;1695;9358;8795;563;8338;7812;526;53.0;1230;0.66;1230;0.66;187899
7001;Noord-Drenthe (CR);2008 januari;187899;152;148;809;761;48;695;655;40;;118;0.06;118;0.06;188017
7002;Noord-Drenthe (CR);2008 februari;188017;155;139;648;609;39;613;542;71;;51;0.03;169;0.09;188068
7003;Noord-Drenthe (CR);2008 maart;188068;152;139;618;566;52;596;558;38;;35;0.02;204;0.11;188103
7004;Noord-Drenthe (CR);2008 april;188103;166;150;687;629;58;606;560;46;;97;0.05;301;0.16;188200
7005;Noord-Drenthe (CR);2008 mei;188200;173;126;653;615;38;582;542;40;;118;0.06;419;0.22;188318
7006;Noord-Drenthe (CR);2008 juni;188318;159;138;657;618;39;588;558;30;;90;0.05;509;0.27;188408
7007;Noord-Drenthe (CR);2008 juli;188408;186;139;886;832;54;855;782;73;;78;0.04;587;0.31;188486
7008;Noord-Drenthe (CR);2008 augustus;188486;181;136;870;800;70;848;752;96;;67;0.04;654;0.35;188553
7009;Noord-Drenthe (CR);2008 september;188553;166;125;821;763;58;818;776;42;;44;0.02;698;0.37;188597
7010;Noord-Drenthe (CR);2008 oktober;188597;165;147;761;700;61;706;650;56;;73;0.04;771;0.41;188670
7011;Noord-Drenthe (CR);2008 november;188670;148;145;672;638;34;617;574;43;;58;0.03;829;0.44;188728
7012;Noord-Drenthe (CR);2008 december;188728;106;142;762;717;45;577;532;45;38.0;187;0.1;1016;0.54;188915
7013;Noord-Drenthe (CR);2008;187899;1909;1674;8844;8248;596;8101;7481;620;38.0;1016;0.54;1016;0.54;188915
7014;Noord-Drenthe (CR);2009 januari;188915;163;172;650;601;49;663;614;49;;-22;-0.01;-22;-0.01;188893
7015;Noord-Drenthe (CR);2009 februari;188893;134;152;635;577;58;651;625;26;;-34;-0.02;-56;-0.03;188859
7016;Noord-Drenthe (CR);2009 maart;188859;154;144;631;590;41;577;547;30;;64;0.03;8;0.0;188923
7017;Noord-Drenthe (CR);2009 april;188923;160;147;658;605;53;571;529;42;;100;0.05;108;0.06;189023
7018;Noord-Drenthe (CR);2009 mei;189023;163;128;540;515;25;543;508;35;;32;0.02;140;0.07;189055
7019;Noord-Drenthe (CR);2009 juni;189055;174;124;591;532;59;542;533;9;;99;0.05;239;0.13;189154
7020;Noord-Drenthe (CR);2009 juli;189154;167;122;800;739;61;774;703;71;;71;0.04;310;0.16;189225
7021;Noord-Drenthe (CR);2009 augustus;189225;130;143;787;700;87;818;776;42;;-44;-0.02;266;0.14;189181
7022;Noord-Drenthe (CR);2009 september;189181;154;126;682;638;44;702;666;36;;8;0.0;274;0.15;189189
7023;Noord-Drenthe (CR);2009 oktober;189189;132;144;644;586;58;578;539;39;;54;0.03;328;0.17;189243
7024;Noord-Drenthe (CR);2009 november;189243;134;126;588;529;59;591;540;51;;5;0.0;333;0.18;189248
7025;Noord-Drenthe (CR);2009 december;189248;168;159;550;496;54;554;533;21;-57.0;-52;-0.03;281;0.15;189196
7026;Noord-Drenthe (CR);2009;188915;1833;1687;7756;7108;648;7564;7113;451;-57.0;281;0.15;281;0.15;189196
7027;Noord-Drenthe (CR);2010 januari;189196;148;146;587;528;59;602;571;31;;-13;-0.01;-13;-0.01;189183
7028;Noord-Drenthe (CR);2010 februari;189183;122;127;588;544;44;547;498;49;;36;0.02;23;0.01;189219
7029;Noord-Drenthe (CR);2010 maart;189219;154;150;646;587;59;619;542;77;;31;0.02;54;0.03;189250
7030;Noord-Drenthe (CR);2010 april;189250;135;134;602;555;47;552;516;36;;51;0.03;105;0.06;189301
7031;Noord-Drenthe (CR);2010 mei;189301;160;139;550;495;55;537;514;23;;34;0.02;139;0.07;189335
7032;Noord-Drenthe (CR);2010 juni;189335;139;129;636;530;106;501;466;35;;145;0.08;284;0.15;189480
7033;Noord-Drenthe (CR);2010 juli;189480;156;147;783;694;89;717;635;82;;75;0.04;359;0.19;189555
7034;Noord-Drenthe (CR);2010 augustus;189555;163;132;775;712;63;792;725;67;;14;0.01;373;0.2;189569
7035;Noord-Drenthe (CR);2010 september;189569;147;117;721;642;79;677;642;35;;74;0.04;447;0.24;189643
7036;Noord-Drenthe (CR);2010 oktober;189643;151;146;589;517;72;567;542;25;;27;0.01;474;0.25;189670
7037;Noord-Drenthe (CR);2010 november;189670;133;132;606;561;45;538;509;29;;69;0.04;543;0.29;189739
7038;Noord-Drenthe (CR);2010 december;189739;181;176;627;585;42;590;555;35;6.0;48;0.03;591;0.31;189787
7039;Noord-Drenthe (CR);2010;189196;1789;1675;7710;6950;760;7239;6715;524;6.0;591;0.31;591;0.31;189787
7040;Noord-Drenthe (CR);2011 januari;189787;145;163;649;613;36;603;558;45;;28;0.01;28;0.01;189815
7041;Noord-Drenthe (CR);2011 februari;189815;135;138;593;546;47;612;578;34;;-22;-0.01;6;0.0;189793
7042;Noord-Drenthe (CR);2011 maart;189793;137;151;565;530;35;589;540;49;;-38;-0.02;-32;-0.02;189755
7043;Noord-Drenthe (CR);2011 april;189755;134;152;633;579;54;521;487;34;;94;0.05;62;0.03;189849
7044;Noord-Drenthe (CR);2011 mei;189849;145;157;600;572;28;649;598;51;;-61;-0.03;1;0.0;189788
7045;Noord-Drenthe (CR);2011 juni;189788;140;136;588;549;39;520;487;33;;72;0.04;73;0.04;189860
7046;Noord-Drenthe (CR);2011 juli;189860;178;151;759;703;56;657;598;59;;129;0.07;202;0.11;189989
7047;Noord-Drenthe (CR);2011 augustus;189989;147;131;764;682;82;791;744;47;;-11;-0.01;191;0.1;189978
7048;Noord-Drenthe (CR);2011 september;189978;130;148;731;665;66;820;744;76;;-107;-0.06;84;0.04;189871
7049;Noord-Drenthe (CR);2011 oktober;189871;148;153;654;599;55;689;628;61;;-40;-0.02;44;0.02;189831
7050;Noord-Drenthe (CR);2011 november;189831;126;165;584;540;44;632;574;58;;-87;-0.05;-43;-0.02;189744
7051;Noord-Drenthe (CR);2011 december;189744;115;148;629;590;39;539;503;36;15.0;72;0.04;29;0.02;189816
7052;Noord-Drenthe (CR);2011;189787;1680;1793;7749;7168;581;7622;7039;583;15.0;29;0.02;29;0.02;189816
7053;Noord-Drenthe (CR);2012 januari;189816;156;188;667;634;33;678;617;61;;-43;-0.02;-43;-0.02;189773
7054;Noord-Drenthe (CR);2012 februari;189773;135;164;626;584;42;574;549;25;;23;0.01;-20;-0.01;189796
7055;Noord-Drenthe (CR);2012 maart;189796;139;173;589;552;37;693;543;150;;-138;-0.07;-158;-0.08;189658
7056;Noord-Drenthe (CR);2012 april;189658;121;165;545;512;33;503;473;30;;-2;0.0;-160;-0.08;189656
7057;Noord-Drenthe (CR);2012 mei;189656;155;144;537;488;49;492;475;17;;56;0.03;-104;-0.05;189712
7058;Noord-Drenthe (CR);2012 juni;189712;141;138;672;628;44;664;643;21;;11;0.01;-93;-0.05;189723
7059;Noord-Drenthe (CR);2012 juli;189723;144;137;734;661;73;696;642;54;;45;0.02;-48;-0.03;189768
7060;Noord-Drenthe (CR);2012 augustus;189768;155;152;779;716;63;876;820;56;;-94;-0.05;-142;-0.07;189674
7061;Noord-Drenthe (CR);2012 september;189674;146;147;705;652;53;795;736;59;;-91;-0.05;-233;-0.12;189583
7062;Noord-Drenthe (CR);2012 oktober;189583;143;134;708;648;60;643;604;39;;74;0.04;-159;-0.08;189657
7063;Noord-Drenthe (CR);2012 november;189657;144;134;607;559;48;526;527;-1;;91;0.05;-68;-0.04;189748
7064;Noord-Drenthe (CR);2012 december;189748;114;163;606;576;30;660;611;49;2.0;-101;-0.05;-169;-0.09;189647
7065;Noord-Drenthe (CR);2012;189816;1693;1839;7775;7210;565;7800;7240;560;2.0;-169;-0.09;-169;-0.09;189647
7066;Noord-Drenthe (CR);2013 januari;189647;121;177;714;664;50;701;661;40;;-43;-0.02;-43;-0.02;189604
7067;Noord-Drenthe (CR);2013 februari;189604;128;184;658;604;54;563;532;31;;39;0.02;-4;0.0;189643
7068;Noord-Drenthe (CR);2013 maart;189643;124;171;571;533;38;590;561;29;;-66;-0.03;-70;-0.04;189577
7069;Noord-Drenthe (CR);2013 april;189577;135;175;561;519;42;506;490;16;;15;0.01;-55;-0.03;189592
7070;Noord-Drenthe (CR);2013 mei;189592;143;159;555;510;45;575;536;39;;-36;-0.02;-91;-0.05;189556
7071;Noord-Drenthe (CR);2013 juni;189556;123;121;615;549;66;572;540;32;;45;0.02;-46;-0.02;189601
7072;Noord-Drenthe (CR);2013 juli;189601;159;127;783;718;65;758;698;60;;57;0.03;11;0.01;189658
7073;Noord-Drenthe (CR);2013 augustus;189658;153;118;834;762;72;906;849;57;;-37;-0.02;-26;-0.01;189621
7074;Noord-Drenthe (CR);2013 september;189621;135;127;684;615;69;746;717;29;;-54;-0.03;-80;-0.04;189567
7075;Noord-Drenthe (CR);2013 oktober;189567;124;146;685;623;62;640;591;49;;23;0.01;-57;-0.03;189590
7076;Noord-Drenthe (CR);2013 november;189590;112;136;637;590;47;678;637;41;;-65;-0.03;-122;-0.06;189525
7077;Noord-Drenthe (CR);2013 december;189525;115;145;621;591;30;627;580;47;4.0;-32;-0.02;-154;-0.08;189493
7078;Noord-Drenthe (CR);2013;189647;1572;1786;7918;7278;640;7862;7392;470;4.0;-154;-0.08;-154;-0.08;189493
7079;Noord-Drenthe (CR);2014 januari;189493;123;132;710;659;51;673;656;17;;28;0.01;28;0.01;189521
7080;Noord-Drenthe (CR);2014 februari;189521;128;130;687;644;43;636;598;38;;49;0.03;77;0.04;189570
7081;Noord-Drenthe (CR);2014 maart;189570;140;144;567;537;30;553;533;20;;10;0.01;87;0.05;189580
7082;Noord-Drenthe (CR);2014 april;189580;138;127;527;482;45;510;485;25;;28;0.01;115;0.06;189608
7083;Noord-Drenthe (CR);2014 mei;189608;147;132;565;525;40;573;527;46;;7;0.0;122;0.06;189615
7084;Noord-Drenthe (CR);2014 juni;189615;138;136;605;557;48;571;551;20;;36;0.02;158;0.08;189651
7085;Noord-Drenthe (CR);2014 juli;189651;156;153;872;795;77;853;792;61;;22;0.01;180;0.09;189673
7086;Noord-Drenthe (CR);2014 augustus;189673;140;160;777;720;57;931;830;101;;-174;-0.09;6;0.0;189499
7087;Noord-Drenthe (CR);2014 september;189499;144;126;717;650;67;824;757;67;;-89;-0.05;-83;-0.04;189410
7088;Noord-Drenthe (CR);2014 oktober;189410;129;154;687;631;56;706;648;58;;-44;-0.02;-127;-0.07;189366
7089;Noord-Drenthe (CR);2014 november;189366;116;135;675;626;49;682;639;43;;-26;-0.01;-153;-0.08;189340
7090;Noord-Drenthe (CR);2014 december;189340;138;157;752;694;58;719;677;42;5.0;19;0.01;-134;-0.07;189359
7091;Noord-Drenthe (CR);2014;189493;1637;1686;8141;7520;621;8231;7693;538;5.0;-134;-0.07;-134;-0.07;189359
7092;Noord-Drenthe (CR);2015 januari;189359;122;220;789;730;59;802;750;52;;-111;-0.06;-111;-0.06;189248
7093;Noord-Drenthe (CR);2015 februari;189248;115;161;680;612;68;652;603;49;;-18;-0.01;-129;-0.07;189230
7094;Noord-Drenthe (CR);2015 maart;189230;125;177;803;718;85;709;687;22;;42;0.02;-87;-0.05;189272
7095;Noord-Drenthe (CR);2015 april;189272;122;180;629;587;42;655;620;35;;-84;-0.04;-171;-0.09;189188
7096;Noord-Drenthe (CR);2015 mei;189188;117;139;681;632;49;625;585;40;;34;0.02;-137;-0.07;189222
7097;Noord-Drenthe (CR);2015 juni;189222;136;138;794;628;166;651;596;55;;141;0.07;4;0.0;189363
7098;Noord-Drenthe (CR);2015 juli;189363;127;163;1116;923;193;878;819;59;;202;0.11;206;0.11;189565
7099;Noord-Drenthe (CR);2015 augustus;189565;125;151;1043;816;227;1010;937;73;;7;0.0;213;0.11;189572
7100;Noord-Drenthe (CR);2015 september;189572;140;170;937;776;161;973;920;53;;-66;-0.03;147;0.08;189506
7101;Noord-Drenthe (CR);2015 oktober;189506;115;165;962;866;96;857;802;55;;55;0.03;202;0.11;189561
7102;Noord-Drenthe (CR);2015 november;189561;148;137;715;621;94;756;716;40;;-30;-0.02;172;0.09;189531
7103;Noord-Drenthe (CR);2015 december;189531;114;147;890;787;103;787;733;54;-4.0;66;0.03;238;0.13;189597
7104;Noord-Drenthe (CR);2015;189359;1506;1948;10039;8696;1343;9355;8768;587;-4.0;238;0.13;238;0.13;189597
7105;Noord-Drenthe (CR);2016 januari;189597;121;165;874;717;157;823;765;58;;7;0.0;7;0.0;189604
7106;Noord-Drenthe (CR);2016 februari;189604;133;159;998;766;232;901;854;47;;71;0.04;78;0.04;189675
7107;Noord-Drenthe (CR);2016 maart;189675;138;166;865;659;206;778;735;43;;59;0.03;137;0.07;189734
7108;Noord-Drenthe (CR);2016 april;189734;120;161;994;842;152;773;728;45;;180;0.09;317;0.17;189914
7109;Noord-Drenthe (CR);2016 mei;189914;142;158;1126;699;427;827;790;37;;283;0.15;600;0.32;190197
7110;Noord-Drenthe (CR);2016 juni;190197;132;156;1321;811;510;1079;1022;57;;218;0.11;818;0.43;190415
7111;Noord-Drenthe (CR);2016 juli;190415;157;147;1628;1085;543;1352;1288;64;;286;0.15;1104;0.58;190701
7112;Noord-Drenthe (CR);2016 augustus;190701;147;138;1598;917;681;1588;1530;58;;19;0.01;1123;0.59;190720
7113;Noord-Drenthe (CR);2016 september;190720;152;147;1796;900;896;1414;1369;45;;387;0.2;1510;0.8;191107
7114;Noord-Drenthe (CR);2016 oktober;191107;159;163;2601;916;1685;1943;1908;35;;654;0.34;2164;1.14;191761
7115;Noord-Drenthe (CR);2016 november;191761;112;182;3124;763;2361;2508;2465;43;;546;0.28;2710;1.43;192307
7116;Noord-Drenthe (CR);2016 december;192307;95;146;3271;935;2336;3041;2970;71;11.0;190;0.1;2900;1.53;192497
7117;Noord-Drenthe (CR);2016;189597;1608;1888;20196;10010;10186;17027;16424;603;11.0;2900;1.53;2900;1.53;192497
7118;Noord-Drenthe (CR);2017 januari;192497;143;222;2401;912;1489;2757;2713;44;;-435;-0.23;-435;-0.23;192062
7119;Noord-Drenthe (CR);2017 februari;192062;118;188;3233;799;2434;2879;2842;37;;284;0.15;-151;-0.08;192346
7120;Noord-Drenthe (CR);2017 maart;192346;120;154;3152;891;2261;3337;3305;32;;-219;-0.11;-370;-0.19;192127
7121;Noord-Drenthe (CR);2017 april;192127;104;154;2692;750;1942;2603;2569;34;;39;0.02;-331;-0.17;192166
7122;Noord-Drenthe (CR);2017 mei;192166;127;172;2638;822;1816;2787;2756;31;;-194;-0.1;-525;-0.27;191972
7123;Noord-Drenthe (CR);2017 juni;191972;130;158;1938;761;1177;2333;2289;44;;-423;-0.22;-948;-0.49;191549
7124;Noord-Drenthe (CR);2017 juli;191549;142;158;1895;899;996;2012;1930;82;;-133;-0.07;-1081;-0.56;191416
7125;Noord-Drenthe (CR);2017 augustus;191416;156;136;2197;1134;1063;2125;2048;77;;92;0.05;-989;-0.51;191508
7126;Noord-Drenthe (CR);2017 september;191508;133;146;2014;927;1087;1749;1697;52;;252;0.13;-737;-0.38;191760
7127;Noord-Drenthe (CR);2017 oktober;191760;151;150;1957;853;1104;1979;1922;57;;-21;-0.01;-758;-0.39;191739
7128;Noord-Drenthe (CR);2017 november;191739;158;180;1959;773;1186;1834;1793;41;;103;0.05;-655;-0.34;191842
7129;Noord-Drenthe (CR);2017 december;191842;116;177;2161;886;1275;1821;1783;38;-19.0;260;0.14;-395;-0.21;192102
7130;Noord-Drenthe (CR);2017;192497;1598;1995;28237;10407;17830;28216;27647;569;-19.0;-395;-0.21;-395;-0.21;192102
7131;Noord-Drenthe (CR);2018 januari;192102;118;201;1004;913;91;1632;1571;61;;-711;-0.37;-711;-0.37;191391
7132;Noord-Drenthe (CR);2018 februari;191391;117;197;771;730;41;927;900;27;;-236;-0.12;-947;-0.49;191155
7133;Noord-Drenthe (CR);2018 maart;191155;143;210;812;750;62;812;775;37;;-67;-0.04;-1014;-0.53;191088
7134;Noord-Drenthe (CR);2018 april;191088;113;145;767;717;50;720;685;35;;15;0.01;-999;-0.52;191103
7135;Noord-Drenthe (CR);2018 mei;191103;128;165;824;773;51;799;766;33;;-12;-0.01;-1011;-0.53;191091
7136;Noord-Drenthe (CR);2018 juni;191091;132;164;915;861;54;764;696;68;;119;0.06;-892;-0.46;191210
7137;Noord-Drenthe (CR);2018 juli;191210;145;152;964;874;90;886;820;66;;71;0.04;-821;-0.43;191281
7138;Noord-Drenthe (CR);2018 augustus;191281;138;162;1184;1076;108;1087;1016;71;;73;0.04;-748;-0.39;191354
7139;Noord-Drenthe (CR);2018 september;191354;160;153;989;925;64;909;849;60;;87;0.05;-661;-0.34;191441
7140;Noord-Drenthe (CR);2018 oktober;191441;132;156;994;910;84;837;796;41;;133;0.07;-528;-0.27;191574
7141;Noord-Drenthe (CR);2018 november;191574;122;172;845;789;56;807;785;22;;-12;-0.01;-540;-0.28;191562
7142;Noord-Drenthe (CR);2018 december;191562;127;191;835;776;59;794;763;31;-24.0;-47;-0.02;-587;-0.31;191515
7143;Noord-Drenthe (CR);2018;192102;1575;2068;10904;10094;810;10974;10422;552;-24.0;-587;-0.31;-587;-0.31;191515
7144;Noord-Drenthe (CR);2019 januari;191515;115;182;943;868;75;852;811;41;;24;0.01;24;0.01;191539
7145;Noord-Drenthe (CR);2019 februari;191539;102;172;878;822;56;817;783;34;;-9;0.0;15;0.01;191530
7146;Noord-Drenthe (CR);2019 maart;191530;119;173;824;742;82;760;745;15;;10;0.01;25;0.01;191540
7147;Noord-Drenthe (CR);2019 april;191540;129;161;855;765;90;713;692;21;;110;0.06;135;0.07;191650
7148;Noord-Drenthe (CR);2019 mei;191650;133;155;893;794;99;713;689;24;;158;0.08;293;0.15;191808
7149;Noord-Drenthe (CR);2019 juni;191808;126;158;730;633;97;648;616;32;;50;0.03;343;0.18;191858
7150;Noord-Drenthe (CR);2019 juli;191858;138;180;1107;953;154;862;800;62;;203;0.11;546;0.29;192061
7151;Noord-Drenthe (CR);2019 augustus;192061;141;156;1047;901;146;978;913;65;;54;0.03;600;0.31;192115
7152;Noord-Drenthe (CR);2019 september;192115;133;151;907;813;94;906;866;40;;-17;-0.01;583;0.3;192098
7153;Noord-Drenthe (CR);2019 oktober;192098;144;148;920;814;106;787;740;47;;129;0.07;712;0.37;192227
7154;Noord-Drenthe (CR);2019 november;192227;127;176;846;772;74;802;752;50;;-5;0.0;707;0.37;192222
7155;Noord-Drenthe (CR);2019 december;192222;119;175;985;885;100;776;743;33;-6.0;147;0.08;854;0.45;192369
7156;Noord-Drenthe (CR);2019;191515;1526;1987;10935;9762;1173;9614;9150;464;-6.0;854;0.45;854;0.45;192369
7157;Noord-Drenthe (CR);2020 januari;192369;145;196;926;839;87;912;861;51;;-37;-0.02;-37;-0.02;192332
7158;Noord-Drenthe (CR);2020 februari;192332;120;161;875;830;45;780;744;36;;54;0.03;17;0.01;192386
7159;Noord-Drenthe (CR);2020 maart;192386;133;189;796;730;66;767;749;18;;-27;-0.01;-10;-0.01;192359
7160;Noord-Drenthe (CR);2020 april;192359;136;165;773;731;42;695;683;12;;49;0.03;39;0.02;192408
7161;Noord-Drenthe (CR);2020 mei;192408;128;184;865;835;30;740;723;17;;69;0.04;108;0.06;192477
7162;Noord-Drenthe (CR);2020 juni;192477;120;163;837;788;49;738;721;17;;56;0.03;164;0.09;192533
7163;Noord-Drenthe (CR);2020 juli;192533;145;184;1083;1026;57;988;937;51;;56;0.03;220;0.11;192589
7164;Noord-Drenthe (CR);2020 augustus;192589;123;169;891;809;82;849;830;19;;-4;0.0;216;0.11;192585
7165;Noord-Drenthe (CR);2020 september;192585;159;181;934;862;72;834;784;50;;78;0.04;294;0.15;192663
7166;Noord-Drenthe (CR);2020 oktober;192663;136;192;988;943;45;920;867;53;;12;0.01;306;0.16;192675
7167;Noord-Drenthe (CR);2020 november;192675;124;176;860;810;50;816;780;36;;-8;0.0;298;0.15;192667
7168;Noord-Drenthe (CR);2020 december;192667;134;192;984;923;61;782;751;31;-3.0;141;0.07;439;0.23;192808
7169;Noord-Drenthe (CR);2020;192369;1603;2152;10812;10126;686;9821;9430;391;-3.0;439;0.23;439;0.23;192808
7170;Noord-Drenthe (CR);2021 januari;192808;134;248;937;887;50;838;808;30;0.0;-15;-0.01;-15;-0.01;192793
7171;Noord-Drenthe (CR);2021 februari;192793;140;191;896;869;27;746;725;21;0.0;99;0.05;84;0.04;192892
7172;Noord-Drenthe (CR);2021 maart;192892;173;180;1116;1073;43;908;879;29;0.0;201;0.1;285;0.15;193093
7173;Noord-Drenthe (CR);2021 april;193093;150;174;945;909;36;800;781;19;0.0;121;0.06;406;0.21;193214
7174;Noord-Drenthe (CR);2021 mei;193214;145;167;792;771;21;747;719;28;0.0;23;0.01;429;0.22;193237
7175;Noord-Drenthe (CR);2021 juni;193237;130;163;931;882;49;790;736;54;0.0;108;0.06;537;0.28;193345
7176;Noord-Drenthe (CR);2021 juli;193345;135;142;1052;977;75;884;803;81;0.0;161;0.08;698;0.36;193506
7177;Noord-Drenthe (CR);2021 augustus;193506;137;129;958;894;64;840;761;79;0.0;126;0.07;824;0.43;193632
7178;Noord-Drenthe (CR);2021 september;193632;177;172;957;915;42;836;765;71;0.0;126;0.07;950;0.49;193758
7179;Noord-Drenthe (CR);2021 oktober;193758;134;173;829;787;42;803;753;50;0.0;-13;-0.01;937;0.49;193745
7180;Noord-Drenthe (CR);2021 november;193745;143;214;840;760;80;787;770;17;0.0;-18;-0.01;919;0.48;193727
7181;Noord-Drenthe (CR);2021 december;193727;125;231;823;782;41;725;669;56;-13.0;-21;-0.01;898;0.47;193706
7182;Noord-Drenthe (CR);2021;192808;1723;2184;11076;10506;570;9704;9169;535;-13.0;898;0.47;898;0.47;193706
7183;Noord-Drenthe (CR);2022 januari;193706;124;199;990;942;48;742;700;42;;173;0.09;173;0.09;193879
7184;Noord-Drenthe (CR);2022 februari;193879;130;158;787;736;51;637;617;20;;122;0.06;295;0.15;194001
7185;Noord-Drenthe (CR);2022 maart;194001;119;189;1149;738;411;750;721;29;;329;0.17;624;0.32;194330
7186;Noord-Drenthe (CR);2022 april;194330;134;193;1182;827;355;790;766;24;;333;0.17;957;0.49;194663
7187;Noord-Drenthe (CR);2022 mei;194663;116;197;935;768;167;859;792;67;;-5;0.0;952;0.49;194658
7188;Noord-Drenthe (CR);2022 juni;194658;116;197;1010;716;294;771;663;108;;158;0.08;1110;0.57;194816
7189;Noord-Drenthe (CR);2022 juli;194816;149;190;1112;882;230;915;838;77;;156;0.08;1266;0.65;194972
7190;Noord-Drenthe (CR);2022 augustus;194972;134;191;993;848;145;942;810;132;;-6;0.0;1260;0.65;194966
7191;Noord-Drenthe (CR);2022 september;194966;161;153;1216;956;260;920;811;109;;304;0.16;1564;0.81;195270
7192;Noord-Drenthe (CR);2022 oktober;195270;135;175;984;817;167;829;763;66;;115;0.06;1679;0.87;195385
7193;Noord-Drenthe (CR);2022 november;195385;135;190;856;762;94;849;779;70;;-48;-0.02;1631;0.84;195337
7194;Noord-Drenthe (CR);2022 december;195337;124;216;960;883;77;896;808;88;-1.0;-29;-0.01;1602;0.83;195308
7195;Noord-Drenthe (CR);2022;193706;1577;2248;12174;9875;2299;9900;9068;832;-1.0;1602;0.83;1602;0.83;195308
7196;Noord-Drenthe (CR);2023 januari;195308;131;196;917;818;99;854;775;79;0.0;-2;0.0;-2;0.0;195306
7197;Noord-Drenthe (CR);2023 februari;195306;123;180;876;779;97;733;655;78;0.0;86;0.04;84;0.04;195392
7198;Noord-Drenthe (CR);2023 maart;195392;137;208;944;825;119;832;754;78;0.0;41;0.02;125;0.06;195433
7199;Noord-Drenthe (CR);2023 april;195433;118;178;776;698;78;723;639;84;0.0;-7;0.0;118;0.06;195426
7200;Noord-Drenthe (CR);2023 mei;195426;113;183;951;875;76;796;716;80;0.0;85;0.04;203;0.1;195511
7201;Noord-Drenthe (CR);2023 juni;195511;123;166;1027;954;73;948;857;91;0.0;36;0.02;239;0.12;195547
7202;Noord-Drenthe (CR);2023 juli;195547;154;168;1153;978;175;1022;949;73;0.0;117;0.06;356;0.18;195664
7203;Noord-Drenthe (CR);2023 augustus;195664;124;173;1124;881;243;1044;948;96;0.0;31;0.02;387;0.2;195695
7204;Noord-Drenthe (CR);2023 september;195695;145;170;1014;867;147;940;848;92;0.0;49;0.03;436;0.22;195744
7205;Noord-Drenthe (CR);2023 oktober;195744;132;178;940;764;176;823;718;105;0.0;71;0.04;507;0.26;195815
7206;Noord-Drenthe (CR);2023 november;195815;152;195;915;816;99;739;675;64;0.0;133;0.07;640;0.33;195948
7207;Noord-Drenthe (CR);2023 december;195948;127;213;1012;928;84;807;725;82;-7.0;112;0.06;752;0.39;196060
7208;Noord-Drenthe (CR);2023;195308;1579;2208;11649;10183;1466;10261;9259;1002;-7.0;752;0.39;752;0.39;196060
7209;Noord-Drenthe (CR);2024 januari;196060;140;252;1060;927;133;876;814;62;;72;0.04;72;0.04;196132
7210;Noord-Drenthe (CR);2024 februari;196132;117;218;941;832;109;756;691;65;;84;0.04;156;0.08;196216
7211;Noord-Drenthe (CR);2024 maart;196216;98;206;990;867;123;790;717;73;;92;0.05;248;0.13;196308
7212;Noord-Drenthe (CR);2024 april;196308;123;177;852;767;85;850;749;101;;-52;-0.03;196;0.1;196256
7213;Noord-Drenthe (CR);2024 mei;196256;106;205;911;825;86;715;660;55;;97;0.05;293;0.15;196353
7214;Noord-Drenthe (CR);2024 juni;196353;129;179;923;811;112;714;637;77;;159;0.08;452;0.23;196512
7215;Noord-Drenthe (CR);2024 juli;196512;129;184;1043;912;131;857;766;91;;131;0.07;583;0.3;196643
7216;Noord-Drenthe (CR);2024 augustus;196643;125;182;1147;960;187;977;889;88;;113;0.06;696;0.35;196756
7217;Noord-Drenthe (CR);2024 september;196756;137;168;1029;878;151;844;773;71;;154;0.08;850;0.43;196910
7218;Noord-Drenthe (CR);2024 oktober;196910;137;199;977;858;119;791;715;76;;124;0.06;974;0.5;197034
7219;Noord-Drenthe (CR);2024 november;197034;127;181;889;827;62;811;720;91;;24;0.01;998;0.51;197058
7220;Noord-Drenthe (CR);2024 december;197058;141;205;920;847;73;777;709;68;0.0;79;0.04;1077;0.55;197137
7221;Noord-Drenthe (CR);2024;196060;1509;2356;11682;10311;1371;9758;8840;918;0.0;1077;0.55;1077;0.55;197137
7222;Noord-Drenthe (CR);2025 januari;197137;119;245;915;827;88;832;767;65;;-43;-0.02;-43;-0.02;197094
7223;Noord-Drenthe (CR);2025 februari;197094;139;227;902;829;73;798;726;72;;16;0.01;-27;-0.01;197110
7224;Zuidoost-Drenthe (CR);2002 januari;170456;194;164;542;457;85;558;462;96;;14;0.01;14;0.01;170470
7225;Zuidoost-Drenthe (CR);2002 februari;170470;157;132;520;445;75;472;408;64;;73;0.04;87;0.05;170543
7226;Zuidoost-Drenthe (CR);2002 maart;170543;168;165;510;433;77;527;463;64;;-14;-0.01;73;0.04;170529
7227;Zuidoost-Drenthe (CR);2002 april;170529;124;148;472;410;62;502;422;80;;-54;-0.03;19;0.01;170475
7228;Zuidoost-Drenthe (CR);2002 mei;170475;179;156;520;461;59;540;448;92;;3;0.0;22;0.01;170478
7229;Zuidoost-Drenthe (CR);2002 juni;170478;159;132;417;356;61;508;436;72;;-64;-0.04;-42;-0.02;170414
7230;Zuidoost-Drenthe (CR);2002 juli;170414;177;146;736;651;85;696;587;109;;71;0.04;29;0.02;170485
7231;Zuidoost-Drenthe (CR);2002 augustus;170485;175;113;708;606;102;690;591;99;;80;0.05;109;0.06;170565
7232;Zuidoost-Drenthe (CR);2002 september;170565;179;110;610;476;134;607;512;95;;72;0.04;181;0.11;170637
7233;Zuidoost-Drenthe (CR);2002 oktober;170637;180;145;603;504;99;518;476;42;;120;0.07;301;0.18;170757
7234;Zuidoost-Drenthe (CR);2002 november;170757;151;137;467;378;89;565;468;97;;-84;-0.05;217;0.13;170673
7235;Zuidoost-Drenthe (CR);2002 december;170673;145;154;473;436;37;492;394;98;1.0;-27;-0.02;190;0.11;170646
7236;Zuidoost-Drenthe (CR);2002;170456;1988;1702;6578;5613;965;6675;5667;1008;1.0;190;0.11;190;0.11;170646
7237;Zuidoost-Drenthe (CR);2003 januari;170646;156;158;586;518;68;542;490;52;;42;0.02;42;0.02;170688
7238;Zuidoost-Drenthe (CR);2003 februari;170688;147;118;440;388;52;544;436;108;;-75;-0.04;-33;-0.02;170613
7239;Zuidoost-Drenthe (CR);2003 maart;170613;147;176;481;426;55;494;430;64;;-42;-0.02;-75;-0.04;170571
7240;Zuidoost-Drenthe (CR);2003 april;170571;155;128;460;429;31;535;473;62;;-48;-0.03;-123;-0.07;170523
7241;Zuidoost-Drenthe (CR);2003 mei;170523;166;117;466;413;53;493;414;79;;22;0.01;-101;-0.06;170545
7242;Zuidoost-Drenthe (CR);2003 juni;170545;147;113;524;452;72;513;443;70;;45;0.03;-56;-0.03;170590
7243;Zuidoost-Drenthe (CR);2003 juli;170590;166;126;632;584;48;553;464;89;;119;0.07;63;0.04;170709
7244;Zuidoost-Drenthe (CR);2003 augustus;170709;157;135;618;547;71;706;594;112;;-66;-0.04;-3;0.0;170643
7245;Zuidoost-Drenthe (CR);2003 september;170643;158;146;541;474;67;628;574;54;;-75;-0.04;-78;-0.05;170568
7246;Zuidoost-Drenthe (CR);2003 oktober;170568;180;128;585;496;89;530;469;61;;107;0.06;29;0.02;170675
7247;Zuidoost-Drenthe (CR);2003 november;170675;155;106;522;408;114;442;379;63;;129;0.08;158;0.09;170804
7248;Zuidoost-Drenthe (CR);2003 december;170804;136;137;533;481;52;474;384;90;72.0;130;0.08;288;0.17;170934
7249;Zuidoost-Drenthe (CR);2003;170646;1870;1588;6388;5616;772;6454;5550;904;72.0;288;0.17;288;0.17;170934
7250;Zuidoost-Drenthe (CR);2004 januari;170934;143;137;500;456;44;476;439;37;;30;0.02;30;0.02;170964
7251;Zuidoost-Drenthe (CR);2004 februari;170964;131;119;443;405;38;547;482;65;;-92;-0.05;-62;-0.04;170872
7252;Zuidoost-Drenthe (CR);2004 maart;170872;161;150;562;516;46;649;568;81;;-76;-0.04;-138;-0.08;170796
7253;Zuidoost-Drenthe (CR);2004 april;170796;138;132;480;443;37;465;391;74;;21;0.01;-117;-0.07;170817
7254;Zuidoost-Drenthe (CR);2004 mei;170817;151;128;460;380;80;414;355;59;;69;0.04;-48;-0.03;170886
7255;Zuidoost-Drenthe (CR);2004 juni;170886;154;135;491;448;43;475;418;57;;35;0.02;-13;-0.01;170921
7256;Zuidoost-Drenthe (CR);2004 juli;170921;179;128;562;500;62;596;489;107;;17;0.01;4;0.0;170938
7257;Zuidoost-Drenthe (CR);2004 augustus;170938;156;118;607;541;66;647;545;102;;-2;0.0;2;0.0;170936
7258;Zuidoost-Drenthe (CR);2004 september;170936;163;128;583;526;57;672;555;117;;-54;-0.03;-52;-0.03;170882
7259;Zuidoost-Drenthe (CR);2004 oktober;170882;148;128;502;432;70;506;443;63;;16;0.01;-36;-0.02;170898
7260;Zuidoost-Drenthe (CR);2004 november;170898;145;133;531;482;49;509;452;57;;34;0.02;-2;0.0;170932
7261;Zuidoost-Drenthe (CR);2004 december;170932;127;141;512;489;23;456;404;52;56.0;98;0.06;96;0.06;171030
7262;Zuidoost-Drenthe (CR);2004;170934;1796;1577;6233;5618;615;6412;5541;871;56.0;96;0.06;96;0.06;171030
7263;Zuidoost-Drenthe (CR);2005 januari;171030;126;129;477;442;35;482;434;48;;-8;0.0;-8;0.0;171022
7264;Zuidoost-Drenthe (CR);2005 februari;171022;101;132;455;407;48;503;460;43;;-79;-0.05;-87;-0.05;170943
7265;Zuidoost-Drenthe (CR);2005 maart;170943;140;177;457;411;46;568;504;64;;-148;-0.09;-235;-0.14;170795
7266;Zuidoost-Drenthe (CR);2005 april;170795;157;133;544;478;66;538;458;80;;30;0.02;-205;-0.12;170825
7267;Zuidoost-Drenthe (CR);2005 mei;170825;141;129;516;496;20;467;371;96;;61;0.04;-144;-0.08;170886
7268;Zuidoost-Drenthe (CR);2005 juni;170886;158;137;532;478;54;497;415;82;;56;0.03;-88;-0.05;170942
7269;Zuidoost-Drenthe (CR);2005 juli;170942;140;121;590;548;42;563;479;84;;46;0.03;-42;-0.02;170988
7270;Zuidoost-Drenthe (CR);2005 augustus;170988;181;118;703;624;79;744;658;86;;22;0.01;-20;-0.01;171010
7271;Zuidoost-Drenthe (CR);2005 september;171010;166;111;636;564;72;717;630;87;;-26;-0.02;-46;-0.03;170984
7272;Zuidoost-Drenthe (CR);2005 oktober;170984;146;130;546;484;62;572;484;88;;-10;-0.01;-56;-0.03;170974
7273;Zuidoost-Drenthe (CR);2005 november;170974;135;133;551;490;61;572;503;69;;-19;-0.01;-75;-0.04;170955
7274;Zuidoost-Drenthe (CR);2005 december;170955;123;137;543;517;26;500;424;76;43.0;72;0.04;-3;0.0;171027
7275;Zuidoost-Drenthe (CR);2005;171030;1714;1587;6550;5939;611;6723;5820;903;43.0;-3;0.0;-3;0.0;171027
7276;Zuidoost-Drenthe (CR);2006 januari;171027;156;157;551;521;30;516;453;63;;34;0.02;34;0.02;171061
7277;Zuidoost-Drenthe (CR);2006 februari;171061;143;123;462;435;27;493;408;85;;-11;-0.01;23;0.01;171050
7278;Zuidoost-Drenthe (CR);2006 maart;171050;154;141;551;500;51;518;458;60;;46;0.03;69;0.04;171096
7279;Zuidoost-Drenthe (CR);2006 april;171096;156;128;447;408;39;457;403;54;;18;0.01;87;0.05;171114
7280;Zuidoost-Drenthe (CR);2006 mei;171114;130;127;440;393;47;475;417;58;;-32;-0.02;55;0.03;171082
7281;Zuidoost-Drenthe (CR);2006 juni;171082;134;133;495;465;30;478;403;75;;18;0.01;73;0.04;171100
7282;Zuidoost-Drenthe (CR);2006 juli;171100;145;149;661;598;63;569;485;84;;88;0.05;161;0.09;171188
7283;Zuidoost-Drenthe (CR);2006 augustus;171188;149;124;666;611;55;704;624;80;;-13;-0.01;148;0.09;171175
7284;Zuidoost-Drenthe (CR);2006 september;171175;140;120;543;480;63;663;636;27;;-100;-0.06;48;0.03;171075
7285;Zuidoost-Drenthe (CR);2006 oktober;171075;144;143;556;484;72;573;481;92;;-16;-0.01;32;0.02;171059
7286;Zuidoost-Drenthe (CR);2006 november;171059;143;98;493;443;50;493;419;74;;45;0.03;77;0.05;171104
7287;Zuidoost-Drenthe (CR);2006 december;171104;131;114;472;435;37;462;400;62;38.0;65;0.04;142;0.08;171169
7288;Zuidoost-Drenthe (CR);2006;171027;1725;1557;6337;5773;564;6401;5587;814;38.0;142;0.08;142;0.08;171169
7289;Zuidoost-Drenthe (CR);2007 januari;171169;127;153;537;496;41;476;394;82;;35;0.02;35;0.02;171204
7290;Zuidoost-Drenthe (CR);2007 februari;171204;135;123;495;454;41;497;422;75;;10;0.01;45;0.03;171214
7291;Zuidoost-Drenthe (CR);2007 maart;171214;138;133;541;450;91;489;438;51;;57;0.03;102;0.06;171271
7292;Zuidoost-Drenthe (CR);2007 april;171271;123;116;410;357;53;406;365;41;;11;0.01;113;0.07;171282
7293;Zuidoost-Drenthe (CR);2007 mei;171282;121;140;498;447;51;554;441;113;;-75;-0.04;38;0.02;171207
7294;Zuidoost-Drenthe (CR);2007 juni;171207;133;142;455;400;55;488;387;101;;-42;-0.02;-4;0.0;171165
7295;Zuidoost-Drenthe (CR);2007 juli;171165;153;118;599;545;54;603;532;71;;31;0.02;27;0.02;171196
7296;Zuidoost-Drenthe (CR);2007 augustus;171196;151;125;673;602;71;734;660;74;;-35;-0.02;-8;0.0;171161
7297;Zuidoost-Drenthe (CR);2007 september;171161;148;110;659;440;219;607;556;51;;90;0.05;82;0.05;171251
7298;Zuidoost-Drenthe (CR);2007 oktober;171251;151;154;607;507;100;634;567;67;;-30;-0.02;52;0.03;171221
7299;Zuidoost-Drenthe (CR);2007 november;171221;119;113;511;454;57;462;433;29;;55;0.03;107;0.06;171276
7300;Zuidoost-Drenthe (CR);2007 december;171276;126;141;491;452;39;426;400;26;19.0;69;0.04;176;0.1;171345
7301;Zuidoost-Drenthe (CR);2007;171169;1625;1568;6476;5604;872;6376;5595;781;19.0;176;0.1;176;0.1;171345
7302;Zuidoost-Drenthe (CR);2008 januari;171345;160;155;578;509;69;560;495;65;;23;0.01;23;0.01;171368
7303;Zuidoost-Drenthe (CR);2008 februari;171368;121;145;470;424;46;475;433;42;;-29;-0.02;-6;0.0;171339
7304;Zuidoost-Drenthe (CR);2008 maart;171339;128;147;473;411;62;446;386;60;;8;0.0;2;0.0;171347
7305;Zuidoost-Drenthe (CR);2008 april;171347;131;120;464;411;53;419;386;33;;56;0.03;58;0.03;171403
7306;Zuidoost-Drenthe (CR);2008 mei;171403;136;145;465;401;64;480;394;86;;-24;-0.01;34;0.02;171379
7307;Zuidoost-Drenthe (CR);2008 juni;171379;129;130;508;425;83;482;439;43;;25;0.01;59;0.03;171404
7308;Zuidoost-Drenthe (CR);2008 juli;171404;165;134;686;625;61;735;527;208;;-18;-0.01;41;0.02;171386
7309;Zuidoost-Drenthe (CR);2008 augustus;171386;131;119;650;594;56;735;668;67;;-73;-0.04;-32;-0.02;171313
7310;Zuidoost-Drenthe (CR);2008 september;171313;141;134;784;524;260;715;654;61;;76;0.04;44;0.03;171389
7311;Zuidoost-Drenthe (CR);2008 oktober;171389;120;129;612;523;89;597;516;81;;6;0.0;50;0.03;171395
7312;Zuidoost-Drenthe (CR);2008 november;171395;122;133;458;389;69;433;382;51;;14;0.01;64;0.04;171409
7313;Zuidoost-Drenthe (CR);2008 december;171409;134;142;535;463;72;489;451;38;32.0;70;0.04;134;0.08;171479
7314;Zuidoost-Drenthe (CR);2008;171345;1618;1633;6683;5699;984;6566;5731;835;32.0;134;0.08;134;0.08;171479
7315;Zuidoost-Drenthe (CR);2009 januari;171479;163;165;513;441;72;537;417;120;;-26;-0.02;-26;-0.02;171453
7316;Zuidoost-Drenthe (CR);2009 februari;171453;98;156;542;445;97;462;375;87;;22;0.01;-4;0.0;171475
7317;Zuidoost-Drenthe (CR);2009 maart;171475;148;165;544;438;106;483;419;64;;44;0.03;40;0.02;171519
7318;Zuidoost-Drenthe (CR);2009 april;171519;135;137;517;405;112;451;371;80;;64;0.04;104;0.06;171583
7319;Zuidoost-Drenthe (CR);2009 mei;171583;133;127;410;324;86;291;268;23;;125;0.07;229;0.13;171708
7320;Zuidoost-Drenthe (CR);2009 juni;171708;146;120;479;363;116;506;406;100;;-1;0.0;228;0.13;171707
7321;Zuidoost-Drenthe (CR);2009 juli;171707;163;140;704;534;170;754;509;245;;-27;-0.02;201;0.12;171680
7322;Zuidoost-Drenthe (CR);2009 augustus;171680;152;126;538;438;100;676;584;92;;-112;-0.07;89;0.05;171568
7323;Zuidoost-Drenthe (CR);2009 september;171568;156;141;588;434;154;607;581;26;;-4;0.0;85;0.05;171564
7324;Zuidoost-Drenthe (CR);2009 oktober;171564;158;145;490;400;90;517;457;60;;-14;-0.01;71;0.04;171550
7325;Zuidoost-Drenthe (CR);2009 november;171550;136;144;466;387;79;440;357;83;;18;0.01;89;0.05;171568
7326;Zuidoost-Drenthe (CR);2009 december;171568;164;160;518;428;90;421;376;45;15.0;116;0.07;205;0.12;171684
7327;Zuidoost-Drenthe (CR);2009;171479;1752;1726;6309;5037;1272;6145;5120;1025;15.0;205;0.12;205;0.12;171684
7328;Zuidoost-Drenthe (CR);2010 januari;171684;125;164;468;397;71;513;405;108;;-84;-0.05;-84;-0.05;171600
7329;Zuidoost-Drenthe (CR);2010 februari;171600;113;164;481;391;90;421;389;32;;9;0.01;-75;-0.04;171609
7330;Zuidoost-Drenthe (CR);2010 maart;171609;117;146;435;378;57;485;416;69;;-79;-0.05;-154;-0.09;171530
7331;Zuidoost-Drenthe (CR);2010 april;171530;116;134;439;344;95;378;346;32;;43;0.03;-111;-0.06;171573
7332;Zuidoost-Drenthe (CR);2010 mei;171573;122;171;394;312;82;368;332;36;;-23;-0.01;-134;-0.08;171550
7333;Zuidoost-Drenthe (CR);2010 juni;171550;133;139;454;368;86;478;404;74;;-30;-0.02;-164;-0.1;171520
7334;Zuidoost-Drenthe (CR);2010 juli;171520;136;151;616;480;136;680;511;169;;-79;-0.05;-243;-0.14;171441
7335;Zuidoost-Drenthe (CR);2010 augustus;171441;143;137;549;456;93;612;548;64;;-57;-0.03;-300;-0.17;171384
7336;Zuidoost-Drenthe (CR);2010 september;171384;154;120;604;438;166;636;565;71;;2;0.0;-298;-0.17;171386
7337;Zuidoost-Drenthe (CR);2010 oktober;171386;151;151;451;368;83;460;390;70;;-9;-0.01;-307;-0.18;171377
7338;Zuidoost-Drenthe (CR);2010 november;171377;126;137;477;380;97;556;432;124;;-90;-0.05;-397;-0.23;171287
7339;Zuidoost-Drenthe (CR);2010 december;171287;141;165;455;350;105;424;402;22;-27.0;-20;-0.01;-417;-0.24;171267
7340;Zuidoost-Drenthe (CR);2010;171684;1577;1779;5823;4662;1161;6011;5140;871;-27.0;-417;-0.24;-417;-0.24;171267
7341;Zuidoost-Drenthe (CR);2011 januari;171267;133;143;498;402;96;570;498;72;;-82;-0.05;-82;-0.05;171185
7342;Zuidoost-Drenthe (CR);2011 februari;171185;127;126;494;402;92;562;397;165;;-67;-0.04;-149;-0.09;171118
7343;Zuidoost-Drenthe (CR);2011 maart;171118;141;146;513;411;102;506;397;109;;2;0.0;-147;-0.09;171120
7344;Zuidoost-Drenthe (CR);2011 april;171120;115;147;410;332;78;461;396;65;;-83;-0.05;-230;-0.13;171037
7345;Zuidoost-Drenthe (CR);2011 mei;171037;122;145;423;348;75;415;383;32;;-15;-0.01;-245;-0.14;171022
7346;Zuidoost-Drenthe (CR);2011 juni;171022;140;128;413;313;100;475;381;94;;-50;-0.03;-295;-0.17;170972
7347;Zuidoost-Drenthe (CR);2011 juli;170972;154;161;599;499;100;529;447;82;;63;0.04;-232;-0.14;171035
7348;Zuidoost-Drenthe (CR);2011 augustus;171035;149;153;521;425;96;736;631;105;;-219;-0.13;-451;-0.26;170816
7349;Zuidoost-Drenthe (CR);2011 september;170816;132;117;553;416;137;661;586;75;;-93;-0.05;-544;-0.32;170723
7350;Zuidoost-Drenthe (CR);2011 oktober;170723;146;114;477;375;102;511;428;83;;-2;0.0;-546;-0.32;170721
7351;Zuidoost-Drenthe (CR);2011 november;170721;117;146;453;367;86;502;426;76;;-78;-0.05;-624;-0.36;170643
7352;Zuidoost-Drenthe (CR);2011 december;170643;128;158;410;351;59;450;402;48;5.0;-65;-0.04;-689;-0.4;170578
7353;Zuidoost-Drenthe (CR);2011;171267;1604;1684;5764;4641;1123;6378;5372;1006;5.0;-689;-0.4;-689;-0.4;170578
7354;Zuidoost-Drenthe (CR);2012 januari;170578;125;161;558;421;137;525;416;109;;-3;0.0;-3;0.0;170575
7355;Zuidoost-Drenthe (CR);2012 februari;170575;100;144;521;396;125;522;447;75;;-45;-0.03;-48;-0.03;170530
7356;Zuidoost-Drenthe (CR);2012 maart;170530;110;160;455;373;82;470;437;33;;-65;-0.04;-113;-0.07;170465
7357;Zuidoost-Drenthe (CR);2012 april;170465;123;139;415;353;62;523;459;64;;-124;-0.07;-237;-0.14;170341
7358;Zuidoost-Drenthe (CR);2012 mei;170341;119;152;470;411;59;490;436;54;;-53;-0.03;-290;-0.17;170288
7359;Zuidoost-Drenthe (CR);2012 juni;170288;129;143;567;495;72;603;500;103;;-50;-0.03;-340;-0.2;170238
7360;Zuidoost-Drenthe (CR);2012 juli;170238;115;124;597;504;93;548;462;86;;40;0.02;-300;-0.18;170278
7361;Zuidoost-Drenthe (CR);2012 augustus;170278;130;149;594;450;144;724;643;81;;-149;-0.09;-449;-0.26;170129
7362;Zuidoost-Drenthe (CR);2012 september;170129;132;142;470;400;70;589;558;31;;-129;-0.08;-578;-0.34;170000
7363;Zuidoost-Drenthe (CR);2012 oktober;170000;153;136;519;445;74;660;495;165;;-124;-0.07;-702;-0.41;169876
7364;Zuidoost-Drenthe (CR);2012 november;169876;129;145;436;377;59;513;444;69;;-93;-0.05;-795;-0.47;169783
7365;Zuidoost-Drenthe (CR);2012 december;169783;102;160;459;411;48;360;339;21;-5.0;36;0.02;-759;-0.44;169819
7366;Zuidoost-Drenthe (CR);2012;170578;1467;1755;6061;5036;1025;6527;5636;891;-5.0;-759;-0.44;-759;-0.44;169819
7367;Zuidoost-Drenthe (CR);2013 januari;169819;127;173;531;430;101;491;416;75;;-6;0.0;-6;0.0;169813
7368;Zuidoost-Drenthe (CR);2013 februari;169813;93;181;493;398;95;553;459;94;;-148;-0.09;-154;-0.09;169665
7369;Zuidoost-Drenthe (CR);2013 maart;169665;120;186;440;369;71;482;441;41;;-108;-0.06;-262;-0.15;169557
7370;Zuidoost-Drenthe (CR);2013 april;169557;111;133;429;333;96;416;368;48;;-9;-0.01;-271;-0.16;169548
7371;Zuidoost-Drenthe (CR);2013 mei;169548;105;134;475;408;67;414;347;67;;32;0.02;-239;-0.14;169580
7372;Zuidoost-Drenthe (CR);2013 juni;169580;107;110;449;380;69;407;368;39;;39;0.02;-200;-0.12;169619
7373;Zuidoost-Drenthe (CR);2013 juli;169619;128;122;595;492;103;572;504;68;;29;0.02;-171;-0.1;169648
7374;Zuidoost-Drenthe (CR);2013 augustus;169648;145;127;566;454;112;753;687;66;;-169;-0.1;-340;-0.2;169479
7375;Zuidoost-Drenthe (CR);2013 september;169479;126;124;587;499;88;628;567;61;;-39;-0.02;-379;-0.22;169440
7376;Zuidoost-Drenthe (CR);2013 oktober;169440;121;128;571;491;80;570;499;71;;-6;0.0;-385;-0.23;169434
7377;Zuidoost-Drenthe (CR);2013 november;169434;123;134;513;432;81;448;407;41;;54;0.03;-331;-0.19;169488
7378;Zuidoost-Drenthe (CR);2013 december;169488;97;158;444;352;92;422;357;65;-1.0;-40;-0.02;-371;-0.22;169448
7379;Zuidoost-Drenthe (CR);2013;169819;1403;1710;6093;5038;1055;6156;5420;736;-1.0;-371;-0.22;-371;-0.22;169448
7380;Zuidoost-Drenthe (CR);2014 januari;169448;119;154;570;457;113;531;459;72;;4;0.0;4;0.0;169452
7381;Zuidoost-Drenthe (CR);2014 februari;169452;93;160;437;372;65;484;418;66;;-114;-0.07;-110;-0.06;169338
7382;Zuidoost-Drenthe (CR);2014 maart;169338;99;144;411;344;67;471;403;68;;-105;-0.06;-215;-0.13;169233
7383;Zuidoost-Drenthe (CR);2014 april;169233;114;147;440;340;100;420;355;65;;-13;-0.01;-228;-0.13;169220
7384;Zuidoost-Drenthe (CR);2014 mei;169220;131;122;393;345;48;393;348;45;;9;0.01;-219;-0.13;169229
7385;Zuidoost-Drenthe (CR);2014 juni;169229;100;137;443;354;89;519;437;82;;-113;-0.07;-332;-0.2;169116
7386;Zuidoost-Drenthe (CR);2014 juli;169116;114;141;572;484;88;552;494;58;;-7;0.0;-339;-0.2;169109
7387;Zuidoost-Drenthe (CR);2014 augustus;169109;130;111;506;420;86;751;698;53;;-226;-0.13;-565;-0.33;168883
7388;Zuidoost-Drenthe (CR);2014 september;168883;130;139;576;495;81;636;590;46;;-69;-0.04;-634;-0.37;168814
7389;Zuidoost-Drenthe (CR);2014 oktober;168814;138;138;551;415;136;508;442;66;;43;0.03;-591;-0.35;168857
7390;Zuidoost-Drenthe (CR);2014 november;168857;124;145;393;309;84;422;363;59;;-50;-0.03;-641;-0.38;168807
7391;Zuidoost-Drenthe (CR);2014 december;168807;120;169;522;430;92;460;400;60;-8.0;5;0.0;-636;-0.38;168812
7392;Zuidoost-Drenthe (CR);2014;169448;1412;1707;5814;4765;1049;6147;5407;740;-8.0;-636;-0.38;-636;-0.38;168812
7393;Zuidoost-Drenthe (CR);2015 januari;168812;117;180;609;531;78;567;491;76;;-21;-0.01;-21;-0.01;168791
7394;Zuidoost-Drenthe (CR);2015 februari;168791;103;152;503;444;59;507;457;50;;-53;-0.03;-74;-0.04;168738
7395;Zuidoost-Drenthe (CR);2015 maart;168738;104;164;494;391;103;527;462;65;;-93;-0.06;-167;-0.1;168645
7396;Zuidoost-Drenthe (CR);2015 april;168645;88;144;458;371;87;444;382;62;;-42;-0.02;-209;-0.12;168603
7397;Zuidoost-Drenthe (CR);2015 mei;168603;118;149;434;362;72;422;388;34;;-19;-0.01;-228;-0.14;168584
7398;Zuidoost-Drenthe (CR);2015 juni;168584;102;137;474;422;52;473;439;34;;-34;-0.02;-262;-0.16;168550
7399;Zuidoost-Drenthe (CR);2015 juli;168550;131;142;655;575;80;654;556;98;;-10;-0.01;-272;-0.16;168540
7400;Zuidoost-Drenthe (CR);2015 augustus;168540;141;144;704;586;118;715;661;54;;-14;-0.01;-286;-0.17;168526
7401;Zuidoost-Drenthe (CR);2015 september;168526;116;119;543;400;143;607;553;54;;-67;-0.04;-353;-0.21;168459
7402;Zuidoost-Drenthe (CR);2015 oktober;168459;107;138;543;433;110;536;478;58;;-24;-0.01;-377;-0.22;168435
7403;Zuidoost-Drenthe (CR);2015 november;168435;100;158;530;431;99;515;441;74;;-43;-0.03;-420;-0.25;168392
7404;Zuidoost-Drenthe (CR);2015 december;168392;107;134;530;436;94;549;472;77;-10.0;-56;-0.03;-476;-0.28;168336
7405;Zuidoost-Drenthe (CR);2015;168812;1334;1761;6477;5382;1095;6516;5780;736;-10.0;-476;-0.28;-476;-0.28;168336
7406;Zuidoost-Drenthe (CR);2016 januari;168336;125;176;569;449;120;505;439;66;;13;0.01;13;0.01;168349
7407;Zuidoost-Drenthe (CR);2016 februari;168349;120;149;482;388;94;534;487;47;;-81;-0.05;-68;-0.04;168268
7408;Zuidoost-Drenthe (CR);2016 maart;168268;107;162;546;462;84;522;471;51;;-31;-0.02;-99;-0.06;168237
7409;Zuidoost-Drenthe (CR);2016 april;168237;119;159;529;451;78;445;410;35;;44;0.03;-55;-0.03;168281
7410;Zuidoost-Drenthe (CR);2016 mei;168281;114;158;576;505;71;429;388;41;;103;0.06;48;0.03;168384
7411;Zuidoost-Drenthe (CR);2016 juni;168384;125;147;590;494;96;577;486;91;;-9;-0.01;39;0.02;168375
7412;Zuidoost-Drenthe (CR);2016 juli;168375;115;143;634;539;95;620;557;63;;-14;-0.01;25;0.01;168361
7413;Zuidoost-Drenthe (CR);2016 augustus;168361;119;147;659;533;126;731;660;71;;-100;-0.06;-75;-0.04;168261
7414;Zuidoost-Drenthe (CR);2016 september;168261;131;137;695;588;107;671;618;53;;18;0.01;-57;-0.03;168279
7415;Zuidoost-Drenthe (CR);2016 oktober;168279;116;157;555;477;78;555;495;60;;-41;-0.02;-98;-0.06;168238
7416;Zuidoost-Drenthe (CR);2016 november;168238;99;149;531;471;60;549;492;57;;-68;-0.04;-166;-0.1;168170
7417;Zuidoost-Drenthe (CR);2016 december;168170;125;155;512;484;28;526;466;60;5.0;-39;-0.02;-205;-0.12;168131
7418;Zuidoost-Drenthe (CR);2016;168336;1415;1839;6878;5841;1037;6664;5969;695;5.0;-205;-0.12;-205;-0.12;168131
7419;Zuidoost-Drenthe (CR);2017 januari;168131;101;186;629;574;55;602;549;53;;-58;-0.03;-58;-0.03;168073
7420;Zuidoost-Drenthe (CR);2017 februari;168073;110;158;570;510;60;587;534;53;;-65;-0.04;-123;-0.07;168008
7421;Zuidoost-Drenthe (CR);2017 maart;168008;125;187;588;532;56;560;528;32;;-34;-0.02;-157;-0.09;167974
7422;Zuidoost-Drenthe (CR);2017 april;167974;96;143;440;398;42;413;381;32;;-20;-0.01;-177;-0.11;167954
7423;Zuidoost-Drenthe (CR);2017 mei;167954;111;152;575;524;51;529;481;48;;5;0.0;-172;-0.1;167959
7424;Zuidoost-Drenthe (CR);2017 juni;167959;112;136;600;549;51;531;490;41;;45;0.03;-127;-0.08;168004
7425;Zuidoost-Drenthe (CR);2017 juli;168004;122;144;782;717;65;680;623;57;;80;0.05;-47;-0.03;168084
7426;Zuidoost-Drenthe (CR);2017 augustus;168084;134;148;727;648;79;725;677;48;;-12;-0.01;-59;-0.04;168072
7427;Zuidoost-Drenthe (CR);2017 september;168072;109;158;697;604;93;783;736;47;;-135;-0.08;-194;-0.12;167937
7428;Zuidoost-Drenthe (CR);2017 oktober;167937;111;132;609;528;81;598;543;55;;-10;-0.01;-204;-0.12;167927
7429;Zuidoost-Drenthe (CR);2017 november;167927;113;136;579;525;54;621;570;51;;-65;-0.04;-269;-0.16;167862
7430;Zuidoost-Drenthe (CR);2017 december;167862;120;156;540;497;43;518;475;43;-6.0;-20;-0.01;-289;-0.17;167842
7431;Zuidoost-Drenthe (CR);2017;168131;1364;1836;7336;6606;730;7147;6587;560;-6.0;-289;-0.17;-289;-0.17;167842
7432;Zuidoost-Drenthe (CR);2018 januari;167842;99;157;613;558;55;545;496;49;;10;0.01;10;0.01;167852
7433;Zuidoost-Drenthe (CR);2018 februari;167852;104;179;603;556;47;581;540;41;;-53;-0.03;-43;-0.03;167799
7434;Zuidoost-Drenthe (CR);2018 maart;167799;98;182;560;506;54;542;512;30;;-66;-0.04;-109;-0.06;167733
7435;Zuidoost-Drenthe (CR);2018 april;167733;103;155;511;450;61;465;427;38;;-6;0.0;-115;-0.07;167727
7436;Zuidoost-Drenthe (CR);2018 mei;167727;99;147;535;482;53;492;460;32;;-5;0.0;-120;-0.07;167722
7437;Zuidoost-Drenthe (CR);2018 juni;167722;112;138;594;515;79;527;474;53;;41;0.02;-79;-0.05;167763
7438;Zuidoost-Drenthe (CR);2018 juli;167763;101;189;643;572;71;598;546;52;;-43;-0.03;-122;-0.07;167720
7439;Zuidoost-Drenthe (CR);2018 augustus;167720;127;150;781;662;119;695;643;52;;63;0.04;-59;-0.04;167783
7440;Zuidoost-Drenthe (CR);2018 september;167783;126;126;572;495;77;580;539;41;;-8;0.0;-67;-0.04;167775
7441;Zuidoost-Drenthe (CR);2018 oktober;167775;125;152;755;681;74;550;497;53;;178;0.11;111;0.07;167953
7442;Zuidoost-Drenthe (CR);2018 november;167953;114;126;631;566;65;567;529;38;;52;0.03;163;0.1;168005
7443;Zuidoost-Drenthe (CR);2018 december;168005;91;157;531;478;53;497;452;45;-5.0;-37;-0.02;126;0.08;167968
7444;Zuidoost-Drenthe (CR);2018;167842;1299;1858;7329;6521;808;6639;6115;524;-5.0;126;0.08;126;0.08;167968
7445;Zuidoost-Drenthe (CR);2019 januari;167968;118;141;687;597;90;620;565;55;;44;0.03;44;0.03;168012
7446;Zuidoost-Drenthe (CR);2019 februari;168012;110;154;544;468;76;511;426;85;;-11;-0.01;33;0.02;168001
7447;Zuidoost-Drenthe (CR);2019 maart;168001;109;170;582;523;59;610;544;66;;-89;-0.05;-56;-0.03;167912
7448;Zuidoost-Drenthe (CR);2019 april;167912;106;128;543;472;71;472;394;78;;49;0.03;-7;0.0;167961
7449;Zuidoost-Drenthe (CR);2019 mei;167961;117;156;493;440;53;563;514;49;;-109;-0.06;-116;-0.07;167852
7450;Zuidoost-Drenthe (CR);2019 juni;167852;104;151;535;490;45;523;477;46;;-35;-0.02;-151;-0.09;167817
7451;Zuidoost-Drenthe (CR);2019 juli;167817;121;164;774;689;85;652;572;80;;79;0.05;-72;-0.04;167896
7452;Zuidoost-Drenthe (CR);2019 augustus;167896;134;149;750;643;107;656;611;45;;79;0.05;7;0.0;167975
7453;Zuidoost-Drenthe (CR);2019 september;167975;125;139;698;607;91;635;585;50;;49;0.03;56;0.03;168024
7454;Zuidoost-Drenthe (CR);2019 oktober;168024;127;122;617;549;68;643;521;122;;-21;-0.01;35;0.02;168003
7455;Zuidoost-Drenthe (CR);2019 november;168003;121;183;557;494;63;562;499;63;;-67;-0.04;-32;-0.02;167936
7456;Zuidoost-Drenthe (CR);2019 december;167936;109;186;603;559;44;520;477;43;-38.0;-32;-0.02;-64;-0.04;167904
7457;Zuidoost-Drenthe (CR);2019;167968;1401;1843;7383;6531;852;6967;6185;782;-38.0;-64;-0.04;-64;-0.04;167904
7458;Zuidoost-Drenthe (CR);2020 januari;167904;119;175;633;586;47;578;523;55;;-1;0.0;-1;0.0;167903
7459;Zuidoost-Drenthe (CR);2020 februari;167903;105;157;545;506;39;552;509;43;;-59;-0.04;-60;-0.04;167844
7460;Zuidoost-Drenthe (CR);2020 maart;167844;111;163;594;537;57;493;425;68;;49;0.03;-11;-0.01;167893
7461;Zuidoost-Drenthe (CR);2020 april;167893;114;189;527;489;38;428;398;30;;24;0.01;13;0.01;167917
7462;Zuidoost-Drenthe (CR);2020 mei;167917;89;135;537;495;42;461;428;33;;30;0.02;43;0.03;167947
7463;Zuidoost-Drenthe (CR);2020 juni;167947;112;145;619;550;69;599;541;58;;-13;-0.01;30;0.02;167934
7464;Zuidoost-Drenthe (CR);2020 juli;167934;125;141;673;622;51;629;580;49;;28;0.02;58;0.03;167962
7465;Zuidoost-Drenthe (CR);2020 augustus;167962;123;158;642;570;72;637;580;57;;-30;-0.02;28;0.02;167932
7466;Zuidoost-Drenthe (CR);2020 september;167932;120;181;611;540;71;532;500;32;;18;0.01;46;0.03;167950
7467;Zuidoost-Drenthe (CR);2020 oktober;167950;116;182;630;587;43;577;523;54;;-13;-0.01;33;0.02;167937
7468;Zuidoost-Drenthe (CR);2020 november;167937;109;185;559;527;32;504;473;31;;-21;-0.01;12;0.01;167916
7469;Zuidoost-Drenthe (CR);2020 december;167916;120;159;631;583;48;537;491;46;-32.0;23;0.01;35;0.02;167939
7470;Zuidoost-Drenthe (CR);2020;167904;1363;1970;7201;6592;609;6527;5971;556;-32.0;35;0.02;35;0.02;167939
7471;Zuidoost-Drenthe (CR);2021 januari;167939;103;194;614;562;52;480;437;43;0.0;43;0.03;43;0.03;167982
7472;Zuidoost-Drenthe (CR);2021 februari;167982;105;164;547;512;35;434;408;26;0.0;54;0.03;97;0.06;168036
7473;Zuidoost-Drenthe (CR);2021 maart;168036;116;177;652;603;49;543;501;42;0.0;48;0.03;145;0.09;168084
7474;Zuidoost-Drenthe (CR);2021 april;168084;116;181;613;583;30;420;399;21;0.0;128;0.08;273;0.16;168212
7475;Zuidoost-Drenthe (CR);2021 mei;168212;117;158;592;538;54;402;375;27;0.0;149;0.09;422;0.25;168361
7476;Zuidoost-Drenthe (CR);2021 juni;168361;102;162;535;495;40;470;424;46;0.0;5;0.0;427;0.25;168366
7477;Zuidoost-Drenthe (CR);2021 juli;168366;121;151;718;659;59;643;539;104;0.0;45;0.03;472;0.28;168411
7478;Zuidoost-Drenthe (CR);2021 augustus;168411;112;149;721;632;89;619;563;56;0.0;65;0.04;537;0.32;168476
7479;Zuidoost-Drenthe (CR);2021 september;168476;138;146;736;660;76;532;492;40;0.0;196;0.12;733;0.44;168672
7480;Zuidoost-Drenthe (CR);2021 oktober;168672;161;180;755;689;66;505;454;51;0.0;231;0.14;964;0.57;168903
7481;Zuidoost-Drenthe (CR);2021 november;168903;130;199;771;725;46;528;472;56;0.0;174;0.1;1138;0.68;169077
7482;Zuidoost-Drenthe (CR);2021 december;169077;124;223;667;632;35;567;521;46;-24.0;-23;-0.01;1115;0.66;169054
7483;Zuidoost-Drenthe (CR);2021;167939;1445;2084;7921;7290;631;6143;5585;558;-24.0;1115;0.66;1115;0.66;169054
7484;Zuidoost-Drenthe (CR);2022 januari;169054;110;150;593;543;50;558;520;38;;-5;0.0;-5;0.0;169049
7485;Zuidoost-Drenthe (CR);2022 februari;169049;107;173;555;493;62;411;373;38;;78;0.05;73;0.04;169127
7486;Zuidoost-Drenthe (CR);2022 maart;169127;107;185;877;530;347;483;454;29;;316;0.19;389;0.23;169443
7487;Zuidoost-Drenthe (CR);2022 april;169443;96;181;795;581;214;496;479;17;;214;0.13;603;0.36;169657
7488;Zuidoost-Drenthe (CR);2022 mei;169657;109;158;713;557;156;489;434;55;;175;0.1;778;0.46;169832
7489;Zuidoost-Drenthe (CR);2022 juni;169832;124;153;598;496;102;446;382;64;;123;0.07;901;0.53;169955
7490;Zuidoost-Drenthe (CR);2022 juli;169955;130;196;841;684;157;600;521;79;;175;0.1;1076;0.64;170130
7491;Zuidoost-Drenthe (CR);2022 augustus;170130;112;191;758;567;191;579;496;83;;100;0.06;1176;0.7;170230
7492;Zuidoost-Drenthe (CR);2022 september;170230;125;173;696;552;144;604;515;89;;44;0.03;1220;0.72;170274
7493;Zuidoost-Drenthe (CR);2022 oktober;170274;123;187;699;557;142;543;455;88;;92;0.05;1312;0.78;170366
7494;Zuidoost-Drenthe (CR);2022 november;170366;105;182;668;537;131;534;485;49;;57;0.03;1369;0.81;170423
7495;Zuidoost-Drenthe (CR);2022 december;170423;107;222;649;563;86;537;458;79;-36.0;-39;-0.02;1330;0.79;170384
7496;Zuidoost-Drenthe (CR);2022;169054;1355;2151;8442;6660;1782;6280;5572;708;-36.0;1330;0.79;1330;0.79;170384
7497;Zuidoost-Drenthe (CR);2023 januari;170384;118;211;752;609;143;526;440;86;0.0;133;0.08;133;0.08;170517
7498;Zuidoost-Drenthe (CR);2023 februari;170517;103;165;636;525;111;567;481;86;0.0;7;0.0;140;0.08;170524
7499;Zuidoost-Drenthe (CR);2023 maart;170524;102;189;730;593;137;574;485;89;0.0;69;0.04;209;0.12;170593
7500;Zuidoost-Drenthe (CR);2023 april;170593;119;156;591;519;72;512;422;90;0.0;42;0.02;251;0.15;170635
7501;Zuidoost-Drenthe (CR);2023 mei;170635;118;149;604;510;94;491;439;52;0.0;82;0.05;333;0.2;170717
7502;Zuidoost-Drenthe (CR);2023 juni;170717;115;153;638;543;95;576;475;101;0.0;24;0.01;357;0.21;170741
7503;Zuidoost-Drenthe (CR);2023 juli;170741;104;150;705;574;131;685;579;106;0.0;-26;-0.02;331;0.19;170715
7504;Zuidoost-Drenthe (CR);2023 augustus;170715;115;164;754;610;144;691;629;62;0.0;14;0.01;345;0.2;170729
7505;Zuidoost-Drenthe (CR);2023 september;170729;92;155;864;578;286;614;525;89;0.0;187;0.11;532;0.31;170916
7506;Zuidoost-Drenthe (CR);2023 oktober;170916;132;189;695;570;125;536;478;58;0.0;102;0.06;634;0.37;171018
7507;Zuidoost-Drenthe (CR);2023 november;171018;110;184;654;568;86;515;423;92;0.0;65;0.04;699;0.41;171083
7508;Zuidoost-Drenthe (CR);2023 december;171083;117;200;633;521;112;510;424;86;-38.0;2;0.0;701;0.41;171085
7509;Zuidoost-Drenthe (CR);2023;170384;1345;2065;8256;6720;1536;6797;5800;997;-38.0;701;0.41;701;0.41;171085
7510;Zuidoost-Drenthe (CR);2024 januari;171085;102;241;679;507;172;541;447;94;;-1;0.0;-1;0.0;171084
7511;Zuidoost-Drenthe (CR);2024 februari;171084;103;158;584;480;104;558;482;76;;-29;-0.02;-30;-0.02;171055
7512;Zuidoost-Drenthe (CR);2024 maart;171055;120;184;715;616;99;531;471;60;;120;0.07;90;0.05;171175
7513;Zuidoost-Drenthe (CR);2024 april;171175;91;173;620;520;100;531;449;82;;7;0.0;97;0.06;171182
7514;Zuidoost-Drenthe (CR);2024 mei;171182;126;196;601;535;66;457;410;47;;74;0.04;171;0.1;171256
7515;Zuidoost-Drenthe (CR);2024 juni;171256;114;162;592;482;110;530;389;141;;14;0.01;185;0.11;171270
7516;Zuidoost-Drenthe (CR);2024 juli;171270;141;170;791;604;187;580;481;99;;182;0.11;367;0.21;171452
7517;Zuidoost-Drenthe (CR);2024 augustus;171452;108;187;646;542;104;624;499;125;;-57;-0.03;310;0.18;171395
7518;Zuidoost-Drenthe (CR);2024 september;171395;101;167;710;551;159;532;453;79;;112;0.07;422;0.25;171507
7519;Zuidoost-Drenthe (CR);2024 oktober;171507;116;176;624;491;133;541;450;91;;23;0.01;445;0.26;171530
7520;Zuidoost-Drenthe (CR);2024 november;171530;113;186;635;544;91;537;446;91;;25;0.01;470;0.27;171555
7521;Zuidoost-Drenthe (CR);2024 december;171555;106;164;620;514;106;499;432;67;0.0;63;0.04;533;0.31;171618
7522;Zuidoost-Drenthe (CR);2024;171085;1341;2164;7817;6386;1431;6461;5409;1052;0.0;533;0.31;533;0.31;171618
7523;Zuidoost-Drenthe (CR);2025 januari;171618;99;210;610;519;91;609;492;117;;-110;-0.06;-110;-0.06;171508
7524;Zuidoost-Drenthe (CR);2025 februari;171508;123;212;629;560;69;543;444;99;;-3;0.0;-113;-0.07;171505
7525;Zuidwest-Drenthe (CR);2002 januari;126440;148;114;459;389;70;414;388;26;;79;0.06;79;0.06;126519
7526;Zuidwest-Drenthe (CR);2002 februari;126519;149;91;340;311;29;389;341;48;;9;0.01;88;0.07;126528
7527;Zuidwest-Drenthe (CR);2002 maart;126528;128;96;373;326;47;413;384;29;;-8;-0.01;80;0.06;126520
7528;Zuidwest-Drenthe (CR);2002 april;126520;129;106;394;360;34;408;331;77;;9;0.01;89;0.07;126529
7529;Zuidwest-Drenthe (CR);2002 mei;126529;131;101;380;361;19;450;381;69;;-40;-0.03;49;0.04;126489
7530;Zuidwest-Drenthe (CR);2002 juni;126489;108;81;400;345;55;408;385;23;;19;0.02;68;0.05;126508
7531;Zuidwest-Drenthe (CR);2002 juli;126508;140;91;514;451;63;467;442;25;;96;0.08;164;0.13;126604
7532;Zuidwest-Drenthe (CR);2002 augustus;126604;120;94;576;525;51;548;506;42;;54;0.04;218;0.17;126658
7533;Zuidwest-Drenthe (CR);2002 september;126658;137;93;404;376;28;473;444;29;;-25;-0.02;193;0.15;126633
7534;Zuidwest-Drenthe (CR);2002 oktober;126633;132;100;561;409;152;456;394;62;;137;0.11;330;0.26;126770
7535;Zuidwest-Drenthe (CR);2002 november;126770;127;96;415;359;56;389;348;41;;57;0.04;387;0.31;126827
7536;Zuidwest-Drenthe (CR);2002 december;126827;123;102;485;372;113;330;284;46;-37.0;139;0.11;526;0.42;126966
7537;Zuidwest-Drenthe (CR);2002;126440;1572;1165;5301;4584;717;5145;4628;517;-37.0;526;0.42;526;0.42;126966
7538;Zuidwest-Drenthe (CR);2003 januari;126966;130;99;472;434;38;554;482;72;;-51;-0.04;-51;-0.04;126915
7539;Zuidwest-Drenthe (CR);2003 februari;126915;126;92;426;393;33;393;354;39;;67;0.05;16;0.01;126982
7540;Zuidwest-Drenthe (CR);2003 maart;126982;122;103;356;322;34;416;384;32;;-41;-0.03;-25;-0.02;126941
7541;Zuidwest-Drenthe (CR);2003 april;126941;122;120;389;360;29;383;352;31;;8;0.01;-17;-0.01;126949
7542;Zuidwest-Drenthe (CR);2003 mei;126949;117;100;389;370;19;347;330;17;;59;0.05;42;0.03;127008
7543;Zuidwest-Drenthe (CR);2003 juni;127008;145;81;346;328;18;352;329;23;;58;0.05;100;0.08;127066
7544;Zuidwest-Drenthe (CR);2003 juli;127066;136;84;493;446;47;483;437;46;;62;0.05;162;0.13;127128
7545;Zuidwest-Drenthe (CR);2003 augustus;127128;125;84;509;473;36;496;400;96;;54;0.04;216;0.17;127182
7546;Zuidwest-Drenthe (CR);2003 september;127182;147;82;398;360;38;493;465;28;;-30;-0.02;186;0.15;127152
7547;Zuidwest-Drenthe (CR);2003 oktober;127152;114;112;407;367;40;460;411;49;;-51;-0.04;135;0.11;127101
7548;Zuidwest-Drenthe (CR);2003 november;127101;114;91;336;326;10;359;326;33;;0;0.0;135;0.11;127101
7549;Zuidwest-Drenthe (CR);2003 december;127101;118;119;399;362;37;368;351;17;69.0;99;0.08;234;0.18;127200
7550;Zuidwest-Drenthe (CR);2003;126966;1516;1167;4920;4541;379;5104;4621;483;69.0;234;0.18;234;0.18;127200
7551;Zuidwest-Drenthe (CR);2004 januari;127200;139;146;397;373;24;417;393;24;;-27;-0.02;-27;-0.02;127173
7552;Zuidwest-Drenthe (CR);2004 februari;127173;115;98;314;298;16;455;431;24;;-124;-0.1;-151;-0.12;127049
7553;Zuidwest-Drenthe (CR);2004 maart;127049;131;110;366;356;10;501;456;45;;-114;-0.09;-265;-0.21;126935
7554;Zuidwest-Drenthe (CR);2004 april;126935;134;98;371;358;13;383;355;28;;24;0.02;-241;-0.19;126959
7555;Zuidwest-Drenthe (CR);2004 mei;126959;92;80;373;350;23;347;328;19;;38;0.03;-203;-0.16;126997
7556;Zuidwest-Drenthe (CR);2004 juni;126997;149;100;401;375;26;376;345;31;;74;0.06;-129;-0.1;127071
7557;Zuidwest-Drenthe (CR);2004 juli;127071;141;91;505;480;25;414;394;20;;141;0.11;12;0.01;127212
7558;Zuidwest-Drenthe (CR);2004 augustus;127212;113;93;422;403;19;460;435;25;;-18;-0.01;-6;0.0;127194
7559;Zuidwest-Drenthe (CR);2004 september;127194;141;83;329;309;20;473;421;52;;-86;-0.07;-92;-0.07;127108
7560;Zuidwest-Drenthe (CR);2004 oktober;127108;116;84;436;416;20;428;354;74;;40;0.03;-52;-0.04;127148
7561;Zuidwest-Drenthe (CR);2004 november;127148;133;104;388;378;10;383;353;30;;34;0.03;-18;-0.01;127182
7562;Zuidwest-Drenthe (CR);2004 december;127182;119;97;378;365;13;358;332;26;34.0;76;0.06;58;0.05;127258
7563;Zuidwest-Drenthe (CR);2004;127200;1523;1184;4680;4461;219;4995;4597;398;34.0;58;0.05;58;0.05;127258
7564;Zuidwest-Drenthe (CR);2005 januari;127258;116;102;336;315;21;307;286;21;;43;0.03;43;0.03;127301
7565;Zuidwest-Drenthe (CR);2005 februari;127301;112;108;297;287;10;370;332;38;;-69;-0.05;-26;-0.02;127232
7566;Zuidwest-Drenthe (CR);2005 maart;127232;133;119;381;361;20;401;360;41;;-6;0.0;-32;-0.03;127226
7567;Zuidwest-Drenthe (CR);2005 april;127226;108;83;358;337;21;340;324;16;;43;0.03;11;0.01;127269
7568;Zuidwest-Drenthe (CR);2005 mei;127269;127;93;363;343;20;368;346;22;;29;0.02;40;0.03;127298
7569;Zuidwest-Drenthe (CR);2005 juni;127298;110;85;357;328;29;332;310;22;;50;0.04;90;0.07;127348
7570;Zuidwest-Drenthe (CR);2005 juli;127348;125;75;516;482;34;339;326;13;;227;0.18;317;0.25;127575
7571;Zuidwest-Drenthe (CR);2005 augustus;127575;129;85;530;500;30;491;462;29;;83;0.07;400;0.31;127658
7572;Zuidwest-Drenthe (CR);2005 september;127658;114;75;466;443;23;545;515;30;;-40;-0.03;360;0.28;127618
7573;Zuidwest-Drenthe (CR);2005 oktober;127618;120;86;472;441;31;464;406;58;;42;0.03;402;0.32;127660
7574;Zuidwest-Drenthe (CR);2005 november;127660;124;102;416;400;16;386;341;45;;52;0.04;454;0.36;127712
7575;Zuidwest-Drenthe (CR);2005 december;127712;102;87;406;393;13;427;355;72;26.0;20;0.02;474;0.37;127732
7576;Zuidwest-Drenthe (CR);2005;127258;1420;1100;4898;4630;268;4770;4363;407;26.0;474;0.37;474;0.37;127732
7577;Zuidwest-Drenthe (CR);2006 januari;127732;107;98;481;459;22;410;366;44;;80;0.06;80;0.06;127812
7578;Zuidwest-Drenthe (CR);2006 februari;127812;97;93;398;380;18;354;308;46;;48;0.04;128;0.1;127860
7579;Zuidwest-Drenthe (CR);2006 maart;127860;120;108;468;440;28;395;359;36;;85;0.07;213;0.17;127945
7580;Zuidwest-Drenthe (CR);2006 april;127945;95;104;345;329;16;307;297;10;;29;0.02;242;0.19;127974
7581;Zuidwest-Drenthe (CR);2006 mei;127974;131;92;424;402;22;349;333;16;;114;0.09;356;0.28;128088
7582;Zuidwest-Drenthe (CR);2006 juni;128088;133;85;430;409;21;432;389;43;;46;0.04;402;0.31;128134
7583;Zuidwest-Drenthe (CR);2006 juli;128134;119;101;511;480;31;522;471;51;;7;0.01;409;0.32;128141
7584;Zuidwest-Drenthe (CR);2006 augustus;128141;119;84;595;557;38;534;478;56;;96;0.07;505;0.4;128237
7585;Zuidwest-Drenthe (CR);2006 september;128237;108;85;496;466;30;497;457;40;;22;0.02;527;0.41;128259
7586;Zuidwest-Drenthe (CR);2006 oktober;128259;124;97;407;375;32;426;385;41;;8;0.01;535;0.42;128267
7587;Zuidwest-Drenthe (CR);2006 november;128267;101;87;390;377;13;440;407;33;;-36;-0.03;499;0.39;128231
7588;Zuidwest-Drenthe (CR);2006 december;128231;117;103;436;408;28;361;339;22;39.0;128;0.1;627;0.49;128359
7589;Zuidwest-Drenthe (CR);2006;127732;1371;1137;5381;5082;299;5027;4589;438;39.0;627;0.49;627;0.49;128359
7590;Zuidwest-Drenthe (CR);2007 januari;128359;117;98;484;461;23;468;415;53;;35;0.03;35;0.03;128394
7591;Zuidwest-Drenthe (CR);2007 februari;128394;111;104;433;410;23;351;326;25;;89;0.07;124;0.1;128483
7592;Zuidwest-Drenthe (CR);2007 maart;128483;111;118;434;410;24;369;348;21;;58;0.05;182;0.14;128541
7593;Zuidwest-Drenthe (CR);2007 april;128541;108;83;345;316;29;312;302;10;;58;0.05;240;0.19;128599
7594;Zuidwest-Drenthe (CR);2007 mei;128599;118;84;447;413;34;389;349;40;;92;0.07;332;0.26;128691
7595;Zuidwest-Drenthe (CR);2007 juni;128691;105;83;452;416;36;366;357;9;;108;0.08;440;0.34;128799
7596;Zuidwest-Drenthe (CR);2007 juli;128799;131;85;566;531;35;494;413;81;;118;0.09;558;0.43;128917
7597;Zuidwest-Drenthe (CR);2007 augustus;128917;113;74;545;504;41;560;531;29;;24;0.02;582;0.45;128941
7598;Zuidwest-Drenthe (CR);2007 september;128941;126;94;406;360;46;470;434;36;;-32;-0.02;550;0.43;128909
7599;Zuidwest-Drenthe (CR);2007 oktober;128909;114;98;441;420;21;443;408;35;;14;0.01;564;0.44;128923
7600;Zuidwest-Drenthe (CR);2007 november;128923;119;103;371;350;21;473;411;62;;-86;-0.07;478;0.37;128837
7601;Zuidwest-Drenthe (CR);2007 december;128837;108;105;383;364;19;350;309;41;18.0;54;0.04;532;0.41;128891
7602;Zuidwest-Drenthe (CR);2007;128359;1381;1129;5307;4955;352;5045;4603;442;18.0;532;0.41;532;0.41;128891
7603;Zuidwest-Drenthe (CR);2008 januari;128891;125;131;499;465;34;460;419;41;;33;0.03;33;0.03;128924
7604;Zuidwest-Drenthe (CR);2008 februari;128924;107;98;400;378;22;387;373;14;;22;0.02;55;0.04;128946
7605;Zuidwest-Drenthe (CR);2008 maart;128946;95;98;375;355;20;372;335;37;;0;0.0;55;0.04;128946
7606;Zuidwest-Drenthe (CR);2008 april;128946;105;109;378;335;43;356;348;8;;18;0.01;73;0.06;128964
7607;Zuidwest-Drenthe (CR);2008 mei;128964;117;101;355;344;11;332;316;16;;39;0.03;112;0.09;129003
7608;Zuidwest-Drenthe (CR);2008 juni;129003;124;87;450;411;39;422;396;26;;65;0.05;177;0.14;129068
7609;Zuidwest-Drenthe (CR);2008 juli;129068;126;84;530;490;40;462;429;33;;110;0.09;287;0.22;129178
7610;Zuidwest-Drenthe (CR);2008 augustus;129178;110;82;486;421;65;495;461;34;;19;0.01;306;0.24;129197
7611;Zuidwest-Drenthe (CR);2008 september;129197;141;92;395;368;27;459;414;45;;-15;-0.01;291;0.23;129182
7612;Zuidwest-Drenthe (CR);2008 oktober;129182;117;103;467;423;44;396;376;20;;85;0.07;376;0.29;129267
7613;Zuidwest-Drenthe (CR);2008 november;129267;113;104;467;436;31;323;310;13;;153;0.12;529;0.41;129420
7614;Zuidwest-Drenthe (CR);2008 december;129420;107;117;420;397;23;338;313;25;32.0;104;0.08;633;0.49;129524
7615;Zuidwest-Drenthe (CR);2008;128891;1387;1206;5222;4823;399;4802;4490;312;32.0;633;0.49;633;0.49;129524
7616;Zuidwest-Drenthe (CR);2009 januari;129524;127;152;400;375;25;432;394;38;;-57;-0.04;-57;-0.04;129467
7617;Zuidwest-Drenthe (CR);2009 februari;129467;101;102;420;376;44;346;322;24;;73;0.06;16;0.01;129540
7618;Zuidwest-Drenthe (CR);2009 maart;129540;111;97;379;345;34;343;305;38;;50;0.04;66;0.05;129590
7619;Zuidwest-Drenthe (CR);2009 april;129590;128;85;372;319;53;320;310;10;;95;0.07;161;0.12;129685
7620;Zuidwest-Drenthe (CR);2009 mei;129685;139;75;345;310;35;346;310;36;;63;0.05;224;0.17;129748
7621;Zuidwest-Drenthe (CR);2009 juni;129748;110;88;383;346;37;315;301;14;;90;0.07;314;0.24;129838
7622;Zuidwest-Drenthe (CR);2009 juli;129838;147;91;471;422;49;442;421;21;;85;0.07;399;0.31;129923
7623;Zuidwest-Drenthe (CR);2009 augustus;129923;113;72;439;391;48;425;410;15;;55;0.04;454;0.35;129978
7624;Zuidwest-Drenthe (CR);2009 september;129978;113;77;391;357;34;425;401;24;;2;0.0;456;0.35;129980
7625;Zuidwest-Drenthe (CR);2009 oktober;129980;108;78;353;330;23;372;341;31;;11;0.01;467;0.36;129991
7626;Zuidwest-Drenthe (CR);2009 november;129991;122;87;338;302;36;331;313;18;;42;0.03;509;0.39;130033
7627;Zuidwest-Drenthe (CR);2009 december;130033;118;107;338;300;38;332;318;14;51.0;68;0.05;577;0.45;130101
7628;Zuidwest-Drenthe (CR);2009;129524;1437;1111;4629;4173;456;4429;4146;283;51.0;577;0.45;577;0.45;130101
7629;Zuidwest-Drenthe (CR);2010 januari;130101;105;92;350;328;22;345;312;33;;18;0.01;18;0.01;130119
7630;Zuidwest-Drenthe (CR);2010 februari;130119;117;103;341;310;31;356;347;9;;-1;0.0;17;0.01;130118
7631;Zuidwest-Drenthe (CR);2010 maart;130118;120;91;404;363;41;364;345;19;;69;0.05;86;0.07;130187
7632;Zuidwest-Drenthe (CR);2010 april;130187;104;101;353;324;29;308;302;6;;48;0.04;134;0.1;130235
7633;Zuidwest-Drenthe (CR);2010 mei;130235;110;82;343;309;34;281;256;25;;90;0.07;224;0.17;130325
7634;Zuidwest-Drenthe (CR);2010 juni;130325;104;84;371;340;31;282;266;16;;109;0.08;333;0.26;130434
7635;Zuidwest-Drenthe (CR);2010 juli;130434;116;101;429;376;53;395;369;26;;49;0.04;382;0.29;130483
7636;Zuidwest-Drenthe (CR);2010 augustus;130483;110;104;446;416;30;481;439;42;;-29;-0.02;353;0.27;130454
7637;Zuidwest-Drenthe (CR);2010 september;130454;130;98;353;306;47;450;414;36;;-65;-0.05;288;0.22;130389
7638;Zuidwest-Drenthe (CR);2010 oktober;130389;130;86;329;304;25;363;325;38;;10;0.01;298;0.23;130399
7639;Zuidwest-Drenthe (CR);2010 november;130399;128;118;289;261;28;374;346;28;;-75;-0.06;223;0.17;130324
7640;Zuidwest-Drenthe (CR);2010 december;130324;110;102;403;364;39;364;340;24;-14.0;33;0.03;256;0.2;130357
7641;Zuidwest-Drenthe (CR);2010;130101;1384;1162;4411;4001;410;4363;4061;302;-14.0;256;0.2;256;0.2;130357
7642;Zuidwest-Drenthe (CR);2011 januari;130357;120;98;359;312;47;375;344;31;;6;0.0;6;0.0;130363
7643;Zuidwest-Drenthe (CR);2011 februari;130363;97;100;321;291;30;333;318;15;;-15;-0.01;-9;-0.01;130348
7644;Zuidwest-Drenthe (CR);2011 maart;130348;102;115;365;321;44;375;352;23;;-23;-0.02;-32;-0.02;130325
7645;Zuidwest-Drenthe (CR);2011 april;130325;104;100;429;367;62;335;311;24;;98;0.08;66;0.05;130423
7646;Zuidwest-Drenthe (CR);2011 mei;130423;104;85;322;290;32;287;264;23;;54;0.04;120;0.09;130477
7647;Zuidwest-Drenthe (CR);2011 juni;130477;117;78;332;297;35;274;255;19;;97;0.07;217;0.17;130574
7648;Zuidwest-Drenthe (CR);2011 juli;130574;112;105;420;374;46;429;387;42;;-2;0.0;215;0.16;130572
7649;Zuidwest-Drenthe (CR);2011 augustus;130572;114;98;449;408;41;505;481;24;;-40;-0.03;175;0.13;130532
7650;Zuidwest-Drenthe (CR);2011 september;130532;129;94;398;344;54;456;423;33;;-23;-0.02;152;0.12;130509
7651;Zuidwest-Drenthe (CR);2011 oktober;130509;122;99;356;308;48;420;381;39;;-41;-0.03;111;0.09;130468
7652;Zuidwest-Drenthe (CR);2011 november;130468;102;100;290;269;21;357;324;33;;-65;-0.05;46;0.04;130403
7653;Zuidwest-Drenthe (CR);2011 december;130403;109;118;403;371;32;383;349;34;-1.0;10;0.01;56;0.04;130413
7654;Zuidwest-Drenthe (CR);2011;130357;1332;1190;4444;3952;492;4529;4189;340;-1.0;56;0.04;56;0.04;130413
7655;Zuidwest-Drenthe (CR);2012 januari;130413;113;108;426;396;30;434;413;21;;-3;0.0;-3;0.0;130410
7656;Zuidwest-Drenthe (CR);2012 februari;130410;91;96;360;341;19;363;346;17;;-8;-0.01;-11;-0.01;130402
7657;Zuidwest-Drenthe (CR);2012 maart;130402;100;119;429;390;39;417;394;23;;-7;-0.01;-18;-0.01;130395
7658;Zuidwest-Drenthe (CR);2012 april;130395;97;124;326;299;27;318;297;21;;-19;-0.01;-37;-0.03;130376
7659;Zuidwest-Drenthe (CR);2012 mei;130376;93;89;383;362;21;332;322;10;;55;0.04;18;0.01;130431
7660;Zuidwest-Drenthe (CR);2012 juni;130431;114;98;410;384;26;337;309;28;;89;0.07;107;0.08;130520
7661;Zuidwest-Drenthe (CR);2012 juli;130520;114;88;486;441;45;436;418;18;;76;0.06;183;0.14;130596
7662;Zuidwest-Drenthe (CR);2012 augustus;130596;110;107;431;385;46;490;450;40;;-56;-0.04;127;0.1;130540
7663;Zuidwest-Drenthe (CR);2012 september;130540;86;100;373;335;38;431;398;33;;-72;-0.06;55;0.04;130468
7664;Zuidwest-Drenthe (CR);2012 oktober;130468;115;101;409;353;56;393;389;4;;30;0.02;85;0.07;130498
7665;Zuidwest-Drenthe (CR);2012 november;130498;108;112;351;312;39;389;355;34;;-42;-0.03;43;0.03;130456
7666;Zuidwest-Drenthe (CR);2012 december;130456;105;104;343;326;17;351;324;27;3.0;-4;0.0;39;0.03;130452
7667;Zuidwest-Drenthe (CR);2012;130413;1246;1246;4727;4324;403;4691;4415;276;3.0;39;0.03;39;0.03;130452
7668;Zuidwest-Drenthe (CR);2013 januari;130452;94;129;413;368;45;417;404;13;;-39;-0.03;-39;-0.03;130413
7669;Zuidwest-Drenthe (CR);2013 februari;130413;97;109;304;281;23;304;288;16;;-12;-0.01;-51;-0.04;130401
7670;Zuidwest-Drenthe (CR);2013 maart;130401;94;134;385;363;22;348;313;35;;-3;0.0;-54;-0.04;130398
7671;Zuidwest-Drenthe (CR);2013 april;130398;112;108;337;309;28;354;332;22;;-13;-0.01;-67;-0.05;130385
7672;Zuidwest-Drenthe (CR);2013 mei;130385;109;109;325;289;36;292;287;5;;33;0.03;-34;-0.03;130418
7673;Zuidwest-Drenthe (CR);2013 juni;130418;104;102;284;251;33;310;276;34;;-24;-0.02;-58;-0.04;130394
7674;Zuidwest-Drenthe (CR);2013 juli;130394;120;91;447;382;65;451;424;27;;25;0.02;-33;-0.03;130419
7675;Zuidwest-Drenthe (CR);2013 augustus;130419;94;108;421;385;36;532;499;33;;-125;-0.1;-158;-0.12;130294
7676;Zuidwest-Drenthe (CR);2013 september;130294;104;95;392;365;27;532;491;41;;-131;-0.1;-289;-0.22;130163
7677;Zuidwest-Drenthe (CR);2013 oktober;130163;88;99;353;333;20;398;363;35;;-56;-0.04;-345;-0.26;130107
7678;Zuidwest-Drenthe (CR);2013 november;130107;92;112;374;347;27;368;318;50;;-14;-0.01;-359;-0.28;130093
7679;Zuidwest-Drenthe (CR);2013 december;130093;91;97;334;320;14;369;346;23;-5.0;-46;-0.04;-405;-0.31;130047
7680;Zuidwest-Drenthe (CR);2013;130452;1199;1293;4369;3993;376;4675;4341;334;-5.0;-405;-0.31;-405;-0.31;130047
7681;Zuidwest-Drenthe (CR);2014 januari;130047;98;108;437;406;31;423;389;34;;4;0.0;4;0.0;130051
7682;Zuidwest-Drenthe (CR);2014 februari;130051;87;90;356;330;26;353;333;20;;0;0.0;4;0.0;130051
7683;Zuidwest-Drenthe (CR);2014 maart;130051;92;96;396;374;22;357;340;17;;35;0.03;39;0.03;130086
7684;Zuidwest-Drenthe (CR);2014 april;130086;115;104;418;361;57;383;325;58;;46;0.04;85;0.07;130132
7685;Zuidwest-Drenthe (CR);2014 mei;130132;101;108;389;345;44;370;318;52;;12;0.01;97;0.07;130144
7686;Zuidwest-Drenthe (CR);2014 juni;130144;123;91;361;326;35;331;301;30;;62;0.05;159;0.12;130206
7687;Zuidwest-Drenthe (CR);2014 juli;130206;121;95;477;429;48;441;408;33;;62;0.05;221;0.17;130268
7688;Zuidwest-Drenthe (CR);2014 augustus;130268;115;114;479;421;58;490;470;20;;-10;-0.01;211;0.16;130258
7689;Zuidwest-Drenthe (CR);2014 september;130258;107;90;427;388;39;486;446;40;;-42;-0.03;169;0.13;130216
7690;Zuidwest-Drenthe (CR);2014 oktober;130216;99;104;456;420;36;392;378;14;;59;0.05;228;0.18;130275
7691;Zuidwest-Drenthe (CR);2014 november;130275;93;93;370;332;38;351;316;35;;19;0.01;247;0.19;130294
7692;Zuidwest-Drenthe (CR);2014 december;130294;102;131;538;443;95;408;387;21;10.0;111;0.09;358;0.28;130405
7693;Zuidwest-Drenthe (CR);2014;130047;1253;1224;5104;4575;529;4785;4411;374;10.0;358;0.28;358;0.28;130405
7694;Zuidwest-Drenthe (CR);2015 januari;130405;115;115;465;393;72;477;436;41;;-12;-0.01;-12;-0.01;130393
7695;Zuidwest-Drenthe (CR);2015 februari;130393;83;101;472;418;54;451;427;24;;3;0.0;-9;-0.01;130396
7696;Zuidwest-Drenthe (CR);2015 maart;130396;97;102;473;432;41;385;371;14;;83;0.06;74;0.06;130479
7697;Zuidwest-Drenthe (CR);2015 april;130479;75;111;478;352;126;401;349;52;;41;0.03;115;0.09;130520
7698;Zuidwest-Drenthe (CR);2015 mei;130520;96;110;547;363;184;339;320;19;;194;0.15;309;0.24;130714
7699;Zuidwest-Drenthe (CR);2015 juni;130714;103;106;499;365;134;427;399;28;;69;0.05;378;0.29;130783
7700;Zuidwest-Drenthe (CR);2015 juli;130783;92;103;641;484;157;580;542;38;;50;0.04;428;0.33;130833
7701;Zuidwest-Drenthe (CR);2015 augustus;130833;116;94;530;428;102;599;563;36;;-47;-0.04;381;0.29;130786
7702;Zuidwest-Drenthe (CR);2015 september;130786;93;111;512;407;105;497;451;46;;-3;0.0;378;0.29;130783
7703;Zuidwest-Drenthe (CR);2015 oktober;130783;120;83;438;363;75;593;552;41;;-118;-0.09;260;0.2;130665
7704;Zuidwest-Drenthe (CR);2015 november;130665;102;112;474;320;154;482;462;20;;-18;-0.01;242;0.19;130647
7705;Zuidwest-Drenthe (CR);2015 december;130647;97;118;564;423;141;497;468;29;3.0;49;0.04;291;0.22;130696
7706;Zuidwest-Drenthe (CR);2015;130405;1189;1266;6093;4748;1345;5728;5340;388;3.0;291;0.22;291;0.22;130696
7707;Zuidwest-Drenthe (CR);2016 januari;130696;86;142;561;470;91;571;526;45;;-66;-0.05;-66;-0.05;130630
7708;Zuidwest-Drenthe (CR);2016 februari;130630;101;105;673;508;165;471;457;14;;198;0.15;132;0.1;130828
7709;Zuidwest-Drenthe (CR);2016 maart;130828;104;141;578;460;118;508;483;25;;33;0.03;165;0.13;130861
7710;Zuidwest-Drenthe (CR);2016 april;130861;89;124;584;480;104;506;476;30;;43;0.03;208;0.16;130904
7711;Zuidwest-Drenthe (CR);2016 mei;130904;106;124;480;411;69;466;444;22;;-4;0.0;204;0.16;130900
7712;Zuidwest-Drenthe (CR);2016 juni;130900;95;103;591;506;85;465;428;37;;118;0.09;322;0.25;131018
7713;Zuidwest-Drenthe (CR);2016 juli;131018;112;90;591;530;61;550;527;23;;63;0.05;385;0.29;131081
7714;Zuidwest-Drenthe (CR);2016 augustus;131081;111;110;700;588;112;608;584;24;;93;0.07;478;0.37;131174
7715;Zuidwest-Drenthe (CR);2016 september;131174;98;92;612;514;98;667;623;44;;-49;-0.04;429;0.33;131125
7716;Zuidwest-Drenthe (CR);2016 oktober;131125;93;99;544;485;59;529;488;41;;9;0.01;438;0.34;131134
7717;Zuidwest-Drenthe (CR);2016 november;131134;94;107;600;541;59;560;514;46;;27;0.02;465;0.36;131161
7718;Zuidwest-Drenthe (CR);2016 december;131161;96;120;552;500;52;523;501;22;-2.0;3;0.0;468;0.36;131164
7719;Zuidwest-Drenthe (CR);2016;130696;1185;1357;7066;5993;1073;6424;6051;373;-2.0;468;0.36;468;0.36;131164
7720;Zuidwest-Drenthe (CR);2017 januari;131164;89;140;553;513;40;468;444;24;;34;0.03;34;0.03;131198
7721;Zuidwest-Drenthe (CR);2017 februari;131198;76;133;499;465;34;412;388;24;;30;0.02;64;0.05;131228
7722;Zuidwest-Drenthe (CR);2017 maart;131228;98;103;574;524;50;516;491;25;;53;0.04;117;0.09;131281
7723;Zuidwest-Drenthe (CR);2017 april;131281;100;101;443;391;52;473;453;20;;-31;-0.02;86;0.07;131250
7724;Zuidwest-Drenthe (CR);2017 mei;131250;102;115;557;494;63;413;386;27;;131;0.1;217;0.17;131381
7725;Zuidwest-Drenthe (CR);2017 juni;131381;106;107;493;455;38;440;412;28;;52;0.04;269;0.21;131433
7726;Zuidwest-Drenthe (CR);2017 juli;131433;114;102;660;612;48;516;485;31;;156;0.12;425;0.32;131589
7727;Zuidwest-Drenthe (CR);2017 augustus;131589;114;132;735;652;83;609;582;27;;108;0.08;533;0.41;131697
7728;Zuidwest-Drenthe (CR);2017 september;131697;114;102;621;560;61;556;530;26;;77;0.06;610;0.47;131774
7729;Zuidwest-Drenthe (CR);2017 oktober;131774;122;109;646;596;50;490;459;31;;169;0.13;779;0.59;131943
7730;Zuidwest-Drenthe (CR);2017 november;131943;101;105;566;505;61;439;425;14;;123;0.09;902;0.69;132066
7731;Zuidwest-Drenthe (CR);2017 december;132066;93;122;622;560;62;498;473;25;-5.0;90;0.07;992;0.76;132156
7732;Zuidwest-Drenthe (CR);2017;131164;1229;1371;6969;6327;642;5830;5528;302;-5.0;992;0.76;992;0.76;132156
7733;Zuidwest-Drenthe (CR);2018 januari;132156;100;154;506;463;43;443;411;32;;9;0.01;9;0.01;132165
7734;Zuidwest-Drenthe (CR);2018 februari;132165;82;145;531;462;69;427;402;25;;41;0.03;50;0.04;132206
7735;Zuidwest-Drenthe (CR);2018 maart;132206;92;161;588;519;69;547;483;64;;-28;-0.02;22;0.02;132178
7736;Zuidwest-Drenthe (CR);2018 april;132178;97;106;526;463;63;442;404;38;;75;0.06;97;0.07;132253
7737;Zuidwest-Drenthe (CR);2018 mei;132253;90;90;543;467;76;440;415;25;;103;0.08;200;0.15;132356
7738;Zuidwest-Drenthe (CR);2018 juni;132356;86;103;502;464;38;480;426;54;;5;0.0;205;0.16;132361
7739;Zuidwest-Drenthe (CR);2018 juli;132361;97;102;597;541;56;577;511;66;;15;0.01;220;0.17;132376
7740;Zuidwest-Drenthe (CR);2018 augustus;132376;97;82;705;614;91;573;551;22;;147;0.11;367;0.28;132523
7741;Zuidwest-Drenthe (CR);2018 september;132523;99;107;655;553;102;622;546;76;;25;0.02;392;0.3;132548
7742;Zuidwest-Drenthe (CR);2018 oktober;132548;97;117;591;496;95;565;471;94;;6;0.0;398;0.3;132554
7743;Zuidwest-Drenthe (CR);2018 november;132554;107;112;621;548;73;496;463;33;;120;0.09;518;0.39;132674
7744;Zuidwest-Drenthe (CR);2018 december;132674;74;135;518;450;68;451;412;39;4.0;10;0.01;528;0.4;132684
7745;Zuidwest-Drenthe (CR);2018;132156;1118;1414;6883;6040;843;6063;5495;568;4.0;528;0.4;528;0.4;132684
7746;Zuidwest-Drenthe (CR);2019 januari;132684;102;132;596;511;85;509;464;45;;57;0.04;57;0.04;132741
7747;Zuidwest-Drenthe (CR);2019 februari;132741;80;100;508;463;45;515;485;30;;-27;-0.02;30;0.02;132714
7748;Zuidwest-Drenthe (CR);2019 maart;132714;87;113;550;495;55;476;450;26;;48;0.04;78;0.06;132762
7749;Zuidwest-Drenthe (CR);2019 april;132762;104;129;470;425;45;414;397;17;;31;0.02;109;0.08;132793
7750;Zuidwest-Drenthe (CR);2019 mei;132793;90;116;477;434;43;436;412;24;;15;0.01;124;0.09;132808
7751;Zuidwest-Drenthe (CR);2019 juni;132808;103;86;430;379;51;374;322;52;;73;0.05;197;0.15;132881
7752;Zuidwest-Drenthe (CR);2019 juli;132881;110;100;659;618;41;529;485;44;;140;0.11;337;0.25;133021
7753;Zuidwest-Drenthe (CR);2019 augustus;133021;114;123;680;563;117;509;453;56;;162;0.12;499;0.38;133183
7754;Zuidwest-Drenthe (CR);2019 september;133183;118;98;551;489;62;533;478;55;;38;0.03;537;0.4;133221
7755;Zuidwest-Drenthe (CR);2019 oktober;133221;88;98;640;581;59;578;553;25;;52;0.04;589;0.44;133273
7756;Zuidwest-Drenthe (CR);2019 november;133273;94;112;615;573;42;466;442;24;;131;0.1;720;0.54;133404
7757;Zuidwest-Drenthe (CR);2019 december;133404;93;106;469;439;30;448;425;23;-3.0;5;0.0;725;0.55;133409
7758;Zuidwest-Drenthe (CR);2019;132684;1183;1313;6645;5970;675;5787;5366;421;-3.0;725;0.55;725;0.55;133409
7759;Zuidwest-Drenthe (CR);2020 januari;133409;104;137;571;520;51;522;497;25;;16;0.01;16;0.01;133425
7760;Zuidwest-Drenthe (CR);2020 februari;133425;74;109;586;513;73;517;477;40;;34;0.03;50;0.04;133459
7761;Zuidwest-Drenthe (CR);2020 maart;133459;79;107;509;473;36;471;425;46;;10;0.01;60;0.04;133469
7762;Zuidwest-Drenthe (CR);2020 april;133469;95;136;479;439;40;403;395;8;;35;0.03;95;0.07;133504
7763;Zuidwest-Drenthe (CR);2020 mei;133504;113;111;482;454;28;473;454;19;;11;0.01;106;0.08;133515
7764;Zuidwest-Drenthe (CR);2020 juni;133515;77;98;501;468;33;438;412;26;;42;0.03;148;0.11;133557
7765;Zuidwest-Drenthe (CR);2020 juli;133557;99;108;656;601;55;591;554;37;;56;0.04;204;0.15;133613
7766;Zuidwest-Drenthe (CR);2020 augustus;133613;102;115;619;544;75;513;484;29;;93;0.07;297;0.22;133706
7767;Zuidwest-Drenthe (CR);2020 september;133706;125;109;582;498;84;523;494;29;;75;0.06;372;0.28;133781
7768;Zuidwest-Drenthe (CR);2020 oktober;133781;102;113;603;564;39;529;509;20;;63;0.05;435;0.33;133844
7769;Zuidwest-Drenthe (CR);2020 november;133844;92;126;518;482;36;396;370;26;;88;0.07;523;0.39;133932
7770;Zuidwest-Drenthe (CR);2020 december;133932;107;160;579;534;45;441;411;30;7.0;92;0.07;615;0.46;134024
7771;Zuidwest-Drenthe (CR);2020;133409;1169;1429;6685;6090;595;5817;5482;335;7.0;615;0.46;615;0.46;134024
7772;Zuidwest-Drenthe (CR);2021 januari;134024;105;184;600;558;42;529;481;48;0.0;-8;-0.01;-8;-0.01;134016
7773;Zuidwest-Drenthe (CR);2021 februari;134016;90;128;584;543;41;499;478;21;0.0;47;0.04;39;0.03;134063
7774;Zuidwest-Drenthe (CR);2021 maart;134063;95;127;741;702;39;526;503;23;0.0;183;0.14;222;0.17;134246
7775;Zuidwest-Drenthe (CR);2021 april;134246;122;124;611;588;23;464;443;21;0.0;145;0.11;367;0.27;134391
7776;Zuidwest-Drenthe (CR);2021 mei;134391;110;139;554;520;34;417;392;25;0.0;108;0.08;475;0.35;134499
7777;Zuidwest-Drenthe (CR);2021 juni;134499;106;111;635;562;73;445;399;46;0.0;185;0.14;660;0.49;134684
7778;Zuidwest-Drenthe (CR);2021 juli;134684;119;127;635;572;63;469;416;53;0.0;158;0.12;818;0.61;134842
7779;Zuidwest-Drenthe (CR);2021 augustus;134842;127;94;663;521;142;506;453;53;0.0;190;0.14;1008;0.75;135032
7780;Zuidwest-Drenthe (CR);2021 september;135032;105;116;545;456;89;513;463;50;0.0;21;0.02;1029;0.77;135053
7781;Zuidwest-Drenthe (CR);2021 oktober;135053;99;119;603;542;61;534;489;45;0.0;49;0.04;1078;0.8;135102
7782;Zuidwest-Drenthe (CR);2021 november;135102;93;156;447;418;29;428;408;20;0.0;-44;-0.03;1034;0.77;135058
7783;Zuidwest-Drenthe (CR);2021 december;135058;104;183;476;448;28;468;434;34;-4.0;-75;-0.06;959;0.72;134983
7784;Zuidwest-Drenthe (CR);2021;134024;1275;1608;7094;6430;664;5798;5359;439;-4.0;959;0.72;959;0.72;134983
7785;Zuidwest-Drenthe (CR);2022 januari;134983;95;128;526;483;43;436;411;25;;57;0.04;57;0.04;135040
7786;Zuidwest-Drenthe (CR);2022 februari;135040;93;135;493;456;37;472;423;49;;-21;-0.02;36;0.03;135019
7787;Zuidwest-Drenthe (CR);2022 maart;135019;72;147;747;507;240;454;431;23;;218;0.16;254;0.19;135237
7788;Zuidwest-Drenthe (CR);2022 april;135237;98;143;659;455;204;471;436;35;;143;0.11;397;0.29;135380
7789;Zuidwest-Drenthe (CR);2022 mei;135380;89;134;677;504;173;505;454;51;;127;0.09;524;0.39;135507
7790;Zuidwest-Drenthe (CR);2022 juni;135507;90;119;649;478;171;466;399;67;;154;0.11;678;0.5;135661
7791;Zuidwest-Drenthe (CR);2022 juli;135661;109;125;756;565;191;526;436;90;;214;0.16;892;0.66;135875
7792;Zuidwest-Drenthe (CR);2022 augustus;135875;104;139;758;539;219;536;488;48;;187;0.14;1079;0.8;136062
7793;Zuidwest-Drenthe (CR);2022 september;136062;89;113;746;569;177;608;548;60;;114;0.08;1193;0.88;136176
7794;Zuidwest-Drenthe (CR);2022 oktober;136176;92;147;607;484;123;517;456;61;;35;0.03;1228;0.91;136211
7795;Zuidwest-Drenthe (CR);2022 november;136211;88;140;630;523;107;490;417;73;;88;0.06;1316;0.97;136299
7796;Zuidwest-Drenthe (CR);2022 december;136299;85;161;621;558;63;490;431;59;5.0;60;0.04;1376;1.02;136359
7797;Zuidwest-Drenthe (CR);2022;134983;1104;1631;7869;6121;1748;5971;5330;641;5.0;1376;1.02;1376;1.02;136359
7798;Zuidwest-Drenthe (CR);2023 januari;136359;81;158;579;507;72;530;468;62;0.0;-28;-0.02;-28;-0.02;136331
7799;Zuidwest-Drenthe (CR);2023 februari;136331;86;136;568;474;94;517;419;98;0.0;1;0.0;-27;-0.02;136332
7800;Zuidwest-Drenthe (CR);2023 maart;136332;110;130;607;508;99;505;453;52;0.0;82;0.06;55;0.04;136414
7801;Zuidwest-Drenthe (CR);2023 april;136414;78;119;617;567;50;473;409;64;0.0;103;0.08;158;0.12;136517
7802;Zuidwest-Drenthe (CR);2023 mei;136517;96;119;548;496;52;456;395;61;0.0;69;0.05;227;0.17;136586
7803;Zuidwest-Drenthe (CR);2023 juni;136586;92;123;631;555;76;573;503;70;0.0;27;0.02;254;0.19;136613
7804;Zuidwest-Drenthe (CR);2023 juli;136613;100;108;687;577;110;612;536;76;0.0;67;0.05;321;0.24;136680
7805;Zuidwest-Drenthe (CR);2023 augustus;136680;92;103;698;539;159;633;552;81;0.0;54;0.04;375;0.28;136734
7806;Zuidwest-Drenthe (CR);2023 september;136734;94;111;681;538;143;599;540;59;0.0;65;0.05;440;0.32;136799
7807;Zuidwest-Drenthe (CR);2023 oktober;136799;103;129;610;504;106;526;470;56;0.0;58;0.04;498;0.37;136857
7808;Zuidwest-Drenthe (CR);2023 november;136857;96;137;645;534;111;495;438;57;0.0;109;0.08;607;0.45;136966
7809;Zuidwest-Drenthe (CR);2023 december;136966;89;149;570;474;96;485;435;50;-7.0;18;0.01;625;0.46;136984
7810;Zuidwest-Drenthe (CR);2023;136359;1117;1522;7441;6273;1168;6404;5618;786;-7.0;625;0.46;625;0.46;136984
7811;Zuidwest-Drenthe (CR);2024 januari;136984;94;177;615;514;101;505;436;69;;27;0.02;27;0.02;137011
7812;Zuidwest-Drenthe (CR);2024 februari;137011;83;146;502;425;77;449;388;61;;-10;-0.01;17;0.01;137001
7813;Zuidwest-Drenthe (CR);2024 maart;137001;77;108;643;544;99;546;497;49;;66;0.05;83;0.06;137067
7814;Zuidwest-Drenthe (CR);2024 april;137067;87;126;737;680;57;494;447;47;;204;0.15;287;0.21;137271
7815;Zuidwest-Drenthe (CR);2024 mei;137271;92;116;442;384;58;503;465;38;;-85;-0.06;202;0.15;137186
7816;Zuidwest-Drenthe (CR);2024 juni;137186;86;115;535;475;60;433;363;70;;73;0.05;275;0.2;137259
7817;Zuidwest-Drenthe (CR);2024 juli;137259;98;100;670;583;87;535;460;75;;133;0.1;408;0.3;137392
7818;Zuidwest-Drenthe (CR);2024 augustus;137392;103;124;776;645;131;606;524;82;;149;0.11;557;0.41;137541
7819;Zuidwest-Drenthe (CR);2024 september;137541;121;119;682;567;115;552;488;64;;132;0.1;689;0.5;137673
7820;Zuidwest-Drenthe (CR);2024 oktober;137673;74;126;778;601;177;489;420;69;;237;0.17;926;0.68;137910
7821;Zuidwest-Drenthe (CR);2024 november;137910;98;122;490;446;44;473;419;54;;-7;-0.01;919;0.67;137903
7822;Zuidwest-Drenthe (CR);2024 december;137903;104;142;527;472;55;535;452;83;0.0;-46;-0.03;873;0.64;137857
7823;Zuidwest-Drenthe (CR);2024;136984;1117;1521;7397;6336;1061;6120;5359;761;0.0;873;0.64;873;0.64;137857
7824;Zuidwest-Drenthe (CR);2025 januari;137857;83;132;628;524;104;511;452;59;;68;0.05;68;0.05;137925
7825;Zuidwest-Drenthe (CR);2025 februari;137925;85;150;647;559;88;532;476;56;;50;0.04;118;0.09;137975
7826;Noord-Overijssel (CR);2002 januari;337314;420;258;1152;1039;113;1078;966;112;;236;0.07;236;0.07;337550
7827;Noord-Overijssel (CR);2002 februari;337550;377;223;963;856;107;838;767;71;;279;0.08;515;0.15;337829
7828;Noord-Overijssel (CR);2002 maart;337829;407;242;1010;883;127;949;900;49;;226;0.07;741;0.22;338055
7829;Noord-Overijssel (CR);2002 april;338055;412;249;927;810;117;917;858;59;;173;0.05;914;0.27;338228
7830;Noord-Overijssel (CR);2002 mei;338228;380;205;982;857;125;923;880;43;;234;0.07;1148;0.34;338462
7831;Noord-Overijssel (CR);2002 juni;338462;386;230;987;827;160;914;832;82;;229;0.07;1377;0.41;338691
7832;Noord-Overijssel (CR);2002 juli;338691;395;242;1327;1177;150;1280;1099;181;;200;0.06;1577;0.47;338891
7833;Noord-Overijssel (CR);2002 augustus;338891;428;229;1320;1132;188;1297;1191;106;;222;0.07;1799;0.53;339113
7834;Noord-Overijssel (CR);2002 september;339113;428;213;1196;1045;151;1209;1100;109;;202;0.06;2001;0.59;339315
7835;Noord-Overijssel (CR);2002 oktober;339315;427;190;1190;1051;139;1185;1013;172;;242;0.07;2243;0.66;339557
7836;Noord-Overijssel (CR);2002 november;339557;384;218;1015;856;159;878;813;65;;303;0.09;2546;0.75;339860
7837;Noord-Overijssel (CR);2002 december;339860;396;260;853;741;112;939;833;106;71.0;121;0.04;2667;0.79;339981
7838;Noord-Overijssel (CR);2002;337314;4840;2759;12922;11274;1648;12407;11252;1155;71.0;2667;0.79;2667;0.79;339981
7839;Noord-Overijssel (CR);2003 januari;339981;409;254;1207;1094;113;1122;1032;90;;240;0.07;240;0.07;340221
7840;Noord-Overijssel (CR);2003 februari;340221;379;213;896;801;95;905;826;79;;157;0.05;397;0.12;340378
7841;Noord-Overijssel (CR);2003 maart;340378;415;238;983;871;112;997;831;166;;163;0.05;560;0.16;340541
7842;Noord-Overijssel (CR);2003 april;340541;399;243;887;813;74;998;865;133;;45;0.01;605;0.18;340586
7843;Noord-Overijssel (CR);2003 mei;340586;411;219;890;838;52;993;865;128;;89;0.03;694;0.2;340675
7844;Noord-Overijssel (CR);2003 juni;340675;391;226;1023;933;90;1014;919;95;;174;0.05;868;0.26;340849
7845;Noord-Overijssel (CR);2003 juli;340849;456;197;1294;1156;138;1286;1131;155;;267;0.08;1135;0.33;341116
7846;Noord-Overijssel (CR);2003 augustus;341116;424;225;1289;1158;131;1407;1289;118;;81;0.02;1216;0.36;341197
7847;Noord-Overijssel (CR);2003 september;341197;425;224;1112;1017;95;1384;1255;129;;-71;-0.02;1145;0.34;341126
7848;Noord-Overijssel (CR);2003 oktober;341126;412;233;1074;961;113;1121;1021;100;;132;0.04;1277;0.38;341258
7849;Noord-Overijssel (CR);2003 november;341258;413;251;878;804;74;956;807;149;;84;0.02;1361;0.4;341342
7850;Noord-Overijssel (CR);2003 december;341342;358;260;1000;932;68;1033;907;126;153.0;218;0.06;1579;0.46;341560
7851;Noord-Overijssel (CR);2003;339981;4892;2783;12533;11378;1155;13216;11748;1468;153.0;1579;0.46;1579;0.46;341560
7852;Noord-Overijssel (CR);2004 januari;341560;378;267;1011;935;76;1093;1001;92;;29;0.01;29;0.01;341589
7853;Noord-Overijssel (CR);2004 februari;341589;356;206;886;808;78;1011;939;72;;25;0.01;54;0.02;341614
7854;Noord-Overijssel (CR);2004 maart;341614;418;267;923;863;60;950;885;65;;124;0.04;178;0.05;341738
7855;Noord-Overijssel (CR);2004 april;341738;383;235;912;844;68;801;732;69;;259;0.08;437;0.13;341997
7856;Noord-Overijssel (CR);2004 mei;341997;351;207;796;720;76;807;727;80;;133;0.04;570;0.17;342130
7857;Noord-Overijssel (CR);2004 juni;342130;401;208;922;831;91;1010;863;147;;105;0.03;675;0.2;342235
7858;Noord-Overijssel (CR);2004 juli;342235;444;191;1207;1113;94;1254;1120;134;;206;0.06;881;0.26;342441
7859;Noord-Overijssel (CR);2004 augustus;342441;366;208;1234;1127;107;1454;1319;135;;-62;-0.02;819;0.24;342379
7860;Noord-Overijssel (CR);2004 september;342379;363;203;998;910;88;1288;1171;117;;-130;-0.04;689;0.2;342249
7861;Noord-Overijssel (CR);2004 oktober;342249;402;221;992;894;98;1090;1012;78;;83;0.02;772;0.23;342332
7862;Noord-Overijssel (CR);2004 november;342332;378;221;967;900;67;956;904;52;;168;0.05;940;0.28;342500
7863;Noord-Overijssel (CR);2004 december;342500;371;247;942;884;58;981;915;66;56.0;141;0.04;1081;0.32;342641
7864;Noord-Overijssel (CR);2004;341560;4611;2681;11790;10829;961;12695;11588;1107;56.0;1081;0.32;1081;0.32;342641
7865;Noord-Overijssel (CR);2005 januari;342641;395;255;1061;995;66;1050;939;111;;151;0.04;151;0.04;342792
7866;Noord-Overijssel (CR);2005 februari;342792;381;236;913;858;55;880;742;138;;178;0.05;329;0.1;342970
7867;Noord-Overijssel (CR);2005 maart;342970;413;264;889;819;70;863;791;72;;175;0.05;504;0.15;343145
7868;Noord-Overijssel (CR);2005 april;343145;395;205;926;855;71;907;810;97;;209;0.06;713;0.21;343354
7869;Noord-Overijssel (CR);2005 mei;343354;369;232;984;901;83;831;777;54;;290;0.08;1003;0.29;343644
7870;Noord-Overijssel (CR);2005 juni;343644;395;188;925;842;83;945;848;97;;187;0.05;1190;0.35;343831
7871;Noord-Overijssel (CR);2005 juli;343831;418;216;1191;1095;96;1231;1071;160;;162;0.05;1352;0.39;343993
7872;Noord-Overijssel (CR);2005 augustus;343993;423;215;1367;1218;149;1343;1230;113;;232;0.07;1584;0.46;344225
7873;Noord-Overijssel (CR);2005 september;344225;370;167;1380;1293;87;1373;1238;135;;210;0.06;1794;0.52;344435
7874;Noord-Overijssel (CR);2005 oktober;344435;410;225;1090;991;99;1166;1036;130;;109;0.03;1903;0.56;344544
7875;Noord-Overijssel (CR);2005 november;344544;353;211;1008;941;67;1036;952;84;;114;0.03;2017;0.59;344658
7876;Noord-Overijssel (CR);2005 december;344658;358;252;907;858;49;963;857;106;93.0;143;0.04;2160;0.63;344801
7877;Noord-Overijssel (CR);2005;342641;4680;2666;12641;11666;975;12588;11291;1297;93.0;2160;0.63;2160;0.63;344801
7878;Noord-Overijssel (CR);2006 januari;344801;393;243;1134;1058;76;950;890;60;;334;0.1;334;0.1;345135
7879;Noord-Overijssel (CR);2006 februari;345135;358;225;958;898;60;897;849;48;;194;0.06;528;0.15;345329
7880;Noord-Overijssel (CR);2006 maart;345329;364;259;946;904;42;1111;975;136;;-60;-0.02;468;0.14;345269
7881;Noord-Overijssel (CR);2006 april;345269;354;251;961;876;85;846;774;72;;218;0.06;686;0.2;345487
7882;Noord-Overijssel (CR);2006 mei;345487;367;212;988;914;74;935;787;148;;208;0.06;894;0.26;345695
7883;Noord-Overijssel (CR);2006 juni;345695;387;225;1076;983;93;905;842;63;;333;0.1;1227;0.36;346028
7884;Noord-Overijssel (CR);2006 juli;346028;418;240;1323;1247;76;1148;1061;87;;353;0.1;1580;0.46;346381
7885;Noord-Overijssel (CR);2006 augustus;346381;384;217;1464;1340;124;1572;1416;156;;59;0.02;1639;0.48;346440
7886;Noord-Overijssel (CR);2006 september;346440;403;207;1348;1232;116;1397;1253;144;;147;0.04;1786;0.52;346587
7887;Noord-Overijssel (CR);2006 oktober;346587;393;229;1074;990;84;1193;1098;95;;45;0.01;1831;0.53;346632
7888;Noord-Overijssel (CR);2006 november;346632;392;213;1121;1059;62;1140;1017;123;;160;0.05;1991;0.58;346792
7889;Noord-Overijssel (CR);2006 december;346792;345;226;947;888;59;1038;901;137;76.0;104;0.03;2095;0.61;346896
7890;Noord-Overijssel (CR);2006;344801;4558;2747;13340;12389;951;13132;11863;1269;76.0;2095;0.61;2095;0.61;346896
7891;Noord-Overijssel (CR);2007 januari;346896;393;247;1132;1048;84;1071;921;150;;207;0.06;207;0.06;347103
7892;Noord-Overijssel (CR);2007 februari;347103;321;236;967;870;97;996;925;71;;56;0.02;263;0.08;347159
7893;Noord-Overijssel (CR);2007 maart;347159;390;236;1039;953;86;934;857;77;;259;0.07;522;0.15;347418
7894;Noord-Overijssel (CR);2007 april;347418;326;215;883;822;61;881;792;89;;113;0.03;635;0.18;347531
7895;Noord-Overijssel (CR);2007 mei;347531;367;197;970;903;67;924;855;69;;216;0.06;851;0.25;347747
7896;Noord-Overijssel (CR);2007 juni;347747;338;193;1071;973;98;1041;935;106;;175;0.05;1026;0.3;347922
7897;Noord-Overijssel (CR);2007 juli;347922;403;197;1470;1375;95;1386;1257;129;;290;0.08;1316;0.38;348212
7898;Noord-Overijssel (CR);2007 augustus;348212;370;173;1446;1320;126;1399;1278;121;;244;0.07;1560;0.45;348456
7899;Noord-Overijssel (CR);2007 september;348456;409;197;1351;1203;148;1338;1211;127;;225;0.06;1785;0.51;348681
7900;Noord-Overijssel (CR);2007 oktober;348681;393;217;1186;1059;127;1139;1041;98;;223;0.06;2008;0.58;348904
7901;Noord-Overijssel (CR);2007 november;348904;371;217;1098;1021;77;1021;937;84;;231;0.07;2239;0.65;349135
7902;Noord-Overijssel (CR);2007 december;349135;381;259;900;829;71;964;850;114;103.0;161;0.05;2400;0.69;349296
7903;Noord-Overijssel (CR);2007;346896;4462;2584;13513;12376;1137;13094;11859;1235;103.0;2400;0.69;2400;0.69;349296
7904;Noord-Overijssel (CR);2008 januari;349296;363;266;1288;1159;129;1187;1060;127;;198;0.06;198;0.06;349494
7905;Noord-Overijssel (CR);2008 februari;349494;352;222;1128;1026;102;934;871;63;;324;0.09;522;0.15;349818
7906;Noord-Overijssel (CR);2008 maart;349818;353;203;989;905;84;899;824;75;;240;0.07;762;0.22;350058
7907;Noord-Overijssel (CR);2008 april;350058;355;216;1006;917;89;900;805;95;;245;0.07;1007;0.29;350303
7908;Noord-Overijssel (CR);2008 mei;350303;354;193;916;839;77;877;777;100;;200;0.06;1207;0.35;350503
7909;Noord-Overijssel (CR);2008 juni;350503;385;205;1034;943;91;1007;893;114;;207;0.06;1414;0.4;350710
7910;Noord-Overijssel (CR);2008 juli;350710;436;191;1371;1222;149;1278;1180;98;;338;0.1;1752;0.5;351048
7911;Noord-Overijssel (CR);2008 augustus;351048;384;213;1406;1272;134;1461;1270;191;;116;0.03;1868;0.53;351164
7912;Noord-Overijssel (CR);2008 september;351164;386;177;1273;1112;161;1381;1280;101;;101;0.03;1969;0.56;351265
7913;Noord-Overijssel (CR);2008 oktober;351265;406;197;1117;997;120;1177;1090;87;;149;0.04;2118;0.61;351414
7914;Noord-Overijssel (CR);2008 november;351414;388;225;1010;895;115;978;902;76;;195;0.06;2313;0.66;351609
7915;Noord-Overijssel (CR);2008 december;351609;354;222;1010;924;86;917;865;52;44.0;269;0.08;2582;0.74;351878
7916;Noord-Overijssel (CR);2008;349296;4516;2530;13548;12211;1337;12996;11817;1179;44.0;2582;0.74;2582;0.74;351878
7917;Noord-Overijssel (CR);2009 januari;351878;394;279;1114;993;121;1005;928;77;;224;0.06;224;0.06;352102
7918;Noord-Overijssel (CR);2009 februari;352102;357;227;1048;915;133;967;852;115;;211;0.06;435;0.12;352313
7919;Noord-Overijssel (CR);2009 maart;352313;391;228;985;870;115;880;793;87;;268;0.08;703;0.2;352581
7920;Noord-Overijssel (CR);2009 april;352581;382;237;791;719;72;802;716;86;;134;0.04;837;0.24;352715
7921;Noord-Overijssel (CR);2009 mei;352715;349;200;795;705;90;711;648;63;;233;0.07;1070;0.3;352948
7922;Noord-Overijssel (CR);2009 juni;352948;363;196;941;821;120;869;782;87;;239;0.07;1309;0.37;353187
7923;Noord-Overijssel (CR);2009 juli;353187;389;214;1254;1137;117;1350;1184;166;;79;0.02;1388;0.39;353266
7924;Noord-Overijssel (CR);2009 augustus;353266;406;207;1233;1096;137;1353;1227;126;;79;0.02;1467;0.42;353345
7925;Noord-Overijssel (CR);2009 september;353345;418;202;1234;1055;179;1347;1244;103;;103;0.03;1570;0.45;353448
7926;Noord-Overijssel (CR);2009 oktober;353448;383;200;1023;917;106;1019;952;67;;187;0.05;1757;0.5;353635
7927;Noord-Overijssel (CR);2009 november;353635;370;207;904;823;81;882;816;66;;185;0.05;1942;0.55;353820
7928;Noord-Overijssel (CR);2009 december;353820;373;231;921;857;64;882;802;80;53.0;234;0.07;2176;0.62;354054
7929;Noord-Overijssel (CR);2009;351878;4575;2628;12243;10908;1335;12067;10944;1123;53.0;2176;0.62;2176;0.62;354054
7930;Noord-Overijssel (CR);2010 januari;354054;381;231;1057;922;135;1002;914;88;;205;0.06;205;0.06;354259
7931;Noord-Overijssel (CR);2010 februari;354259;355;249;990;864;126;917;859;58;;179;0.05;384;0.11;354438
7932;Noord-Overijssel (CR);2010 maart;354438;356;223;931;824;107;900;819;81;;164;0.05;548;0.15;354602
7933;Noord-Overijssel (CR);2010 april;354602;360;221;873;805;68;804;763;41;;208;0.06;756;0.21;354810
7934;Noord-Overijssel (CR);2010 mei;354810;389;227;853;743;110;745;683;62;;270;0.08;1026;0.29;355080
7935;Noord-Overijssel (CR);2010 juni;355080;345;202;869;774;95;903;782;121;;109;0.03;1135;0.32;355189
7936;Noord-Overijssel (CR);2010 juli;355189;387;206;1281;1114;167;1137;1001;136;;325;0.09;1460;0.41;355514
7937;Noord-Overijssel (CR);2010 augustus;355514;392;191;1349;1174;175;1412;1274;138;;138;0.04;1598;0.45;355652
7938;Noord-Overijssel (CR);2010 september;355652;379;207;1189;1020;169;1303;1210;93;;58;0.02;1656;0.47;355710
7939;Noord-Overijssel (CR);2010 oktober;355710;415;219;918;832;86;926;839;87;;188;0.05;1844;0.52;355898
7940;Noord-Overijssel (CR);2010 november;355898;388;226;943;851;92;948;839;109;;157;0.04;2001;0.57;356055
7941;Noord-Overijssel (CR);2010 december;356055;375;248;915;831;84;924;847;77;-12.0;106;0.03;2107;0.6;356161
7942;Noord-Overijssel (CR);2010;354054;4522;2650;12168;10754;1414;11921;10830;1091;-12.0;2107;0.6;2107;0.6;356161
7943;Noord-Overijssel (CR);2011 januari;356161;359;255;1001;902;99;1006;892;114;;99;0.03;99;0.03;356260
7944;Noord-Overijssel (CR);2011 februari;356260;349;200;1020;864;156;858;782;76;;311;0.09;410;0.12;356571
7945;Noord-Overijssel (CR);2011 maart;356571;367;226;882;778;104;887;790;97;;136;0.04;546;0.15;356707
7946;Noord-Overijssel (CR);2011 april;356707;345;247;877;791;86;815;743;72;;160;0.04;706;0.2;356867
7947;Noord-Overijssel (CR);2011 mei;356867;332;219;829;727;102;763;685;78;;179;0.05;885;0.25;357046
7948;Noord-Overijssel (CR);2011 juni;357046;375;211;931;786;145;910;817;93;;185;0.05;1070;0.3;357231
7949;Noord-Overijssel (CR);2011 juli;357231;379;217;1264;1119;145;1247;1053;194;;179;0.05;1249;0.35;357410
7950;Noord-Overijssel (CR);2011 augustus;357410;407;179;1285;1115;170;1399;1288;111;;114;0.03;1363;0.38;357524
7951;Noord-Overijssel (CR);2011 september;357524;388;209;1474;1211;263;1366;1229;137;;287;0.08;1650;0.46;357811
7952;Noord-Overijssel (CR);2011 oktober;357811;411;230;973;856;117;988;891;97;;166;0.05;1816;0.51;357977
7953;Noord-Overijssel (CR);2011 november;357977;352;208;912;810;102;1022;819;203;;34;0.01;1850;0.52;358011
7954;Noord-Overijssel (CR);2011 december;358011;355;261;920;843;77;878;794;84;1.0;137;0.04;1987;0.56;358148
7955;Noord-Overijssel (CR);2011;356161;4419;2662;12368;10802;1566;12139;10783;1356;1.0;1987;0.56;1987;0.56;358148
7956;Noord-Overijssel (CR);2012 januari;358148;362;222;1176;1049;127;1133;1024;109;;183;0.05;183;0.05;358331
7957;Noord-Overijssel (CR);2012 februari;358331;371;256;1003;842;161;1069;937;132;;49;0.01;232;0.06;358380
7958;Noord-Overijssel (CR);2012 maart;358380;357;209;975;866;109;917;810;107;;206;0.06;438;0.12;358586
7959;Noord-Overijssel (CR);2012 april;358586;349;256;937;848;89;848;774;74;;182;0.05;620;0.17;358768
7960;Noord-Overijssel (CR);2012 mei;358768;384;221;979;873;106;919;822;97;;223;0.06;843;0.24;358991
7961;Noord-Overijssel (CR);2012 juni;358991;346;215;1008;878;130;1034;911;123;;105;0.03;948;0.26;359096
7962;Noord-Overijssel (CR);2012 juli;359096;426;207;1225;1079;146;1282;1142;140;;162;0.05;1110;0.31;359258
7963;Noord-Overijssel (CR);2012 augustus;359258;391;201;1361;1220;141;1537;1386;151;;14;0.0;1124;0.31;359272
7964;Noord-Overijssel (CR);2012 september;359272;388;206;1276;1080;196;1277;1152;125;;181;0.05;1305;0.36;359453
7965;Noord-Overijssel (CR);2012 oktober;359453;396;214;1037;934;103;1030;921;109;;189;0.05;1494;0.42;359642
7966;Noord-Overijssel (CR);2012 november;359642;340;206;919;833;86;990;887;103;;63;0.02;1557;0.43;359705
7967;Noord-Overijssel (CR);2012 december;359705;356;259;846;764;82;840;747;93;-2.0;101;0.03;1658;0.46;359806
7968;Noord-Overijssel (CR);2012;358148;4466;2672;12742;11266;1476;12876;11513;1363;-2.0;1658;0.46;1658;0.46;359806
7969;Noord-Overijssel (CR);2013 januari;359806;380;265;1114;985;129;1125;980;145;;104;0.03;104;0.03;359910
7970;Noord-Overijssel (CR);2013 februari;359910;282;237;1027;871;156;996;883;113;;76;0.02;180;0.05;359986
7971;Noord-Overijssel (CR);2013 maart;359986;341;250;899;800;99;995;887;108;;-5;0.0;175;0.05;359981
7972;Noord-Overijssel (CR);2013 april;359981;354;236;897;810;87;815;732;83;;200;0.06;375;0.1;360181
7973;Noord-Overijssel (CR);2013 mei;360181;387;239;827;739;88;963;818;145;;12;0.0;387;0.11;360193
7974;Noord-Overijssel (CR);2013 juni;360193;348;230;869;758;111;876;757;119;;111;0.03;498;0.14;360304
7975;Noord-Overijssel (CR);2013 juli;360304;393;226;1385;1245;140;1291;1158;133;;261;0.07;759;0.21;360565
7976;Noord-Overijssel (CR);2013 augustus;360565;392;195;1325;1169;156;1514;1396;118;;8;0.0;767;0.21;360573
7977;Noord-Overijssel (CR);2013 september;360573;379;191;1247;1033;214;1427;1271;156;;8;0.0;775;0.22;360581
7978;Noord-Overijssel (CR);2013 oktober;360581;375;197;1060;969;91;1169;1040;129;;69;0.02;844;0.23;360650
7979;Noord-Overijssel (CR);2013 november;360650;342;220;930;830;100;1037;932;105;;15;0.0;859;0.24;360665
7980;Noord-Overijssel (CR);2013 december;360665;351;241;935;844;91;967;893;74;4.0;82;0.02;941;0.26;360747
7981;Noord-Overijssel (CR);2013;359806;4324;2727;12515;11053;1462;13175;11747;1428;4.0;941;0.26;941;0.26;360747
7982;Noord-Overijssel (CR);2014 januari;360747;356;267;1185;1045;140;1245;1052;193;;29;0.01;29;0.01;360776
7983;Noord-Overijssel (CR);2014 februari;360776;354;192;1082;955;127;1018;937;81;;226;0.06;255;0.07;361002
7984;Noord-Overijssel (CR);2014 maart;361002;345;233;982;863;119;956;853;103;;138;0.04;393;0.11;361140
7985;Noord-Overijssel (CR);2014 april;361140;347;228;890;799;91;904;800;104;;105;0.03;498;0.14;361245
7986;Noord-Overijssel (CR);2014 mei;361245;361;266;895;818;77;891;800;91;;99;0.03;597;0.17;361344
7987;Noord-Overijssel (CR);2014 juni;361344;385;219;1024;924;100;1041;884;157;;149;0.04;746;0.21;361493
7988;Noord-Overijssel (CR);2014 juli;361493;367;217;1282;1156;126;1300;1120;180;;132;0.04;878;0.24;361625
7989;Noord-Overijssel (CR);2014 augustus;361625;358;205;1364;1181;183;1625;1473;152;;-108;-0.03;770;0.21;361517
7990;Noord-Overijssel (CR);2014 september;361517;380;245;1444;1230;214;1503;1371;132;;76;0.02;846;0.23;361593
7991;Noord-Overijssel (CR);2014 oktober;361593;403;219;1035;922;113;1184;1078;106;;35;0.01;881;0.24;361628
7992;Noord-Overijssel (CR);2014 november;361628;345;236;944;871;73;982;913;69;;71;0.02;952;0.26;361699
7993;Noord-Overijssel (CR);2014 december;361699;318;286;1137;1029;108;1185;1070;115;11.0;-5;0.0;947;0.26;361694
7994;Noord-Overijssel (CR);2014;360747;4319;2813;13264;11793;1471;13834;12351;1483;11.0;947;0.26;947;0.26;361694
7995;Noord-Overijssel (CR);2015 januari;361694;354;286;1539;1165;374;1280;1092;188;;327;0.09;327;0.09;362021
7996;Noord-Overijssel (CR);2015 februari;362021;313;265;1152;1023;129;1150;1035;115;;50;0.01;377;0.1;362071
7997;Noord-Overijssel (CR);2015 maart;362071;345;247;1082;987;95;1120;1037;83;;60;0.02;437;0.12;362131
7998;Noord-Overijssel (CR);2015 april;362131;352;244;1001;903;98;952;878;74;;157;0.04;594;0.16;362288
7999;Noord-Overijssel (CR);2015 mei;362288;356;213;969;888;81;999;894;105;;113;0.03;707;0.2;362401
8000;Noord-Overijssel (CR);2015 juni;362401;320;228;1199;1070;129;1154;1014;140;;137;0.04;844;0.23;362538
8001;Noord-Overijssel (CR);2015 juli;362538;399;231;1417;1290;127;1240;1066;174;;345;0.1;1189;0.33;362883
8002;Noord-Overijssel (CR);2015 augustus;362883;364;225;1507;1325;182;1506;1377;129;;140;0.04;1329;0.37;363023
8003;Noord-Overijssel (CR);2015 september;363023;372;204;1488;1211;277;1356;1250;106;;300;0.08;1629;0.45;363323
8004;Noord-Overijssel (CR);2015 oktober;363323;380;265;1299;1117;182;1139;1044;95;;275;0.08;1904;0.53;363598
8005;Noord-Overijssel (CR);2015 november;363598;347;215;1238;1051;187;1032;974;58;;338;0.09;2242;0.62;363936
8006;Noord-Overijssel (CR);2015 december;363936;309;230;1325;1100;225;1059;987;72;19.0;364;0.1;2606;0.72;364300
8007;Noord-Overijssel (CR);2015;361694;4211;2853;15216;13130;2086;13987;12648;1339;19.0;2606;0.72;2606;0.72;364300
8008;Noord-Overijssel (CR);2016 januari;364300;358;280;1298;1125;173;1254;1071;183;;122;0.03;122;0.03;364422
8009;Noord-Overijssel (CR);2016 februari;364422;295;246;1315;1097;218;1222;1121;101;;142;0.04;264;0.07;364564
8010;Noord-Overijssel (CR);2016 maart;364564;378;278;1125;1020;105;1155;1076;79;;70;0.02;334;0.09;364634
8011;Noord-Overijssel (CR);2016 april;364634;358;220;1205;1115;90;1247;1113;134;;96;0.03;430;0.12;364730
8012;Noord-Overijssel (CR);2016 mei;364730;373;237;1015;897;118;897;810;87;;254;0.07;684;0.19;364984
8013;Noord-Overijssel (CR);2016 juni;364984;370;212;1106;1015;91;1140;970;170;;124;0.03;808;0.22;365108
8014;Noord-Overijssel (CR);2016 juli;365108;321;219;1585;1444;141;1511;1346;165;;176;0.05;984;0.27;365284
8015;Noord-Overijssel (CR);2016 augustus;365284;357;206;1676;1489;187;1669;1530;139;;158;0.04;1142;0.31;365442
8016;Noord-Overijssel (CR);2016 september;365442;375;229;1508;1263;245;1415;1293;122;;239;0.07;1381;0.38;365681
8017;Noord-Overijssel (CR);2016 oktober;365681;381;250;1258;1114;144;1303;1173;130;;86;0.02;1467;0.4;365767
8018;Noord-Overijssel (CR);2016 november;365767;361;259;1411;1309;102;1146;1084;62;;367;0.1;1834;0.5;366134
8019;Noord-Overijssel (CR);2016 december;366134;323;262;1393;1310;83;1260;1154;106;-9.0;185;0.05;2019;0.55;366319
8020;Noord-Overijssel (CR);2016;364300;4250;2898;15895;14198;1697;15219;13741;1478;-9.0;2019;0.55;2019;0.55;366319
8021;Noord-Overijssel (CR);2017 januari;366319;340;322;1543;1353;190;1304;1134;170;;257;0.07;257;0.07;366576
8022;Noord-Overijssel (CR);2017 februari;366576;324;246;1348;1226;122;1255;1157;98;;171;0.05;428;0.12;366747
8023;Noord-Overijssel (CR);2017 maart;366747;347;255;1336;1224;112;1216;1117;99;;212;0.06;640;0.17;366959
8024;Noord-Overijssel (CR);2017 april;366959;336;229;1140;1048;92;964;905;59;;283;0.08;923;0.25;367242
8025;Noord-Overijssel (CR);2017 mei;367242;375;250;1307;1196;111;1127;1073;54;;305;0.08;1228;0.34;367547
8026;Noord-Overijssel (CR);2017 juni;367547;318;226;1156;1038;118;1235;1067;168;;13;0.0;1241;0.34;367560
8027;Noord-Overijssel (CR);2017 juli;367560;336;223;1536;1383;153;1487;1329;158;;162;0.04;1403;0.38;367722
8028;Noord-Overijssel (CR);2017 augustus;367722;370;209;1846;1656;190;1604;1486;118;;403;0.11;1806;0.49;368125
8029;Noord-Overijssel (CR);2017 september;368125;339;238;1827;1516;311;1591;1487;104;;337;0.09;2143;0.59;368462
8030;Noord-Overijssel (CR);2017 oktober;368462;396;243;1319;1170;149;1213;1116;97;;259;0.07;2402;0.66;368721
8031;Noord-Overijssel (CR);2017 november;368721;304;240;1284;1179;105;1236;1093;143;;112;0.03;2514;0.69;368833
8032;Noord-Overijssel (CR);2017 december;368833;306;279;1236;1128;108;1272;1175;97;-5.0;-14;0.0;2500;0.68;368819
8033;Noord-Overijssel (CR);2017;366319;4091;2960;16878;15117;1761;15504;14139;1365;-5.0;2500;0.68;2500;0.68;368819
8034;Noord-Overijssel (CR);2018 januari;368819;315;287;1355;1247;108;1298;1108;190;;85;0.02;85;0.02;368904
8035;Noord-Overijssel (CR);2018 februari;368904;292;259;1327;1117;210;1094;1015;79;;266;0.07;351;0.1;369170
8036;Noord-Overijssel (CR);2018 maart;369170;347;348;1381;1309;72;1301;1198;103;;79;0.02;430;0.12;369249
8037;Noord-Overijssel (CR);2018 april;369249;344;269;1066;941;125;1018;923;95;;123;0.03;553;0.15;369372
8038;Noord-Overijssel (CR);2018 mei;369372;363;244;1253;1111;142;1141;1074;67;;231;0.06;784;0.21;369603
8039;Noord-Overijssel (CR);2018 juni;369603;332;231;1262;1153;109;1182;1039;143;;181;0.05;965;0.26;369784
8040;Noord-Overijssel (CR);2018 juli;369784;373;245;1763;1566;197;1469;1280;189;;422;0.11;1387;0.38;370206
8041;Noord-Overijssel (CR);2018 augustus;370206;366;207;1887;1650;237;1704;1587;117;;342;0.09;1729;0.47;370548
8042;Noord-Overijssel (CR);2018 september;370548;386;239;1613;1331;282;1431;1311;120;;329;0.09;2058;0.56;370877
8043;Noord-Overijssel (CR);2018 oktober;370877;352;262;1530;1367;163;1350;1235;115;;270;0.07;2328;0.63;371147
8044;Noord-Overijssel (CR);2018 november;371147;315;200;1271;1107;164;1162;1069;93;;224;0.06;2552;0.69;371371
8045;Noord-Overijssel (CR);2018 december;371371;296;290;1464;1328;136;1235;1154;81;2.0;237;0.06;2789;0.76;371608
8046;Noord-Overijssel (CR);2018;368819;4081;3081;17172;15227;1945;15385;13993;1392;2.0;2789;0.76;2789;0.76;371608
8047;Noord-Overijssel (CR);2019 januari;371608;340;282;1499;1277;222;1308;1148;160;;249;0.07;249;0.07;371857
8048;Noord-Overijssel (CR);2019 februari;371857;299;244;1378;1163;215;1115;1052;63;;318;0.09;567;0.15;372175
8049;Noord-Overijssel (CR);2019 maart;372175;351;252;1302;1141;161;1202;1080;122;;199;0.05;766;0.21;372374
8050;Noord-Overijssel (CR);2019 april;372374;338;227;1241;1069;172;1090;979;111;;262;0.07;1028;0.28;372636
8051;Noord-Overijssel (CR);2019 mei;372636;363;264;1256;1134;122;1206;1101;105;;149;0.04;1177;0.32;372785
8052;Noord-Overijssel (CR);2019 juni;372785;377;229;1215;1019;196;1043;905;138;;320;0.09;1497;0.4;373105
8053;Noord-Overijssel (CR);2019 juli;373105;357;236;1599;1385;214;1411;1248;163;;309;0.08;1806;0.49;373414
8054;Noord-Overijssel (CR);2019 augustus;373414;366;236;1666;1456;210;1470;1336;134;;326;0.09;2132;0.57;373740
8055;Noord-Overijssel (CR);2019 september;373740;341;208;1581;1246;335;1390;1267;123;;324;0.09;2456;0.66;374064
8056;Noord-Overijssel (CR);2019 oktober;374064;367;241;1486;1298;188;1328;1176;152;;284;0.08;2740;0.74;374348
8057;Noord-Overijssel (CR);2019 november;374348;304;259;1244;1104;140;1147;1042;105;;142;0.04;2882;0.78;374490
8058;Noord-Overijssel (CR);2019 december;374490;315;264;1220;1104;116;1091;976;115;-11.0;169;0.05;3051;0.82;374659
8059;Noord-Overijssel (CR);2019;371608;4118;2942;16687;14396;2291;14801;13310;1491;-11.0;3051;0.82;3051;0.82;374659
8060;Noord-Overijssel (CR);2020 januari;374659;333;279;1511;1314;197;1361;1192;169;;204;0.05;204;0.05;374863
8061;Noord-Overijssel (CR);2020 februari;374863;304;241;1346;1122;224;1176;1063;113;;233;0.06;437;0.12;375096
8062;Noord-Overijssel (CR);2020 maart;375096;332;353;1420;1177;243;1246;1132;114;;153;0.04;590;0.16;375249
8063;Noord-Overijssel (CR);2020 april;375249;334;450;1190;1106;84;1106;1047;59;;-32;-0.01;558;0.15;375217
8064;Noord-Overijssel (CR);2020 mei;375217;342;212;1291;1204;87;1053;1019;34;;368;0.1;926;0.25;375585
8065;Noord-Overijssel (CR);2020 juni;375585;327;238;1266;1143;123;1171;1099;72;;184;0.05;1110;0.3;375769
8066;Noord-Overijssel (CR);2020 juli;375769;382;231;1647;1480;167;1476;1319;157;;322;0.09;1432;0.38;376091
8067;Noord-Overijssel (CR);2020 augustus;376091;394;250;1532;1367;165;1415;1293;122;;261;0.07;1693;0.45;376352
8068;Noord-Overijssel (CR);2020 september;376352;355;214;1413;1233;180;1312;1215;97;;242;0.06;1935;0.52;376594
8069;Noord-Overijssel (CR);2020 oktober;376594;340;231;1509;1339;170;1357;1253;104;;261;0.07;2196;0.59;376855
8070;Noord-Overijssel (CR);2020 november;376855;302;263;1268;1152;116;1094;999;95;;213;0.06;2409;0.64;377068
8071;Noord-Overijssel (CR);2020 december;377068;347;296;1392;1270;122;1208;1111;97;-11.0;224;0.06;2633;0.7;377292
8072;Noord-Overijssel (CR);2020;374659;4092;3258;16785;14907;1878;14975;13742;1233;-11.0;2633;0.7;2633;0.7;377292
8073;Noord-Overijssel (CR);2021 januari;377292;361;319;1508;1374;134;1390;1260;130;0.0;160;0.04;160;0.04;377452
8074;Noord-Overijssel (CR);2021 februari;377452;308;252;1359;1166;193;1133;1055;78;0.0;282;0.07;442;0.12;377734
8075;Noord-Overijssel (CR);2021 maart;377734;357;298;1376;1277;99;1287;1180;107;0.0;148;0.04;590;0.16;377882
8076;Noord-Overijssel (CR);2021 april;377882;359;259;1296;1202;94;1176;1082;94;0.0;220;0.06;810;0.21;378102
8077;Noord-Overijssel (CR);2021 mei;378102;341;243;1216;1101;115;1148;1083;65;0.0;166;0.04;976;0.26;378268
8078;Noord-Overijssel (CR);2021 juni;378268;347;238;1243;1124;119;1182;1058;124;0.0;170;0.04;1146;0.3;378438
8079;Noord-Overijssel (CR);2021 juli;378438;362;244;1543;1390;153;1437;1224;213;0.0;224;0.06;1370;0.36;378662
8080;Noord-Overijssel (CR);2021 augustus;378662;397;258;1560;1394;166;1340;1214;126;0.0;359;0.09;1729;0.46;379021
8081;Noord-Overijssel (CR);2021 september;379021;347;224;1496;1204;292;1244;1150;94;0.0;375;0.1;2104;0.56;379396
8082;Noord-Overijssel (CR);2021 oktober;379396;360;256;1418;1264;154;1288;1197;91;0.0;234;0.06;2338;0.62;379630
8083;Noord-Overijssel (CR);2021 november;379630;338;337;1245;1116;129;1148;1031;117;0.0;98;0.03;2436;0.65;379728
8084;Noord-Overijssel (CR);2021 december;379728;355;350;1283;1164;119;1087;975;112;-18.0;183;0.05;2619;0.69;379911
8085;Noord-Overijssel (CR);2021;377292;4232;3278;16543;14776;1767;14860;13509;1351;-18.0;2619;0.69;2619;0.69;379911
8086;Noord-Overijssel (CR);2022 januari;379911;363;288;1342;1185;157;1114;938;176;;303;0.08;303;0.08;380214
8087;Noord-Overijssel (CR);2022 februari;380214;339;270;1303;1123;180;1123;1023;100;;249;0.07;552;0.15;380463
8088;Noord-Overijssel (CR);2022 maart;380463;330;307;1865;1105;760;1126;1036;90;;762;0.2;1314;0.35;381225
8089;Noord-Overijssel (CR);2022 april;381225;336;309;2324;1202;1122;1122;1006;116;;1229;0.32;2543;0.67;382454
8090;Noord-Overijssel (CR);2022 mei;382454;339;270;1724;1174;550;1304;1133;171;;489;0.13;3032;0.8;382943
8091;Noord-Overijssel (CR);2022 juni;382943;335;252;1573;1226;347;1224;1017;207;;432;0.11;3464;0.91;383375
8092;Noord-Overijssel (CR);2022 juli;383375;367;245;1871;1454;417;1549;1229;320;;444;0.12;3908;1.03;383819
8093;Noord-Overijssel (CR);2022 augustus;383819;365;276;1848;1533;315;1459;1211;248;;478;0.12;4386;1.15;384297
8094;Noord-Overijssel (CR);2022 september;384297;359;254;1955;1472;483;1525;1317;208;;535;0.14;4921;1.3;384832
8095;Noord-Overijssel (CR);2022 oktober;384832;351;322;1620;1297;323;1327;1140;187;;322;0.08;5243;1.38;385154
8096;Noord-Overijssel (CR);2022 november;385154;327;258;1440;1154;286;1259;1112;147;;250;0.06;5493;1.45;385404
8097;Noord-Overijssel (CR);2022 december;385404;316;362;1433;1247;186;1325;1169;156;7.0;69;0.02;5562;1.46;385473
8098;Noord-Overijssel (CR);2022;379911;4127;3413;20298;15172;5126;15457;13331;2126;7.0;5562;1.46;5562;1.46;385473
8099;Noord-Overijssel (CR);2023 januari;385473;281;313;1533;1315;218;1403;1172;231;0.0;98;0.03;98;0.03;385571
8100;Noord-Overijssel (CR);2023 februari;385571;275;231;1385;1115;270;1363;1165;198;0.0;66;0.02;164;0.04;385637
8101;Noord-Overijssel (CR);2023 maart;385637;348;302;1392;1166;226;1249;1096;153;0.0;189;0.05;353;0.09;385826
8102;Noord-Overijssel (CR);2023 april;385826;300;273;1253;1073;180;1312;1114;198;0.0;-32;-0.01;321;0.08;385794
8103;Noord-Overijssel (CR);2023 mei;385794;318;278;1332;1091;241;1123;971;152;0.0;249;0.06;570;0.15;386043
8104;Noord-Overijssel (CR);2023 juni;386043;335;255;1360;1161;199;1323;1170;153;0.0;117;0.03;687;0.18;386160
8105;Noord-Overijssel (CR);2023 juli;386160;371;263;1658;1422;236;1637;1377;260;0.0;129;0.03;816;0.21;386289
8106;Noord-Overijssel (CR);2023 augustus;386289;354;247;1851;1554;297;1740;1544;196;0.0;218;0.06;1034;0.27;386507
8107;Noord-Overijssel (CR);2023 september;386507;370;260;1739;1319;420;1519;1346;173;0.0;330;0.09;1364;0.35;386837
8108;Noord-Overijssel (CR);2023 oktober;386837;338;264;1666;1305;361;1298;1142;156;0.0;442;0.11;1806;0.47;387279
8109;Noord-Overijssel (CR);2023 november;387279;318;248;1475;1199;276;1269;1110;159;0.0;276;0.07;2082;0.54;387555
8110;Noord-Overijssel (CR);2023 december;387555;281;331;1385;1200;185;1249;1083;166;-18.0;68;0.02;2150;0.56;387623
8111;Noord-Overijssel (CR);2023;385473;3889;3265;18029;14920;3109;16485;14290;2195;-18.0;2150;0.56;2150;0.56;387623
8112;Noord-Overijssel (CR);2024 januari;387623;334;370;1441;1213;228;1411;1116;295;;-6;0.0;-6;0.0;387617
8113;Noord-Overijssel (CR);2024 februari;387617;330;279;1613;1185;428;1189;1062;127;;475;0.12;469;0.12;388092
8114;Noord-Overijssel (CR);2024 maart;388092;328;271;1551;1309;242;1239;1115;124;;369;0.1;838;0.22;388461
8115;Noord-Overijssel (CR);2024 april;388461;322;296;1479;1282;197;1288;1126;162;;217;0.06;1055;0.27;388678
8116;Noord-Overijssel (CR);2024 mei;388678;343;279;1335;1151;184;1115;955;160;;284;0.07;1339;0.35;388962
8117;Noord-Overijssel (CR);2024 juni;388962;328;247;1232;1054;178;1100;953;147;;213;0.05;1552;0.4;389175
8118;Noord-Overijssel (CR);2024 juli;389175;325;251;1826;1553;273;1639;1325;314;;261;0.07;1813;0.47;389436
8119;Noord-Overijssel (CR);2024 augustus;389436;340;231;1652;1411;241;1592;1353;239;;169;0.04;1982;0.51;389605
8120;Noord-Overijssel (CR);2024 september;389605;348;295;1584;1219;365;1394;1188;206;;243;0.06;2225;0.57;389848
8121;Noord-Overijssel (CR);2024 oktober;389848;328;279;1374;1168;206;1228;1103;125;;195;0.05;2420;0.62;390043
8122;Noord-Overijssel (CR);2024 november;390043;312;275;1318;1161;157;1210;1058;152;;145;0.04;2565;0.66;390188
8123;Noord-Overijssel (CR);2024 december;390188;318;312;1290;1127;163;1201;1033;168;0.0;95;0.02;2660;0.69;390283
8124;Noord-Overijssel (CR);2024;387623;3956;3385;17695;14833;2862;15606;13387;2219;0.0;2660;0.69;2660;0.69;390283
8125;Noord-Overijssel (CR);2025 januari;390283;356;351;1519;1292;227;1485;1207;278;;39;0.01;39;0.01;390322
8126;Noord-Overijssel (CR);2025 februari;390322;299;298;1478;1205;273;1302;1136;166;;177;0.05;216;0.06;390499
8127;Zuidwest-Overijssel (CR);2002 januari;144921;148;133;566;483;83;388;378;10;;193;0.13;193;0.13;145114
8128;Zuidwest-Overijssel (CR);2002 februari;145114;159;112;456;401;55;383;354;29;;120;0.08;313;0.22;145234
8129;Zuidwest-Overijssel (CR);2002 maart;145234;172;124;508;412;96;478;410;68;;78;0.05;391;0.27;145312
8130;Zuidwest-Overijssel (CR);2002 april;145312;148;121;434;391;43;346;337;9;;115;0.08;506;0.35;145427
8131;Zuidwest-Overijssel (CR);2002 mei;145427;169;111;408;359;49;468;319;149;;-2;0.0;504;0.35;145425
8132;Zuidwest-Overijssel (CR);2002 juni;145425;160;103;436;384;52;362;323;39;;131;0.09;635;0.44;145556
8133;Zuidwest-Overijssel (CR);2002 juli;145556;181;77;669;618;51;556;501;55;;217;0.15;852;0.59;145773
8134;Zuidwest-Overijssel (CR);2002 augustus;145773;172;105;676;590;86;636;594;42;;107;0.07;959;0.66;145880
8135;Zuidwest-Overijssel (CR);2002 september;145880;197;95;723;470;253;628;530;98;;197;0.14;1156;0.8;146077
8136;Zuidwest-Overijssel (CR);2002 oktober;146077;167;98;734;471;263;463;441;22;;340;0.23;1496;1.03;146417
8137;Zuidwest-Overijssel (CR);2002 november;146417;178;113;480;382;98;404;375;29;;141;0.1;1637;1.13;146558
8138;Zuidwest-Overijssel (CR);2002 december;146558;174;130;456;388;68;363;320;43;69.0;206;0.14;1843;1.27;146764
8139;Zuidwest-Overijssel (CR);2002;144921;2025;1322;6546;5349;1197;5475;4882;593;69.0;1843;1.27;1843;1.27;146764
8140;Zuidwest-Overijssel (CR);2003 januari;146764;163;119;494;434;60;444;402;42;;94;0.06;94;0.06;146858
8141;Zuidwest-Overijssel (CR);2003 februari;146858;155;84;470;397;73;397;371;26;;144;0.1;238;0.16;147002
8142;Zuidwest-Overijssel (CR);2003 maart;147002;175;111;462;347;115;379;334;45;;147;0.1;385;0.26;147149
8143;Zuidwest-Overijssel (CR);2003 april;147149;170;117;490;364;126;362;336;26;;181;0.12;566;0.39;147330
8144;Zuidwest-Overijssel (CR);2003 mei;147330;140;111;457;362;95;350;323;27;;136;0.09;702;0.48;147466
8145;Zuidwest-Overijssel (CR);2003 juni;147466;159;87;547;427;120;334;300;34;;285;0.19;987;0.67;147751
8146;Zuidwest-Overijssel (CR);2003 juli;147751;161;107;651;599;52;528;453;75;;177;0.12;1164;0.79;147928
8147;Zuidwest-Overijssel (CR);2003 augustus;147928;175;96;618;468;150;583;543;40;;114;0.08;1278;0.87;148042
8148;Zuidwest-Overijssel (CR);2003 september;148042;182;94;725;522;203;669;535;134;;144;0.1;1422;0.97;148186
8149;Zuidwest-Overijssel (CR);2003 oktober;148186;157;108;723;476;247;504;414;90;;268;0.18;1690;1.15;148454
8150;Zuidwest-Overijssel (CR);2003 november;148454;169;102;537;415;122;483;382;101;;121;0.08;1811;1.23;148575
8151;Zuidwest-Overijssel (CR);2003 december;148575;156;144;462;412;50;433;411;22;33.0;74;0.05;1885;1.28;148649
8152;Zuidwest-Overijssel (CR);2003;146764;1962;1280;6636;5223;1413;5466;4804;662;33.0;1885;1.28;1885;1.28;148649
8153;Zuidwest-Overijssel (CR);2004 januari;148649;161;137;492;450;42;396;374;22;;120;0.08;120;0.08;148769
8154;Zuidwest-Overijssel (CR);2004 februari;148769;155;128;557;474;83;420;385;35;;164;0.11;284;0.19;148933
8155;Zuidwest-Overijssel (CR);2004 maart;148933;161;126;598;478;120;504;365;139;;129;0.09;413;0.28;149062
8156;Zuidwest-Overijssel (CR);2004 april;149062;153;100;476;399;77;419;373;46;;110;0.07;523;0.35;149172
8157;Zuidwest-Overijssel (CR);2004 mei;149172;133;93;456;405;51;316;302;14;;180;0.12;703;0.47;149352
8158;Zuidwest-Overijssel (CR);2004 juni;149352;165;111;462;406;56;405;384;21;;111;0.07;814;0.55;149463
8159;Zuidwest-Overijssel (CR);2004 juli;149463;160;87;537;497;40;615;494;121;;-5;0.0;809;0.54;149458
8160;Zuidwest-Overijssel (CR);2004 augustus;149458;169;107;614;503;111;660;556;104;;16;0.01;825;0.55;149474
8161;Zuidwest-Overijssel (CR);2004 september;149474;163;92;668;518;150;568;511;57;;171;0.11;996;0.67;149645
8162;Zuidwest-Overijssel (CR);2004 oktober;149645;159;89;598;406;192;622;381;241;;46;0.03;1042;0.7;149691
8163;Zuidwest-Overijssel (CR);2004 november;149691;148;102;546;471;75;512;421;91;;80;0.05;1122;0.75;149771
8164;Zuidwest-Overijssel (CR);2004 december;149771;155;116;486;423;63;449;366;83;58.0;134;0.09;1256;0.84;149905
8165;Zuidwest-Overijssel (CR);2004;148649;1882;1288;6490;5430;1060;5886;4912;974;58.0;1256;0.84;1256;0.84;149905
8166;Zuidwest-Overijssel (CR);2005 januari;149905;147;90;564;516;48;473;442;31;;148;0.1;148;0.1;150053
8167;Zuidwest-Overijssel (CR);2005 februari;150053;138;115;444;395;49;441;347;94;;26;0.02;174;0.12;150079
8168;Zuidwest-Overijssel (CR);2005 maart;150079;170;121;593;414;179;435;387;48;;207;0.14;381;0.25;150286
8169;Zuidwest-Overijssel (CR);2005 april;150286;149;108;475;415;60;365;293;72;;151;0.1;532;0.35;150437
8170;Zuidwest-Overijssel (CR);2005 mei;150437;163;95;460;420;40;375;336;39;;153;0.1;685;0.46;150590
8171;Zuidwest-Overijssel (CR);2005 juni;150590;152;107;464;446;18;414;346;68;;95;0.06;780;0.52;150685
8172;Zuidwest-Overijssel (CR);2005 juli;150685;171;86;562;514;48;523;487;36;;124;0.08;904;0.6;150809
8173;Zuidwest-Overijssel (CR);2005 augustus;150809;134;83;719;614;105;729;598;131;;41;0.03;945;0.63;150850
8174;Zuidwest-Overijssel (CR);2005 september;150850;154;99;747;538;209;769;641;128;;33;0.02;978;0.65;150883
8175;Zuidwest-Overijssel (CR);2005 oktober;150883;160;102;610;486;124;574;427;147;;94;0.06;1072;0.72;150977
8176;Zuidwest-Overijssel (CR);2005 november;150977;152;105;522;431;91;533;390;143;;36;0.02;1108;0.74;151013
8177;Zuidwest-Overijssel (CR);2005 december;151013;145;131;521;471;50;514;364;150;12.0;33;0.02;1141;0.76;151046
8178;Zuidwest-Overijssel (CR);2005;149905;1835;1242;6681;5660;1021;6145;5058;1087;12.0;1141;0.76;1141;0.76;151046
8179;Zuidwest-Overijssel (CR);2006 januari;151046;155;112;506;450;56;472;424;48;;77;0.05;77;0.05;151123
8180;Zuidwest-Overijssel (CR);2006 februari;151123;144;106;492;418;74;469;404;65;;61;0.04;138;0.09;151184
8181;Zuidwest-Overijssel (CR);2006 maart;151184;155;130;553;501;52;522;397;125;;56;0.04;194;0.13;151240
8182;Zuidwest-Overijssel (CR);2006 april;151240;147;124;470;426;44;479;329;150;;14;0.01;208;0.14;151254
8183;Zuidwest-Overijssel (CR);2006 mei;151254;142;98;442;361;81;499;421;78;;-13;-0.01;195;0.13;151241
8184;Zuidwest-Overijssel (CR);2006 juni;151241;153;95;508;448;60;508;415;93;;58;0.04;253;0.17;151299
8185;Zuidwest-Overijssel (CR);2006 juli;151299;129;115;597;530;67;681;516;165;;-70;-0.05;183;0.12;151229
8186;Zuidwest-Overijssel (CR);2006 augustus;151229;144;99;690;630;60;771;611;160;;-36;-0.02;147;0.1;151193
8187;Zuidwest-Overijssel (CR);2006 september;151193;153;105;646;511;135;678;590;88;;16;0.01;163;0.11;151209
8188;Zuidwest-Overijssel (CR);2006 oktober;151209;150;94;511;437;74;550;465;85;;17;0.01;180;0.12;151226
8189;Zuidwest-Overijssel (CR);2006 november;151226;134;103;551;485;66;562;485;77;;20;0.01;200;0.13;151246
8190;Zuidwest-Overijssel (CR);2006 december;151246;144;113;429;392;37;449;412;37;-2.0;9;0.01;209;0.14;151255
8191;Zuidwest-Overijssel (CR);2006;151046;1750;1294;6395;5589;806;6640;5469;1171;-2.0;209;0.14;209;0.14;151255
8192;Zuidwest-Overijssel (CR);2007 januari;151255;150;116;543;481;62;533;436;97;;44;0.03;44;0.03;151299
8193;Zuidwest-Overijssel (CR);2007 februari;151299;141;102;488;431;57;425;403;22;;102;0.07;146;0.1;151401
8194;Zuidwest-Overijssel (CR);2007 maart;151401;146;108;467;395;72;496;444;52;;9;0.01;155;0.1;151410
8195;Zuidwest-Overijssel (CR);2007 april;151410;146;108;517;438;79;434;373;61;;121;0.08;276;0.18;151531
8196;Zuidwest-Overijssel (CR);2007 mei;151531;141;121;456;391;65;397;385;12;;79;0.05;355;0.23;151610
8197;Zuidwest-Overijssel (CR);2007 juni;151610;156;108;459;412;47;409;384;25;;98;0.06;453;0.3;151708
8198;Zuidwest-Overijssel (CR);2007 juli;151708;147;93;674;593;81;708;580;128;;20;0.01;473;0.31;151728
8199;Zuidwest-Overijssel (CR);2007 augustus;151728;156;82;711;636;75;791;708;83;;-6;0.0;467;0.31;151722
8200;Zuidwest-Overijssel (CR);2007 september;151722;172;92;612;492;120;777;609;168;;-85;-0.06;382;0.25;151637
8201;Zuidwest-Overijssel (CR);2007 oktober;151637;157;94;626;535;91;593;501;92;;96;0.06;478;0.32;151733
8202;Zuidwest-Overijssel (CR);2007 november;151733;143;103;505;455;50;683;515;168;;-138;-0.09;340;0.22;151595
8203;Zuidwest-Overijssel (CR);2007 december;151595;156;119;469;435;34;442;364;78;47.0;111;0.07;451;0.3;151706
8204;Zuidwest-Overijssel (CR);2007;151255;1811;1246;6527;5694;833;6688;5702;986;47.0;451;0.3;451;0.3;151706
8205;Zuidwest-Overijssel (CR);2008 januari;151706;137;112;534;461;73;529;470;59;;30;0.02;30;0.02;151736
8206;Zuidwest-Overijssel (CR);2008 februari;151736;147;111;506;441;65;552;447;105;;-10;-0.01;20;0.01;151726
8207;Zuidwest-Overijssel (CR);2008 maart;151726;176;105;530;436;94;519;468;51;;82;0.05;102;0.07;151808
8208;Zuidwest-Overijssel (CR);2008 april;151808;165;108;525;467;58;479;416;63;;103;0.07;205;0.14;151911
8209;Zuidwest-Overijssel (CR);2008 mei;151911;159;115;432;361;71;377;358;19;;99;0.07;304;0.2;152010
8210;Zuidwest-Overijssel (CR);2008 juni;152010;157;98;495;414;81;417;421;-4;;137;0.09;441;0.29;152147
8211;Zuidwest-Overijssel (CR);2008 juli;152147;154;108;661;553;108;640;539;101;;67;0.04;508;0.33;152214
8212;Zuidwest-Overijssel (CR);2008 augustus;152214;155;95;633;501;132;660;581;79;;33;0.02;541;0.36;152247
8213;Zuidwest-Overijssel (CR);2008 september;152247;151;87;708;481;227;658;607;51;;114;0.07;655;0.43;152361
8214;Zuidwest-Overijssel (CR);2008 oktober;152361;117;107;568;425;143;745;505;240;;-167;-0.11;488;0.32;152194
8215;Zuidwest-Overijssel (CR);2008 november;152194;140;81;445;325;120;465;414;51;;39;0.03;527;0.35;152233
8216;Zuidwest-Overijssel (CR);2008 december;152233;144;117;500;414;86;567;498;69;72.0;32;0.02;559;0.37;152265
8217;Zuidwest-Overijssel (CR);2008;151706;1802;1244;6537;5279;1258;6608;5724;884;72.0;559;0.37;559;0.37;152265
8218;Zuidwest-Overijssel (CR);2009 januari;152265;147;154;545;424;121;498;441;57;;40;0.03;40;0.03;152305
8219;Zuidwest-Overijssel (CR);2009 februari;152305;133;117;446;329;117;440;378;62;;22;0.01;62;0.04;152327
8220;Zuidwest-Overijssel (CR);2009 maart;152327;159;107;468;366;102;521;451;70;;-1;0.0;61;0.04;152326
8221;Zuidwest-Overijssel (CR);2009 april;152326;133;93;453;335;118;432;408;24;;61;0.04;122;0.08;152387
8222;Zuidwest-Overijssel (CR);2009 mei;152387;158;96;367;311;56;361;355;6;;68;0.04;190;0.12;152455
8223;Zuidwest-Overijssel (CR);2009 juni;152455;139;104;445;328;117;410;355;55;;70;0.05;260;0.17;152525
8224;Zuidwest-Overijssel (CR);2009 juli;152525;163;109;574;436;138;524;495;29;;104;0.07;364;0.24;152629
8225;Zuidwest-Overijssel (CR);2009 augustus;152629;149;98;612;442;170;591;539;52;;72;0.05;436;0.29;152701
8226;Zuidwest-Overijssel (CR);2009 september;152701;162;108;598;438;160;622;597;25;;30;0.02;466;0.31;152731
8227;Zuidwest-Overijssel (CR);2009 oktober;152731;149;100;531;388;143;497;407;90;;83;0.05;549;0.36;152814
8228;Zuidwest-Overijssel (CR);2009 november;152814;129;108;517;353;164;453;429;24;;85;0.06;634;0.42;152899
8229;Zuidwest-Overijssel (CR);2009 december;152899;131;115;400;319;81;422;399;23;-34.0;-40;-0.03;594;0.39;152859
8230;Zuidwest-Overijssel (CR);2009;152265;1752;1309;5956;4469;1487;5771;5254;517;-34.0;594;0.39;594;0.39;152859
8231;Zuidwest-Overijssel (CR);2010 januari;152859;135;100;493;423;70;538;426;112;;-10;-0.01;-10;-0.01;152849
8232;Zuidwest-Overijssel (CR);2010 februari;152849;135;108;409;339;70;482;418;64;;-46;-0.03;-56;-0.04;152803
8233;Zuidwest-Overijssel (CR);2010 maart;152803;154;108;488;346;142;439;381;58;;95;0.06;39;0.03;152898
8234;Zuidwest-Overijssel (CR);2010 april;152898;133;110;424;351;73;430;341;89;;17;0.01;56;0.04;152915
8235;Zuidwest-Overijssel (CR);2010 mei;152915;127;127;363;297;66;371;324;47;;-8;-0.01;48;0.03;152907
8236;Zuidwest-Overijssel (CR);2010 juni;152907;155;99;442;343;99;375;346;29;;123;0.08;171;0.11;153030
8237;Zuidwest-Overijssel (CR);2010 juli;153030;152;112;567;460;107;635;487;148;;-28;-0.02;143;0.09;153002
8238;Zuidwest-Overijssel (CR);2010 augustus;153002;154;97;626;461;165;659;561;98;;24;0.02;167;0.11;153026
8239;Zuidwest-Overijssel (CR);2010 september;153026;158;92;531;357;174;637;535;102;;-40;-0.03;127;0.08;152986
8240;Zuidwest-Overijssel (CR);2010 oktober;152986;163;103;471;325;146;501;406;95;;30;0.02;157;0.1;153016
8241;Zuidwest-Overijssel (CR);2010 november;153016;139;104;420;311;109;490;454;36;;-35;-0.02;122;0.08;152981
8242;Zuidwest-Overijssel (CR);2010 december;152981;154;127;401;329;72;479;404;75;-3.0;-54;-0.04;68;0.04;152927
8243;Zuidwest-Overijssel (CR);2010;152859;1759;1287;5635;4342;1293;6036;5083;953;-3.0;68;0.04;68;0.04;152927
8244;Zuidwest-Overijssel (CR);2011 januari;152927;118;122;489;412;77;437;406;31;;48;0.03;48;0.03;152975
8245;Zuidwest-Overijssel (CR);2011 februari;152975;129;87;430;349;81;440;407;33;;32;0.02;80;0.05;153007
8246;Zuidwest-Overijssel (CR);2011 maart;153007;151;98;472;328;144;552;393;159;;-27;-0.02;53;0.03;152980
8247;Zuidwest-Overijssel (CR);2011 april;152980;120;112;390;318;72;454;392;62;;-56;-0.04;-3;0.0;152924
8248;Zuidwest-Overijssel (CR);2011 mei;152924;133;94;375;278;97;380;288;92;;34;0.02;31;0.02;152958
8249;Zuidwest-Overijssel (CR);2011 juni;152958;152;107;394;299;95;491;371;120;;-52;-0.03;-21;-0.01;152906
8250;Zuidwest-Overijssel (CR);2011 juli;152906;133;81;486;408;78;533;444;89;;5;0.0;-16;-0.01;152911
8251;Zuidwest-Overijssel (CR);2011 augustus;152911;146;90;590;466;124;657;579;78;;-11;-0.01;-27;-0.02;152900
8252;Zuidwest-Overijssel (CR);2011 september;152900;131;80;629;382;247;606;537;69;;74;0.05;47;0.03;152974
8253;Zuidwest-Overijssel (CR);2011 oktober;152974;140;98;526;401;125;559;458;101;;9;0.01;56;0.04;152983
8254;Zuidwest-Overijssel (CR);2011 november;152983;161;120;417;357;60;512;439;73;;-54;-0.04;2;0.0;152929
8255;Zuidwest-Overijssel (CR);2011 december;152929;125;115;462;398;64;466;391;75;-1.0;5;0.0;7;0.0;152934
8256;Zuidwest-Overijssel (CR);2011;152927;1639;1204;5660;4396;1264;6087;5105;982;-1.0;7;0.0;7;0.0;152934
8257;Zuidwest-Overijssel (CR);2012 januari;152934;129;123;534;419;115;542;469;73;;-2;0.0;-2;0.0;152932
8258;Zuidwest-Overijssel (CR);2012 februari;152932;131;109;494;352;142;517;445;72;;-1;0.0;-3;0.0;152931
8259;Zuidwest-Overijssel (CR);2012 maart;152931;142;104;390;323;67;484;419;65;;-56;-0.04;-59;-0.04;152875
8260;Zuidwest-Overijssel (CR);2012 april;152875;143;113;335;280;55;416;341;75;;-51;-0.03;-110;-0.07;152824
8261;Zuidwest-Overijssel (CR);2012 mei;152824;130;101;363;312;51;413;347;66;;-21;-0.01;-131;-0.09;152803
8262;Zuidwest-Overijssel (CR);2012 juni;152803;145;80;468;393;75;491;431;60;;42;0.03;-89;-0.06;152845
8263;Zuidwest-Overijssel (CR);2012 juli;152845;143;94;536;429;107;650;514;136;;-65;-0.04;-154;-0.1;152780
8264;Zuidwest-Overijssel (CR);2012 augustus;152780;155;102;638;515;123;700;623;77;;-9;-0.01;-163;-0.11;152771
8265;Zuidwest-Overijssel (CR);2012 september;152771;132;109;513;382;131;586;491;95;;-50;-0.03;-213;-0.14;152721
8266;Zuidwest-Overijssel (CR);2012 oktober;152721;149;107;572;364;208;554;484;70;;60;0.04;-153;-0.1;152781
8267;Zuidwest-Overijssel (CR);2012 november;152781;114;107;404;342;62;413;369;44;;-2;0.0;-155;-0.1;152779
8268;Zuidwest-Overijssel (CR);2012 december;152779;138;116;391;325;66;378;317;61;4.0;39;0.03;-116;-0.08;152818
8269;Zuidwest-Overijssel (CR);2012;152934;1651;1265;5638;4436;1202;6144;5250;894;4.0;-116;-0.08;-116;-0.08;152818
8270;Zuidwest-Overijssel (CR);2013 januari;152818;129;149;458;394;64;515;389;126;;-77;-0.05;-77;-0.05;152741
8271;Zuidwest-Overijssel (CR);2013 februari;152741;111;108;488;376;112;468;405;63;;23;0.02;-54;-0.04;152764
8272;Zuidwest-Overijssel (CR);2013 maart;152764;137;100;524;374;150;481;415;66;;80;0.05;26;0.02;152844
8273;Zuidwest-Overijssel (CR);2013 april;152844;114;110;360;295;65;459;375;84;;-95;-0.06;-69;-0.05;152749
8274;Zuidwest-Overijssel (CR);2013 mei;152749;129;116;422;339;83;387;326;61;;48;0.03;-21;-0.01;152797
8275;Zuidwest-Overijssel (CR);2013 juni;152797;100;101;371;288;83;384;312;72;;-14;-0.01;-35;-0.02;152783
8276;Zuidwest-Overijssel (CR);2013 juli;152783;147;125;573;483;90;614;489;125;;-19;-0.01;-54;-0.04;152764
8277;Zuidwest-Overijssel (CR);2013 augustus;152764;160;97;592;472;120;755;650;105;;-100;-0.07;-154;-0.1;152664
8278;Zuidwest-Overijssel (CR);2013 september;152664;122;107;647;397;250;669;513;156;;-7;0.0;-161;-0.11;152657
8279;Zuidwest-Overijssel (CR);2013 oktober;152657;149;98;531;418;113;505;445;60;;77;0.05;-84;-0.05;152734
8280;Zuidwest-Overijssel (CR);2013 november;152734;147;83;461;396;65;539;475;64;;-14;-0.01;-98;-0.06;152720
8281;Zuidwest-Overijssel (CR);2013 december;152720;118;120;444;378;66;553;433;120;2.0;-109;-0.07;-207;-0.14;152611
8282;Zuidwest-Overijssel (CR);2013;152818;1563;1314;5871;4610;1261;6329;5227;1102;2.0;-207;-0.14;-207;-0.14;152611
8283;Zuidwest-Overijssel (CR);2014 januari;152611;107;106;525;440;85;505;436;69;;21;0.01;21;0.01;152632
8284;Zuidwest-Overijssel (CR);2014 februari;152632;131;102;544;417;127;520;431;89;;53;0.03;74;0.05;152685
8285;Zuidwest-Overijssel (CR);2014 maart;152685;126;104;478;354;124;441;401;40;;59;0.04;133;0.09;152744
8286;Zuidwest-Overijssel (CR);2014 april;152744;141;99;409;329;80;418;394;24;;33;0.02;166;0.11;152777
8287;Zuidwest-Overijssel (CR);2014 mei;152777;122;101;489;375;114;388;330;58;;122;0.08;288;0.19;152899
8288;Zuidwest-Overijssel (CR);2014 juni;152899;125;109;440;353;87;452;360;92;;4;0.0;292;0.19;152903
8289;Zuidwest-Overijssel (CR);2014 juli;152903;150;108;637;507;130;591;471;120;;88;0.06;380;0.25;152991
8290;Zuidwest-Overijssel (CR);2014 augustus;152991;116;112;643;488;155;707;610;97;;-60;-0.04;320;0.21;152931
8291;Zuidwest-Overijssel (CR);2014 september;152931;145;101;662;451;211;708;602;106;;-2;0.0;318;0.21;152929
8292;Zuidwest-Overijssel (CR);2014 oktober;152929;148;126;613;453;160;524;438;86;;111;0.07;429;0.28;153040
8293;Zuidwest-Overijssel (CR);2014 november;153040;129;123;429;338;91;498;429;69;;-63;-0.04;366;0.24;152977
8294;Zuidwest-Overijssel (CR);2014 december;152977;129;118;557;464;93;562;491;71;-1.0;5;0.0;371;0.24;152982
8295;Zuidwest-Overijssel (CR);2014;152611;1569;1309;6426;4969;1457;6314;5393;921;-1.0;371;0.24;371;0.24;152982
8296;Zuidwest-Overijssel (CR);2015 januari;152982;123;162;553;465;88;563;470;93;;-49;-0.03;-49;-0.03;152933
8297;Zuidwest-Overijssel (CR);2015 februari;152933;112;115;588;409;179;522;441;81;;63;0.04;14;0.01;152996
8298;Zuidwest-Overijssel (CR);2015 maart;152996;118;94;504;423;81;504;441;63;;24;0.02;38;0.02;153020
8299;Zuidwest-Overijssel (CR);2015 april;153020;128;116;449;373;76;435;361;74;;26;0.02;64;0.04;153046
8300;Zuidwest-Overijssel (CR);2015 mei;153046;142;98;526;430;96;455;389;66;;115;0.08;179;0.12;153161
8301;Zuidwest-Overijssel (CR);2015 juni;153161;117;109;491;399;92;463;420;43;;36;0.02;215;0.14;153197
8302;Zuidwest-Overijssel (CR);2015 juli;153197;130;95;737;598;139;727;586;141;;45;0.03;260;0.17;153242
8303;Zuidwest-Overijssel (CR);2015 augustus;153242;125;100;712;568;144;687;617;70;;50;0.03;310;0.2;153292
8304;Zuidwest-Overijssel (CR);2015 september;153292;120;123;695;494;201;585;547;38;;107;0.07;417;0.27;153399
8305;Zuidwest-Overijssel (CR);2015 oktober;153399;125;115;560;449;111;521;462;59;;49;0.03;466;0.3;153448
8306;Zuidwest-Overijssel (CR);2015 november;153448;112;91;491;430;61;548;489;59;;-36;-0.02;430;0.28;153412
8307;Zuidwest-Overijssel (CR);2015 december;153412;111;120;619;510;109;563;500;63;-4.0;43;0.03;473;0.31;153455
8308;Zuidwest-Overijssel (CR);2015;152982;1463;1338;6925;5548;1377;6573;5723;850;-4.0;473;0.31;473;0.31;153455
8309;Zuidwest-Overijssel (CR);2016 januari;153455;142;125;615;502;113;520;465;55;;112;0.07;112;0.07;153567
8310;Zuidwest-Overijssel (CR);2016 februari;153567;115;110;684;507;177;522;459;63;;167;0.11;279;0.18;153734
8311;Zuidwest-Overijssel (CR);2016 maart;153734;118;103;591;456;135;504;445;59;;102;0.07;381;0.25;153836
8312;Zuidwest-Overijssel (CR);2016 april;153836;122;106;565;493;72;540;466;74;;41;0.03;422;0.27;153877
8313;Zuidwest-Overijssel (CR);2016 mei;153877;130;112;515;446;69;498;423;75;;35;0.02;457;0.3;153912
8314;Zuidwest-Overijssel (CR);2016 juni;153912;119;91;529;440;89;560;409;151;;-3;0.0;454;0.3;153909
8315;Zuidwest-Overijssel (CR);2016 juli;153909;148;120;654;552;102;690;526;164;;-8;-0.01;446;0.29;153901
8316;Zuidwest-Overijssel (CR);2016 augustus;153901;128;114;760;614;146;872;649;223;;-98;-0.06;348;0.23;153803
8317;Zuidwest-Overijssel (CR);2016 september;153803;149;83;828;614;214;666;613;53;;228;0.15;576;0.38;154031
8318;Zuidwest-Overijssel (CR);2016 oktober;154031;144;103;579;501;78;522;469;53;;98;0.06;674;0.44;154129
8319;Zuidwest-Overijssel (CR);2016 november;154129;124;111;546;472;74;507;448;59;;52;0.03;726;0.47;154181
8320;Zuidwest-Overijssel (CR);2016 december;154181;120;130;590;529;61;597;536;61;-5.0;-22;-0.01;704;0.46;154159
8321;Zuidwest-Overijssel (CR);2016;153455;1559;1308;7456;6126;1330;6998;5908;1090;-5.0;704;0.46;704;0.46;154159
8322;Zuidwest-Overijssel (CR);2017 januari;154159;136;159;643;535;108;566;478;88;;54;0.04;54;0.04;154213
8323;Zuidwest-Overijssel (CR);2017 februari;154213;108;136;712;608;104;560;522;38;;124;0.08;178;0.12;154337
8324;Zuidwest-Overijssel (CR);2017 maart;154337;107;125;682;595;87;575;495;80;;89;0.06;267;0.17;154426
8325;Zuidwest-Overijssel (CR);2017 april;154426;107;129;541;488;53;528;462;66;;-9;-0.01;258;0.17;154417
8326;Zuidwest-Overijssel (CR);2017 mei;154417;145;109;561;498;63;463;422;41;;134;0.09;392;0.25;154551
8327;Zuidwest-Overijssel (CR);2017 juni;154551;124;113;606;518;88;507;444;63;;110;0.07;502;0.33;154661
8328;Zuidwest-Overijssel (CR);2017 juli;154661;118;103;736;637;99;682;587;95;;69;0.04;571;0.37;154730
8329;Zuidwest-Overijssel (CR);2017 augustus;154730;128;99;704;613;91;763;658;105;;-30;-0.02;541;0.35;154700
8330;Zuidwest-Overijssel (CR);2017 september;154700;139;106;887;685;202;711;634;77;;209;0.14;750;0.49;154909
8331;Zuidwest-Overijssel (CR);2017 oktober;154909;120;103;624;546;78;588;554;34;;53;0.03;803;0.52;154962
8332;Zuidwest-Overijssel (CR);2017 november;154962;117;123;479;414;65;504;432;72;;-31;-0.02;772;0.5;154931
8333;Zuidwest-Overijssel (CR);2017 december;154931;127;123;549;488;61;648;565;83;-2.0;-97;-0.06;675;0.44;154834
8334;Zuidwest-Overijssel (CR);2017;154159;1476;1428;7724;6625;1099;7095;6253;842;-2.0;675;0.44;675;0.44;154834
8335;Zuidwest-Overijssel (CR);2018 januari;154834;123;148;585;497;88;607;489;118;;-47;-0.03;-47;-0.03;154787
8336;Zuidwest-Overijssel (CR);2018 februari;154787;112;134;622;518;104;568;485;83;;32;0.02;-15;-0.01;154819
8337;Zuidwest-Overijssel (CR);2018 maart;154819;117;171;570;509;61;585;530;55;;-69;-0.04;-84;-0.05;154750
8338;Zuidwest-Overijssel (CR);2018 april;154750;145;115;534;468;66;428;392;36;;136;0.09;52;0.03;154886
8339;Zuidwest-Overijssel (CR);2018 mei;154886;136;98;477;414;63;447;416;31;;68;0.04;120;0.08;154954
8340;Zuidwest-Overijssel (CR);2018 juni;154954;122;101;528;439;89;450;392;58;;99;0.06;219;0.14;155053
8341;Zuidwest-Overijssel (CR);2018 juli;155053;124;125;776;630;146;679;571;108;;96;0.06;315;0.2;155149
8342;Zuidwest-Overijssel (CR);2018 augustus;155149;127;128;841;730;111;717;665;52;;123;0.08;438;0.28;155272
8343;Zuidwest-Overijssel (CR);2018 september;155272;138;104;780;551;229;623;567;56;;191;0.12;629;0.41;155463
8344;Zuidwest-Overijssel (CR);2018 oktober;155463;105;119;567;458;109;574;511;63;;-21;-0.01;608;0.39;155442
8345;Zuidwest-Overijssel (CR);2018 november;155442;128;93;541;441;100;532;485;47;;44;0.03;652;0.42;155486
8346;Zuidwest-Overijssel (CR);2018 december;155486;107;123;561;467;94;497;474;23;5.0;53;0.03;705;0.46;155539
8347;Zuidwest-Overijssel (CR);2018;154834;1484;1459;7382;6122;1260;6707;5977;730;5.0;705;0.46;705;0.46;155539
8348;Zuidwest-Overijssel (CR);2019 januari;155539;129;141;674;535;139;567;488;79;;95;0.06;95;0.06;155634
8349;Zuidwest-Overijssel (CR);2019 februari;155634;129;113;601;489;112;613;473;140;;4;0.0;99;0.06;155638
8350;Zuidwest-Overijssel (CR);2019 maart;155638;115;102;516;442;74;536;459;77;;-7;0.0;92;0.06;155631
8351;Zuidwest-Overijssel (CR);2019 april;155631;118;125;534;446;88;476;411;65;;51;0.03;143;0.09;155682
8352;Zuidwest-Overijssel (CR);2019 mei;155682;111;119;623;518;105;546;468;78;;69;0.04;212;0.14;155751
8353;Zuidwest-Overijssel (CR);2019 juni;155751;113;118;525;413;112;403;360;43;;117;0.08;329;0.21;155868
8354;Zuidwest-Overijssel (CR);2019 juli;155868;140;127;733;607;126;601;476;125;;145;0.09;474;0.3;156013
8355;Zuidwest-Overijssel (CR);2019 augustus;156013;140;110;714;550;164;575;496;79;;169;0.11;643;0.41;156182
8356;Zuidwest-Overijssel (CR);2019 september;156182;146;127;789;591;198;594;537;57;;214;0.14;857;0.55;156396
8357;Zuidwest-Overijssel (CR);2019 oktober;156396;122;139;636;543;93;532;488;44;;87;0.06;944;0.61;156483
8358;Zuidwest-Overijssel (CR);2019 november;156483;92;118;633;524;109;479;423;56;;128;0.08;1072;0.69;156611
8359;Zuidwest-Overijssel (CR);2019 december;156611;98;137;621;540;81;501;461;40;-9.0;72;0.05;1144;0.74;156683
8360;Zuidwest-Overijssel (CR);2019;155539;1453;1476;7599;6198;1401;6423;5540;883;-9.0;1144;0.74;1144;0.74;156683
8361;Zuidwest-Overijssel (CR);2020 januari;156683;138;122;695;568;127;639;552;87;;72;0.05;72;0.05;156755
8362;Zuidwest-Overijssel (CR);2020 februari;156755;120;115;675;551;124;610;556;54;;70;0.04;142;0.09;156825
8363;Zuidwest-Overijssel (CR);2020 maart;156825;111;179;555;478;77;535;471;64;;-48;-0.03;94;0.06;156777
8364;Zuidwest-Overijssel (CR);2020 april;156777;101;212;558;509;49;464;448;16;;-17;-0.01;77;0.05;156760
8365;Zuidwest-Overijssel (CR);2020 mei;156760;127;130;521;456;65;430;402;28;;88;0.06;165;0.11;156848
8366;Zuidwest-Overijssel (CR);2020 juni;156848;123;100;490;415;75;485;443;42;;28;0.02;193;0.12;156876
8367;Zuidwest-Overijssel (CR);2020 juli;156876;152;121;723;631;92;631;569;62;;123;0.08;316;0.2;156999
8368;Zuidwest-Overijssel (CR);2020 augustus;156999;138;113;694;615;79;609;535;74;;110;0.07;426;0.27;157109
8369;Zuidwest-Overijssel (CR);2020 september;157109;139;104;633;537;96;602;537;65;;66;0.04;492;0.31;157175
8370;Zuidwest-Overijssel (CR);2020 oktober;157175;126;144;612;549;63;481;437;44;;113;0.07;605;0.39;157288
8371;Zuidwest-Overijssel (CR);2020 november;157288;114;127;577;508;69;493;448;45;;71;0.05;676;0.43;157359
8372;Zuidwest-Overijssel (CR);2020 december;157359;100;161;691;623;68;483;467;16;2.0;149;0.09;825;0.53;157508
8373;Zuidwest-Overijssel (CR);2020;156683;1489;1628;7424;6440;984;6462;5865;597;2.0;825;0.53;825;0.53;157508
8374;Zuidwest-Overijssel (CR);2021 januari;157508;140;129;598;518;80;535;491;44;0.0;74;0.05;74;0.05;157582
8375;Zuidwest-Overijssel (CR);2021 februari;157582;119;120;627;531;96;491;420;71;0.0;135;0.09;209;0.13;157717
8376;Zuidwest-Overijssel (CR);2021 maart;157717;126;125;614;538;76;530;484;46;0.0;85;0.05;294;0.19;157802
8377;Zuidwest-Overijssel (CR);2021 april;157802;107;115;564;494;70;564;504;60;0.0;-8;-0.01;286;0.18;157794
8378;Zuidwest-Overijssel (CR);2021 mei;157794;103;129;573;521;52;536;500;36;0.0;11;0.01;297;0.19;157805
8379;Zuidwest-Overijssel (CR);2021 juni;157805;110;134;577;507;70;543;469;74;0.0;10;0.01;307;0.19;157815
8380;Zuidwest-Overijssel (CR);2021 juli;157815;144;128;653;581;72;607;537;70;0.0;62;0.04;369;0.23;157877
8381;Zuidwest-Overijssel (CR);2021 augustus;157877;144;120;666;580;86;650;539;111;0.0;40;0.03;409;0.26;157917
8382;Zuidwest-Overijssel (CR);2021 september;157917;140;117;686;523;163;554;491;63;0.0;155;0.1;564;0.36;158072
8383;Zuidwest-Overijssel (CR);2021 oktober;158072;125;142;598;497;101;535;469;66;0.0;46;0.03;610;0.39;158118
8384;Zuidwest-Overijssel (CR);2021 november;158118;116;156;548;488;60;501;466;35;0.0;7;0.0;617;0.39;158125
8385;Zuidwest-Overijssel (CR);2021 december;158125;138;169;508;436;72;525;454;71;5.0;-43;-0.03;574;0.36;158082
8386;Zuidwest-Overijssel (CR);2021;157508;1512;1584;7212;6214;998;6571;5824;747;5.0;574;0.36;574;0.36;158082
8387;Zuidwest-Overijssel (CR);2022 januari;158082;136;136;597;523;74;537;477;60;;60;0.04;60;0.04;158142
8388;Zuidwest-Overijssel (CR);2022 februari;158142;130;123;551;450;101;420;387;33;;138;0.09;198;0.13;158280
8389;Zuidwest-Overijssel (CR);2022 maart;158280;131;156;729;499;230;481;438;43;;223;0.14;421;0.27;158503
8390;Zuidwest-Overijssel (CR);2022 april;158503;108;139;767;482;285;476;432;44;;260;0.16;681;0.43;158763
8391;Zuidwest-Overijssel (CR);2022 mei;158763;124;117;636;516;120;483;407;76;;160;0.1;841;0.53;158923
8392;Zuidwest-Overijssel (CR);2022 juni;158923;133;126;632;491;141;503;449;54;;136;0.09;977;0.62;159059
8393;Zuidwest-Overijssel (CR);2022 juli;159059;136;133;700;552;148;595;492;103;;108;0.07;1085;0.69;159167
8394;Zuidwest-Overijssel (CR);2022 augustus;159167;129;113;776;576;200;554;463;91;;238;0.15;1323;0.84;159405
8395;Zuidwest-Overijssel (CR);2022 september;159405;141;130;844;556;288;531;468;63;;324;0.2;1647;1.04;159729
8396;Zuidwest-Overijssel (CR);2022 oktober;159729;146;134;644;508;136;598;545;53;;58;0.04;1705;1.08;159787
8397;Zuidwest-Overijssel (CR);2022 november;159787;94;127;640;504;136;490;422;68;;117;0.07;1822;1.15;159904
8398;Zuidwest-Overijssel (CR);2022 december;159904;124;166;590;519;71;483;439;44;-6.0;59;0.04;1881;1.19;159963
8399;Zuidwest-Overijssel (CR);2022;158082;1532;1600;8106;6176;1930;6151;5419;732;-6.0;1881;1.19;1881;1.19;159963
8400;Zuidwest-Overijssel (CR);2023 januari;159963;112;176;640;539;101;576;515;61;0.0;0;0.0;0;0.0;159963
8401;Zuidwest-Overijssel (CR);2023 februari;159963;87;125;615;475;140;564;443;121;0.0;13;0.01;13;0.01;159976
8402;Zuidwest-Overijssel (CR);2023 maart;159976;114;135;626;536;90;633;494;139;0.0;-28;-0.02;-15;-0.01;159948
8403;Zuidwest-Overijssel (CR);2023 april;159948;114;98;516;434;82;492;393;99;0.0;40;0.03;25;0.02;159988
8404;Zuidwest-Overijssel (CR);2023 mei;159988;107;136;596;521;75;537;455;82;0.0;30;0.02;55;0.03;160018
8405;Zuidwest-Overijssel (CR);2023 juni;160018;120;136;648;551;97;564;487;77;0.0;68;0.04;123;0.08;160086
8406;Zuidwest-Overijssel (CR);2023 juli;160086;138;123;721;595;126;681;547;134;0.0;55;0.03;178;0.11;160141
8407;Zuidwest-Overijssel (CR);2023 augustus;160141;152;126;768;627;141;703;604;99;0.0;91;0.06;269;0.17;160232
8408;Zuidwest-Overijssel (CR);2023 september;160232;136;124;832;507;325;586;499;87;0.0;258;0.16;527;0.33;160490
8409;Zuidwest-Overijssel (CR);2023 oktober;160490;125;149;646;514;132;547;483;64;0.0;75;0.05;602;0.38;160565
8410;Zuidwest-Overijssel (CR);2023 november;160565;113;136;620;504;116;534;426;108;0.0;63;0.04;665;0.42;160628
8411;Zuidwest-Overijssel (CR);2023 december;160628;118;160;540;473;67;514;429;85;-8.0;-24;-0.01;641;0.4;160604
8412;Zuidwest-Overijssel (CR);2023;159963;1436;1624;7768;6276;1492;6931;5775;1156;-8.0;641;0.4;641;0.4;160604
8413;Zuidwest-Overijssel (CR);2024 januari;160604;128;163;691;596;95;568;464;104;;88;0.05;88;0.05;160692
8414;Zuidwest-Overijssel (CR);2024 februari;160692;120;155;609;504;105;579;475;104;;-5;0.0;83;0.05;160687
8415;Zuidwest-Overijssel (CR);2024 maart;160687;130;149;621;506;115;486;414;72;;116;0.07;199;0.12;160803
8416;Zuidwest-Overijssel (CR);2024 april;160803;109;130;706;606;100;534;462;72;;151;0.09;350;0.22;160954
8417;Zuidwest-Overijssel (CR);2024 mei;160954;130;99;622;525;97;518;446;72;;135;0.08;485;0.3;161089
8418;Zuidwest-Overijssel (CR);2024 juni;161089;113;122;546;452;94;492;402;90;;45;0.03;530;0.33;161134
8419;Zuidwest-Overijssel (CR);2024 juli;161134;121;137;756;649;107;558;454;104;;182;0.11;712;0.44;161316
8420;Zuidwest-Overijssel (CR);2024 augustus;161316;134;114;633;550;83;575;468;107;;78;0.05;790;0.49;161394
8421;Zuidwest-Overijssel (CR);2024 september;161394;130;134;776;553;223;554;458;96;;218;0.14;1008;0.63;161612
8422;Zuidwest-Overijssel (CR);2024 oktober;161612;126;112;597;493;104;515;443;72;;96;0.06;1104;0.69;161708
8423;Zuidwest-Overijssel (CR);2024 november;161708;121;135;644;552;92;511;434;77;;119;0.07;1223;0.76;161827
8424;Zuidwest-Overijssel (CR);2024 december;161827;136;155;643;526;117;533;448;85;0.0;91;0.06;1314;0.82;161918
8425;Zuidwest-Overijssel (CR);2024;160604;1498;1605;7844;6512;1332;6423;5368;1055;0.0;1314;0.82;1314;0.82;161918
8426;Zuidwest-Overijssel (CR);2025 januari;161918;106;176;717;627;90;580;495;85;;67;0.04;67;0.04;161985
8427;Zuidwest-Overijssel (CR);2025 februari;161985;97;159;645;560;85;495;390;105;;88;0.05;155;0.1;162073
8428;Twente (CR);2002 januari;611797;676;515;1923;1554;369;1885;1569;316;;199;0.03;199;0.03;611996
8429;Twente (CR);2002 februari;611996;557;482;1594;1340;254;1565;1340;225;;104;0.02;303;0.05;612100
8430;Twente (CR);2002 maart;612100;652;493;1645;1387;258;1624;1361;263;;180;0.03;483;0.08;612280
8431;Twente (CR);2002 april;612280;597;501;1752;1271;481;1674;1316;358;;174;0.03;657;0.11;612454
8432;Twente (CR);2002 mei;612454;624;485;1732;1461;271;1673;1352;321;;198;0.03;855;0.14;612652
8433;Twente (CR);2002 juni;612652;613;437;1642;1382;260;1718;1386;332;;100;0.02;955;0.16;612752
8434;Twente (CR);2002 juli;612752;672;468;2140;1900;240;2140;1785;355;;204;0.03;1159;0.19;612956
8435;Twente (CR);2002 augustus;612956;710;452;2526;2069;457;2307;1990;317;;477;0.08;1636;0.27;613433
8436;Twente (CR);2002 september;613433;688;450;2323;1652;671;2099;1740;359;;462;0.08;2098;0.34;613895
8437;Twente (CR);2002 oktober;613895;746;480;1906;1582;324;2109;1558;551;;63;0.01;2161;0.35;613958
8438;Twente (CR);2002 november;613958;623;468;1722;1488;234;1911;1502;409;;-34;-0.01;2127;0.35;613924
8439;Twente (CR);2002 december;613924;640;530;1518;1378;140;1637;1265;372;17.0;8;0.0;2135;0.35;613932
8440;Twente (CR);2002;611797;7798;5761;22423;18464;3959;22342;18164;4178;17.0;2135;0.35;2135;0.35;613932
8441;Twente (CR);2003 januari;613932;674;529;1852;1629;223;1997;1643;354;;0;0.0;0;0.0;613932
8442;Twente (CR);2003 februari;613932;628;453;1527;1311;216;1593;1387;206;;109;0.02;109;0.02;614041
8443;Twente (CR);2003 maart;614041;689;534;1569;1336;233;1549;1317;232;;175;0.03;284;0.05;614216
8444;Twente (CR);2003 april;614216;627;508;1395;1163;232;1457;1178;279;;57;0.01;341;0.06;614273
8445;Twente (CR);2003 mei;614273;649;483;1424;1242;182;1775;1303;472;;-185;-0.03;156;0.03;614088
8446;Twente (CR);2003 juni;614088;649;454;1583;1391;192;1722;1393;329;;56;0.01;212;0.03;614144
8447;Twente (CR);2003 juli;614144;744;474;2045;1776;269;2010;1635;375;;305;0.05;517;0.08;614449
8448;Twente (CR);2003 augustus;614449;687;480;2302;1917;385;2208;1791;417;;301;0.05;818;0.13;614750
8449;Twente (CR);2003 september;614750;694;451;2203;1719;484;2244;1871;373;;202;0.03;1020;0.17;614952
8450;Twente (CR);2003 oktober;614952;702;468;1843;1566;277;1966;1591;375;;111;0.02;1131;0.18;615063
8451;Twente (CR);2003 november;615063;642;446;1506;1319;187;1607;1356;251;;95;0.02;1226;0.2;615158
8452;Twente (CR);2003 december;615158;618;557;1629;1462;167;1841;1411;430;296.0;145;0.02;1371;0.22;615303
8453;Twente (CR);2003;613932;8003;5837;20878;17831;3047;21969;17876;4093;296.0;1371;0.22;1371;0.22;615303
8454;Twente (CR);2004 januari;615303;656;526;1682;1489;193;1867;1470;397;;-55;-0.01;-55;-0.01;615248
8455;Twente (CR);2004 februari;615248;576;448;1335;1196;139;1447;1216;231;;16;0.0;-39;-0.01;615264
8456;Twente (CR);2004 maart;615264;612;497;1645;1439;206;1602;1362;240;;158;0.03;119;0.02;615422
8457;Twente (CR);2004 april;615422;605;456;1356;1234;122;1404;1221;183;;101;0.02;220;0.04;615523
8458;Twente (CR);2004 mei;615523;647;394;1241;1063;178;1278;1089;189;;216;0.04;436;0.07;615739
8459;Twente (CR);2004 juni;615739;635;416;1656;1410;246;1559;1324;235;;316;0.05;752;0.12;616055
8460;Twente (CR);2004 juli;616055;640;434;1954;1752;202;1983;1663;320;;177;0.03;929;0.15;616232
8461;Twente (CR);2004 augustus;616232;739;448;2340;1984;356;2184;1878;306;;447;0.07;1376;0.22;616679
8462;Twente (CR);2004 september;616679;621;415;1939;1642;297;2113;1886;227;;32;0.01;1408;0.23;616711
8463;Twente (CR);2004 oktober;616711;660;442;1681;1379;302;1867;1436;431;;32;0.01;1440;0.23;616743
8464;Twente (CR);2004 november;616743;623;450;1627;1411;216;1778;1398;380;;22;0.0;1462;0.24;616765
8465;Twente (CR);2004 december;616765;591;476;1570;1377;193;1648;1359;289;84.0;121;0.02;1583;0.26;616886
8466;Twente (CR);2004;615303;7605;5402;20026;17376;2650;20730;17302;3428;84.0;1583;0.26;1583;0.26;616886
8467;Twente (CR);2005 januari;616886;592;553;1698;1441;257;1812;1468;344;;-75;-0.01;-75;-0.01;616811
8468;Twente (CR);2005 februari;616811;578;460;1613;1406;207;1607;1406;201;;124;0.02;49;0.01;616935
8469;Twente (CR);2005 maart;616935;647;584;1570;1388;182;1634;1391;243;;-1;0.0;48;0.01;616934
8470;Twente (CR);2005 april;616934;592;468;1512;1315;197;1887;1360;527;;-251;-0.04;-203;-0.03;616683
8471;Twente (CR);2005 mei;616683;653;459;1288;1149;139;1367;1162;205;;115;0.02;-88;-0.01;616798
8472;Twente (CR);2005 juni;616798;605;427;1487;1287;200;1599;1370;229;;66;0.01;-22;0.0;616864
8473;Twente (CR);2005 juli;616864;636;404;1999;1767;232;2064;1639;425;;167;0.03;145;0.02;617031
8474;Twente (CR);2005 augustus;617031;662;395;2384;2109;275;2496;2178;318;;155;0.03;300;0.05;617186
8475;Twente (CR);2005 september;617186;661;391;2345;1945;400;2438;2183;255;;177;0.03;477;0.08;617363
8476;Twente (CR);2005 oktober;617363;637;415;1897;1599;298;1937;1691;246;;182;0.03;659;0.11;617545
8477;Twente (CR);2005 november;617545;572;442;1651;1418;233;1722;1444;278;;59;0.01;718;0.12;617604
8478;Twente (CR);2005 december;617604;592;476;1565;1397;168;1725;1379;346;122.0;78;0.01;796;0.13;617682
8479;Twente (CR);2005;616886;7427;5474;21009;18221;2788;22288;18671;3617;122.0;796;0.13;796;0.13;617682
8480;Twente (CR);2006 januari;617682;623;494;1894;1683;211;1851;1656;195;;172;0.03;172;0.03;617854
8481;Twente (CR);2006 februari;617854;541;447;1539;1379;160;1616;1438;178;;17;0.0;189;0.03;617871
8482;Twente (CR);2006 maart;617871;625;494;1697;1491;206;1955;1504;451;;-127;-0.02;62;0.01;617744
8483;Twente (CR);2006 april;617744;559;467;1367;1218;149;1589;1302;287;;-130;-0.02;-68;-0.01;617614
8484;Twente (CR);2006 mei;617614;631;456;1523;1346;177;1708;1437;271;;-10;0.0;-78;-0.01;617604
8485;Twente (CR);2006 juni;617604;639;362;1561;1388;173;1739;1418;321;;99;0.02;21;0.0;617703
8486;Twente (CR);2006 juli;617703;641;475;2066;1811;255;2042;1626;416;;190;0.03;211;0.03;617893
8487;Twente (CR);2006 augustus;617893;655;398;2455;2142;313;2455;2181;274;;257;0.04;468;0.08;618150
8488;Twente (CR);2006 september;618150;619;417;2487;1929;558;2566;2124;442;;123;0.02;591;0.1;618273
8489;Twente (CR);2006 oktober;618273;648;417;1656;1421;235;1935;1546;389;;-48;-0.01;543;0.09;618225
8490;Twente (CR);2006 november;618225;596;453;1586;1416;170;1944;1556;388;;-215;-0.03;328;0.05;618010
8491;Twente (CR);2006 december;618010;582;483;1506;1372;134;1489;1281;208;97.0;213;0.03;541;0.09;618223
8492;Twente (CR);2006;617682;7359;5363;21337;18596;2741;22889;19069;3820;97.0;541;0.09;541;0.09;618223
8493;Twente (CR);2007 januari;618223;586;444;1880;1576;304;2116;1615;501;;-94;-0.02;-94;-0.02;618129
8494;Twente (CR);2007 februari;618129;556;447;1638;1390;248;1660;1480;180;;87;0.01;-7;0.0;618216
8495;Twente (CR);2007 maart;618216;611;464;1525;1329;196;1602;1353;249;;70;0.01;63;0.01;618286
8496;Twente (CR);2007 april;618286;570;438;1366;1206;160;1474;1197;277;;24;0.0;87;0.01;618310
8497;Twente (CR);2007 mei;618310;581;415;1574;1386;188;1631;1402;229;;109;0.02;196;0.03;618419
8498;Twente (CR);2007 juni;618419;569;396;1655;1457;198;1848;1482;366;;-20;0.0;176;0.03;618399
8499;Twente (CR);2007 juli;618399;642;416;2025;1724;301;2082;1770;312;;169;0.03;345;0.06;618568
8500;Twente (CR);2007 augustus;618568;660;408;2750;2279;471;2622;2250;372;;380;0.06;725;0.12;618948
8501;Twente (CR);2007 september;618948;624;357;2177;1695;482;2244;1946;298;;200;0.03;925;0.15;619148
8502;Twente (CR);2007 oktober;619148;604;408;1749;1482;267;2095;1628;467;;-150;-0.02;775;0.13;618998
8503;Twente (CR);2007 november;618998;544;446;1571;1375;196;1792;1525;267;;-123;-0.02;652;0.11;618875
8504;Twente (CR);2007 december;618875;548;453;1362;1198;164;1438;1210;228;98.0;117;0.02;769;0.12;618992
8505;Twente (CR);2007;618223;7095;5092;21272;18097;3175;22604;18858;3746;98.0;769;0.12;769;0.12;618992
8506;Twente (CR);2008 januari;618992;579;492;1932;1630;302;1899;1642;257;;120;0.02;120;0.02;619112
8507;Twente (CR);2008 februari;619112;547;480;1797;1464;333;1621;1437;184;;243;0.04;363;0.06;619355
8508;Twente (CR);2008 maart;619355;577;476;1553;1346;207;1647;1362;285;;7;0.0;370;0.06;619362
8509;Twente (CR);2008 april;619362;609;461;1614;1329;285;1732;1472;260;;30;0.0;400;0.06;619392
8510;Twente (CR);2008 mei;619392;609;456;1471;1220;251;1416;1241;175;;208;0.03;608;0.1;619600
8511;Twente (CR);2008 juni;619600;606;418;1675;1382;293;1699;1459;240;;164;0.03;772;0.12;619764
8512;Twente (CR);2008 juli;619764;646;436;2111;1759;352;2190;1784;406;;131;0.02;903;0.15;619895
8513;Twente (CR);2008 augustus;619895;594;399;2760;2225;535;2488;2165;323;;467;0.08;1370;0.22;620362
8514;Twente (CR);2008 september;620362;614;442;2338;1810;528;2247;1988;259;;263;0.04;1633;0.26;620625
8515;Twente (CR);2008 oktober;620625;608;395;1946;1503;443;1895;1581;314;;264;0.04;1897;0.31;620889
8516;Twente (CR);2008 november;620889;529;419;1606;1282;324;1559;1312;247;;157;0.03;2054;0.33;621046
8517;Twente (CR);2008 december;621046;575;462;1634;1391;243;1612;1404;208;111.0;246;0.04;2300;0.37;621292
8518;Twente (CR);2008;618992;7093;5336;22437;18341;4096;22005;18847;3158;111.0;2300;0.37;2300;0.37;621292
8519;Twente (CR);2009 januari;621292;609;560;1783;1413;370;1661;1390;271;;171;0.03;171;0.03;621463
8520;Twente (CR);2009 februari;621463;529;454;1695;1394;301;1586;1379;207;;184;0.03;355;0.06;621647
8521;Twente (CR);2009 maart;621647;617;445;1635;1355;280;1781;1356;425;;26;0.0;381;0.06;621673
8522;Twente (CR);2009 april;621673;577;459;1463;1217;246;1388;1143;245;;193;0.03;574;0.09;621866
8523;Twente (CR);2009 mei;621866;573;410;1346;1094;252;1290;1086;204;;219;0.04;793;0.13;622085
8524;Twente (CR);2009 juni;622085;573;409;1509;1256;253;1521;1206;315;;152;0.02;945;0.15;622237
8525;Twente (CR);2009 juli;622237;593;423;2205;1790;415;2080;1699;381;;295;0.05;1240;0.2;622532
8526;Twente (CR);2009 augustus;622532;598;389;2331;1793;538;2298;1979;319;;242;0.04;1482;0.24;622774
8527;Twente (CR);2009 september;622774;616;415;2188;1704;484;2254;1995;259;;135;0.02;1617;0.26;622909
8528;Twente (CR);2009 oktober;622909;585;467;1845;1290;555;1715;1419;296;;248;0.04;1865;0.3;623157
8529;Twente (CR);2009 november;623157;542;431;1591;1258;333;1553;1265;288;;149;0.02;2014;0.32;623306
8530;Twente (CR);2009 december;623306;521;452;1508;1328;180;1576;1315;261;125.0;126;0.02;2140;0.34;623432
8531;Twente (CR);2009;621292;6933;5314;21099;16892;4207;20703;17232;3471;125.0;2140;0.34;2140;0.34;623432
8532;Twente (CR);2010 januari;623432;534;492;1651;1390;261;1657;1351;306;;36;0.01;36;0.01;623468
8533;Twente (CR);2010 februari;623468;524;462;1594;1266;328;1466;1221;245;;190;0.03;226;0.04;623658
8534;Twente (CR);2010 maart;623658;595;489;1575;1313;262;1749;1309;440;;-68;-0.01;158;0.03;623590
8535;Twente (CR);2010 april;623590;569;406;1506;1231;275;1559;1279;280;;110;0.02;268;0.04;623700
8536;Twente (CR);2010 mei;623700;579;430;1341;1089;252;1367;1149;218;;123;0.02;391;0.06;623823
8537;Twente (CR);2010 juni;623823;584;409;1619;1231;388;1410;1222;188;;384;0.06;775;0.12;624207
8538;Twente (CR);2010 juli;624207;652;488;1989;1626;363;1969;1667;302;;184;0.03;959;0.15;624391
8539;Twente (CR);2010 augustus;624391;587;394;2521;1844;677;2236;1984;252;;478;0.08;1437;0.23;624869
8540;Twente (CR);2010 september;624869;579;408;2206;1697;509;2168;1844;324;;209;0.03;1646;0.26;625078
8541;Twente (CR);2010 oktober;625078;596;417;1910;1431;479;1796;1469;327;;293;0.05;1939;0.31;625371
8542;Twente (CR);2010 november;625371;549;431;1617;1330;287;1724;1373;351;;11;0.0;1950;0.31;625382
8543;Twente (CR);2010 december;625382;551;506;1564;1316;248;1605;1297;308;-9.0;-5;0.0;1945;0.31;625377
8544;Twente (CR);2010;623432;6899;5332;21093;16764;4329;20706;17165;3541;-9.0;1945;0.31;1945;0.31;625377
8545;Twente (CR);2011 januari;625377;575;479;1791;1419;372;1849;1468;381;;38;0.01;38;0.01;625415
8546;Twente (CR);2011 februari;625415;524;438;1664;1332;332;1607;1328;279;;143;0.02;181;0.03;625558
8547;Twente (CR);2011 maart;625558;559;469;1661;1381;280;1680;1272;408;;71;0.01;252;0.04;625629
8548;Twente (CR);2011 april;625629;500;456;1332;1089;243;1529;1171;358;;-153;-0.02;99;0.02;625476
8549;Twente (CR);2011 mei;625476;539;449;1458;1168;290;1480;1227;253;;68;0.01;167;0.03;625544
8550;Twente (CR);2011 juni;625544;588;415;1503;1195;308;1568;1243;325;;108;0.02;275;0.04;625652
8551;Twente (CR);2011 juli;625652;602;435;2092;1693;399;2077;1629;448;;182;0.03;457;0.07;625834
8552;Twente (CR);2011 augustus;625834;585;422;2794;2064;730;2539;2150;389;;418;0.07;875;0.14;626252
8553;Twente (CR);2011 september;626252;555;413;2428;1848;580;2308;2019;289;;262;0.04;1137;0.18;626514
8554;Twente (CR);2011 oktober;626514;550;443;1855;1366;489;1804;1421;383;;158;0.03;1295;0.21;626672
8555;Twente (CR);2011 november;626672;499;465;1659;1330;329;1762;1445;317;;-69;-0.01;1226;0.2;626603
8556;Twente (CR);2011 december;626603;517;485;1632;1306;326;1684;1338;346;3.0;-17;0.0;1209;0.19;626586
8557;Twente (CR);2011;625377;6593;5369;21869;17191;4678;21887;17711;4176;3.0;1209;0.19;1209;0.19;626586
8558;Twente (CR);2012 januari;626586;495;462;1961;1633;328;2081;1688;393;;-87;-0.01;-87;-0.01;626499
8559;Twente (CR);2012 februari;626499;504;475;1836;1472;364;1727;1465;262;;138;0.02;51;0.01;626637
8560;Twente (CR);2012 maart;626637;507;464;1646;1329;317;1770;1459;311;;-81;-0.01;-30;0.0;626556
8561;Twente (CR);2012 april;626556;481;430;1326;1119;207;1507;1170;337;;-130;-0.02;-160;-0.03;626426
8562;Twente (CR);2012 mei;626426;549;453;1435;1203;232;1512;1231;281;;19;0.0;-141;-0.02;626445
8563;Twente (CR);2012 juni;626445;515;447;1635;1368;267;1694;1369;325;;9;0.0;-132;-0.02;626454
8564;Twente (CR);2012 juli;626454;571;455;2100;1745;355;2259;1799;460;;-43;-0.01;-175;-0.03;626411
8565;Twente (CR);2012 augustus;626411;554;423;2655;2011;644;2651;2225;426;;135;0.02;-40;-0.01;626546
8566;Twente (CR);2012 september;626546;561;404;2261;1707;554;2351;1986;365;;67;0.01;27;0.0;626613
8567;Twente (CR);2012 oktober;626613;528;484;1943;1476;467;1793;1504;289;;194;0.03;221;0.04;626807
8568;Twente (CR);2012 november;626807;521;480;1624;1389;235;1615;1416;199;;50;0.01;271;0.04;626857
8569;Twente (CR);2012 december;626857;464;507;1560;1335;225;1645;1391;254;-3.0;-131;-0.02;140;0.02;626726
8570;Twente (CR);2012;626586;6250;5484;21982;17787;4195;22605;18703;3902;-3.0;140;0.02;140;0.02;626726
8571;Twente (CR);2013 januari;626726;541;558;1861;1563;298;1870;1527;343;;-26;0.0;-26;0.0;626700
8572;Twente (CR);2013 februari;626700;475;480;1812;1442;370;1794;1451;343;;13;0.0;-13;0.0;626713
8573;Twente (CR);2013 maart;626713;482;569;1603;1350;253;1565;1377;188;;-49;-0.01;-62;-0.01;626664
8574;Twente (CR);2013 april;626664;506;485;1398;1180;218;1660;1217;443;;-241;-0.04;-303;-0.05;626423
8575;Twente (CR);2013 mei;626423;504;490;1443;1176;267;1483;1197;286;;-26;0.0;-329;-0.05;626397
8576;Twente (CR);2013 juni;626397;513;421;1408;1185;223;1396;1115;281;;104;0.02;-225;-0.04;626501
8577;Twente (CR);2013 juli;626501;577;471;1881;1578;303;2218;1707;511;;-231;-0.04;-456;-0.07;626270
8578;Twente (CR);2013 augustus;626270;545;451;2749;2147;602;2860;2429;431;;-17;0.0;-473;-0.08;626253
8579;Twente (CR);2013 september;626253;578;435;2288;1811;477;2468;2097;371;;-37;-0.01;-510;-0.08;626216
8580;Twente (CR);2013 oktober;626216;527;463;2031;1552;479;1953;1637;316;;142;0.02;-368;-0.06;626358
8581;Twente (CR);2013 november;626358;512;441;1565;1346;219;1615;1360;255;;21;0.0;-347;-0.06;626379
8582;Twente (CR);2013 december;626379;504;448;1427;1234;193;1533;1248;285;10.0;-40;-0.01;-387;-0.06;626339
8583;Twente (CR);2013;626726;6264;5712;21466;17564;3902;22415;18362;4053;10.0;-387;-0.06;-387;-0.06;626339
8584;Twente (CR);2014 januari;626339;566;467;1772;1493;279;1882;1527;355;;-11;0.0;-11;0.0;626328
8585;Twente (CR);2014 februari;626328;469;472;1796;1451;345;1737;1420;317;;56;0.01;45;0.01;626384
8586;Twente (CR);2014 maart;626384;537;477;1686;1426;260;1743;1435;308;;3;0.0;48;0.01;626387
8587;Twente (CR);2014 april;626387;486;482;1469;1255;214;1639;1246;393;;-166;-0.03;-118;-0.02;626221
8588;Twente (CR);2014 mei;626221;496;429;1373;1186;187;1592;1252;340;;-152;-0.02;-270;-0.04;626069
8589;Twente (CR);2014 juni;626069;450;444;1553;1325;228;1655;1371;284;;-96;-0.02;-366;-0.06;625973
8590;Twente (CR);2014 juli;625973;572;420;2037;1689;348;2359;1846;513;;-170;-0.03;-536;-0.09;625803
8591;Twente (CR);2014 augustus;625803;564;475;2806;2154;652;2689;2295;394;;206;0.03;-330;-0.05;626009
8592;Twente (CR);2014 september;626009;529;441;2309;1806;503;2478;2088;390;;-81;-0.01;-411;-0.07;625928
8593;Twente (CR);2014 oktober;625928;569;452;2019;1543;476;1971;1642;329;;165;0.03;-246;-0.04;626093
8594;Twente (CR);2014 november;626093;473;434;1568;1321;247;1556;1354;202;;51;0.01;-195;-0.03;626144
8595;Twente (CR);2014 december;626144;493;508;1740;1517;223;1878;1609;269;-15.0;-168;-0.03;-363;-0.06;625976
8596;Twente (CR);2014;626339;6204;5501;22128;18166;3962;23179;19085;4094;-15.0;-363;-0.06;-363;-0.06;625976
8597;Twente (CR);2015 januari;625976;502;596;1691;1442;249;1849;1516;333;;-252;-0.04;-252;-0.04;625724
8598;Twente (CR);2015 februari;625724;445;546;1988;1595;393;1869;1551;318;;18;0.0;-234;-0.04;625742
8599;Twente (CR);2015 maart;625742;470;521;1847;1486;361;1704;1424;280;;92;0.01;-142;-0.02;625834
8600;Twente (CR);2015 april;625834;478;530;1473;1170;303;1453;1155;298;;-32;-0.01;-174;-0.03;625802
8601;Twente (CR);2015 mei;625802;532;400;1404;1179;225;1408;1194;214;;128;0.02;-46;-0.01;625930
8602;Twente (CR);2015 juni;625930;499;454;1765;1459;306;1833;1524;309;;-23;0.0;-69;-0.01;625907
8603;Twente (CR);2015 juli;625907;518;449;2357;1906;451;2477;2008;469;;-51;-0.01;-120;-0.02;625856
8604;Twente (CR);2015 augustus;625856;542;463;2997;2182;815;2791;2450;341;;285;0.05;165;0.03;626141
8605;Twente (CR);2015 september;626141;534;418;2512;1826;686;2520;2105;415;;108;0.02;273;0.04;626249
8606;Twente (CR);2015 oktober;626249;561;464;2266;1581;685;2033;1647;386;;330;0.05;603;0.1;626579
8607;Twente (CR);2015 november;626579;515;456;1809;1435;374;1841;1514;327;;27;0.0;630;0.1;626606
8608;Twente (CR);2015 december;626606;495;497;1895;1531;364;1964;1576;388;-10.0;-81;-0.01;549;0.09;626525
8609;Twente (CR);2015;625976;6091;5794;24004;18792;5212;23742;19664;4078;-10.0;549;0.09;549;0.09;626525
8610;Twente (CR);2016 januari;626525;472;547;2031;1669;362;2061;1705;356;;-105;-0.02;-105;-0.02;626420
8611;Twente (CR);2016 februari;626420;443;512;2217;1698;519;2145;1766;379;;3;0.0;-102;-0.02;626423
8612;Twente (CR);2016 maart;626423;487;564;1925;1561;364;1951;1646;305;;-103;-0.02;-205;-0.03;626320
8613;Twente (CR);2016 april;626320;463;502;2018;1682;336;1760;1496;264;;219;0.03;14;0.0;626539
8614;Twente (CR);2016 mei;626539;500;500;1824;1528;296;1840;1444;396;;-16;0.0;-2;0.0;626523
8615;Twente (CR);2016 juni;626523;491;433;1834;1504;330;1919;1585;334;;-27;0.0;-29;0.0;626496
8616;Twente (CR);2016 juli;626496;540;470;2403;2053;350;2712;2240;472;;-239;-0.04;-268;-0.04;626257
8617;Twente (CR);2016 augustus;626257;535;464;3240;2391;849;2768;2445;323;;543;0.09;275;0.04;626800
8618;Twente (CR);2016 september;626800;546;455;2734;2007;727;2571;2185;386;;254;0.04;529;0.08;627054
8619;Twente (CR);2016 oktober;627054;461;463;2183;1796;387;2093;1813;280;;88;0.01;617;0.1;627142
8620;Twente (CR);2016 november;627142;480;485;1999;1686;313;1964;1719;245;;30;0.0;647;0.1;627172
8621;Twente (CR);2016 december;627172;501;533;2239;1929;310;2160;1873;287;-10.0;37;0.01;684;0.11;627209
8622;Twente (CR);2016;626525;5919;5928;26647;21504;5143;25944;21917;4027;-10.0;684;0.11;684;0.11;627209
8623;Twente (CR);2017 januari;627209;482;644;2137;1819;318;2116;1832;284;;-141;-0.02;-141;-0.02;627068
8624;Twente (CR);2017 februari;627068;446;531;2312;1816;496;2126;1808;318;;101;0.02;-40;-0.01;627169
8625;Twente (CR);2017 maart;627169;454;500;2006;1752;254;2108;1806;302;;-148;-0.02;-188;-0.03;627021
8626;Twente (CR);2017 april;627021;430;470;1682;1488;194;1825;1521;304;;-183;-0.03;-371;-0.06;626838
8627;Twente (CR);2017 mei;626838;510;521;1929;1674;255;1876;1647;229;;42;0.01;-329;-0.05;626880
8628;Twente (CR);2017 juni;626880;462;446;2026;1716;310;2017;1710;307;;25;0.0;-304;-0.05;626905
8629;Twente (CR);2017 juli;626905;546;450;2324;1984;340;2480;2017;463;;-60;-0.01;-364;-0.06;626845
8630;Twente (CR);2017 augustus;626845;515;410;2864;2327;537;2645;2334;311;;324;0.05;-40;-0.01;627169
8631;Twente (CR);2017 september;627169;542;450;3333;2251;1082;2764;2383;381;;661;0.11;621;0.1;627830
8632;Twente (CR);2017 oktober;627830;470;460;2370;1857;513;2155;1854;301;;225;0.04;846;0.13;628055
8633;Twente (CR);2017 november;628055;442;467;1910;1598;312;1959;1675;284;;-74;-0.01;772;0.12;627981
8634;Twente (CR);2017 december;627981;479;517;1948;1690;258;2030;1690;340;-13.0;-133;-0.02;639;0.1;627848
8635;Twente (CR);2017;627209;5778;5866;26841;21972;4869;26101;22277;3824;-13.0;639;0.1;639;0.1;627848
8636;Twente (CR);2018 januari;627848;493;619;2019;1687;332;2065;1780;285;;-172;-0.03;-172;-0.03;627676
8637;Twente (CR);2018 februari;627676;438;568;2136;1651;485;2057;1779;278;;-51;-0.01;-223;-0.04;627625
8638;Twente (CR);2018 maart;627625;457;675;1944;1621;323;1861;1587;274;;-135;-0.02;-358;-0.06;627490
8639;Twente (CR);2018 april;627490;407;484;1783;1510;273;1806;1503;303;;-100;-0.02;-458;-0.07;627390
8640;Twente (CR);2018 mei;627390;517;466;1808;1511;297;1680;1452;228;;179;0.03;-279;-0.04;627569
8641;Twente (CR);2018 juni;627569;434;430;1966;1572;394;1878;1507;371;;92;0.01;-187;-0.03;627661
8642;Twente (CR);2018 juli;627661;501;450;2375;2011;364;2497;2028;469;;-71;-0.01;-258;-0.04;627590
8643;Twente (CR);2018 augustus;627590;483;441;3093;2324;769;2648;2290;358;;487;0.08;229;0.04;628077
8644;Twente (CR);2018 september;628077;496;429;3022;1980;1042;2334;1999;335;;755;0.12;984;0.16;628832
8645;Twente (CR);2018 oktober;628832;479;438;2190;1707;483;2089;1787;302;;142;0.02;1126;0.18;628974
8646;Twente (CR);2018 november;628974;437;472;2163;1738;425;1875;1644;231;;253;0.04;1379;0.22;629227
8647;Twente (CR);2018 december;629227;471;498;1833;1555;278;1733;1475;258;-16.0;57;0.01;1436;0.23;629284
8648;Twente (CR);2018;627848;5613;5970;26332;20867;5465;24523;20831;3692;-16.0;1436;0.23;1436;0.23;629284
8649;Twente (CR);2019 januari;629284;444;489;2102;1709;393;1977;1623;354;;80;0.01;80;0.01;629364
8650;Twente (CR);2019 februari;629364;413;484;2065;1616;449;1985;1576;409;;9;0.0;89;0.01;629373
8651;Twente (CR);2019 maart;629373;425;542;2053;1629;424;2123;1654;469;;-187;-0.03;-98;-0.02;629186
8652;Twente (CR);2019 april;629186;444;508;1982;1616;366;1819;1518;301;;99;0.02;1;0.0;629285
8653;Twente (CR);2019 mei;629285;492;520;1894;1607;287;1941;1623;318;;-75;-0.01;-74;-0.01;629210
8654;Twente (CR);2019 juni;629210;454;472;1830;1556;274;1767;1458;309;;45;0.01;-29;0.0;629255
8655;Twente (CR);2019 juli;629255;526;490;2423;1989;434;2539;2018;521;;-80;-0.01;-109;-0.02;629175
8656;Twente (CR);2019 augustus;629175;551;482;3245;2422;823;2599;2264;335;;715;0.11;606;0.1;629890
8657;Twente (CR);2019 september;629890;485;490;3477;1932;1545;2238;1952;286;;1234;0.2;1840;0.29;631124
8658;Twente (CR);2019 oktober;631124;491;511;2256;1732;524;2037;1734;303;;199;0.03;2039;0.32;631323
8659;Twente (CR);2019 november;631323;471;506;2068;1664;404;1951;1680;271;;82;0.01;2121;0.34;631405
8660;Twente (CR);2019 december;631405;458;566;1878;1575;303;2073;1710;363;-38.0;-341;-0.05;1780;0.28;631064
8661;Twente (CR);2019;629284;5654;6060;27273;21047;6226;25049;20810;4239;-38.0;1780;0.28;1780;0.28;631064
8662;Twente (CR);2020 januari;631064;483;540;2160;1740;420;2230;1812;418;;-127;-0.02;-127;-0.02;630937
8663;Twente (CR);2020 februari;630937;416;552;2227;1693;534;2025;1674;351;;66;0.01;-61;-0.01;631003
8664;Twente (CR);2020 maart;631003;470;605;1959;1578;381;1828;1630;198;;-4;0.0;-65;-0.01;630999
8665;Twente (CR);2020 april;630999;379;577;1681;1508;173;1690;1452;238;;-207;-0.03;-272;-0.04;630792
8666;Twente (CR);2020 mei;630792;441;478;1823;1639;184;1758;1585;173;;28;0.0;-244;-0.04;630820
8667;Twente (CR);2020 juni;630820;483;471;1914;1646;268;1955;1639;316;;-29;0.0;-273;-0.04;630791
8668;Twente (CR);2020 juli;630791;479;462;2456;2068;388;2401;2022;379;;72;0.01;-201;-0.03;630863
8669;Twente (CR);2020 augustus;630863;486;463;3190;2337;853;2691;2276;415;;522;0.08;321;0.05;631385
8670;Twente (CR);2020 september;631385;500;521;3019;1997;1022;2389;2034;355;;609;0.1;930;0.15;631994
8671;Twente (CR);2020 oktober;631994;487;599;2363;1863;500;2199;1897;302;;52;0.01;982;0.16;632046
8672;Twente (CR);2020 november;632046;442;655;2104;1738;366;2000;1685;315;;-109;-0.02;873;0.14;631937
8673;Twente (CR);2020 december;631937;452;753;2066;1782;284;1954;1621;333;-15.0;-204;-0.03;669;0.11;631733
8674;Twente (CR);2020;631064;5518;6676;26962;21589;5373;25120;21327;3793;-15.0;669;0.11;669;0.11;631733
8675;Twente (CR);2021 januari;631733;476;770;2367;2039;328;2337;1987;350;0.0;-264;-0.04;-264;-0.04;631469
8676;Twente (CR);2021 februari;631469;449;561;2168;1758;410;1906;1634;272;0.0;150;0.02;-114;-0.02;631619
8677;Twente (CR);2021 maart;631619;473;494;2177;1851;326;2086;1813;273;0.0;70;0.01;-44;-0.01;631689
8678;Twente (CR);2021 april;631689;481;558;2039;1735;304;1858;1613;245;0.0;104;0.02;60;0.01;631793
8679;Twente (CR);2021 mei;631793;456;513;1761;1529;232;1704;1460;244;0.0;0;0.0;60;0.01;631793
8680;Twente (CR);2021 juni;631793;478;545;1920;1628;292;1963;1608;355;0.0;-110;-0.02;-50;-0.01;631683
8681;Twente (CR);2021 juli;631683;534;501;2218;1850;368;2228;1711;517;0.0;23;0.0;-27;0.0;631706
8682;Twente (CR);2021 augustus;631706;529;504;2926;2045;881;2392;2060;332;0.0;559;0.09;532;0.08;632265
8683;Twente (CR);2021 september;632265;512;526;3454;1864;1590;2139;1812;327;0.0;1301;0.21;1833;0.29;633566
8684;Twente (CR);2021 oktober;633566;537;545;2296;1765;531;1945;1602;343;0.0;343;0.05;2176;0.34;633909
8685;Twente (CR);2021 november;633909;473;627;2161;1742;419;1894;1581;313;0.0;113;0.02;2289;0.36;634022
8686;Twente (CR);2021 december;634022;486;682;1983;1695;288;1881;1604;277;-11.0;-105;-0.02;2184;0.35;633917
8687;Twente (CR);2021;631733;5884;6826;27470;21501;5969;24333;20485;3848;-11.0;2184;0.35;2184;0.35;633917
8688;Twente (CR);2022 januari;633917;473;557;2134;1796;338;2022;1683;339;;28;0.0;28;0.0;633945
8689;Twente (CR);2022 februari;633945;435;519;2114;1591;523;1884;1517;367;;146;0.02;174;0.03;634091
8690;Twente (CR);2022 maart;634091;449;575;2974;1790;1184;1853;1593;260;;995;0.16;1169;0.18;635086
8691;Twente (CR);2022 april;635086;422;583;2931;1713;1218;1907;1617;290;;863;0.14;2032;0.32;635949
8692;Twente (CR);2022 mei;635949;490;541;2718;1655;1063;1889;1518;371;;778;0.12;2810;0.44;636727
8693;Twente (CR);2022 juni;636727;447;517;2375;1537;838;1925;1552;373;;380;0.06;3190;0.5;637107
8694;Twente (CR);2022 juli;637107;502;513;2582;1870;712;2479;1834;645;;92;0.01;3282;0.52;637199
8695;Twente (CR);2022 augustus;637199;547;554;3258;2102;1156;2578;2038;540;;673;0.11;3955;0.62;637872
8696;Twente (CR);2022 september;637872;510;492;3489;1965;1524;2436;1975;461;;1071;0.17;5026;0.79;638943
8697;Twente (CR);2022 oktober;638943;459;597;2370;1770;600;2245;1776;469;;-13;0.0;5013;0.79;638930
8698;Twente (CR);2022 november;638930;451;563;2224;1683;541;1982;1630;352;;130;0.02;5143;0.81;639060
8699;Twente (CR);2022 december;639060;457;695;2232;1780;452;2121;1693;428;-36.0;-163;-0.03;4980;0.79;638897
8700;Twente (CR);2022;633917;5642;6706;31401;21252;10149;25321;20426;4895;-36.0;4980;0.79;4980;0.79;638897
8701;Twente (CR);2023 januari;638897;429;642;2485;1880;605;2195;1793;402;0.0;77;0.01;77;0.01;638974
8702;Twente (CR);2023 februari;638974;424;601;2320;1595;725;2087;1554;533;0.0;56;0.01;133;0.02;639030
8703;Twente (CR);2023 maart;639030;479;606;2262;1763;499;2173;1698;475;0.0;-38;-0.01;95;0.01;638992
8704;Twente (CR);2023 april;638992;420;535;1904;1532;372;1836;1453;383;0.0;-47;-0.01;48;0.01;638945
8705;Twente (CR);2023 mei;638945;506;529;2289;1808;481;1968;1629;339;0.0;298;0.05;346;0.05;639243
8706;Twente (CR);2023 juni;639243;493;520;2284;1846;438;2164;1756;408;0.0;93;0.01;439;0.07;639336
8707;Twente (CR);2023 juli;639336;507;481;2687;2219;468;2796;2197;599;0.0;-83;-0.01;356;0.06;639253
8708;Twente (CR);2023 augustus;639253;504;492;3324;2442;882;3036;2505;531;0.0;300;0.05;656;0.1;639553
8709;Twente (CR);2023 september;639553;476;481;3668;2101;1567;2785;2260;525;0.0;878;0.14;1534;0.24;640431
8710;Twente (CR);2023 oktober;640431;480;547;2665;1903;762;2226;1836;390;0.0;372;0.06;1906;0.3;640803
8711;Twente (CR);2023 november;640803;449;555;2364;1878;486;2071;1679;392;0.0;187;0.03;2093;0.33;640990
8712;Twente (CR);2023 december;640990;443;649;2190;1802;388;2157;1774;383;-11.0;-184;-0.03;1909;0.3;640806
8713;Twente (CR);2023;638897;5610;6638;30442;22769;7673;27494;22134;5360;-11.0;1909;0.3;1909;0.3;640806
8714;Twente (CR);2024 januari;640806;479;713;2481;1990;491;2360;1898;462;;-113;-0.02;-113;-0.02;640693
8715;Twente (CR);2024 februari;640693;464;610;2654;1928;726;2288;1768;520;;220;0.03;107;0.02;640913
8716;Twente (CR);2024 maart;640913;440;545;2401;1940;461;2191;1800;391;;105;0.02;212;0.03;641018
8717;Twente (CR);2024 april;641018;440;577;2241;1762;479;1987;1622;365;;117;0.02;329;0.05;641135
8718;Twente (CR);2024 mei;641135;465;516;2216;1796;420;1895;1566;329;;270;0.04;599;0.09;641405
8719;Twente (CR);2024 juni;641405;497;538;2153;1735;418;1947;1561;386;;165;0.03;764;0.12;641570
8720;Twente (CR);2024 juli;641570;496;549;2779;2240;539;2529;1946;583;;197;0.03;961;0.15;641767
8721;Twente (CR);2024 augustus;641767;508;499;3083;2352;731;2631;2079;552;;461;0.07;1422;0.22;642228
8722;Twente (CR);2024 september;642228;479;506;3560;2085;1475;2397;1913;484;;1136;0.18;2558;0.4;643364
8723;Twente (CR);2024 oktober;643364;488;565;2439;1861;578;2196;1734;462;;166;0.03;2724;0.43;643530
8724;Twente (CR);2024 november;643530;474;575;2250;1803;447;2100;1631;469;;49;0.01;2773;0.43;643579
8725;Twente (CR);2024 december;643579;430;589;2256;1871;385;2085;1622;463;0.0;12;0.0;2785;0.43;643591
8726;Twente (CR);2024;640806;5660;6782;30513;23363;7150;26606;21140;5466;0.0;2785;0.43;2785;0.43;643591
8727;Twente (CR);2025 januari;643591;470;633;2383;1927;456;2167;1745;422;;53;0.01;53;0.01;643644
8728;Twente (CR);2025 februari;643644;396;550;2745;2063;682;2022;1570;452;;569;0.09;622;0.1;644213
8729;Veluwe (CR);2002 januari;635583;688;510;2074;1779;295;1861;1714;147;;391;0.06;391;0.06;635974
8730;Veluwe (CR);2002 februari;635974;657;428;1892;1656;236;1659;1516;143;;462;0.07;853;0.13;636436
8731;Veluwe (CR);2002 maart;636436;710;548;1920;1677;243;1897;1700;197;;185;0.03;1038;0.16;636621
8732;Veluwe (CR);2002 april;636621;667;487;1835;1570;265;1637;1506;131;;378;0.06;1416;0.22;636999
8733;Veluwe (CR);2002 mei;636999;683;472;1901;1609;292;1768;1627;141;;344;0.05;1760;0.28;637343
8734;Veluwe (CR);2002 juni;637343;638;435;1822;1507;315;1759;1583;176;;266;0.04;2026;0.32;637609
8735;Veluwe (CR);2002 juli;637609;714;489;2349;2024;325;2520;2284;236;;54;0.01;2080;0.33;637663
8736;Veluwe (CR);2002 augustus;637663;719;438;2706;2270;436;2464;2224;240;;523;0.08;2603;0.41;638186
8737;Veluwe (CR);2002 september;638186;690;388;2598;2209;389;2318;2078;240;;582;0.09;3185;0.5;638768
8738;Veluwe (CR);2002 oktober;638768;711;470;2249;1878;371;2016;1851;165;;474;0.07;3659;0.58;639242
8739;Veluwe (CR);2002 november;639242;622;419;1852;1615;237;1820;1674;146;;235;0.04;3894;0.61;639477
8740;Veluwe (CR);2002 december;639477;697;503;1705;1499;206;1637;1467;170;60.0;322;0.05;4216;0.66;639799
8741;Veluwe (CR);2002;635583;8196;5587;24903;21293;3610;23356;21224;2132;60.0;4216;0.66;4216;0.66;639799
8742;Veluwe (CR);2003 januari;639799;696;505;2004;1755;249;2025;1834;191;;170;0.03;170;0.03;639969
8743;Veluwe (CR);2003 februari;639969;655;461;1799;1579;220;1762;1509;253;;231;0.04;401;0.06;640200
8744;Veluwe (CR);2003 maart;640200;687;536;1766;1561;205;1926;1632;294;;-9;0.0;392;0.06;640191
8745;Veluwe (CR);2003 april;640191;623;471;1671;1508;163;1773;1568;205;;50;0.01;442;0.07;640241
8746;Veluwe (CR);2003 mei;640241;666;446;1756;1522;234;1687;1479;208;;289;0.05;731;0.11;640530
8747;Veluwe (CR);2003 juni;640530;597;471;1808;1617;191;1857;1618;239;;77;0.01;808;0.13;640607
8748;Veluwe (CR);2003 juli;640607;721;437;2377;2172;205;2345;2077;268;;316;0.05;1124;0.18;640923
8749;Veluwe (CR);2003 augustus;640923;718;486;2487;2135;352;2346;2102;244;;373;0.06;1497;0.23;641296
8750;Veluwe (CR);2003 september;641296;731;447;2478;2121;357;2381;2123;258;;381;0.06;1878;0.29;641677
8751;Veluwe (CR);2003 oktober;641677;684;448;2241;1950;291;2128;1905;223;;349;0.05;2227;0.35;642026
8752;Veluwe (CR);2003 november;642026;680;454;1960;1723;237;1796;1640;156;;390;0.06;2617;0.41;642416
8753;Veluwe (CR);2003 december;642416;625;573;1923;1699;224;2089;1828;261;111.0;-3;0.0;2614;0.41;642413
8754;Veluwe (CR);2003;639799;8083;5735;24270;21342;2928;24115;21315;2800;111.0;2614;0.41;2614;0.41;642413
8755;Veluwe (CR);2004 januari;642413;656;521;2010;1847;163;2098;1794;304;;47;0.01;47;0.01;642460
8756;Veluwe (CR);2004 februari;642460;595;468;1672;1541;131;1917;1631;286;;-118;-0.02;-71;-0.01;642342
8757;Veluwe (CR);2004 maart;642342;671;449;1770;1608;162;1991;1700;291;;1;0.0;-70;-0.01;642343
8758;Veluwe (CR);2004 april;642343;678;412;1628;1461;167;1863;1577;286;;31;0.0;-39;-0.01;642374
8759;Veluwe (CR);2004 mei;642374;630;433;1587;1393;194;1732;1483;249;;52;0.01;13;0.0;642426
8760;Veluwe (CR);2004 juni;642426;661;403;1894;1691;203;2128;1820;308;;24;0.0;37;0.01;642450
8761;Veluwe (CR);2004 juli;642450;673;427;2468;2271;197;2506;2219;287;;208;0.03;245;0.04;642658
8762;Veluwe (CR);2004 augustus;642658;703;420;2671;2310;361;2546;2287;259;;408;0.06;653;0.1;643066
8763;Veluwe (CR);2004 september;643066;694;374;2666;2276;390;2535;2240;295;;451;0.07;1104;0.17;643517
8764;Veluwe (CR);2004 oktober;643517;666;454;1892;1699;193;1961;1739;222;;143;0.02;1247;0.19;643660
8765;Veluwe (CR);2004 november;643660;650;415;1832;1669;163;2061;1835;226;;6;0.0;1253;0.2;643666
8766;Veluwe (CR);2004 december;643666;639;479;2009;1838;171;1935;1754;181;111.0;345;0.05;1598;0.25;644011
8767;Veluwe (CR);2004;642413;7916;5255;24099;21604;2495;25273;22079;3194;111.0;1598;0.25;1598;0.25;644011
8768;Veluwe (CR);2005 januari;644011;645;501;1869;1664;205;1995;1786;209;;18;0.0;18;0.0;644029
8769;Veluwe (CR);2005 februari;644029;599;457;1733;1582;151;1828;1682;146;;47;0.01;65;0.01;644076
8770;Veluwe (CR);2005 maart;644076;639;552;1892;1746;146;1971;1743;228;;8;0.0;73;0.01;644084
8771;Veluwe (CR);2005 april;644084;629;438;1865;1672;193;1978;1783;195;;78;0.01;151;0.02;644162
8772;Veluwe (CR);2005 mei;644162;611;480;1567;1425;142;1655;1483;172;;43;0.01;194;0.03;644205
8773;Veluwe (CR);2005 juni;644205;576;428;1879;1698;181;2029;1756;273;;-2;0.0;192;0.03;644203
8774;Veluwe (CR);2005 juli;644203;632;428;2297;2099;198;2331;2039;292;;170;0.03;362;0.06;644373
8775;Veluwe (CR);2005 augustus;644373;656;418;2791;2331;460;2740;2400;340;;289;0.04;651;0.1;644662
8776;Veluwe (CR);2005 september;644662;588;404;2878;2525;353;2706;2384;322;;356;0.06;1007;0.16;645018
8777;Veluwe (CR);2005 oktober;645018;663;429;2131;1949;182;2130;1936;194;;235;0.04;1242;0.19;645253
8778;Veluwe (CR);2005 november;645253;568;444;1898;1735;163;2112;1796;316;;-90;-0.01;1152;0.18;645163
8779;Veluwe (CR);2005 december;645163;629;499;1872;1748;124;1929;1740;189;147.0;220;0.03;1372;0.21;645383
8780;Veluwe (CR);2005;644011;7435;5478;24672;22174;2498;25404;22528;2876;147.0;1372;0.21;1372;0.21;645383
8781;Veluwe (CR);2006 januari;645383;638;497;2252;2045;207;2295;2108;187;;98;0.02;98;0.02;645481
8782;Veluwe (CR);2006 februari;645481;592;441;1832;1715;117;2047;1814;233;;-64;-0.01;34;0.01;645417
8783;Veluwe (CR);2006 maart;645417;618;506;1996;1819;177;2183;1965;218;;-75;-0.01;-41;-0.01;645342
8784;Veluwe (CR);2006 april;645342;639;427;1739;1555;184;1953;1777;176;;-2;0.0;-43;-0.01;645340
8785;Veluwe (CR);2006 mei;645340;617;440;1892;1753;139;1943;1663;280;;126;0.02;83;0.01;645466
8786;Veluwe (CR);2006 juni;645466;576;460;1788;1622;166;1993;1822;171;;-89;-0.01;-6;0.0;645377
8787;Veluwe (CR);2006 juli;645377;666;487;2386;2161;225;2493;2178;315;;72;0.01;66;0.01;645449
8788;Veluwe (CR);2006 augustus;645449;674;416;2985;2519;466;3014;2654;360;;229;0.04;295;0.05;645678
8789;Veluwe (CR);2006 september;645678;686;401;2640;2323;317;2437;2208;229;;488;0.08;783;0.12;646166
8790;Veluwe (CR);2006 oktober;646166;720;386;2098;1898;200;2162;1962;200;;270;0.04;1053;0.16;646436
8791;Veluwe (CR);2006 november;646436;619;439;2104;1915;189;2285;2015;270;;-1;0.0;1052;0.16;646435
8792;Veluwe (CR);2006 december;646435;568;448;1785;1648;137;1798;1605;193;126.0;233;0.04;1285;0.2;646668
8793;Veluwe (CR);2006;645383;7613;5348;25497;22973;2524;26603;23771;2832;126.0;1285;0.2;1285;0.2;646668
8794;Veluwe (CR);2007 januari;646668;594;451;2211;1996;215;2359;2041;318;;-5;0.0;-5;0.0;646663
8795;Veluwe (CR);2007 februari;646663;548;423;1803;1658;145;1881;1730;151;;47;0.01;42;0.01;646710
8796;Veluwe (CR);2007 maart;646710;616;467;1972;1787;185;2057;1819;238;;64;0.01;106;0.02;646774
8797;Veluwe (CR);2007 april;646774;559;446;1571;1420;151;1635;1467;168;;49;0.01;155;0.02;646823
8798;Veluwe (CR);2007 mei;646823;603;426;1797;1636;161;1830;1652;178;;144;0.02;299;0.05;646967
8799;Veluwe (CR);2007 juni;646967;611;409;1792;1613;179;1979;1767;212;;15;0.0;314;0.05;646982
8800;Veluwe (CR);2007 juli;646982;645;411;2403;2180;223;2453;2206;247;;184;0.03;498;0.08;647166
8801;Veluwe (CR);2007 augustus;647166;646;390;3035;2472;563;2764;2489;275;;527;0.08;1025;0.16;647693
8802;Veluwe (CR);2007 september;647693;647;382;2540;2230;310;2381;2142;239;;424;0.07;1449;0.22;648117
8803;Veluwe (CR);2007 oktober;648117;598;433;2242;1992;250;2241;1984;257;;166;0.03;1615;0.25;648283
8804;Veluwe (CR);2007 november;648283;605;448;2101;1912;189;2177;1962;215;;81;0.01;1696;0.26;648364
8805;Veluwe (CR);2007 december;648364;587;493;1725;1566;159;1889;1624;265;74.0;4;0.0;1700;0.26;648368
8806;Veluwe (CR);2007;646668;7259;5179;25192;22462;2730;25646;22883;2763;74.0;1700;0.26;1700;0.26;648368
8807;Veluwe (CR);2008 januari;648368;612;469;2149;1894;255;2250;2011;239;;42;0.01;42;0.01;648410
8808;Veluwe (CR);2008 februari;648410;622;464;1830;1619;211;1904;1734;170;;84;0.01;126;0.02;648494
8809;Veluwe (CR);2008 maart;648494;601;477;1806;1569;237;1803;1593;210;;127;0.02;253;0.04;648621
8810;Veluwe (CR);2008 april;648621;572;419;1961;1722;239;2124;1847;277;;-10;0.0;243;0.04;648611
8811;Veluwe (CR);2008 mei;648611;659;455;1807;1613;194;1850;1649;201;;161;0.02;404;0.06;648772
8812;Veluwe (CR);2008 juni;648772;630;417;1942;1752;190;2068;1739;329;;87;0.01;491;0.08;648859
8813;Veluwe (CR);2008 juli;648859;694;435;2567;2291;276;2611;2274;337;;215;0.03;706;0.11;649074
8814;Veluwe (CR);2008 augustus;649074;647;407;2740;2271;469;2592;2268;324;;388;0.06;1094;0.17;649462
8815;Veluwe (CR);2008 september;649462;673;393;3028;2521;507;2685;2335;350;;623;0.1;1717;0.26;650085
8816;Veluwe (CR);2008 oktober;650085;666;429;2382;2070;312;2241;2013;228;;378;0.06;2095;0.32;650463
8817;Veluwe (CR);2008 november;650463;592;414;2008;1783;225;1947;1772;175;;239;0.04;2334;0.36;650702
8818;Veluwe (CR);2008 december;650702;613;477;1986;1777;209;2060;1869;191;158.0;220;0.03;2554;0.39;650922
8819;Veluwe (CR);2008;648368;7581;5256;26206;22882;3324;26135;23104;3031;158.0;2554;0.39;2554;0.39;650922
8820;Veluwe (CR);2009 januari;650922;565;640;2082;1767;315;2041;1765;276;;-34;-0.01;-34;-0.01;650888
8821;Veluwe (CR);2009 februari;650888;535;475;1870;1656;214;1778;1641;137;;152;0.02;118;0.02;651040
8822;Veluwe (CR);2009 maart;651040;648;415;1979;1707;272;1843;1644;199;;369;0.06;487;0.07;651409
8823;Veluwe (CR);2009 april;651409;610;451;1622;1446;176;1633;1490;143;;148;0.02;635;0.1;651557
8824;Veluwe (CR);2009 mei;651557;590;416;1620;1406;214;1736;1474;262;;58;0.01;693;0.11;651615
8825;Veluwe (CR);2009 juni;651615;617;393;1960;1684;276;1805;1544;261;;379;0.06;1072;0.16;651994
8826;Veluwe (CR);2009 juli;651994;700;379;2504;2210;294;2190;1945;245;;635;0.1;1707;0.26;652629
8827;Veluwe (CR);2009 augustus;652629;671;407;2729;2103;626;2381;2138;243;;612;0.09;2319;0.36;653241
8828;Veluwe (CR);2009 september;653241;642;425;2694;2232;462;2418;2162;256;;493;0.08;2812;0.43;653734
8829;Veluwe (CR);2009 oktober;653734;605;462;2059;1750;309;1966;1739;227;;236;0.04;3048;0.47;653970
8830;Veluwe (CR);2009 november;653970;601;390;1789;1520;269;1719;1486;233;;281;0.04;3329;0.51;654251
8831;Veluwe (CR);2009 december;654251;573;466;1995;1765;230;1935;1625;310;45.0;212;0.03;3541;0.54;654463
8832;Veluwe (CR);2009;650922;7357;5319;24903;21246;3657;23445;20653;2792;45.0;3541;0.54;3541;0.54;654463
8833;Veluwe (CR);2010 januari;654463;607;494;1956;1663;293;1907;1679;228;;162;0.02;162;0.02;654625
8834;Veluwe (CR);2010 februari;654625;567;468;1977;1729;248;1967;1759;208;;109;0.02;271;0.04;654734
8835;Veluwe (CR);2010 maart;654734;652;489;2056;1753;303;2023;1798;225;;196;0.03;467;0.07;654930
8836;Veluwe (CR);2010 april;654930;581;436;1675;1428;247;1835;1430;405;;-15;0.0;452;0.07;654915
8837;Veluwe (CR);2010 mei;654915;600;457;1687;1444;243;1582;1423;159;;248;0.04;700;0.11;655163
8838;Veluwe (CR);2010 juni;655163;573;428;1807;1527;280;1873;1645;228;;79;0.01;779;0.12;655242
8839;Veluwe (CR);2010 juli;655242;636;417;2373;2040;333;2350;2074;276;;242;0.04;1021;0.16;655484
8840;Veluwe (CR);2010 augustus;655484;642;425;2824;2180;644;2538;2208;330;;503;0.08;1524;0.23;655987
8841;Veluwe (CR);2010 september;655987;612;401;2941;2232;709;3869;2157;1712;;-717;-0.11;807;0.12;655270
8842;Veluwe (CR);2010 oktober;655270;661;440;2177;1781;396;1807;1609;198;;591;0.09;1398;0.21;655861
8843;Veluwe (CR);2010 november;655861;632;392;1986;1736;250;1824;1612;212;;402;0.06;1800;0.28;656263
8844;Veluwe (CR);2010 december;656263;619;500;1911;1702;209;1884;1642;242;-37.0;109;0.02;1909;0.29;656372
8845;Veluwe (CR);2010;654463;7382;5347;25370;21215;4155;25459;21036;4423;-37.0;1909;0.29;1909;0.29;656372
8846;Veluwe (CR);2011 januari;656372;625;458;2022;1677;345;2002;1727;275;;187;0.03;187;0.03;656559
8847;Veluwe (CR);2011 februari;656559;555;445;1868;1627;241;1857;1622;235;;121;0.02;308;0.05;656680
8848;Veluwe (CR);2011 maart;656680;600;452;1927;1658;269;1849;1623;226;;226;0.03;534;0.08;656906
8849;Veluwe (CR);2011 april;656906;572;420;1723;1478;245;1677;1495;182;;198;0.03;732;0.11;657104
8850;Veluwe (CR);2011 mei;657104;610;418;1741;1497;244;1883;1590;293;;50;0.01;782;0.12;657154
8851;Veluwe (CR);2011 juni;657154;612;415;1920;1659;261;1802;1585;217;;315;0.05;1097;0.17;657469
8852;Veluwe (CR);2011 juli;657469;573;422;2205;1903;302;2167;1892;275;;189;0.03;1286;0.2;657658
8853;Veluwe (CR);2011 augustus;657658;693;414;3123;2315;808;2545;2187;358;;857;0.13;2143;0.33;658515
8854;Veluwe (CR);2011 september;658515;614;413;2788;2251;537;2542;2156;386;;447;0.07;2590;0.39;658962
8855;Veluwe (CR);2011 oktober;658962;620;445;2185;1813;372;2055;1749;306;;305;0.05;2895;0.44;659267
8856;Veluwe (CR);2011 november;659267;592;491;2037;1740;297;2243;1716;527;;-105;-0.02;2790;0.43;659162
8857;Veluwe (CR);2011 december;659162;602;516;1871;1647;224;1922;1685;237;21.0;56;0.01;2846;0.43;659218
8858;Veluwe (CR);2011;656372;7268;5309;25410;21265;4145;24544;21027;3517;21.0;2846;0.43;2846;0.43;659218
8859;Veluwe (CR);2012 januari;659218;591;530;2193;1905;288;2137;1897;240;;117;0.02;117;0.02;659335
8860;Veluwe (CR);2012 februari;659335;537;489;2146;1823;323;2065;1807;258;;129;0.02;246;0.04;659464
8861;Veluwe (CR);2012 maart;659464;629;471;2015;1710;305;1913;1716;197;;260;0.04;506;0.08;659724
8862;Veluwe (CR);2012 april;659724;581;496;1724;1522;202;1859;1550;309;;-50;-0.01;456;0.07;659674
8863;Veluwe (CR);2012 mei;659674;592;447;1781;1558;223;1862;1584;278;;64;0.01;520;0.08;659738
8864;Veluwe (CR);2012 juni;659738;601;440;2295;2020;275;2084;1847;237;;372;0.06;892;0.14;660110
8865;Veluwe (CR);2012 juli;660110;616;463;2402;2103;299;2388;2042;346;;167;0.03;1059;0.16;660277
8866;Veluwe (CR);2012 augustus;660277;652;427;3326;2477;849;2739;2413;326;;812;0.12;1871;0.28;661089
8867;Veluwe (CR);2012 september;661089;584;459;2773;2271;502;2444;2126;318;;454;0.07;2325;0.35;661543
8868;Veluwe (CR);2012 oktober;661543;622;453;2161;1850;311;2232;1864;368;;98;0.01;2423;0.37;661641
8869;Veluwe (CR);2012 november;661641;597;430;2012;1767;245;1849;1649;200;;330;0.05;2753;0.42;661971
8870;Veluwe (CR);2012 december;661971;527;483;1848;1666;182;1940;1637;303;62.0;14;0.0;2767;0.42;661985
8871;Veluwe (CR);2012;659218;7129;5588;26676;22672;4004;25512;22132;3380;62.0;2767;0.42;2767;0.42;661985
8872;Veluwe (CR);2013 januari;661985;574;521;2318;1963;355;2145;1880;265;;226;0.03;226;0.03;662211
8873;Veluwe (CR);2013 februari;662211;512;496;2037;1719;318;1943;1720;223;;110;0.02;336;0.05;662321
8874;Veluwe (CR);2013 maart;662321;593;574;1900;1663;237;1869;1647;222;;50;0.01;386;0.06;662371
8875;Veluwe (CR);2013 april;662371;596;515;1815;1578;237;1771;1563;208;;125;0.02;511;0.08;662496
8876;Veluwe (CR);2013 mei;662496;575;431;1793;1579;214;1875;1573;302;;62;0.01;573;0.09;662558
8877;Veluwe (CR);2013 juni;662558;571;454;1794;1536;258;1726;1481;245;;185;0.03;758;0.11;662743
8878;Veluwe (CR);2013 juli;662743;651;431;2584;2220;364;2625;2288;337;;179;0.03;937;0.14;662922
8879;Veluwe (CR);2013 augustus;662922;633;419;3516;2679;837;2958;2605;353;;772;0.12;1709;0.26;663694
8880;Veluwe (CR);2013 september;663694;642;419;3028;2475;553;2788;2294;494;;463;0.07;2172;0.33;664157
8881;Veluwe (CR);2013 oktober;664157;593;452;2270;1933;337;2673;1915;758;;-262;-0.04;1910;0.29;663895
8882;Veluwe (CR);2013 november;663895;564;433;2075;1737;338;1922;1682;240;;284;0.04;2194;0.33;664179
8883;Veluwe (CR);2013 december;664179;562;463;1971;1772;199;2196;1653;543;14.0;-112;-0.02;2082;0.31;664067
8884;Veluwe (CR);2013;661985;7066;5608;27101;22854;4247;26491;22301;4190;14.0;2082;0.31;2082;0.31;664067
8885;Veluwe (CR);2014 januari;664067;562;476;2514;2086;428;2272;2016;256;;328;0.05;328;0.05;664395
8886;Veluwe (CR);2014 februari;664395;574;442;2184;1812;372;2139;1870;269;;177;0.03;505;0.08;664572
8887;Veluwe (CR);2014 maart;664572;577;451;2130;1858;272;2044;1747;297;;212;0.03;717;0.11;664784
8888;Veluwe (CR);2014 april;664784;585;426;2046;1676;370;1998;1670;328;;207;0.03;924;0.14;664991
8889;Veluwe (CR);2014 mei;664991;579;469;1911;1700;211;1854;1637;217;;167;0.03;1091;0.16;665158
8890;Veluwe (CR);2014 juni;665158;603;415;2153;1830;323;1981;1614;367;;360;0.05;1451;0.22;665518
8891;Veluwe (CR);2014 juli;665518;572;476;2792;2454;338;2584;2195;389;;304;0.05;1755;0.26;665822
8892;Veluwe (CR);2014 augustus;665822;609;437;3682;2812;870;3070;2689;381;;784;0.12;2539;0.38;666606
8893;Veluwe (CR);2014 september;666606;619;433;3160;2670;490;2918;2407;511;;428;0.06;2967;0.45;667034
8894;Veluwe (CR);2014 oktober;667034;617;495;2656;2253;403;2485;2117;368;;293;0.04;3260;0.49;667327
8895;Veluwe (CR);2014 november;667327;595;468;2217;1901;316;1929;1692;237;;415;0.06;3675;0.55;667742
8896;Veluwe (CR);2014 december;667742;631;531;2409;2109;300;2348;1959;389;43.0;204;0.03;3879;0.58;667946
8897;Veluwe (CR);2014;664067;7123;5519;29854;25161;4693;27622;23613;4009;43.0;3879;0.58;3879;0.58;667946
8898;Veluwe (CR);2015 januari;667946;560;641;2415;2096;319;2178;1892;286;;156;0.02;156;0.02;668102
8899;Veluwe (CR);2015 februari;668102;500;533;2553;2061;492;2192;1904;288;;328;0.05;484;0.07;668430
8900;Veluwe (CR);2015 maart;668430;601;499;2311;1917;394;2303;1997;306;;110;0.02;594;0.09;668540
8901;Veluwe (CR);2015 april;668540;549;488;2025;1785;240;1983;1686;297;;103;0.02;697;0.1;668643
8902;Veluwe (CR);2015 mei;668643;598;492;1946;1719;227;1972;1709;263;;80;0.01;777;0.12;668723
8903;Veluwe (CR);2015 juni;668723;628;450;2311;1917;394;2186;1803;383;;303;0.05;1080;0.16;669026
8904;Veluwe (CR);2015 juli;669026;583;457;3006;2621;385;2862;2426;436;;270;0.04;1350;0.2;669296
8905;Veluwe (CR);2015 augustus;669296;653;425;3976;2916;1060;3098;2704;394;;1106;0.17;2456;0.37;670402
8906;Veluwe (CR);2015 september;670402;629;416;3153;2586;567;2831;2443;388;;535;0.08;2991;0.45;670937
8907;Veluwe (CR);2015 oktober;670937;622;468;2670;2170;500;2396;2040;356;;428;0.06;3419;0.51;671365
8908;Veluwe (CR);2015 november;671365;579;441;2241;1871;370;2086;1779;307;;293;0.04;3712;0.56;671658
8909;Veluwe (CR);2015 december;671658;589;452;2541;2231;310;2339;1986;353;30.0;369;0.05;4081;0.61;672027
8910;Veluwe (CR);2015;667946;7091;5762;31148;25890;5258;28426;24369;4057;30.0;4081;0.61;4081;0.61;672027
8911;Veluwe (CR);2016 januari;672027;594;545;2507;2146;361;2328;1947;381;;228;0.03;228;0.03;672255
8912;Veluwe (CR);2016 februari;672255;611;526;2768;2266;502;2454;2043;411;;399;0.06;627;0.09;672654
8913;Veluwe (CR);2016 maart;672654;643;598;2446;2123;323;2283;1977;306;;208;0.03;835;0.12;672862
8914;Veluwe (CR);2016 april;672862;588;538;2261;2000;261;1980;1750;230;;331;0.05;1166;0.17;673193
8915;Veluwe (CR);2016 mei;673193;607;446;2374;2105;269;2021;1738;283;;514;0.08;1680;0.25;673707
8916;Veluwe (CR);2016 juni;673707;603;479;2593;2294;299;2200;1860;340;;517;0.08;2197;0.33;674224
8917;Veluwe (CR);2016 juli;674224;651;468;3443;3134;309;2923;2537;386;;703;0.1;2900;0.43;674927
8918;Veluwe (CR);2016 augustus;674927;712;430;4086;3060;1026;3087;2615;472;;1281;0.19;4181;0.62;676208
8919;Veluwe (CR);2016 september;676208;600;468;3306;2698;608;2981;2525;456;;457;0.07;4638;0.69;676665
8920;Veluwe (CR);2016 oktober;676665;575;477;2775;2467;308;2575;2187;388;;298;0.04;4936;0.73;676963
8921;Veluwe (CR);2016 november;676963;500;498;2585;2304;281;2269;1999;270;;318;0.05;5254;0.78;677281
8922;Veluwe (CR);2016 december;677281;554;538;2781;2476;305;2414;2112;302;-2.0;381;0.06;5635;0.84;677662
8923;Veluwe (CR);2016;672027;7238;6011;33925;29073;4852;29515;25290;4225;-2.0;5635;0.84;5635;0.84;677662
8924;Veluwe (CR);2017 januari;677662;598;669;2757;2389;368;2444;2152;292;;242;0.04;242;0.04;677904
8925;Veluwe (CR);2017 februari;677904;517;526;2969;2492;477;2462;2154;308;;498;0.07;740;0.11;678402
8926;Veluwe (CR);2017 maart;678402;547;515;2945;2628;317;2657;2373;284;;320;0.05;1060;0.16;678722
8927;Veluwe (CR);2017 april;678722;521;494;2578;2160;418;2144;1873;271;;461;0.07;1521;0.22;679183
8928;Veluwe (CR);2017 mei;679183;561;441;2448;2182;266;2229;1989;240;;339;0.05;1860;0.27;679522
8929;Veluwe (CR);2017 juni;679522;569;428;2486;2202;284;2434;2146;288;;193;0.03;2053;0.3;679715
8930;Veluwe (CR);2017 juli;679715;661;470;3138;2792;346;3170;2503;667;;159;0.02;2212;0.33;679874
8931;Veluwe (CR);2017 augustus;679874;671;473;4319;3162;1157;3145;2708;437;;1372;0.2;3584;0.53;681246
8932;Veluwe (CR);2017 september;681246;641;434;3611;2878;733;3018;2596;422;;800;0.12;4384;0.65;682046
8933;Veluwe (CR);2017 oktober;682046;648;453;2934;2462;472;2571;2188;383;;558;0.08;4942;0.73;682604
8934;Veluwe (CR);2017 november;682604;558;488;2636;2323;313;2406;2052;354;;300;0.04;5242;0.77;682904
8935;Veluwe (CR);2017 december;682904;588;531;2683;2410;273;2365;2100;265;-39.0;336;0.05;5578;0.82;683240
8936;Veluwe (CR);2017;677662;7080;5922;35504;30080;5424;31045;26834;4211;-39.0;5578;0.82;5578;0.82;683240
8937;Veluwe (CR);2018 januari;683240;623;645;2781;2405;376;2637;2345;292;;122;0.02;122;0.02;683362
8938;Veluwe (CR);2018 februari;683362;498;574;2828;2225;603;2551;2160;391;;201;0.03;323;0.05;683563
8939;Veluwe (CR);2018 maart;683563;534;657;2798;2444;354;2675;2339;336;;0;0.0;323;0.05;683563
8940;Veluwe (CR);2018 april;683563;578;474;2348;2022;326;2246;1962;284;;206;0.03;529;0.08;683769
8941;Veluwe (CR);2018 mei;683769;634;460;2510;2152;358;2224;1947;277;;460;0.07;989;0.14;684229
8942;Veluwe (CR);2018 juni;684229;620;417;2568;2222;346;2331;2045;286;;440;0.06;1429;0.21;684669
8943;Veluwe (CR);2018 juli;684669;693;464;3290;2891;399;2851;2457;394;;668;0.1;2097;0.31;685337
8944;Veluwe (CR);2018 augustus;685337;627;512;4411;3388;1023;3288;2850;438;;1238;0.18;3335;0.49;686575
8945;Veluwe (CR);2018 september;686575;594;469;3344;2642;702;2702;2335;367;;767;0.11;4102;0.6;687342
8946;Veluwe (CR);2018 oktober;687342;654;475;3181;2735;446;2776;2257;519;;584;0.08;4686;0.69;687926
8947;Veluwe (CR);2018 november;687926;569;481;2849;2495;354;2452;2120;332;;485;0.07;5171;0.76;688411
8948;Veluwe (CR);2018 december;688411;526;545;2730;2471;259;2334;2076;258;11.0;388;0.06;5559;0.81;688799
8949;Veluwe (CR);2018;683240;7150;6173;35638;30092;5546;31067;26893;4174;11.0;5559;0.81;5559;0.81;688799
8950;Veluwe (CR);2019 januari;688799;587;605;2880;2491;389;2550;2250;300;;312;0.05;312;0.05;689111
8951;Veluwe (CR);2019 februari;689111;505;566;2834;2339;495;2523;2142;381;;250;0.04;562;0.08;689361
8952;Veluwe (CR);2019 maart;689361;551;532;2744;2395;349;2420;2105;315;;343;0.05;905;0.13;689704
8953;Veluwe (CR);2019 april;689704;562;527;2607;2237;370;2468;2146;322;;174;0.03;1079;0.16;689878
8954;Veluwe (CR);2019 mei;689878;630;521;2663;2331;332;2384;2075;309;;388;0.06;1467;0.21;690266
8955;Veluwe (CR);2019 juni;690266;612;476;2479;2136;343;2119;1820;299;;496;0.07;1963;0.28;690762
8956;Veluwe (CR);2019 juli;690762;691;482;3644;3155;489;2871;2478;393;;982;0.14;2945;0.43;691744
8957;Veluwe (CR);2019 augustus;691744;659;497;4464;3295;1169;3038;2653;385;;1588;0.23;4533;0.66;693332
8958;Veluwe (CR);2019 september;693332;644;465;3408;2698;710;2766;2427;339;;821;0.12;5354;0.78;694153
8959;Veluwe (CR);2019 oktober;694153;641;529;3085;2545;540;2704;2351;353;;493;0.07;5847;0.85;694646
8960;Veluwe (CR);2019 november;694646;576;505;2823;2477;346;2483;2182;301;;411;0.06;6258;0.91;695057
8961;Veluwe (CR);2019 december;695057;556;574;2859;2531;328;2391;2059;332;-7.0;443;0.06;6701;0.97;695500
8962;Veluwe (CR);2019;688799;7214;6279;36490;30630;5860;30717;26688;4029;-7.0;6701;0.97;6701;0.97;695500
8963;Veluwe (CR);2020 januari;695500;640;558;3227;2779;448;2693;2331;362;;616;0.09;616;0.09;696116
8964;Veluwe (CR);2020 februari;696116;564;526;2906;2351;555;2512;2183;329;;432;0.06;1048;0.15;696548
8965;Veluwe (CR);2020 maart;696548;608;715;2780;2416;364;2460;2168;292;;213;0.03;1261;0.18;696761
8966;Veluwe (CR);2020 april;696761;565;860;2486;2263;223;2244;1992;252;;-53;-0.01;1208;0.17;696708
8967;Veluwe (CR);2020 mei;696708;576;480;2425;2237;188;2451;2254;197;;70;0.01;1278;0.18;696778
8968;Veluwe (CR);2020 juni;696778;589;488;2629;2348;281;2382;2139;243;;348;0.05;1626;0.23;697126
8969;Veluwe (CR);2020 juli;697126;681;456;3505;3165;340;3054;2763;291;;676;0.1;2302;0.33;697802
8970;Veluwe (CR);2020 augustus;697802;669;478;3852;3299;553;3055;2680;375;;988;0.14;3290;0.47;698790
8971;Veluwe (CR);2020 september;698790;649;476;3624;2909;715;2852;2494;358;;945;0.14;4235;0.61;699735
8972;Veluwe (CR);2020 oktober;699735;621;570;3270;2738;532;2708;2408;300;;613;0.09;4848;0.7;700348
8973;Veluwe (CR);2020 november;700348;577;549;2847;2454;393;2391;2169;222;;484;0.07;5332;0.77;700832
8974;Veluwe (CR);2020 december;700832;565;705;2848;2474;374;2540;2232;308;-25.0;143;0.02;5475;0.79;700975
8975;Veluwe (CR);2020;695500;7304;6861;36399;31433;4966;31342;27813;3529;-25.0;5475;0.79;5475;0.79;700975
8976;Veluwe (CR);2021 januari;700975;643;732;3070;2731;339;2701;2434;267;0.0;280;0.04;280;0.04;701255
8977;Veluwe (CR);2021 februari;701255;589;518;2791;2434;357;2306;2074;232;0.0;556;0.08;836;0.12;701811
8978;Veluwe (CR);2021 maart;701811;626;501;3182;2845;337;2880;2648;232;0.0;427;0.06;1263;0.18;702238
8979;Veluwe (CR);2021 april;702238;609;520;2816;2444;372;2436;2189;247;0.0;469;0.07;1732;0.25;702707
8980;Veluwe (CR);2021 mei;702707;637;530;2601;2305;296;2463;2186;277;0.0;245;0.03;1977;0.28;702952
8981;Veluwe (CR);2021 juni;702952;637;539;2632;2279;353;2402;2149;253;0.0;328;0.05;2305;0.33;703280
8982;Veluwe (CR);2021 juli;703280;699;506;3317;2953;364;2893;2570;323;0.0;617;0.09;2922;0.42;703897
8983;Veluwe (CR);2021 augustus;703897;652;508;3815;2978;837;3013;2608;405;0.0;946;0.13;3868;0.55;704843
8984;Veluwe (CR);2021 september;704843;679;534;3442;2611;831;2594;2286;308;0.0;993;0.14;4861;0.69;705836
8985;Veluwe (CR);2021 oktober;705836;661;586;2895;2425;470;2496;2183;313;0.0;474;0.07;5335;0.76;706310
8986;Veluwe (CR);2021 november;706310;634;727;2765;2371;394;2269;1989;280;0.0;403;0.06;5738;0.82;706713
8987;Veluwe (CR);2021 december;706713;619;679;2635;2311;324;2389;2060;329;-11.0;175;0.02;5913;0.84;706888
8988;Veluwe (CR);2021;700975;7685;6880;35961;30687;5274;30842;27376;3466;-11.0;5913;0.84;5913;0.84;706888
8989;Veluwe (CR);2022 januari;706888;579;557;2600;2245;355;2437;2172;265;;185;0.03;185;0.03;707073
8990;Veluwe (CR);2022 februari;707073;541;535;2649;2114;535;2129;1862;267;;526;0.07;711;0.1;707599
8991;Veluwe (CR);2022 maart;707599;591;624;3844;2361;1483;2506;2182;324;;1305;0.18;2016;0.29;708904
8992;Veluwe (CR);2022 april;708904;522;621;3949;2481;1468;2341;2096;245;;1509;0.21;3525;0.5;710413
8993;Veluwe (CR);2022 mei;710413;664;561;3175;2320;855;2387;2064;323;;891;0.13;4416;0.62;711304
8994;Veluwe (CR);2022 juni;711304;588;532;2995;2284;711;2397;2066;331;;654;0.09;5070;0.72;711958
8995;Veluwe (CR);2022 juli;711958;657;580;3252;2546;706;2900;2386;514;;429;0.06;5499;0.78;712387
8996;Veluwe (CR);2022 augustus;712387;667;523;4214;2796;1418;2935;2426;509;;1423;0.2;6922;0.98;713810
8997;Veluwe (CR);2022 september;713810;676;528;3546;2468;1078;2732;2310;422;;962;0.13;7884;1.12;714772
8998;Veluwe (CR);2022 oktober;714772;619;648;3297;2531;766;2708;2289;419;;560;0.08;8444;1.19;715332
8999;Veluwe (CR);2022 november;715332;584;584;2970;2338;632;2536;2155;381;;434;0.06;8878;1.26;715766
9000;Veluwe (CR);2022 december;715766;560;732;3019;2428;591;2816;2304;512;-5.0;26;0.0;8904;1.26;715792
9001;Veluwe (CR);2022;706888;7248;7025;39510;28912;10598;30824;26312;4512;-5.0;8904;1.26;8904;1.26;715792
9002;Veluwe (CR);2023 januari;715792;531;671;3327;2692;635;2717;2311;406;0.0;470;0.07;470;0.07;716262
9003;Veluwe (CR);2023 februari;716262;523;539;3133;2452;681;2479;2054;425;0.0;638;0.09;1108;0.15;716900
9004;Veluwe (CR);2023 maart;716900;608;656;3089;2537;552;2725;2327;398;0.0;316;0.04;1424;0.2;717216
9005;Veluwe (CR);2023 april;717216;559;508;2843;2411;432;2342;1925;417;0.0;552;0.08;1976;0.28;717768
9006;Veluwe (CR);2023 mei;717768;588;550;2894;2404;490;2411;2047;364;0.0;521;0.07;2497;0.35;718289
9007;Veluwe (CR);2023 juni;718289;607;540;3186;2771;415;2774;2344;430;0.0;479;0.07;2976;0.42;718768
9008;Veluwe (CR);2023 juli;718768;623;471;3564;3044;520;3101;2549;552;0.0;615;0.09;3591;0.5;719383
9009;Veluwe (CR);2023 augustus;719383;628;520;4646;3280;1366;3381;2802;579;0.0;1373;0.19;4964;0.69;720756
9010;Veluwe (CR);2023 september;720756;568;487;3855;2897;958;3088;2618;470;0.0;848;0.12;5812;0.81;721604
9011;Veluwe (CR);2023 oktober;721604;629;579;3342;2600;742;2783;2332;451;0.0;609;0.08;6421;0.9;722213
9012;Veluwe (CR);2023 november;722213;568;647;2816;2270;546;2521;2067;454;0.0;216;0.03;6637;0.93;722429
9013;Veluwe (CR);2023 december;722429;531;619;2817;2389;428;2637;2160;477;-28.0;64;0.01;6701;0.94;722493
9014;Veluwe (CR);2023;715792;6963;6787;39512;31747;7765;32959;27536;5423;-28.0;6701;0.94;6701;0.94;722493
9015;Veluwe (CR);2024 januari;722493;569;696;2980;2382;598;2760;2325;435;;93;0.01;93;0.01;722586
9016;Veluwe (CR);2024 februari;722586;593;643;2757;2140;617;2797;2139;658;;-90;-0.01;3;0.0;722496
9017;Veluwe (CR);2024 maart;722496;576;614;2757;2323;434;2669;2225;444;;50;0.01;53;0.01;722546
9018;Veluwe (CR);2024 april;722546;548;585;2606;2214;392;2433;2074;359;;136;0.02;189;0.03;722682
9019;Veluwe (CR);2024 mei;722682;585;567;2578;2157;421;2393;2013;380;;203;0.03;392;0.05;722885
9020;Veluwe (CR);2024 juni;722885;584;501;2396;1992;404;2286;1894;392;;193;0.03;585;0.08;723078
9021;Veluwe (CR);2024 juli;723078;638;550;3431;2884;547;3053;2473;580;;466;0.06;1051;0.15;723544
9022;Veluwe (CR);2024 augustus;723544;632;509;4436;3133;1303;3104;2670;434;;1455;0.2;2506;0.35;724999
9023;Veluwe (CR);2024 september;724999;607;543;3326;2697;629;2831;2393;438;;559;0.08;3065;0.42;725558
9024;Veluwe (CR);2024 oktober;725558;581;576;3296;2739;557;2682;2205;477;;619;0.09;3684;0.51;726177
9025;Veluwe (CR);2024 november;726177;618;556;2960;2547;413;2666;2252;414;;356;0.05;4040;0.56;726533
9026;Veluwe (CR);2024 december;726533;572;599;3040;2634;406;2539;2077;462;0.0;474;0.07;4514;0.62;727007
9027;Veluwe (CR);2024;722493;7103;6939;36563;29842;6721;32213;26740;5473;0.0;4514;0.62;4514;0.62;727007
9028;Veluwe (CR);2025 januari;727007;625;716;3356;2816;540;2809;2342;467;;456;0.06;456;0.06;727463
9029;Veluwe (CR);2025 februari;727463;511;624;2848;2291;557;2441;2033;408;;294;0.04;750;0.1;727757
9030;Achterhoek (CR);2002 januari;383387;388;344;1369;1240;129;1353;1279;74;;60;0.02;60;0.02;383447
9031;Achterhoek (CR);2002 februari;383447;345;311;1107;1007;100;1129;1038;91;;12;0.0;72;0.02;383459
9032;Achterhoek (CR);2002 maart;383459;380;347;1265;1142;123;1255;1139;116;;43;0.01;115;0.03;383502
9033;Achterhoek (CR);2002 april;383502;392;341;1127;1013;114;1084;939;145;;94;0.02;209;0.05;383596
9034;Achterhoek (CR);2002 mei;383596;395;288;1138;1015;123;1066;959;107;;179;0.05;388;0.1;383775
9035;Achterhoek (CR);2002 juni;383775;391;270;1367;1171;196;1117;1033;84;;371;0.1;759;0.2;384146
9036;Achterhoek (CR);2002 juli;384146;406;291;1640;1496;144;1518;1378;140;;237;0.06;996;0.26;384383
9037;Achterhoek (CR);2002 augustus;384383;423;280;1504;1371;133;1577;1429;148;;70;0.02;1066;0.28;384453
9038;Achterhoek (CR);2002 september;384453;371;291;1429;1258;171;1522;1352;170;;-13;0.0;1053;0.27;384440
9039;Achterhoek (CR);2002 oktober;384440;407;298;1368;1163;205;1345;1211;134;;132;0.03;1185;0.31;384572
9040;Achterhoek (CR);2002 november;384572;417;300;1233;1126;107;1220;1130;90;;130;0.03;1315;0.34;384702
9041;Achterhoek (CR);2002 december;384702;393;350;1349;1207;142;1136;1058;78;163.0;419;0.11;1734;0.45;385121
9042;Achterhoek (CR);2002;383387;4708;3711;15896;14209;1687;15322;13945;1377;163.0;1734;0.45;1734;0.45;385121
9043;Achterhoek (CR);2003 januari;385121;389;381;1347;1242;105;1369;1211;158;;-14;0.0;-14;0.0;385107
9044;Achterhoek (CR);2003 februari;385107;354;287;1210;999;211;1101;965;136;;176;0.05;162;0.04;385283
9045;Achterhoek (CR);2003 maart;385283;401;335;1124;1017;107;1202;1047;155;;-12;0.0;150;0.04;385271
9046;Achterhoek (CR);2003 april;385271;369;352;1099;1000;99;1114;990;124;;2;0.0;152;0.04;385273
9047;Achterhoek (CR);2003 mei;385273;372;276;1175;1051;124;1079;965;114;;192;0.05;344;0.09;385465
9048;Achterhoek (CR);2003 juni;385465;365;297;1136;1034;102;1237;1144;93;;-33;-0.01;311;0.08;385432
9049;Achterhoek (CR);2003 juli;385432;397;270;1456;1354;102;1414;1332;82;;169;0.04;480;0.12;385601
9050;Achterhoek (CR);2003 augustus;385601;372;333;1435;1320;115;1760;1631;129;;-286;-0.07;194;0.05;385315
9051;Achterhoek (CR);2003 september;385315;401;283;1341;1244;97;1631;1502;129;;-172;-0.04;22;0.01;385143
9052;Achterhoek (CR);2003 oktober;385143;412;286;1271;1174;97;1398;1295;103;;-1;0.0;21;0.01;385142
9053;Achterhoek (CR);2003 november;385142;360;286;1148;1057;91;1121;1015;106;;101;0.03;122;0.03;385243
9054;Achterhoek (CR);2003 december;385243;339;341;1393;1295;98;1283;1135;148;-26.0;82;0.02;204;0.05;385325
9055;Achterhoek (CR);2003;385121;4531;3727;15135;13787;1348;15709;14232;1477;-26.0;204;0.05;204;0.05;385325
9056;Achterhoek (CR);2004 januari;385325;373;375;1211;1111;100;1190;1110;80;;19;0.0;19;0.0;385344
9057;Achterhoek (CR);2004 februari;385344;341;326;1091;1022;69;1188;951;237;;-82;-0.02;-63;-0.02;385262
9058;Achterhoek (CR);2004 maart;385262;358;315;1278;1180;98;1287;1140;147;;34;0.01;-29;-0.01;385296
9059;Achterhoek (CR);2004 april;385296;381;280;1101;1016;85;1084;1002;82;;118;0.03;89;0.02;385414
9060;Achterhoek (CR);2004 mei;385414;332;309;1067;1006;61;1001;931;70;;89;0.02;178;0.05;385503
9061;Achterhoek (CR);2004 juni;385503;387;288;1131;1019;112;1128;1054;74;;102;0.03;280;0.07;385605
9062;Achterhoek (CR);2004 juli;385605;393;251;1524;1416;108;1415;1291;124;;251;0.07;531;0.14;385856
9063;Achterhoek (CR);2004 augustus;385856;395;272;1325;1230;95;1514;1390;124;;-66;-0.02;465;0.12;385790
9064;Achterhoek (CR);2004 september;385790;367;259;1307;1193;114;1551;1451;100;;-136;-0.04;329;0.09;385654
9065;Achterhoek (CR);2004 oktober;385654;405;286;1270;1190;80;1283;1185;98;;106;0.03;435;0.11;385760
9066;Achterhoek (CR);2004 november;385760;336;286;1196;1128;68;1335;1210;125;;-89;-0.02;346;0.09;385671
9067;Achterhoek (CR);2004 december;385671;348;292;1051;1010;41;1088;995;93;220.0;239;0.06;585;0.15;385910
9068;Achterhoek (CR);2004;385325;4416;3539;14552;13521;1031;15064;13710;1354;220.0;585;0.15;585;0.15;385910
9069;Achterhoek (CR);2005 januari;402785;345;372;1181;1093;88;939;887;52;;215;0.05;215;0.05;403000
9070;Achterhoek (CR);2005 februari;403000;350;362;1000;925;75;996;883;113;;-8;0.0;207;0.05;402992
9071;Achterhoek (CR);2005 maart;402992;345;434;1100;1036;64;1025;915;110;;-14;0.0;193;0.05;402978
9072;Achterhoek (CR);2005 april;402978;340;313;1020;955;65;1014;888;126;;33;0.01;226;0.06;403011
9073;Achterhoek (CR);2005 mei;403011;350;296;974;899;75;969;849;120;;59;0.01;285;0.07;403070
9074;Achterhoek (CR);2005 juni;403070;376;283;1118;1052;66;1039;955;84;;172;0.04;457;0.11;403242
9075;Achterhoek (CR);2005 juli;403242;363;280;1366;1285;81;1383;1203;180;;66;0.02;523;0.13;403308
9076;Achterhoek (CR);2005 augustus;403308;363;289;1479;1381;98;1728;1532;196;;-175;-0.04;348;0.09;403133
9077;Achterhoek (CR);2005 september;403133;339;286;1258;1193;65;1626;1437;189;;-315;-0.08;33;0.01;402818
9078;Achterhoek (CR);2005 oktober;402818;372;283;1157;1092;65;1341;1190;151;;-95;-0.02;-62;-0.02;402723
9079;Achterhoek (CR);2005 november;402723;352;269;1069;1004;65;1216;1097;119;;-64;-0.02;-126;-0.03;402659
9080;Achterhoek (CR);2005 december;402659;311;304;1289;1221;68;1208;1059;149;-72.0;16;0.0;-110;-0.03;402675
9081;Achterhoek (CR);2005;402785;4206;3771;14011;13136;875;14484;12895;1589;-72.0;-110;-0.03;-110;-0.03;402675
9082;Achterhoek (CR);2006 januari;402675;351;312;1166;1076;90;1323;1151;172;;-118;-0.03;-118;-0.03;402557
9083;Achterhoek (CR);2006 februari;402557;321;328;1107;1035;72;1060;920;140;;40;0.01;-78;-0.02;402597
9084;Achterhoek (CR);2006 maart;402597;375;337;1130;1054;76;1157;1058;99;;11;0.0;-67;-0.02;402608
9085;Achterhoek (CR);2006 april;402608;329;312;1039;965;74;1061;927;134;;-5;0.0;-72;-0.02;402603
9086;Achterhoek (CR);2006 mei;402603;378;303;1048;961;87;1087;989;98;;36;0.01;-36;-0.01;402639
9087;Achterhoek (CR);2006 juni;402639;322;308;1087;1003;84;984;891;93;;117;0.03;81;0.02;402756
9088;Achterhoek (CR);2006 juli;402756;358;323;1328;1242;86;1421;1235;186;;-58;-0.01;23;0.01;402698
9089;Achterhoek (CR);2006 augustus;402698;370;288;1516;1382;134;1874;1690;184;;-276;-0.07;-253;-0.06;402422
9090;Achterhoek (CR);2006 september;402422;384;287;1198;1114;84;1615;1441;174;;-320;-0.08;-573;-0.14;402102
9091;Achterhoek (CR);2006 oktober;402102;352;251;1123;1025;98;1380;1136;244;;-156;-0.04;-729;-0.18;401946
9092;Achterhoek (CR);2006 november;401946;329;298;1085;1005;80;1311;1160;151;;-195;-0.05;-924;-0.23;401751
9093;Achterhoek (CR);2006 december;401751;300;291;1029;966;63;1137;999;138;77.0;-22;-0.01;-946;-0.23;401729
9094;Achterhoek (CR);2006;402675;4169;3638;13856;12828;1028;15410;13597;1813;77.0;-946;-0.23;-946;-0.23;401729
9095;Achterhoek (CR);2007 januari;401729;368;333;1250;1124;126;1232;1075;157;;53;0.01;53;0.01;401782
9096;Achterhoek (CR);2007 februari;401782;288;279;1093;1026;67;1095;975;120;;7;0.0;60;0.01;401789
9097;Achterhoek (CR);2007 maart;401789;338;342;1196;1144;52;1177;1071;106;;15;0.0;75;0.02;401804
9098;Achterhoek (CR);2007 april;401804;296;303;961;903;58;959;830;129;;-5;0.0;70;0.02;401799
9099;Achterhoek (CR);2007 mei;401799;312;303;1064;982;82;1076;962;114;;-3;0.0;67;0.02;401796
9100;Achterhoek (CR);2007 juni;401796;328;265;1174;1096;78;1155;1039;116;;82;0.02;149;0.04;401878
9101;Achterhoek (CR);2007 juli;401878;399;264;1379;1278;101;1290;1173;117;;224;0.06;373;0.09;402102
9102;Achterhoek (CR);2007 augustus;402102;363;264;1469;1367;102;1728;1567;161;;-160;-0.04;213;0.05;401942
9103;Achterhoek (CR);2007 september;401942;345;273;1220;1104;116;1491;1360;131;;-199;-0.05;14;0.0;401743
9104;Achterhoek (CR);2007 oktober;401743;353;310;1258;1150;108;1361;1170;191;;-60;-0.01;-46;-0.01;401683
9105;Achterhoek (CR);2007 november;401683;305;284;1181;1099;82;1229;1100;129;;-27;-0.01;-73;-0.02;401656
9106;Achterhoek (CR);2007 december;401656;310;342;1043;964;79;1019;938;81;118.0;110;0.03;37;0.01;401766
9107;Achterhoek (CR);2007;401729;4005;3562;14288;13237;1051;14812;13260;1552;118.0;37;0.01;37;0.01;401766
9108;Achterhoek (CR);2008 januari;401766;278;349;1467;1355;112;1358;1236;122;;38;0.01;38;0.01;401804
9109;Achterhoek (CR);2008 februari;401804;314;276;1166;1077;89;1079;959;120;;125;0.03;163;0.04;401929
9110;Achterhoek (CR);2008 maart;401929;297;326;1048;962;86;1023;904;119;;-4;0.0;159;0.04;401925
9111;Achterhoek (CR);2008 april;401925;339;341;1084;977;107;1057;964;93;;25;0.01;184;0.05;401950
9112;Achterhoek (CR);2008 mei;401950;302;314;1000;937;63;948;858;90;;40;0.01;224;0.06;401990
9113;Achterhoek (CR);2008 juni;401990;340;261;1186;1076;110;1153;1010;143;;112;0.03;336;0.08;402102
9114;Achterhoek (CR);2008 juli;402102;346;299;1516;1391;125;1359;1214;145;;204;0.05;540;0.13;402306
9115;Achterhoek (CR);2008 augustus;402306;349;290;1447;1332;115;1652;1512;140;;-146;-0.04;394;0.1;402160
9116;Achterhoek (CR);2008 september;402160;331;266;1400;1236;164;1662;1547;115;;-197;-0.05;197;0.05;401963
9117;Achterhoek (CR);2008 oktober;401963;358;302;1245;1135;110;1269;1187;82;;32;0.01;229;0.06;401995
9118;Achterhoek (CR);2008 november;401995;328;278;1095;968;127;1070;992;78;;75;0.02;304;0.08;402070
9119;Achterhoek (CR);2008 december;402070;283;328;1293;1172;121;1166;1050;116;48.0;130;0.03;434;0.11;402200
9120;Achterhoek (CR);2008;401766;3865;3630;14947;13618;1329;14796;13433;1363;48.0;434;0.11;434;0.11;402200
9121;Achterhoek (CR);2009 januari;402200;300;413;1145;1033;112;1094;991;103;;-62;-0.02;-62;-0.02;402138
9122;Achterhoek (CR);2009 februari;402138;272;315;1212;1072;140;1042;953;89;;127;0.03;65;0.02;402265
9123;Achterhoek (CR);2009 maart;402265;322;321;1105;989;116;1105;1036;69;;1;0.0;66;0.02;402266
9124;Achterhoek (CR);2009 april;402266;308;302;936;803;133;941;841;100;;1;0.0;67;0.02;402267
9125;Achterhoek (CR);2009 mei;402267;308;295;913;789;124;885;823;62;;41;0.01;108;0.03;402308
9126;Achterhoek (CR);2009 juni;402308;342;268;1125;1018;107;1114;1022;92;;85;0.02;193;0.05;402393
9127;Achterhoek (CR);2009 juli;402393;371;300;1384;1166;218;1347;1190;157;;108;0.03;301;0.07;402501
9128;Achterhoek (CR);2009 augustus;402501;321;299;1266;1128;138;1570;1414;156;;-282;-0.07;19;0.0;402219
9129;Achterhoek (CR);2009 september;402219;334;259;1228;1022;206;1473;1397;76;;-170;-0.04;-151;-0.04;402049
9130;Achterhoek (CR);2009 oktober;402049;309;314;1180;1044;136;1236;1121;115;;-61;-0.02;-212;-0.05;401988
9131;Achterhoek (CR);2009 november;401988;306;294;1125;943;182;1142;1030;112;;-5;0.0;-217;-0.05;401983
9132;Achterhoek (CR);2009 december;401983;287;321;1052;966;86;1151;1079;72;44.0;-89;-0.02;-306;-0.08;401894
9133;Achterhoek (CR);2009;402200;3780;3701;13671;11973;1698;14100;12897;1203;44.0;-306;-0.08;-306;-0.08;401894
9134;Achterhoek (CR);2010 januari;401894;310;305;1133;1021;112;1132;1070;62;;6;0.0;6;0.0;401900
9135;Achterhoek (CR);2010 februari;401900;286;349;1067;940;127;1098;988;110;;-94;-0.02;-88;-0.02;401806
9136;Achterhoek (CR);2010 maart;401806;314;360;1086;956;130;1119;1009;110;;-79;-0.02;-167;-0.04;401727
9137;Achterhoek (CR);2010 april;401727;256;321;987;822;165;947;846;101;;-25;-0.01;-192;-0.05;401702
9138;Achterhoek (CR);2010 mei;401702;301;320;986;869;117;904;794;110;;63;0.02;-129;-0.03;401765
9139;Achterhoek (CR);2010 juni;401765;288;299;1098;957;141;929;852;77;;158;0.04;29;0.01;401923
9140;Achterhoek (CR);2010 juli;401923;310;301;1372;1160;212;1277;1150;127;;104;0.03;133;0.03;402027
9141;Achterhoek (CR);2010 augustus;402027;326;292;1270;1134;136;1613;1505;108;;-309;-0.08;-176;-0.04;401718
9142;Achterhoek (CR);2010 september;401718;303;280;1301;1136;165;1488;1398;90;;-164;-0.04;-340;-0.08;401554
9143;Achterhoek (CR);2010 oktober;401554;346;316;1173;995;178;1218;1121;97;;-15;0.0;-355;-0.09;401539
9144;Achterhoek (CR);2010 november;401539;308;268;1184;1056;128;1210;1095;115;;14;0.0;-341;-0.08;401553
9145;Achterhoek (CR);2010 december;401553;302;308;1184;1046;138;1074;1004;70;-23.0;81;0.02;-260;-0.06;401634
9146;Achterhoek (CR);2010;401894;3650;3719;13841;12092;1749;14009;12832;1177;-23.0;-260;-0.06;-260;-0.06;401634
9147;Achterhoek (CR);2011 januari;401634;299;336;1193;1036;157;1237;1112;125;;-81;-0.02;-81;-0.02;401553
9148;Achterhoek (CR);2011 februari;401553;274;295;1186;1004;182;1065;1008;57;;100;0.02;19;0.0;401653
9149;Achterhoek (CR);2011 maart;401653;297;316;1152;1000;152;1096;1021;75;;37;0.01;56;0.01;401690
9150;Achterhoek (CR);2011 april;401690;276;301;1077;919;158;977;885;92;;75;0.02;131;0.03;401765
9151;Achterhoek (CR);2011 mei;401765;306;321;977;873;104;920;821;99;;42;0.01;173;0.04;401807
9152;Achterhoek (CR);2011 juni;401807;292;277;1105;960;145;1010;888;122;;110;0.03;283;0.07;401917
9153;Achterhoek (CR);2011 juli;401917;303;294;1337;1201;136;1165;1073;92;;181;0.05;464;0.12;402098
9154;Achterhoek (CR);2011 augustus;402098;297;314;1475;1275;200;1747;1581;166;;-289;-0.07;175;0.04;401809
9155;Achterhoek (CR);2011 september;401809;301;272;1214;1075;139;1459;1372;87;;-216;-0.05;-41;-0.01;401593
9156;Achterhoek (CR);2011 oktober;401593;291;307;1095;948;147;1182;1046;136;;-103;-0.03;-144;-0.04;401490
9157;Achterhoek (CR);2011 november;401490;268;307;1153;1011;142;1165;1084;81;;-51;-0.01;-195;-0.05;401439
9158;Achterhoek (CR);2011 december;401439;276;320;1175;1049;126;1102;995;107;8.0;37;0.01;-158;-0.04;401476
9159;Achterhoek (CR);2011;401634;3480;3660;14139;12351;1788;14125;12886;1239;8.0;-158;-0.04;-158;-0.04;401476
9160;Achterhoek (CR);2012 januari;401476;299;344;1377;1214;163;1400;1209;191;;-68;-0.02;-68;-0.02;401408
9161;Achterhoek (CR);2012 februari;401408;270;339;1170;1050;120;1182;1044;138;;-81;-0.02;-149;-0.04;401327
9162;Achterhoek (CR);2012 maart;401327;271;355;1124;1013;111;1114;1028;86;;-74;-0.02;-223;-0.06;401253
9163;Achterhoek (CR);2012 april;401253;304;327;938;848;90;982;898;84;;-67;-0.02;-290;-0.07;401186
9164;Achterhoek (CR);2012 mei;401186;282;321;1131;1017;114;1003;904;99;;89;0.02;-201;-0.05;401275
9165;Achterhoek (CR);2012 juni;401275;254;320;1258;1146;112;1165;1072;93;;27;0.01;-174;-0.04;401302
9166;Achterhoek (CR);2012 juli;401302;284;295;1520;1331;189;1343;1244;99;;166;0.04;-8;0.0;401468
9167;Achterhoek (CR);2012 augustus;401468;286;309;1483;1312;171;1745;1625;120;;-285;-0.07;-293;-0.07;401183
9168;Achterhoek (CR);2012 september;401183;270;285;1079;967;112;1434;1311;123;;-370;-0.09;-663;-0.17;400813
9169;Achterhoek (CR);2012 oktober;400813;299;275;1239;1079;160;1246;1143;103;;17;0.0;-646;-0.16;400830
9170;Achterhoek (CR);2012 november;400830;281;291;1103;995;108;1147;1074;73;;-54;-0.01;-700;-0.17;400776
9171;Achterhoek (CR);2012 december;400776;234;325;1074;978;96;1034;979;55;2.0;-49;-0.01;-749;-0.19;400727
9172;Achterhoek (CR);2012;401476;3334;3786;14496;12950;1546;14795;13531;1264;2.0;-749;-0.19;-749;-0.19;400727
9173;Achterhoek (CR);2013 januari;400727;271;353;1276;1117;159;1216;1093;123;;-22;-0.01;-22;-0.01;400705
9174;Achterhoek (CR);2013 februari;400705;243;319;1218;1102;116;1171;1070;101;;-29;-0.01;-51;-0.01;400676
9175;Achterhoek (CR);2013 maart;400676;268;374;1162;1018;144;1090;1020;70;;-34;-0.01;-85;-0.02;400642
9176;Achterhoek (CR);2013 april;400642;268;350;985;874;111;982;914;68;;-79;-0.02;-164;-0.04;400563
9177;Achterhoek (CR);2013 mei;400563;260;334;1027;912;115;1033;939;94;;-80;-0.02;-244;-0.06;400483
9178;Achterhoek (CR);2013 juni;400483;260;290;1088;938;150;1002;905;97;;56;0.01;-188;-0.05;400539
9179;Achterhoek (CR);2013 juli;400539;325;290;1433;1323;110;1406;1241;165;;62;0.02;-126;-0.03;400601
9180;Achterhoek (CR);2013 augustus;400601;296;277;1379;1248;131;1708;1587;121;;-310;-0.08;-436;-0.11;400291
9181;Achterhoek (CR);2013 september;400291;299;300;1311;1138;173;1620;1477;143;;-310;-0.08;-746;-0.19;399981
9182;Achterhoek (CR);2013 oktober;399981;257;322;1227;1077;150;1378;1252;126;;-216;-0.05;-962;-0.24;399765
9183;Achterhoek (CR);2013 november;399765;259;302;1017;905;112;1033;961;72;;-59;-0.01;-1021;-0.25;399706
9184;Achterhoek (CR);2013 december;399706;245;329;1228;1096;132;1160;1052;108;17.0;1;0.0;-1020;-0.25;399707
9185;Achterhoek (CR);2013;400727;3251;3840;14351;12748;1603;14799;13511;1288;17.0;-1020;-0.25;-1020;-0.25;399707
9186;Achterhoek (CR);2014 januari;399707;264;382;1374;1217;157;1301;1197;104;;-45;-0.01;-45;-0.01;399662
9187;Achterhoek (CR);2014 februari;399662;235;307;1148;1020;128;1161;1092;69;;-85;-0.02;-130;-0.03;399577
9188;Achterhoek (CR);2014 maart;399577;268;325;1089;971;118;1151;1071;80;;-119;-0.03;-249;-0.06;399458
9189;Achterhoek (CR);2014 april;399458;254;305;1202;1044;158;1164;1064;100;;-13;0.0;-262;-0.07;399445
9190;Achterhoek (CR);2014 mei;399445;281;323;1100;941;159;1075;992;83;;-17;0.0;-279;-0.07;399428
9191;Achterhoek (CR);2014 juni;399428;239;254;1102;950;152;1109;1009;100;;-22;-0.01;-301;-0.08;399406
9192;Achterhoek (CR);2014 juli;399406;296;282;1476;1295;181;1341;1199;142;;149;0.04;-152;-0.04;399555
9193;Achterhoek (CR);2014 augustus;399555;316;316;1413;1230;183;1844;1657;187;;-431;-0.11;-583;-0.15;399124
9194;Achterhoek (CR);2014 september;399124;301;288;1417;1210;207;1652;1502;150;;-222;-0.06;-805;-0.2;398902
9195;Achterhoek (CR);2014 oktober;398902;277;321;1380;1223;157;1375;1268;107;;-39;-0.01;-844;-0.21;398863
9196;Achterhoek (CR);2014 november;398863;257;297;1115;917;198;1133;1041;92;;-58;-0.01;-902;-0.23;398805
9197;Achterhoek (CR);2014 december;398805;275;365;1304;1158;146;1242;1152;90;-5.0;-33;-0.01;-935;-0.23;398772
9198;Achterhoek (CR);2014;399707;3263;3765;15120;13176;1944;15548;14244;1304;-5.0;-935;-0.23;-935;-0.23;398772
9199;Achterhoek (CR);2015 januari;398772;274;380;1341;1166;175;1292;1212;80;;-57;-0.01;-57;-0.01;398715
9200;Achterhoek (CR);2015 februari;398715;242;398;1276;1127;149;1215;1168;47;;-95;-0.02;-152;-0.04;398620
9201;Achterhoek (CR);2015 maart;398620;249;356;1351;1192;159;1198;1118;80;;46;0.01;-106;-0.03;398666
9202;Achterhoek (CR);2015 april;398666;241;351;1189;1036;153;1102;1004;98;;-23;-0.01;-129;-0.03;398643
9203;Achterhoek (CR);2015 mei;398643;245;314;1036;899;137;1028;944;84;;-61;-0.02;-190;-0.05;398582
9204;Achterhoek (CR);2015 juni;398582;282;268;1217;1047;170;1156;1023;133;;75;0.02;-115;-0.03;398657
9205;Achterhoek (CR);2015 juli;398657;260;298;1698;1509;189;1407;1329;78;;253;0.06;138;0.03;398910
9206;Achterhoek (CR);2015 augustus;398910;299;300;1555;1350;205;1723;1600;123;;-169;-0.04;-31;-0.01;398741
9207;Achterhoek (CR);2015 september;398741;284;288;1549;1366;183;1472;1366;106;;73;0.02;42;0.01;398814
9208;Achterhoek (CR);2015 oktober;398814;237;349;1307;1138;169;1279;1186;93;;-84;-0.02;-42;-0.01;398730
9209;Achterhoek (CR);2015 november;398730;273;300;1417;1206;211;1200;1082;118;;190;0.05;148;0.04;398920
9210;Achterhoek (CR);2015 december;398920;292;355;1689;1229;460;1285;1184;101;-1.0;340;0.09;488;0.12;399260
9211;Achterhoek (CR);2015;398772;3178;3957;16625;14265;2360;15357;14216;1141;-1.0;488;0.12;488;0.12;399260
9212;Achterhoek (CR);2016 januari;399260;242;380;1643;1167;476;1547;1435;112;;-42;-0.01;-42;-0.01;399218
9213;Achterhoek (CR);2016 februari;399218;242;345;1800;1247;553;1601;1484;117;;96;0.02;54;0.01;399314
9214;Achterhoek (CR);2016 maart;399314;254;364;1748;1221;527;1653;1549;104;;-15;0.0;39;0.01;399299
9215;Achterhoek (CR);2016 april;399299;261;303;1594;1149;445;1497;1414;83;;55;0.01;94;0.02;399354
9216;Achterhoek (CR);2016 mei;399354;235;326;1567;1140;427;1461;1391;70;;15;0.0;109;0.03;399369
9217;Achterhoek (CR);2016 juni;399369;284;324;1769;1192;577;1629;1527;102;;100;0.03;209;0.05;399469
9218;Achterhoek (CR);2016 juli;399469;309;331;2078;1585;493;1845;1726;119;;211;0.05;420;0.11;399680
9219;Achterhoek (CR);2016 augustus;399680;282;298;2230;1758;472;2044;1907;137;;170;0.04;590;0.15;399850
9220;Achterhoek (CR);2016 september;399850;274;304;1742;1453;289;1810;1691;119;;-98;-0.02;492;0.12;399752
9221;Achterhoek (CR);2016 oktober;399752;262;329;1513;1319;194;1414;1320;94;;32;0.01;524;0.13;399784
9222;Achterhoek (CR);2016 november;399784;245;325;1513;1304;209;1407;1314;93;;26;0.01;550;0.14;399810
9223;Achterhoek (CR);2016 december;399810;254;361;1640;1501;139;1414;1337;77;-8.0;111;0.03;661;0.17;399921
9224;Achterhoek (CR);2016;399260;3144;3990;20837;16036;4801;19322;18095;1227;-8.0;661;0.17;661;0.17;399921
9225;Achterhoek (CR);2017 januari;399921;269;429;1627;1499;128;1539;1448;91;;-72;-0.02;-72;-0.02;399849
9226;Achterhoek (CR);2017 februari;399849;240;394;1505;1378;127;1401;1309;92;;-50;-0.01;-122;-0.03;399799
9227;Achterhoek (CR);2017 maart;399799;265;372;1790;1669;121;1628;1543;85;;55;0.01;-67;-0.02;399854
9228;Achterhoek (CR);2017 april;399854;246;320;1317;1237;80;1178;1066;112;;65;0.02;-2;0.0;399919
9229;Achterhoek (CR);2017 mei;399919;270;354;1510;1334;176;1364;1283;81;;62;0.02;60;0.02;399981
9230;Achterhoek (CR);2017 juni;399981;279;333;1570;1419;151;1310;1235;75;;206;0.05;266;0.07;400187
9231;Achterhoek (CR);2017 juli;400187;300;296;1882;1690;192;1565;1437;128;;321;0.08;587;0.15;400508
9232;Achterhoek (CR);2017 augustus;400508;282;318;1886;1709;177;1868;1719;149;;-18;0.0;569;0.14;400490
9233;Achterhoek (CR);2017 september;400490;261;325;1661;1478;183;1800;1666;134;;-203;-0.05;366;0.09;400287
9234;Achterhoek (CR);2017 oktober;400287;270;326;1580;1465;115;1484;1397;87;;40;0.01;406;0.1;400327
9235;Achterhoek (CR);2017 november;400327;256;352;1402;1278;124;1386;1251;135;;-80;-0.02;326;0.08;400247
9236;Achterhoek (CR);2017 december;400247;246;327;1645;1528;117;1388;1290;98;-7.0;169;0.04;495;0.12;400416
9237;Achterhoek (CR);2017;399921;3184;4146;19375;17684;1691;17911;16644;1267;-7.0;495;0.12;495;0.12;400416
9238;Achterhoek (CR);2018 januari;400416;272;391;1622;1477;145;1444;1347;97;;59;0.01;59;0.01;400475
9239;Achterhoek (CR);2018 februari;400475;231;406;1370;1237;133;1279;1192;87;;-84;-0.02;-25;-0.01;400391
9240;Achterhoek (CR);2018 maart;400391;245;465;1536;1401;135;1383;1270;113;;-67;-0.02;-92;-0.02;400324
9241;Achterhoek (CR);2018 april;400324;244;346;1362;1205;157;1207;1122;85;;53;0.01;-39;-0.01;400377
9242;Achterhoek (CR);2018 mei;400377;240;347;1396;1277;119;1243;1164;79;;46;0.01;7;0.0;400423
9243;Achterhoek (CR);2018 juni;400423;298;311;1327;1158;169;1244;1133;111;;70;0.02;77;0.02;400493
9244;Achterhoek (CR);2018 juli;400493;273;338;1726;1535;191;1415;1288;127;;246;0.06;323;0.08;400739
9245;Achterhoek (CR);2018 augustus;400739;271;298;1833;1633;200;1733;1590;143;;73;0.02;396;0.1;400812
9246;Achterhoek (CR);2018 september;400812;290;277;1449;1278;171;1544;1386;158;;-82;-0.02;314;0.08;400730
9247;Achterhoek (CR);2018 oktober;400730;249;306;1649;1488;161;1586;1462;124;;6;0.0;320;0.08;400736
9248;Achterhoek (CR);2018 november;400736;255;354;1395;1245;150;1319;1226;93;;-23;-0.01;297;0.07;400713
9249;Achterhoek (CR);2018 december;400713;230;359;1358;1248;110;1258;1171;87;1.0;-28;-0.01;269;0.07;400685
9250;Achterhoek (CR);2018;400416;3098;4198;18023;16182;1841;16655;15351;1304;1.0;269;0.07;269;0.07;400685
9251;Achterhoek (CR);2019 januari;400685;258;404;1490;1315;175;1431;1305;126;;-87;-0.02;-87;-0.02;400598
9252;Achterhoek (CR);2019 februari;400598;248;377;1415;1268;147;1288;1187;101;;-2;0.0;-89;-0.02;400596
9253;Achterhoek (CR);2019 maart;400596;236;412;1431;1260;171;1365;1238;127;;-110;-0.03;-199;-0.05;400486
9254;Achterhoek (CR);2019 april;400486;275;355;1352;1221;131;1286;1202;84;;-14;0.0;-213;-0.05;400472
9255;Achterhoek (CR);2019 mei;400472;255;352;1471;1310;161;1283;1201;82;;91;0.02;-122;-0.03;400563
9256;Achterhoek (CR);2019 juni;400563;260;293;1286;1136;150;1199;1045;154;;54;0.01;-68;-0.02;400617
9257;Achterhoek (CR);2019 juli;400617;306;336;1969;1774;195;1639;1488;151;;300;0.07;232;0.06;400917
9258;Achterhoek (CR);2019 augustus;400917;288;283;1816;1633;183;1683;1530;153;;138;0.03;370;0.09;401055
9259;Achterhoek (CR);2019 september;401055;292;365;1537;1386;151;1487;1397;90;;-23;-0.01;347;0.09;401032
9260;Achterhoek (CR);2019 oktober;401032;288;341;1522;1340;182;1306;1199;107;;163;0.04;510;0.13;401195
9261;Achterhoek (CR);2019 november;401195;282;357;1390;1252;138;1368;1267;101;;-53;-0.01;457;0.11;401142
9262;Achterhoek (CR);2019 december;401142;243;348;1474;1343;131;1305;1208;97;-13.0;51;0.01;508;0.13;401193
9263;Achterhoek (CR);2019;400685;3231;4223;18153;16238;1915;16640;15267;1373;-13.0;508;0.13;508;0.13;401193
9264;Achterhoek (CR);2020 januari;401193;270;380;1539;1383;156;1451;1316;135;;-22;-0.01;-22;-0.01;401171
9265;Achterhoek (CR);2020 februari;401171;247;369;1396;1298;98;1229;1151;78;;45;0.01;23;0.01;401216
9266;Achterhoek (CR);2020 maart;401216;248;424;1384;1258;126;1226;1119;107;;-18;0.0;5;0.0;401198
9267;Achterhoek (CR);2020 april;401198;262;442;1299;1202;97;1086;1036;50;;33;0.01;38;0.01;401231
9268;Achterhoek (CR);2020 mei;401231;260;341;1362;1278;84;1113;1054;59;;168;0.04;206;0.05;401399
9269;Achterhoek (CR);2020 juni;401399;236;319;1466;1379;87;1308;1217;91;;75;0.02;281;0.07;401474
9270;Achterhoek (CR);2020 juli;401474;306;299;1875;1694;181;1519;1421;98;;363;0.09;644;0.16;401837
9271;Achterhoek (CR);2020 augustus;401837;288;343;1775;1605;170;1634;1539;95;;86;0.02;730;0.18;401923
9272;Achterhoek (CR);2020 september;401923;288;353;1630;1465;165;1455;1342;113;;110;0.03;840;0.21;402033
9273;Achterhoek (CR);2020 oktober;402033;277;378;1684;1548;136;1473;1377;96;;110;0.03;950;0.24;402143
9274;Achterhoek (CR);2020 november;402143;271;406;1376;1267;109;1202;1118;84;;39;0.01;989;0.25;402182
9275;Achterhoek (CR);2020 december;402182;252;436;1591;1486;105;1351;1261;90;1.0;57;0.01;1046;0.26;402239
9276;Achterhoek (CR);2020;401193;3205;4490;18377;16863;1514;16047;14951;1096;1.0;1046;0.26;1046;0.26;402239
9277;Achterhoek (CR);2021 januari;402239;272;450;1689;1593;96;1377;1308;69;0.0;134;0.03;134;0.03;402373
9278;Achterhoek (CR);2021 februari;402373;254;325;1523;1410;113;1284;1217;67;0.0;168;0.04;302;0.08;402541
9279;Achterhoek (CR);2021 maart;402541;276;388;1617;1512;105;1482;1407;75;0.0;23;0.01;325;0.08;402564
9280;Achterhoek (CR);2021 april;402564;244;403;1510;1407;103;1297;1205;92;0.0;54;0.01;379;0.09;402618
9281;Achterhoek (CR);2021 mei;402618;278;347;1346;1261;85;1143;1061;82;0.0;134;0.03;513;0.13;402752
9282;Achterhoek (CR);2021 juni;402752;274;324;1541;1428;113;1269;1188;81;0.0;222;0.06;735;0.18;402974
9283;Achterhoek (CR);2021 juli;402974;292;343;1818;1696;122;1457;1354;103;0.0;310;0.08;1045;0.26;403284
9284;Achterhoek (CR);2021 augustus;403284;302;342;1682;1531;151;1513;1396;117;0.0;129;0.03;1174;0.29;403413
9285;Achterhoek (CR);2021 september;403413;299;361;1396;1253;143;1271;1161;110;0.0;63;0.02;1237;0.31;403476
9286;Achterhoek (CR);2021 oktober;403476;307;403;1468;1344;124;1374;1259;115;0.0;-2;0.0;1235;0.31;403474
9287;Achterhoek (CR);2021 november;403474;266;531;1386;1274;112;1232;1121;111;0.0;-111;-0.03;1124;0.28;403363
9288;Achterhoek (CR);2021 december;403363;261;509;1575;1486;89;1277;1157;120;-17.0;33;0.01;1157;0.29;403396
9289;Achterhoek (CR);2021;402239;3325;4726;18551;17195;1356;15976;14834;1142;-17.0;1157;0.29;1157;0.29;403396
9290;Achterhoek (CR);2022 januari;403396;250;393;1434;1343;91;1354;1258;96;;-63;-0.02;-63;-0.02;403333
9291;Achterhoek (CR);2022 februari;403333;254;363;1327;1200;127;1173;1080;93;;45;0.01;-18;0.0;403378
9292;Achterhoek (CR);2022 maart;403378;253;418;1932;1258;674;1141;1053;88;;626;0.16;608;0.15;404004
9293;Achterhoek (CR);2022 april;404004;233;404;2205;1385;820;1233;1160;73;;801;0.2;1409;0.35;404805
9294;Achterhoek (CR);2022 mei;404805;246;370;1515;1224;291;1140;1012;128;;251;0.06;1660;0.41;405056
9295;Achterhoek (CR);2022 juni;405056;265;378;1627;1287;340;1156;1013;143;;358;0.09;2018;0.5;405414
9296;Achterhoek (CR);2022 juli;405414;294;394;1897;1582;315;1361;1163;198;;436;0.11;2454;0.61;405850
9297;Achterhoek (CR);2022 augustus;405850;286;355;1913;1610;303;1534;1337;197;;310;0.08;2764;0.69;406160
9298;Achterhoek (CR);2022 september;406160;279;388;1687;1452;235;1482;1263;219;;96;0.02;2860;0.71;406256
9299;Achterhoek (CR);2022 oktober;406256;272;419;1574;1377;197;1468;1282;186;;-41;-0.01;2819;0.7;406215
9300;Achterhoek (CR);2022 november;406215;253;383;1465;1305;160;1308;1135;173;;27;0.01;2846;0.71;406242
9301;Achterhoek (CR);2022 december;406242;234;507;1716;1542;174;1419;1248;171;-5.0;19;0.0;2865;0.71;406261
9302;Achterhoek (CR);2022;403396;3119;4772;20292;16565;3727;15769;14004;1765;-5.0;2865;0.71;2865;0.71;406261
9303;Achterhoek (CR);2023 januari;406261;258;469;1682;1464;218;1388;1243;145;0.0;83;0.02;83;0.02;406344
9304;Achterhoek (CR);2023 februari;406344;243;389;1449;1267;182;1308;1195;113;0.0;-5;0.0;78;0.02;406339
9305;Achterhoek (CR);2023 maart;406339;267;458;1645;1437;208;1417;1251;166;0.0;37;0.01;115;0.03;406376
9306;Achterhoek (CR);2023 april;406376;242;371;1545;1352;193;1320;1166;154;0.0;96;0.02;211;0.05;406472
9307;Achterhoek (CR);2023 mei;406472;272;343;1457;1297;160;1225;1091;134;0.0;161;0.04;372;0.09;406633
9308;Achterhoek (CR);2023 juni;406633;276;325;1544;1374;170;1468;1332;136;0.0;27;0.01;399;0.1;406660
9309;Achterhoek (CR);2023 juli;406660;305;356;1772;1537;235;1559;1376;183;0.0;162;0.04;561;0.14;406822
9310;Achterhoek (CR);2023 augustus;406822;280;346;1772;1514;258;1793;1562;231;0.0;-87;-0.02;474;0.12;406735
9311;Achterhoek (CR);2023 september;406735;314;366;1632;1393;239;1597;1442;155;0.0;-17;0.0;457;0.11;406718
9312;Achterhoek (CR);2023 oktober;406718;283;369;1513;1286;227;1384;1220;164;0.0;43;0.01;500;0.12;406761
9313;Achterhoek (CR);2023 november;406761;236;441;1483;1284;199;1258;1124;134;0.0;20;0.0;520;0.13;406781
9314;Achterhoek (CR);2023 december;406781;256;454;1499;1364;135;1282;1157;125;-15.0;4;0.0;524;0.13;406785
9315;Achterhoek (CR);2023;406261;3232;4687;18993;16569;2424;16999;15159;1840;-15.0;524;0.13;524;0.13;406785
9316;Achterhoek (CR);2024 januari;406785;250;463;1556;1386;170;1349;1191;158;;-6;0.0;-6;0.0;406779
9317;Achterhoek (CR);2024 februari;406779;263;396;1425;1241;184;1264;1135;129;;28;0.01;22;0.01;406807
9318;Achterhoek (CR);2024 maart;406807;263;451;1437;1278;159;1326;1166;160;;-77;-0.02;-55;-0.01;406730
9319;Achterhoek (CR);2024 april;406730;265;380;1441;1275;166;1105;1007;98;;221;0.05;166;0.04;406951
9320;Achterhoek (CR);2024 mei;406951;266;405;1314;1171;143;1214;1077;137;;-39;-0.01;127;0.03;406912
9321;Achterhoek (CR);2024 juni;406912;276;351;1355;1137;218;1104;979;125;;176;0.04;303;0.07;407088
9322;Achterhoek (CR);2024 juli;407088;288;358;1663;1428;235;1327;1147;180;;266;0.07;569;0.14;407354
9323;Achterhoek (CR);2024 augustus;407354;250;355;1785;1553;232;1519;1327;192;;161;0.04;730;0.18;407515
9324;Achterhoek (CR);2024 september;407515;282;334;1620;1383;237;1370;1215;155;;198;0.05;928;0.23;407713
9325;Achterhoek (CR);2024 oktober;407713;275;418;1611;1425;186;1395;1205;190;;73;0.02;1001;0.25;407786
9326;Achterhoek (CR);2024 november;407786;256;385;1495;1357;138;1261;1114;147;;105;0.03;1106;0.27;407891
9327;Achterhoek (CR);2024 december;407891;272;427;1477;1356;121;1255;1079;176;0.0;67;0.02;1173;0.29;407958
9328;Achterhoek (CR);2024;406785;3206;4723;18179;15990;2189;15489;13642;1847;0.0;1173;0.29;1173;0.29;407958
9329;Achterhoek (CR);2025 januari;407958;246;454;1584;1382;202;1374;1237;137;;2;0.0;2;0.0;407960
9330;Achterhoek (CR);2025 februari;407960;247;428;1434;1259;175;1261;1115;146;;-8;0.0;-6;0.0;407952
9331;Arnhem/Nijmegen (CR);2002 januari;701364;762;558;3199;2685;514;2875;2549;326;;528;0.08;528;0.08;701892
9332;Arnhem/Nijmegen (CR);2002 februari;701892;599;466;2708;2354;354;2838;2384;454;;3;0.0;531;0.08;701895
9333;Arnhem/Nijmegen (CR);2002 maart;701895;710;561;2871;2411;460;2730;2403;327;;290;0.04;821;0.12;702185
9334;Arnhem/Nijmegen (CR);2002 april;702185;739;525;2588;2229;359;2542;2303;239;;260;0.04;1081;0.15;702445
9335;Arnhem/Nijmegen (CR);2002 mei;702445;716;544;2752;2403;349;2683;2454;229;;241;0.03;1322;0.19;702686
9336;Arnhem/Nijmegen (CR);2002 juni;702686;699;527;2704;2350;354;2601;2303;298;;275;0.04;1597;0.23;702961
9337;Arnhem/Nijmegen (CR);2002 juli;702961;760;463;3295;2921;374;3449;3093;356;;143;0.02;1740;0.25;703104
9338;Arnhem/Nijmegen (CR);2002 augustus;703104;729;448;3950;3336;614;3505;3169;336;;726;0.1;2466;0.35;703830
9339;Arnhem/Nijmegen (CR);2002 september;703830;740;429;3535;3026;509;3055;2737;318;;791;0.11;3257;0.46;704621
9340;Arnhem/Nijmegen (CR);2002 oktober;704621;782;503;3237;2760;477;2930;2620;310;;586;0.08;3843;0.55;705207
9341;Arnhem/Nijmegen (CR);2002 november;705207;694;543;2742;2452;290;2862;2422;440;;31;0.0;3874;0.55;705238
9342;Arnhem/Nijmegen (CR);2002 december;705238;741;578;2595;2363;232;2682;2288;394;-22.0;54;0.01;3928;0.56;705292
9343;Arnhem/Nijmegen (CR);2002;701364;8671;6145;36176;31290;4886;34752;30725;4027;-22.0;3928;0.56;3928;0.56;705292
9344;Arnhem/Nijmegen (CR);2003 januari;705292;728;602;3169;2828;341;3148;2841;307;;147;0.02;147;0.02;705439
9345;Arnhem/Nijmegen (CR);2003 februari;705439;662;497;2662;2371;291;2475;2210;265;;352;0.05;499;0.07;705791
9346;Arnhem/Nijmegen (CR);2003 maart;705791;706;553;2723;2470;253;2677;2357;320;;199;0.03;698;0.1;705990
9347;Arnhem/Nijmegen (CR);2003 april;705990;709;497;2469;2252;217;2524;2189;335;;157;0.02;855;0.12;706147
9348;Arnhem/Nijmegen (CR);2003 mei;706147;677;495;2434;2211;223;2426;2144;282;;190;0.03;1045;0.15;706337
9349;Arnhem/Nijmegen (CR);2003 juni;706337;658;490;2667;2441;226;2692;2323;369;;143;0.02;1188;0.17;706480
9350;Arnhem/Nijmegen (CR);2003 juli;706480;731;516;3186;2922;264;3340;2852;488;;61;0.01;1249;0.18;706541
9351;Arnhem/Nijmegen (CR);2003 augustus;706541;723;483;3567;3067;500;3232;2900;332;;575;0.08;1824;0.26;707116
9352;Arnhem/Nijmegen (CR);2003 september;707116;730;506;3536;3184;352;3198;2859;339;;562;0.08;2386;0.34;707678
9353;Arnhem/Nijmegen (CR);2003 oktober;707678;710;476;3097;2789;308;3188;2834;354;;143;0.02;2529;0.36;707821
9354;Arnhem/Nijmegen (CR);2003 november;707821;697;508;2669;2447;222;2804;2476;328;;54;0.01;2583;0.37;707875
9355;Arnhem/Nijmegen (CR);2003 december;707875;655;578;2795;2532;263;2893;2572;321;259.0;238;0.03;2821;0.4;708113
9356;Arnhem/Nijmegen (CR);2003;705292;8386;6201;34974;31514;3460;34597;30557;4040;259.0;2821;0.4;2821;0.4;708113
9357;Arnhem/Nijmegen (CR);2004 januari;708113;663;574;2797;2555;242;2734;2404;330;;152;0.02;152;0.02;708265
9358;Arnhem/Nijmegen (CR);2004 februari;708265;617;476;2655;2417;238;2732;2338;394;;64;0.01;216;0.03;708329
9359;Arnhem/Nijmegen (CR);2004 maart;708329;698;542;2840;2607;233;3224;2678;546;;-228;-0.03;-12;0.0;708101
9360;Arnhem/Nijmegen (CR);2004 april;708101;662;472;2497;2301;196;2647;2324;323;;40;0.01;28;0.0;708141
9361;Arnhem/Nijmegen (CR);2004 mei;708141;633;474;2458;2219;239;2452;2199;253;;165;0.02;193;0.03;708306
9362;Arnhem/Nijmegen (CR);2004 juni;708306;711;455;3009;2725;284;3034;2635;399;;231;0.03;424;0.06;708537
9363;Arnhem/Nijmegen (CR);2004 juli;708537;698;480;3278;2927;351;3298;2874;424;;198;0.03;622;0.09;708735
9364;Arnhem/Nijmegen (CR);2004 augustus;708735;723;496;3814;3383;431;3614;3119;495;;427;0.06;1049;0.15;709162
9365;Arnhem/Nijmegen (CR);2004 september;709162;621;456;3770;3319;451;3713;3136;577;;222;0.03;1271;0.18;709384
9366;Arnhem/Nijmegen (CR);2004 oktober;709384;653;506;2993;2687;306;3140;2620;520;;0;0.0;1271;0.18;709384
9367;Arnhem/Nijmegen (CR);2004 november;709384;632;485;2899;2632;267;2853;2449;404;;193;0.03;1464;0.21;709577
9368;Arnhem/Nijmegen (CR);2004 december;709577;675;569;2850;2663;187;3075;2615;460;246.0;127;0.02;1591;0.22;709704
9369;Arnhem/Nijmegen (CR);2004;708113;7986;5985;35860;32435;3425;36516;31391;5125;246.0;1591;0.22;1591;0.22;709704
9370;Arnhem/Nijmegen (CR);2005 januari;692829;637;543;2977;2732;245;2962;2567;395;;109;0.02;109;0.02;692938
9371;Arnhem/Nijmegen (CR);2005 februari;692938;573;542;2541;2267;274;2488;2237;251;;84;0.01;193;0.03;693022
9372;Arnhem/Nijmegen (CR);2005 maart;693022;650;559;2859;2661;198;2940;2606;334;;10;0.0;203;0.03;693032
9373;Arnhem/Nijmegen (CR);2005 april;693032;643;458;2704;2495;209;2722;2431;291;;167;0.02;370;0.05;693199
9374;Arnhem/Nijmegen (CR);2005 mei;693199;661;512;2597;2448;149;2662;2472;190;;84;0.01;454;0.07;693283
9375;Arnhem/Nijmegen (CR);2005 juni;693283;620;456;2698;2470;228;2896;2498;398;;-34;0.0;420;0.06;693249
9376;Arnhem/Nijmegen (CR);2005 juli;693249;644;427;3216;2933;283;3337;2935;402;;96;0.01;516;0.07;693345
9377;Arnhem/Nijmegen (CR);2005 augustus;693345;716;423;4184;3711;473;3787;3430;357;;690;0.1;1206;0.17;694035
9378;Arnhem/Nijmegen (CR);2005 september;694035;649;412;3847;3406;441;3740;3261;479;;344;0.05;1550;0.22;694379
9379;Arnhem/Nijmegen (CR);2005 oktober;694379;655;434;3269;2950;319;3214;2834;380;;276;0.04;1826;0.26;694655
9380;Arnhem/Nijmegen (CR);2005 november;694655;608;446;3074;2841;233;3245;2669;576;;-9;0.0;1817;0.26;694646
9381;Arnhem/Nijmegen (CR);2005 december;694646;570;477;2867;2705;162;3244;2649;595;208.0;-76;-0.01;1741;0.25;694570
9382;Arnhem/Nijmegen (CR);2005;692829;7626;5689;36833;33619;3214;37237;32589;4648;208.0;1741;0.25;1741;0.25;694570
9383;Arnhem/Nijmegen (CR);2006 januari;694570;632;497;3173;2886;287;3156;2730;426;;152;0.02;152;0.02;694722
9384;Arnhem/Nijmegen (CR);2006 februari;694722;584;487;2920;2619;301;3072;2571;501;;-55;-0.01;97;0.01;694667
9385;Arnhem/Nijmegen (CR);2006 maart;694667;640;503;3111;2843;268;3002;2675;327;;246;0.04;343;0.05;694913
9386;Arnhem/Nijmegen (CR);2006 april;694913;566;506;2602;2357;245;2552;2252;300;;110;0.02;453;0.07;695023
9387;Arnhem/Nijmegen (CR);2006 mei;695023;647;446;2694;2472;222;2781;2388;393;;114;0.02;567;0.08;695137
9388;Arnhem/Nijmegen (CR);2006 juni;695137;619;430;2662;2409;253;2856;2454;402;;-5;0.0;562;0.08;695132
9389;Arnhem/Nijmegen (CR);2006 juli;695132;653;561;3416;3087;329;3461;2984;477;;47;0.01;609;0.09;695179
9390;Arnhem/Nijmegen (CR);2006 augustus;695179;671;436;4271;3808;463;3984;3465;519;;522;0.08;1131;0.16;695701
9391;Arnhem/Nijmegen (CR);2006 september;695701;703;451;4086;3429;657;3562;3077;485;;776;0.11;1907;0.27;696477
9392;Arnhem/Nijmegen (CR);2006 oktober;696477;607;423;3394;3021;373;3167;2797;370;;411;0.06;2318;0.33;696888
9393;Arnhem/Nijmegen (CR);2006 november;696888;622;420;3162;2881;281;3138;2766;372;;226;0.03;2544;0.37;697114
9394;Arnhem/Nijmegen (CR);2006 december;697114;638;492;2807;2554;253;2856;2422;434;206.0;303;0.04;2847;0.41;697417
9395;Arnhem/Nijmegen (CR);2006;694570;7582;5652;38298;34366;3932;37587;32581;5006;206.0;2847;0.41;2847;0.41;697417
9396;Arnhem/Nijmegen (CR);2007 januari;697417;594;547;3367;3031;336;3388;2916;472;;26;0.0;26;0.0;697443
9397;Arnhem/Nijmegen (CR);2007 februari;697443;582;493;2817;2449;368;2714;2386;328;;192;0.03;218;0.03;697635
9398;Arnhem/Nijmegen (CR);2007 maart;697635;584;507;2938;2637;301;3015;2629;386;;0;0.0;218;0.03;697635
9399;Arnhem/Nijmegen (CR);2007 april;697635;576;478;2431;2211;220;2548;2191;357;;-19;0.0;199;0.03;697616
9400;Arnhem/Nijmegen (CR);2007 mei;697616;607;465;2672;2400;272;2662;2286;376;;152;0.02;351;0.05;697768
9401;Arnhem/Nijmegen (CR);2007 juni;697768;564;431;2909;2617;292;2948;2550;398;;94;0.01;445;0.06;697862
9402;Arnhem/Nijmegen (CR);2007 juli;697862;620;465;3509;3115;394;3639;3180;459;;25;0.0;470;0.07;697887
9403;Arnhem/Nijmegen (CR);2007 augustus;697887;673;450;4537;3955;582;4151;3699;452;;609;0.09;1079;0.15;698496
9404;Arnhem/Nijmegen (CR);2007 september;698496;631;410;3810;3206;604;3323;2968;355;;708;0.1;1787;0.26;699204
9405;Arnhem/Nijmegen (CR);2007 oktober;699204;635;449;3490;3041;449;3314;2901;413;;362;0.05;2149;0.31;699566
9406;Arnhem/Nijmegen (CR);2007 november;699566;542;486;3175;2849;326;3071;2605;466;;160;0.02;2309;0.33;699726
9407;Arnhem/Nijmegen (CR);2007 december;699726;586;532;2687;2442;245;2720;2343;377;219.0;240;0.03;2549;0.37;699966
9408;Arnhem/Nijmegen (CR);2007;697417;7194;5713;38342;33953;4389;37493;32654;4839;219.0;2549;0.37;2549;0.37;699966
9409;Arnhem/Nijmegen (CR);2008 januari;699966;624;589;3609;3226;383;3463;3023;440;;181;0.03;181;0.03;700147
9410;Arnhem/Nijmegen (CR);2008 februari;700147;595;479;3108;2699;409;2802;2461;341;;422;0.06;603;0.09;700569
9411;Arnhem/Nijmegen (CR);2008 maart;700569;603;510;2926;2564;362;2810;2480;330;;209;0.03;812;0.12;700778
9412;Arnhem/Nijmegen (CR);2008 april;700778;583;499;3069;2722;347;2827;2473;354;;326;0.05;1138;0.16;701104
9413;Arnhem/Nijmegen (CR);2008 mei;701104;654;466;2527;2265;262;2524;2207;317;;191;0.03;1329;0.19;701295
9414;Arnhem/Nijmegen (CR);2008 juni;701295;628;425;2916;2615;301;2997;2578;419;;122;0.02;1451;0.21;701417
9415;Arnhem/Nijmegen (CR);2008 juli;701417;697;440;3722;3302;420;3828;3156;672;;151;0.02;1602;0.23;701568
9416;Arnhem/Nijmegen (CR);2008 augustus;701568;700;411;4122;3628;494;3767;3340;427;;644;0.09;2246;0.32;702212
9417;Arnhem/Nijmegen (CR);2008 september;702212;662;416;4172;3377;795;3627;3190;437;;791;0.11;3037;0.43;703003
9418;Arnhem/Nijmegen (CR);2008 oktober;703003;664;515;3619;3181;438;3339;3037;302;;429;0.06;3466;0.5;703432
9419;Arnhem/Nijmegen (CR);2008 november;703432;569;468;2774;2458;316;2781;2420;361;;94;0.01;3560;0.51;703526
9420;Arnhem/Nijmegen (CR);2008 december;703526;598;502;2972;2674;298;3051;2632;419;249.0;266;0.04;3826;0.55;703792
9421;Arnhem/Nijmegen (CR);2008;699966;7577;5720;39536;34711;4825;37816;32997;4819;249.0;3826;0.55;3826;0.55;703792
9422;Arnhem/Nijmegen (CR);2009 januari;703792;623;597;3093;2721;372;3069;2670;399;;50;0.01;50;0.01;703842
9423;Arnhem/Nijmegen (CR);2009 februari;703842;554;506;2836;2382;454;2738;2353;385;;146;0.02;196;0.03;703988
9424;Arnhem/Nijmegen (CR);2009 maart;703988;616;466;3162;2780;382;2998;2672;326;;314;0.04;510;0.07;704302
9425;Arnhem/Nijmegen (CR);2009 april;704302;626;465;2621;2281;340;2398;2194;204;;384;0.05;894;0.13;704686
9426;Arnhem/Nijmegen (CR);2009 mei;704686;568;445;2450;2186;264;2247;2052;195;;326;0.05;1220;0.17;705012
9427;Arnhem/Nijmegen (CR);2009 juni;705012;648;424;2685;2364;321;2759;2461;298;;150;0.02;1370;0.19;705162
9428;Arnhem/Nijmegen (CR);2009 juli;705162;646;429;3515;3046;469;3449;2927;522;;283;0.04;1653;0.23;705445
9429;Arnhem/Nijmegen (CR);2009 augustus;705445;687;405;3732;3194;538;3467;3023;444;;547;0.08;2200;0.31;705992
9430;Arnhem/Nijmegen (CR);2009 september;705992;665;412;4246;3442;804;3400;3011;389;;1099;0.16;3299;0.47;707091
9431;Arnhem/Nijmegen (CR);2009 oktober;707091;619;459;3252;2795;457;3168;2631;537;;244;0.03;3543;0.5;707335
9432;Arnhem/Nijmegen (CR);2009 november;707335;651;482;2869;2521;348;2939;2420;519;;99;0.01;3642;0.52;707434
9433;Arnhem/Nijmegen (CR);2009 december;707434;614;543;2910;2556;354;2783;2406;377;178.0;376;0.05;4018;0.57;707810
9434;Arnhem/Nijmegen (CR);2009;703792;7517;5633;37371;32268;5103;35415;30820;4595;178.0;4018;0.57;4018;0.57;707810
9435;Arnhem/Nijmegen (CR);2010 januari;707810;618;492;3168;2789;379;2995;2576;419;;299;0.04;299;0.04;708109
9436;Arnhem/Nijmegen (CR);2010 februari;708109;556;475;3027;2582;445;2732;2481;251;;376;0.05;675;0.1;708485
9437;Arnhem/Nijmegen (CR);2010 maart;708485;633;522;2999;2683;316;2898;2583;315;;212;0.03;887;0.13;708697
9438;Arnhem/Nijmegen (CR);2010 april;708697;604;475;2545;2223;322;2647;2238;409;;27;0.0;914;0.13;708724
9439;Arnhem/Nijmegen (CR);2010 mei;708724;617;545;2466;2176;290;2385;2092;293;;153;0.02;1067;0.15;708877
9440;Arnhem/Nijmegen (CR);2010 juni;708877;658;484;2643;2329;314;2734;2337;397;;83;0.01;1150;0.16;708960
9441;Arnhem/Nijmegen (CR);2010 juli;708960;645;469;3348;2852;496;3405;2841;564;;119;0.02;1269;0.18;709079
9442;Arnhem/Nijmegen (CR);2010 augustus;709079;662;478;4120;3452;668;3630;3217;413;;674;0.1;1943;0.27;709753
9443;Arnhem/Nijmegen (CR);2010 september;709753;636;469;4175;3281;894;3381;2932;449;;961;0.14;2904;0.41;710714
9444;Arnhem/Nijmegen (CR);2010 oktober;710714;643;519;3003;2548;455;2774;2415;359;;353;0.05;3257;0.46;711067
9445;Arnhem/Nijmegen (CR);2010 november;711067;633;487;2835;2458;377;2725;2406;319;;256;0.04;3513;0.5;711323
9446;Arnhem/Nijmegen (CR);2010 december;711323;569;517;2849;2515;334;2758;2443;315;-58.0;85;0.01;3598;0.51;711408
9447;Arnhem/Nijmegen (CR);2010;707810;7474;5932;37178;31888;5290;35064;30561;4503;-58.0;3598;0.51;3598;0.51;711408
9448;Arnhem/Nijmegen (CR);2011 januari;711408;606;505;3118;2761;357;2978;2572;406;;241;0.03;241;0.03;711649
9449;Arnhem/Nijmegen (CR);2011 februari;711649;566;467;2904;2471;433;2672;2345;327;;331;0.05;572;0.08;711980
9450;Arnhem/Nijmegen (CR);2011 maart;711980;574;494;2845;2476;369;2752;2351;401;;173;0.02;745;0.1;712153
9451;Arnhem/Nijmegen (CR);2011 april;712153;526;452;2431;2111;320;2570;2113;457;;-65;-0.01;680;0.1;712088
9452;Arnhem/Nijmegen (CR);2011 mei;712088;669;501;2468;2159;309;2498;2133;365;;138;0.02;818;0.11;712226
9453;Arnhem/Nijmegen (CR);2011 juni;712226;622;468;2522;2201;321;2528;2209;319;;148;0.02;966;0.14;712374
9454;Arnhem/Nijmegen (CR);2011 juli;712374;608;497;3048;2622;426;3307;2735;572;;-148;-0.02;818;0.11;712226
9455;Arnhem/Nijmegen (CR);2011 augustus;712226;672;480;4518;3654;864;3909;3484;425;;801;0.11;1619;0.23;713027
9456;Arnhem/Nijmegen (CR);2011 september;713027;601;466;4077;3407;670;3503;3077;426;;709;0.1;2328;0.33;713736
9457;Arnhem/Nijmegen (CR);2011 oktober;713736;657;487;2932;2547;385;2924;2498;426;;178;0.02;2506;0.35;713914
9458;Arnhem/Nijmegen (CR);2011 november;713914;625;494;2877;2585;292;2907;2493;414;;101;0.01;2607;0.37;714015
9459;Arnhem/Nijmegen (CR);2011 december;714015;569;535;2721;2412;309;2728;2343;385;7.0;34;0.0;2641;0.37;714049
9460;Arnhem/Nijmegen (CR);2011;711408;7295;5846;36461;31406;5055;35276;30353;4923;7.0;2641;0.37;2641;0.37;714049
9461;Arnhem/Nijmegen (CR);2012 januari;714049;593;517;3165;2814;351;3132;2653;479;;109;0.02;109;0.02;714158
9462;Arnhem/Nijmegen (CR);2012 februari;714158;540;538;3278;2808;470;2983;2591;392;;297;0.04;406;0.06;714455
9463;Arnhem/Nijmegen (CR);2012 maart;714455;588;544;2868;2493;375;2931;2482;449;;-19;0.0;387;0.05;714436
9464;Arnhem/Nijmegen (CR);2012 april;714436;578;493;2448;2179;269;2367;2062;305;;166;0.02;553;0.08;714602
9465;Arnhem/Nijmegen (CR);2012 mei;714602;612;549;2480;2200;280;2604;2236;368;;-61;-0.01;492;0.07;714541
9466;Arnhem/Nijmegen (CR);2012 juni;714541;571;479;3003;2671;332;3207;2660;547;;-112;-0.02;380;0.05;714429
9467;Arnhem/Nijmegen (CR);2012 juli;714429;610;509;3539;3120;419;3641;3077;564;;-1;0.0;379;0.05;714428
9468;Arnhem/Nijmegen (CR);2012 augustus;714428;663;441;4685;3849;836;4013;3525;488;;894;0.13;1273;0.18;715322
9469;Arnhem/Nijmegen (CR);2012 september;715322;601;512;4039;3255;784;3391;3019;372;;737;0.1;2010;0.28;716059
9470;Arnhem/Nijmegen (CR);2012 oktober;716059;596;525;3517;3093;424;3268;2803;465;;320;0.04;2330;0.33;716379
9471;Arnhem/Nijmegen (CR);2012 november;716379;569;505;2915;2592;323;2730;2331;399;;249;0.03;2579;0.36;716628
9472;Arnhem/Nijmegen (CR);2012 december;716628;520;549;2623;2393;230;2831;2400;431;0.0;-237;-0.03;2342;0.33;716391
9473;Arnhem/Nijmegen (CR);2012;714049;7041;6161;38560;33467;5093;37098;31839;5259;0.0;2342;0.33;2342;0.33;716391
9474;Arnhem/Nijmegen (CR);2013 januari;716391;563;584;3224;2854;370;3336;2883;453;;-133;-0.02;-133;-0.02;716258
9475;Arnhem/Nijmegen (CR);2013 februari;716258;539;532;3061;2624;437;3073;2546;527;;-5;0.0;-138;-0.02;716253
9476;Arnhem/Nijmegen (CR);2013 maart;716253;552;622;2773;2460;313;2804;2413;391;;-101;-0.01;-239;-0.03;716152
9477;Arnhem/Nijmegen (CR);2013 april;716152;568;554;2498;2203;295;2541;2192;349;;-29;0.0;-268;-0.04;716123
9478;Arnhem/Nijmegen (CR);2013 mei;716123;569;482;2658;2342;316;2662;2322;340;;83;0.01;-185;-0.03;716206
9479;Arnhem/Nijmegen (CR);2013 juni;716206;549;452;2606;2288;318;2687;2219;468;;16;0.0;-169;-0.02;716222
9480;Arnhem/Nijmegen (CR);2013 juli;716222;670;494;3631;3184;447;3711;3084;627;;96;0.01;-73;-0.01;716318
9481;Arnhem/Nijmegen (CR);2013 augustus;716318;612;459;4490;3877;613;3956;3528;428;;687;0.1;614;0.09;717005
9482;Arnhem/Nijmegen (CR);2013 september;717005;626;455;4788;3738;1050;3754;3364;390;;1205;0.17;1819;0.25;718210
9483;Arnhem/Nijmegen (CR);2013 oktober;718210;557;513;3364;2869;495;3156;2738;418;;252;0.04;2071;0.29;718462
9484;Arnhem/Nijmegen (CR);2013 november;718462;549;478;3143;2781;362;2816;2489;327;;398;0.06;2469;0.34;718860
9485;Arnhem/Nijmegen (CR);2013 december;718860;564;492;2919;2630;289;3008;2541;467;-1.0;-18;0.0;2451;0.34;718842
9486;Arnhem/Nijmegen (CR);2013;716391;6918;6117;39155;33850;5305;37504;32319;5185;-1.0;2451;0.34;2451;0.34;718842
9487;Arnhem/Nijmegen (CR);2014 januari;718842;568;516;3366;2970;396;3232;2800;432;;186;0.03;186;0.03;719028
9488;Arnhem/Nijmegen (CR);2014 februari;719028;482;483;3253;2778;475;3133;2738;395;;119;0.02;305;0.04;719147
9489;Arnhem/Nijmegen (CR);2014 maart;719147;573;470;3093;2758;335;2897;2577;320;;299;0.04;604;0.08;719446
9490;Arnhem/Nijmegen (CR);2014 april;719446;553;459;2721;2443;278;2671;2271;400;;144;0.02;748;0.1;719590
9491;Arnhem/Nijmegen (CR);2014 mei;719590;613;477;2743;2426;317;2731;2420;311;;148;0.02;896;0.12;719738
9492;Arnhem/Nijmegen (CR);2014 juni;719738;616;494;2905;2561;344;2720;2330;390;;307;0.04;1203;0.17;720045
9493;Arnhem/Nijmegen (CR);2014 juli;720045;648;529;3584;3209;375;3827;3199;628;;-124;-0.02;1079;0.15;719921
9494;Arnhem/Nijmegen (CR);2014 augustus;719921;615;491;4526;3876;650;4070;3579;491;;580;0.08;1659;0.23;720501
9495;Arnhem/Nijmegen (CR);2014 september;720501;638;479;4783;3696;1087;3704;3338;366;;1238;0.17;2897;0.4;721739
9496;Arnhem/Nijmegen (CR);2014 oktober;721739;615;488;3465;2996;469;3292;2846;446;;300;0.04;3197;0.44;722039
9497;Arnhem/Nijmegen (CR);2014 november;722039;557;482;3015;2679;336;2787;2414;373;;303;0.04;3500;0.49;722342
9498;Arnhem/Nijmegen (CR);2014 december;722342;541;547;3376;3038;338;3396;2934;462;-4.0;-30;0.0;3470;0.48;722312
9499;Arnhem/Nijmegen (CR);2014;718842;7019;5915;40830;35430;5400;38460;33446;5014;-4.0;3470;0.48;3470;0.48;722312
9500;Arnhem/Nijmegen (CR);2015 januari;722312;560;627;3377;2971;406;3298;2844;454;;12;0.0;12;0.0;722324
9501;Arnhem/Nijmegen (CR);2015 februari;722324;508;522;3563;3024;539;3237;2799;438;;312;0.04;324;0.04;722636
9502;Arnhem/Nijmegen (CR);2015 maart;722636;572;600;2953;2604;349;3059;2681;378;;-134;-0.02;190;0.03;722502
9503;Arnhem/Nijmegen (CR);2015 april;722502;523;490;3110;2687;423;2829;2475;354;;314;0.04;504;0.07;722816
9504;Arnhem/Nijmegen (CR);2015 mei;722816;597;530;2725;2408;317;2532;2277;255;;260;0.04;764;0.11;723076
9505;Arnhem/Nijmegen (CR);2015 juni;723076;556;477;2915;2533;382;2935;2526;409;;59;0.01;823;0.11;723135
9506;Arnhem/Nijmegen (CR);2015 juli;723135;634;524;4021;3541;480;4207;3555;652;;-76;-0.01;747;0.1;723059
9507;Arnhem/Nijmegen (CR);2015 augustus;723059;643;472;4977;4028;949;4311;3807;504;;837;0.12;1584;0.22;723896
9508;Arnhem/Nijmegen (CR);2015 september;723896;589;476;4632;3423;1209;3754;3285;469;;991;0.14;2575;0.36;724887
9509;Arnhem/Nijmegen (CR);2015 oktober;724887;589;494;3655;3043;612;3344;2924;420;;406;0.06;2981;0.41;725293
9510;Arnhem/Nijmegen (CR);2015 november;725293;581;512;3226;2798;428;2880;2577;303;;415;0.06;3396;0.47;725708
9511;Arnhem/Nijmegen (CR);2015 december;725708;536;496;3554;3157;397;3545;3147;398;2.0;51;0.01;3447;0.48;725759
9512;Arnhem/Nijmegen (CR);2015;722312;6888;6220;42708;36217;6491;39931;34897;5034;2.0;3447;0.48;3447;0.48;725759
9513;Arnhem/Nijmegen (CR);2016 januari;725759;502;582;3792;3305;487;3475;2966;509;;237;0.03;237;0.03;725996
9514;Arnhem/Nijmegen (CR);2016 februari;725996;531;508;4362;3529;833;3750;3331;419;;635;0.09;872;0.12;726631
9515;Arnhem/Nijmegen (CR);2016 maart;726631;562;572;3968;3385;583;3469;3118;351;;489;0.07;1361;0.19;727120
9516;Arnhem/Nijmegen (CR);2016 april;727120;511;562;3544;3025;519;3385;3078;307;;108;0.01;1469;0.2;727228
9517;Arnhem/Nijmegen (CR);2016 mei;727228;536;570;3419;2935;484;3274;2948;326;;111;0.02;1580;0.22;727339
9518;Arnhem/Nijmegen (CR);2016 juni;727339;564;453;3472;2905;567;3535;3026;509;;48;0.01;1628;0.22;727387
9519;Arnhem/Nijmegen (CR);2016 juli;727387;659;495;4461;3848;613;4453;3768;685;;172;0.02;1800;0.25;727559
9520;Arnhem/Nijmegen (CR);2016 augustus;727559;598;446;5848;4470;1378;4839;4301;538;;1161;0.16;2961;0.41;728720
9521;Arnhem/Nijmegen (CR);2016 september;728720;565;487;5249;4018;1231;4238;3840;398;;1089;0.15;4050;0.56;729809
9522;Arnhem/Nijmegen (CR);2016 oktober;729809;571;520;3937;3377;560;3686;3199;487;;302;0.04;4352;0.6;730111
9523;Arnhem/Nijmegen (CR);2016 november;730111;564;485;3790;3315;475;3529;3190;339;;340;0.05;4692;0.65;730451
9524;Arnhem/Nijmegen (CR);2016 december;730451;526;596;3716;3310;406;3643;3200;443;-26.0;-23;0.0;4669;0.64;730428
9525;Arnhem/Nijmegen (CR);2016;725759;6689;6276;49558;41422;8136;45276;39965;5311;-26.0;4669;0.64;4669;0.64;730428
9526;Arnhem/Nijmegen (CR);2017 januari;730428;558;680;4001;3505;496;3927;3347;580;;-48;-0.01;-48;-0.01;730380
9527;Arnhem/Nijmegen (CR);2017 februari;730380;487;609;4164;3403;761;3874;3454;420;;168;0.02;120;0.02;730548
9528;Arnhem/Nijmegen (CR);2017 maart;730548;547;564;4226;3766;460;3552;3266;286;;657;0.09;777;0.11;731205
9529;Arnhem/Nijmegen (CR);2017 april;731205;565;505;3416;3076;340;3129;2845;284;;347;0.05;1124;0.15;731552
9530;Arnhem/Nijmegen (CR);2017 mei;731552;589;516;3659;3240;419;3306;3050;256;;426;0.06;1550;0.21;731978
9531;Arnhem/Nijmegen (CR);2017 juni;731978;607;521;3672;3188;484;3478;3081;397;;280;0.04;1830;0.25;732258
9532;Arnhem/Nijmegen (CR);2017 juli;732258;593;503;4306;3782;524;4380;3720;660;;16;0.0;1846;0.25;732274
9533;Arnhem/Nijmegen (CR);2017 augustus;732274;616;501;5682;4599;1083;4740;4213;527;;1057;0.14;2903;0.4;733331
9534;Arnhem/Nijmegen (CR);2017 september;733331;578;536;5772;4238;1534;4277;3833;444;;1537;0.21;4440;0.61;734868
9535;Arnhem/Nijmegen (CR);2017 oktober;734868;570;516;4107;3378;729;3860;3349;511;;301;0.04;4741;0.65;735169
9536;Arnhem/Nijmegen (CR);2017 november;735169;559;517;3772;3268;504;3663;3251;412;;151;0.02;4892;0.67;735320
9537;Arnhem/Nijmegen (CR);2017 december;735320;562;612;3680;3277;403;3703;3177;526;-44.0;-117;-0.02;4775;0.65;735203
9538;Arnhem/Nijmegen (CR);2017;730428;6831;6580;50457;42720;7737;45889;40586;5303;-44.0;4775;0.65;4775;0.65;735203
9539;Arnhem/Nijmegen (CR);2018 januari;735203;560;660;3803;3322;481;3796;3314;482;;-93;-0.01;-93;-0.01;735110
9540;Arnhem/Nijmegen (CR);2018 februari;735110;467;599;3903;3129;774;3485;2995;490;;286;0.04;193;0.03;735396
9541;Arnhem/Nijmegen (CR);2018 maart;735396;583;730;3767;3301;466;3507;3175;332;;113;0.02;306;0.04;735509
9542;Arnhem/Nijmegen (CR);2018 april;735509;524;540;3285;2881;404;3220;2883;337;;49;0.01;355;0.05;735558
9543;Arnhem/Nijmegen (CR);2018 mei;735558;591;491;3208;2823;385;3239;2904;335;;69;0.01;424;0.06;735627
9544;Arnhem/Nijmegen (CR);2018 juni;735627;590;495;3506;3035;471;3320;2893;427;;281;0.04;705;0.1;735908
9545;Arnhem/Nijmegen (CR);2018 juli;735908;611;529;4112;3491;621;4273;3468;805;;-79;-0.01;626;0.09;735829
9546;Arnhem/Nijmegen (CR);2018 augustus;735829;568;509;5138;4008;1130;4471;3972;499;;726;0.1;1352;0.18;736555
9547;Arnhem/Nijmegen (CR);2018 september;736555;536;461;5138;3513;1625;3737;3290;447;;1476;0.2;2828;0.38;738031
9548;Arnhem/Nijmegen (CR);2018 oktober;738031;581;539;4092;3349;743;3828;3339;489;;306;0.04;3134;0.43;738337
9549;Arnhem/Nijmegen (CR);2018 november;738337;519;526;3569;3052;517;3429;3020;409;;133;0.02;3267;0.44;738470
9550;Arnhem/Nijmegen (CR);2018 december;738470;524;573;3360;2911;449;3351;2946;405;6.0;-34;0.0;3233;0.44;738436
9551;Arnhem/Nijmegen (CR);2018;735203;6654;6652;46881;38815;8066;43656;38199;5457;6.0;3233;0.44;3233;0.44;738436
9552;Arnhem/Nijmegen (CR);2019 januari;738436;534;577;3791;3130;661;3869;3212;657;;-121;-0.02;-121;-0.02;738315
9553;Arnhem/Nijmegen (CR);2019 februari;738315;451;558;3938;2948;990;3294;2872;422;;537;0.07;416;0.06;738852
9554;Arnhem/Nijmegen (CR);2019 maart;738852;519;616;3911;3217;694;3648;3202;446;;166;0.02;582;0.08;739018
9555;Arnhem/Nijmegen (CR);2019 april;739018;537;555;3539;3005;534;3414;3069;345;;107;0.01;689;0.09;739125
9556;Arnhem/Nijmegen (CR);2019 mei;739125;580;564;3441;2820;621;3274;2913;361;;183;0.02;872;0.12;739308
9557;Arnhem/Nijmegen (CR);2019 juni;739308;560;491;3320;2638;682;3244;2766;478;;145;0.02;1017;0.14;739453
9558;Arnhem/Nijmegen (CR);2019 juli;739453;604;557;4598;3695;903;4717;4017;700;;-72;-0.01;945;0.13;739381
9559;Arnhem/Nijmegen (CR);2019 augustus;739381;563;539;5982;4224;1758;4666;4172;494;;1340;0.18;2285;0.31;740721
9560;Arnhem/Nijmegen (CR);2019 september;740721;603;472;4989;3490;1499;3810;3366;444;;1310;0.18;3595;0.49;742031
9561;Arnhem/Nijmegen (CR);2019 oktober;742031;549;516;4078;3179;899;3727;3264;463;;384;0.05;3979;0.54;742415
9562;Arnhem/Nijmegen (CR);2019 november;742415;509;561;3615;3028;587;3401;3019;382;;162;0.02;4141;0.56;742577
9563;Arnhem/Nijmegen (CR);2019 december;742577;542;604;3480;2990;490;3328;2941;387;27.0;117;0.02;4258;0.58;742694
9564;Arnhem/Nijmegen (CR);2019;738436;6551;6610;48682;38364;10318;44392;38813;5579;27.0;4258;0.58;4258;0.58;742694
9565;Arnhem/Nijmegen (CR);2020 januari;742694;524;596;3819;3132;687;3867;3170;697;;-120;-0.02;-120;-0.02;742574
9566;Arnhem/Nijmegen (CR);2020 februari;742574;569;597;4093;3159;934;3658;3268;390;;407;0.05;287;0.04;742981
9567;Arnhem/Nijmegen (CR);2020 maart;742981;534;702;3603;3057;546;3494;3123;371;;-59;-0.01;228;0.03;742922
9568;Arnhem/Nijmegen (CR);2020 april;742922;558;790;3125;2863;262;3037;2817;220;;-144;-0.02;84;0.01;742778
9569;Arnhem/Nijmegen (CR);2020 mei;742778;568;538;3033;2796;237;3041;2810;231;;22;0.0;106;0.01;742800
9570;Arnhem/Nijmegen (CR);2020 juni;742800;575;510;3345;3024;321;3453;3063;390;;-43;-0.01;63;0.01;742757
9571;Arnhem/Nijmegen (CR);2020 juli;742757;611;523;4189;3580;609;4067;3613;454;;210;0.03;273;0.04;742967
9572;Arnhem/Nijmegen (CR);2020 augustus;742967;635;541;5135;3975;1160;4299;3866;433;;930;0.13;1203;0.16;743897
9573;Arnhem/Nijmegen (CR);2020 september;743897;576;516;4558;3445;1113;4057;3550;507;;561;0.08;1764;0.24;744458
9574;Arnhem/Nijmegen (CR);2020 oktober;744458;568;614;4258;3527;731;4051;3657;394;;161;0.02;1925;0.26;744619
9575;Arnhem/Nijmegen (CR);2020 november;744619;518;620;3717;3099;618;3564;3185;379;;51;0.01;1976;0.27;744670
9576;Arnhem/Nijmegen (CR);2020 december;744670;598;718;3766;3152;614;3584;3166;418;-17.0;45;0.01;2021;0.27;744715
9577;Arnhem/Nijmegen (CR);2020;742694;6834;7265;46641;38809;7832;44172;39288;4884;-17.0;2021;0.27;2021;0.27;744715
9578;Arnhem/Nijmegen (CR);2021 januari;744715;519;721;4319;3734;585;4064;3569;495;0.0;53;0.01;53;0.01;744768
9579;Arnhem/Nijmegen (CR);2021 februari;744768;542;577;3719;3146;573;3547;3162;385;0.0;137;0.02;190;0.03;744905
9580;Arnhem/Nijmegen (CR);2021 maart;744905;557;587;4114;3470;644;3766;3464;302;0.0;318;0.04;508;0.07;745223
9581;Arnhem/Nijmegen (CR);2021 april;745223;543;574;3787;3274;513;3538;3258;280;0.0;218;0.03;726;0.1;745441
9582;Arnhem/Nijmegen (CR);2021 mei;745441;572;551;3488;2954;534;3172;2873;299;0.0;337;0.05;1063;0.14;745778
9583;Arnhem/Nijmegen (CR);2021 juni;745778;563;514;3550;2928;622;3417;3052;365;0.0;182;0.02;1245;0.17;745960
9584;Arnhem/Nijmegen (CR);2021 juli;745960;637;545;4178;3427;751;3854;3494;360;0.0;416;0.06;1661;0.22;746376
9585;Arnhem/Nijmegen (CR);2021 augustus;746376;631;556;5003;3545;1458;4033;3599;434;0.0;1045;0.14;2706;0.36;747421
9586;Arnhem/Nijmegen (CR);2021 september;747421;668;539;4624;3151;1473;3459;3107;352;0.0;1294;0.17;4000;0.54;748715
9587;Arnhem/Nijmegen (CR);2021 oktober;748715;633;643;3900;3231;669;3328;2952;376;0.0;562;0.08;4562;0.61;749277
9588;Arnhem/Nijmegen (CR);2021 november;749277;546;711;3664;2989;675;3252;2929;323;0.0;247;0.03;4809;0.65;749524
9589;Arnhem/Nijmegen (CR);2021 december;749524;578;797;3473;2909;564;3558;3143;415;0.0;-304;-0.04;4505;0.6;749220
9590;Arnhem/Nijmegen (CR);2021;744715;6989;7315;47819;38758;9061;42988;38602;4386;0.0;4505;0.6;4505;0.6;749220
9591;Arnhem/Nijmegen (CR);2022 januari;749220;530;566;4055;3308;747;3805;3380;425;;214;0.03;214;0.03;749434
9592;Arnhem/Nijmegen (CR);2022 februari;749434;512;622;3854;2820;1034;3361;3043;318;;383;0.05;597;0.08;749817
9593;Arnhem/Nijmegen (CR);2022 maart;749817;538;685;4847;3225;1622;3671;3239;432;;1029;0.14;1626;0.22;750846
9594;Arnhem/Nijmegen (CR);2022 april;750846;524;667;4350;2899;1451;3319;2982;337;;888;0.12;2514;0.34;751734
9595;Arnhem/Nijmegen (CR);2022 mei;751734;577;575;3854;2818;1036;3552;3009;543;;304;0.04;2818;0.38;752038
9596;Arnhem/Nijmegen (CR);2022 juni;752038;587;564;3760;2838;922;3388;2967;421;;395;0.05;3213;0.43;752433
9597;Arnhem/Nijmegen (CR);2022 juli;752433;571;567;4340;3402;938;4163;3490;673;;181;0.02;3394;0.45;752614
9598;Arnhem/Nijmegen (CR);2022 augustus;752614;628;629;5411;3789;1622;4196;3664;532;;1214;0.16;4608;0.62;753828
9599;Arnhem/Nijmegen (CR);2022 september;753828;617;561;5818;3591;2227;3946;3453;493;;1928;0.26;6536;0.87;755756
9600;Arnhem/Nijmegen (CR);2022 oktober;755756;566;696;4496;3235;1261;3599;3157;442;;767;0.1;7303;0.97;756523
9601;Arnhem/Nijmegen (CR);2022 november;756523;498;569;4050;3034;1016;3645;3139;506;;334;0.04;7637;1.02;756857
9602;Arnhem/Nijmegen (CR);2022 december;756857;520;709;4036;3174;862;3688;3242;446;-21.0;138;0.02;7775;1.04;756995
9603;Arnhem/Nijmegen (CR);2022;749220;6668;7410;52871;38133;14738;44333;38765;5568;-21.0;7775;1.04;7775;1.04;756995
9604;Arnhem/Nijmegen (CR);2023 januari;756995;521;725;4410;3459;951;4046;3460;586;0.0;160;0.02;160;0.02;757155
9605;Arnhem/Nijmegen (CR);2023 februari;757155;469;612;4241;2990;1251;3339;2957;382;0.0;759;0.1;919;0.12;757914
9606;Arnhem/Nijmegen (CR);2023 maart;757914;568;716;4318;3360;958;4025;3550;475;0.0;145;0.02;1064;0.14;758059
9607;Arnhem/Nijmegen (CR);2023 april;758059;500;553;3900;3066;834;3580;3205;375;0.0;267;0.04;1331;0.18;758326
9608;Arnhem/Nijmegen (CR);2023 mei;758326;567;594;4015;2947;1068;3579;3108;471;0.0;409;0.05;1740;0.23;758735
9609;Arnhem/Nijmegen (CR);2023 juni;758735;573;563;4576;3508;1068;3882;3359;523;0.0;704;0.09;2444;0.32;759439
9610;Arnhem/Nijmegen (CR);2023 juli;759439;552;539;5111;3986;1125;4539;3841;698;0.0;585;0.08;3029;0.4;760024
9611;Arnhem/Nijmegen (CR);2023 augustus;760024;660;590;6320;4330;1990;4616;3977;639;0.0;1774;0.23;4803;0.63;761798
9612;Arnhem/Nijmegen (CR);2023 september;761798;549;538;5485;3703;1782;4018;3497;521;0.0;1478;0.19;6281;0.83;763276
9613;Arnhem/Nijmegen (CR);2023 oktober;763276;599;615;4290;3251;1039;3934;3269;665;0.0;340;0.04;6621;0.87;763616
9614;Arnhem/Nijmegen (CR);2023 november;763616;542;622;3985;3101;884;3505;3124;381;0.0;400;0.05;7021;0.93;764016
9615;Arnhem/Nijmegen (CR);2023 december;764016;551;657;3939;3286;653;3710;3171;539;-1.0;122;0.02;7143;0.94;764138
9616;Arnhem/Nijmegen (CR);2023;756995;6651;7324;54590;40987;13603;46773;40518;6255;-1.0;7143;0.94;7143;0.94;764138
9617;Arnhem/Nijmegen (CR);2024 januari;764138;540;705;4462;3495;967;4221;3429;792;;76;0.01;76;0.01;764214
9618;Arnhem/Nijmegen (CR);2024 februari;764214;496;683;4273;3307;966;3581;3074;507;;505;0.07;581;0.08;764719
9619;Arnhem/Nijmegen (CR);2024 maart;764719;531;647;4008;3268;740;3520;3175;345;;372;0.05;953;0.12;765091
9620;Arnhem/Nijmegen (CR);2024 april;765091;516;623;3703;3058;645;3497;3005;492;;99;0.01;1052;0.14;765190
9621;Arnhem/Nijmegen (CR);2024 mei;765190;533;597;3948;3235;713;3338;2924;414;;546;0.07;1598;0.21;765736
9622;Arnhem/Nijmegen (CR);2024 juni;765736;522;551;3777;3075;702;3402;2945;457;;346;0.05;1944;0.25;766082
9623;Arnhem/Nijmegen (CR);2024 juli;766082;584;601;4373;3570;803;4351;3591;760;;5;0.0;1949;0.26;766087
9624;Arnhem/Nijmegen (CR);2024 augustus;766087;659;618;5419;3932;1487;4487;3914;573;;973;0.13;2922;0.38;767060
9625;Arnhem/Nijmegen (CR);2024 september;767060;554;579;5354;3725;1629;3929;3413;516;;1400;0.18;4322;0.57;768460
9626;Arnhem/Nijmegen (CR);2024 oktober;768460;556;653;4395;3490;905;3923;3386;537;;375;0.05;4697;0.61;768835
9627;Arnhem/Nijmegen (CR);2024 november;768835;511;624;4076;3237;839;3849;3249;600;;114;0.01;4811;0.63;768949
9628;Arnhem/Nijmegen (CR);2024 december;768949;501;636;4079;3407;672;3677;3185;492;0.0;267;0.03;5078;0.66;769216
9629;Arnhem/Nijmegen (CR);2024;764138;6503;7517;51867;40799;11068;45775;39290;6485;0.0;5078;0.66;5078;0.66;769216
9630;Arnhem/Nijmegen (CR);2025 januari;769216;567;745;4571;3526;1045;4111;3449;662;;282;0.04;282;0.04;769498
9631;Arnhem/Nijmegen (CR);2025 februari;769498;484;674;4393;3358;1035;3735;3171;564;;468;0.06;750;0.1;769966
9632;Zuidwest-Gelderland (CR);2002 januari;228899;309;182;643;553;90;629;564;65;;141;0.06;141;0.06;229040
9633;Zuidwest-Gelderland (CR);2002 februari;229040;248;163;600;536;64;564;543;21;;121;0.05;262;0.11;229161
9634;Zuidwest-Gelderland (CR);2002 maart;229161;253;149;623;548;75;648;587;61;;79;0.03;341;0.15;229240
9635;Zuidwest-Gelderland (CR);2002 april;229240;253;160;654;587;67;639;592;47;;108;0.05;449;0.2;229348
9636;Zuidwest-Gelderland (CR);2002 mei;229348;266;154;685;630;55;635;588;47;;162;0.07;611;0.27;229510
9637;Zuidwest-Gelderland (CR);2002 juni;229510;237;140;613;546;67;627;569;58;;83;0.04;694;0.3;229593
9638;Zuidwest-Gelderland (CR);2002 juli;229593;291;161;808;721;87;871;787;84;;67;0.03;761;0.33;229660
9639;Zuidwest-Gelderland (CR);2002 augustus;229660;289;152;912;809;103;864;792;72;;185;0.08;946;0.41;229845
9640;Zuidwest-Gelderland (CR);2002 september;229845;296;131;712;638;74;809;750;59;;68;0.03;1014;0.44;229913
9641;Zuidwest-Gelderland (CR);2002 oktober;229913;264;172;723;677;46;806;714;92;;9;0.0;1023;0.45;229922
9642;Zuidwest-Gelderland (CR);2002 november;229922;276;136;721;671;50;758;677;81;;103;0.04;1126;0.49;230025
9643;Zuidwest-Gelderland (CR);2002 december;230025;269;162;705;635;70;688;639;49;61.0;185;0.08;1311;0.57;230210
9644;Zuidwest-Gelderland (CR);2002;228899;3251;1862;8399;7551;848;8538;7802;736;61.0;1311;0.57;1311;0.57;230210
9645;Zuidwest-Gelderland (CR);2003 januari;230210;297;143;797;773;24;783;737;46;;168;0.07;168;0.07;230378
9646;Zuidwest-Gelderland (CR);2003 februari;230378;234;172;543;503;40;585;519;66;;20;0.01;188;0.08;230398
9647;Zuidwest-Gelderland (CR);2003 maart;230398;294;172;518;467;51;606;554;52;;34;0.01;222;0.1;230432
9648;Zuidwest-Gelderland (CR);2003 april;230432;247;161;526;476;50;611;549;62;;1;0.0;223;0.1;230433
9649;Zuidwest-Gelderland (CR);2003 mei;230433;286;148;557;505;52;705;627;78;;-10;0.0;213;0.09;230423
9650;Zuidwest-Gelderland (CR);2003 juni;230423;255;138;694;630;64;722;666;56;;89;0.04;302;0.13;230512
9651;Zuidwest-Gelderland (CR);2003 juli;230512;260;150;803;738;65;820;738;82;;93;0.04;395;0.17;230605
9652;Zuidwest-Gelderland (CR);2003 augustus;230605;289;148;750;691;59;739;682;57;;152;0.07;547;0.24;230757
9653;Zuidwest-Gelderland (CR);2003 september;230757;276;135;709;645;64;794;742;52;;56;0.02;603;0.26;230813
9654;Zuidwest-Gelderland (CR);2003 oktober;230813;305;128;733;669;64;850;791;59;;60;0.03;663;0.29;230873
9655;Zuidwest-Gelderland (CR);2003 november;230873;283;167;606;554;52;633;573;60;;89;0.04;752;0.33;230962
9656;Zuidwest-Gelderland (CR);2003 december;230962;245;175;802;751;51;791;711;80;35.0;116;0.05;868;0.38;231078
9657;Zuidwest-Gelderland (CR);2003;230210;3271;1837;8038;7402;636;8639;7889;750;35.0;868;0.38;868;0.38;231078
9658;Zuidwest-Gelderland (CR);2004 januari;231078;247;163;620;582;38;693;609;84;;11;0.0;11;0.0;231089
9659;Zuidwest-Gelderland (CR);2004 februari;231089;219;153;552;530;22;600;550;50;;18;0.01;29;0.01;231107
9660;Zuidwest-Gelderland (CR);2004 maart;231107;244;163;704;665;39;720;650;70;;65;0.03;94;0.04;231172
9661;Zuidwest-Gelderland (CR);2004 april;231172;223;148;659;632;27;683;643;40;;51;0.02;145;0.06;231223
9662;Zuidwest-Gelderland (CR);2004 mei;231223;256;140;670;624;46;521;483;38;;265;0.11;410;0.18;231488
9663;Zuidwest-Gelderland (CR);2004 juni;231488;221;154;811;754;57;717;673;44;;161;0.07;571;0.25;231649
9664;Zuidwest-Gelderland (CR);2004 juli;231649;257;135;910;856;54;771;724;47;;261;0.11;832;0.36;231910
9665;Zuidwest-Gelderland (CR);2004 augustus;231910;241;164;874;799;75;908;799;109;;43;0.02;875;0.38;231953
9666;Zuidwest-Gelderland (CR);2004 september;231953;261;149;796;727;69;814;736;78;;94;0.04;969;0.42;232047
9667;Zuidwest-Gelderland (CR);2004 oktober;232047;256;143;711;658;53;796;719;77;;28;0.01;997;0.43;232075
9668;Zuidwest-Gelderland (CR);2004 november;232075;264;152;640;605;35;671;627;44;;81;0.03;1078;0.47;232156
9669;Zuidwest-Gelderland (CR);2004 december;232156;228;154;674;619;55;664;610;54;145.0;229;0.1;1307;0.57;232385
9670;Zuidwest-Gelderland (CR);2004;231078;2917;1818;8621;8051;570;8558;7823;735;145.0;1307;0.57;1307;0.57;232385
9671;Zuidwest-Gelderland (CR);2005 januari;232385;242;137;706;664;42;720;653;67;;91;0.04;91;0.04;232476
9672;Zuidwest-Gelderland (CR);2005 februari;232476;236;167;590;557;33;630;560;70;;29;0.01;120;0.05;232505
9673;Zuidwest-Gelderland (CR);2005 maart;232505;243;153;661;628;33;670;593;77;;81;0.03;201;0.09;232586
9674;Zuidwest-Gelderland (CR);2005 april;232586;250;120;559;535;24;619;541;78;;70;0.03;271;0.12;232656
9675;Zuidwest-Gelderland (CR);2005 mei;232656;240;169;609;572;37;619;544;75;;61;0.03;332;0.14;232717
9676;Zuidwest-Gelderland (CR);2005 juni;232717;242;138;769;689;80;784;715;69;;89;0.04;421;0.18;232806
9677;Zuidwest-Gelderland (CR);2005 juli;232806;234;152;894;841;53;840;785;55;;136;0.06;557;0.24;232942
9678;Zuidwest-Gelderland (CR);2005 augustus;232942;262;148;946;870;76;1018;945;73;;42;0.02;599;0.26;232984
9679;Zuidwest-Gelderland (CR);2005 september;232984;278;142;807;749;58;917;841;76;;26;0.01;625;0.27;233010
9680;Zuidwest-Gelderland (CR);2005 oktober;233010;261;148;773;724;49;840;777;63;;46;0.02;671;0.29;233056
9681;Zuidwest-Gelderland (CR);2005 november;233056;224;129;687;643;44;748;682;66;;34;0.01;705;0.3;233090
9682;Zuidwest-Gelderland (CR);2005 december;233090;223;172;686;659;27;773;692;81;22.0;-14;-0.01;691;0.3;233076
9683;Zuidwest-Gelderland (CR);2005;232385;2935;1775;8687;8131;556;9178;8328;850;22.0;691;0.3;691;0.3;233076
9684;Zuidwest-Gelderland (CR);2006 januari;233076;256;163;805;759;46;951;771;180;;-53;-0.02;-53;-0.02;233023
9685;Zuidwest-Gelderland (CR);2006 februari;233023;211;120;627;581;46;719;625;94;;-1;0.0;-54;-0.02;233022
9686;Zuidwest-Gelderland (CR);2006 maart;233022;269;178;735;696;39;891;792;99;;-65;-0.03;-119;-0.05;232957
9687;Zuidwest-Gelderland (CR);2006 april;232957;191;130;588;551;37;628;575;53;;21;0.01;-98;-0.04;232978
9688;Zuidwest-Gelderland (CR);2006 mei;232978;252;132;665;606;59;708;658;50;;77;0.03;-21;-0.01;233055
9689;Zuidwest-Gelderland (CR);2006 juni;233055;226;153;717;680;37;755;683;72;;35;0.02;14;0.01;233090
9690;Zuidwest-Gelderland (CR);2006 juli;233090;230;145;907;842;65;914;817;97;;78;0.03;92;0.04;233168
9691;Zuidwest-Gelderland (CR);2006 augustus;233168;232;137;837;793;44;937;856;81;;-5;0.0;87;0.04;233163
9692;Zuidwest-Gelderland (CR);2006 september;233163;238;121;783;740;43;854;773;81;;46;0.02;133;0.06;233209
9693;Zuidwest-Gelderland (CR);2006 oktober;233209;262;119;679;612;67;787;683;104;;35;0.02;168;0.07;233244
9694;Zuidwest-Gelderland (CR);2006 november;233244;254;152;647;594;53;809;739;70;;-60;-0.03;108;0.05;233184
9695;Zuidwest-Gelderland (CR);2006 december;233184;228;156;596;564;32;696;636;60;89.0;61;0.03;169;0.07;233245
9696;Zuidwest-Gelderland (CR);2006;233076;2849;1706;8586;8018;568;9649;8608;1041;89.0;169;0.07;169;0.07;233245
9697;Zuidwest-Gelderland (CR);2007 januari;233245;230;152;680;638;42;749;698;51;;9;0.0;9;0.0;233254
9698;Zuidwest-Gelderland (CR);2007 februari;233254;227;137;577;532;45;686;631;55;;-19;-0.01;-10;0.0;233235
9699;Zuidwest-Gelderland (CR);2007 maart;233235;243;118;691;631;60;702;658;44;;114;0.05;104;0.04;233349
9700;Zuidwest-Gelderland (CR);2007 april;233349;185;122;589;562;27;649;581;68;;3;0.0;107;0.05;233352
9701;Zuidwest-Gelderland (CR);2007 mei;233352;242;152;662;606;56;693;648;45;;59;0.03;166;0.07;233411
9702;Zuidwest-Gelderland (CR);2007 juni;233411;216;150;756;671;85;794;735;59;;28;0.01;194;0.08;233439
9703;Zuidwest-Gelderland (CR);2007 juli;233439;244;132;890;804;86;982;898;84;;20;0.01;214;0.09;233459
9704;Zuidwest-Gelderland (CR);2007 augustus;233459;238;139;871;795;76;979;880;99;;-9;0.0;205;0.09;233450
9705;Zuidwest-Gelderland (CR);2007 september;233450;258;145;795;725;70;761;726;35;;147;0.06;352;0.15;233597
9706;Zuidwest-Gelderland (CR);2007 oktober;233597;225;160;759;686;73;786;697;89;;38;0.02;390;0.17;233635
9707;Zuidwest-Gelderland (CR);2007 november;233635;221;126;690;620;70;757;689;68;;28;0.01;418;0.18;233663
9708;Zuidwest-Gelderland (CR);2007 december;233663;204;152;728;677;51;708;616;92;34.0;106;0.05;524;0.22;233769
9709;Zuidwest-Gelderland (CR);2007;233245;2733;1685;8688;7947;741;9246;8457;789;34.0;524;0.22;524;0.22;233769
9710;Zuidwest-Gelderland (CR);2008 januari;233769;213;178;753;654;99;851;789;62;;-63;-0.03;-63;-0.03;233706
9711;Zuidwest-Gelderland (CR);2008 februari;233706;197;122;700;603;97;779;706;73;;-4;0.0;-67;-0.03;233702
9712;Zuidwest-Gelderland (CR);2008 maart;233702;204;161;652;554;98;650;613;37;;45;0.02;-22;-0.01;233747
9713;Zuidwest-Gelderland (CR);2008 april;233747;223;127;720;623;97;739;651;88;;77;0.03;55;0.02;233824
9714;Zuidwest-Gelderland (CR);2008 mei;233824;230;157;705;556;149;614;563;51;;164;0.07;219;0.09;233988
9715;Zuidwest-Gelderland (CR);2008 juni;233988;247;145;699;634;65;701;645;56;;100;0.04;319;0.14;234088
9716;Zuidwest-Gelderland (CR);2008 juli;234088;255;152;816;733;83;891;799;92;;28;0.01;347;0.15;234116
9717;Zuidwest-Gelderland (CR);2008 augustus;234116;221;116;906;812;94;991;819;172;;20;0.01;367;0.16;234136
9718;Zuidwest-Gelderland (CR);2008 september;234136;252;123;750;657;93;834;746;88;;45;0.02;412;0.18;234181
9719;Zuidwest-Gelderland (CR);2008 oktober;234181;218;150;706;630;76;803;677;126;;-29;-0.01;383;0.16;234152
9720;Zuidwest-Gelderland (CR);2008 november;234152;209;153;587;519;68;662;584;78;;-19;-0.01;364;0.16;234133
9721;Zuidwest-Gelderland (CR);2008 december;234133;203;162;729;653;76;789;704;85;34.0;15;0.01;379;0.16;234148
9722;Zuidwest-Gelderland (CR);2008;233769;2672;1746;8723;7628;1095;9304;8296;1008;34.0;379;0.16;379;0.16;234148
9723;Zuidwest-Gelderland (CR);2009 januari;234148;217;201;666;603;63;759;688;71;;-77;-0.03;-77;-0.03;234071
9724;Zuidwest-Gelderland (CR);2009 februari;234071;212;152;606;540;66;674;629;45;;-8;0.0;-85;-0.04;234063
9725;Zuidwest-Gelderland (CR);2009 maart;234063;223;143;601;537;64;675;566;109;;6;0.0;-79;-0.03;234069
9726;Zuidwest-Gelderland (CR);2009 april;234069;236;156;601;548;53;617;560;57;;64;0.03;-15;-0.01;234133
9727;Zuidwest-Gelderland (CR);2009 mei;234133;222;142;629;565;64;638;591;47;;71;0.03;56;0.02;234204
9728;Zuidwest-Gelderland (CR);2009 juni;234204;234;139;702;617;85;570;539;31;;227;0.1;283;0.12;234431
9729;Zuidwest-Gelderland (CR);2009 juli;234431;259;135;785;679;106;730;674;56;;179;0.08;462;0.2;234610
9730;Zuidwest-Gelderland (CR);2009 augustus;234610;235;109;726;640;86;827;748;79;;25;0.01;487;0.21;234635
9731;Zuidwest-Gelderland (CR);2009 september;234635;237;112;743;662;81;779;720;59;;89;0.04;576;0.25;234724
9732;Zuidwest-Gelderland (CR);2009 oktober;234724;195;142;635;552;83;715;639;76;;-27;-0.01;549;0.23;234697
9733;Zuidwest-Gelderland (CR);2009 november;234697;216;160;580;531;49;634;573;61;;2;0.0;551;0.24;234699
9734;Zuidwest-Gelderland (CR);2009 december;234699;210;156;620;560;60;639;606;33;35.0;70;0.03;621;0.27;234769
9735;Zuidwest-Gelderland (CR);2009;234148;2696;1747;7894;7034;860;8257;7533;724;35.0;621;0.27;621;0.27;234769
9736;Zuidwest-Gelderland (CR);2010 januari;234769;217;146;681;607;74;739;662;77;;13;0.01;13;0.01;234782
9737;Zuidwest-Gelderland (CR);2010 februari;234782;218;152;576;509;67;636;585;51;;6;0.0;19;0.01;234788
9738;Zuidwest-Gelderland (CR);2010 maart;234788;217;136;645;559;86;644;573;71;;82;0.03;101;0.04;234870
9739;Zuidwest-Gelderland (CR);2010 april;234870;203;144;551;501;50;618;561;57;;-8;0.0;93;0.04;234862
9740;Zuidwest-Gelderland (CR);2010 mei;234862;211;144;597;541;56;528;501;27;;136;0.06;229;0.1;234998
9741;Zuidwest-Gelderland (CR);2010 juni;234998;224;141;612;529;83;650;562;88;;45;0.02;274;0.12;235043
9742;Zuidwest-Gelderland (CR);2010 juli;235043;195;135;703;614;89;756;661;95;;7;0.0;281;0.12;235050
9743;Zuidwest-Gelderland (CR);2010 augustus;235050;239;158;815;697;118;850;775;75;;46;0.02;327;0.14;235096
9744;Zuidwest-Gelderland (CR);2010 september;235096;233;143;697;613;84;765;694;71;;22;0.01;349;0.15;235118
9745;Zuidwest-Gelderland (CR);2010 oktober;235118;215;126;626;562;64;651;577;74;;64;0.03;413;0.18;235182
9746;Zuidwest-Gelderland (CR);2010 november;235182;231;131;647;580;67;712;649;63;;35;0.01;448;0.19;235217
9747;Zuidwest-Gelderland (CR);2010 december;235217;233;176;645;571;74;653;561;92;-9.0;40;0.02;488;0.21;235257
9748;Zuidwest-Gelderland (CR);2010;234769;2636;1732;7795;6883;912;8202;7361;841;-9.0;488;0.21;488;0.21;235257
9749;Zuidwest-Gelderland (CR);2011 januari;235257;192;164;631;578;53;638;579;59;;21;0.01;21;0.01;235278
9750;Zuidwest-Gelderland (CR);2011 februari;235278;235;134;641;568;73;672;611;61;;70;0.03;91;0.04;235348
9751;Zuidwest-Gelderland (CR);2011 maart;235348;210;177;685;618;67;673;616;57;;45;0.02;136;0.06;235393
9752;Zuidwest-Gelderland (CR);2011 april;235393;162;156;571;500;71;589;486;103;;-12;-0.01;124;0.05;235381
9753;Zuidwest-Gelderland (CR);2011 mei;235381;211;147;705;627;78;636;594;42;;133;0.06;257;0.11;235514
9754;Zuidwest-Gelderland (CR);2011 juni;235514;224;132;698;600;98;592;525;67;;198;0.08;455;0.19;235712
9755;Zuidwest-Gelderland (CR);2011 juli;235712;215;137;838;711;127;812;678;134;;104;0.04;559;0.24;235816
9756;Zuidwest-Gelderland (CR);2011 augustus;235816;231;137;840;714;126;832;742;90;;102;0.04;661;0.28;235918
9757;Zuidwest-Gelderland (CR);2011 september;235918;212;140;760;654;106;794;711;83;;38;0.02;699;0.3;235956
9758;Zuidwest-Gelderland (CR);2011 oktober;235956;210;145;590;501;89;719;629;90;;-64;-0.03;635;0.27;235892
9759;Zuidwest-Gelderland (CR);2011 november;235892;216;161;658;567;91;676;600;76;;37;0.02;672;0.29;235929
9760;Zuidwest-Gelderland (CR);2011 december;235929;196;130;653;563;90;636;554;82;-10.0;73;0.03;745;0.32;236002
9761;Zuidwest-Gelderland (CR);2011;235257;2514;1760;8270;7201;1069;8269;7325;944;-10.0;745;0.32;745;0.32;236002
9762;Zuidwest-Gelderland (CR);2012 januari;236002;175;144;736;618;118;703;633;70;;64;0.03;64;0.03;236066
9763;Zuidwest-Gelderland (CR);2012 februari;236066;191;186;641;576;65;660;602;58;;-14;-0.01;50;0.02;236052
9764;Zuidwest-Gelderland (CR);2012 maart;236052;204;177;686;600;86;678;618;60;;35;0.01;85;0.04;236087
9765;Zuidwest-Gelderland (CR);2012 april;236087;196;173;577;526;51;515;479;36;;85;0.04;170;0.07;236172
9766;Zuidwest-Gelderland (CR);2012 mei;236172;181;169;602;530;72;577;520;57;;37;0.02;207;0.09;236209
9767;Zuidwest-Gelderland (CR);2012 juni;236209;192;126;801;718;83;779;700;79;;88;0.04;295;0.12;236297
9768;Zuidwest-Gelderland (CR);2012 juli;236297;215;146;862;756;106;808;729;79;;123;0.05;418;0.18;236420
9769;Zuidwest-Gelderland (CR);2012 augustus;236420;214;125;832;719;113;888;807;81;;33;0.01;451;0.19;236453
9770;Zuidwest-Gelderland (CR);2012 september;236453;174;116;690;547;143;718;670;48;;30;0.01;481;0.2;236483
9771;Zuidwest-Gelderland (CR);2012 oktober;236483;206;141;795;703;92;730;684;46;;130;0.05;611;0.26;236613
9772;Zuidwest-Gelderland (CR);2012 november;236613;188;127;738;637;101;737;662;75;;62;0.03;673;0.29;236675
9773;Zuidwest-Gelderland (CR);2012 december;236675;195;170;634;546;88;649;602;47;3.0;13;0.01;686;0.29;236688
9774;Zuidwest-Gelderland (CR);2012;236002;2331;1800;8594;7476;1118;8442;7706;736;3.0;686;0.29;686;0.29;236688
9775;Zuidwest-Gelderland (CR);2013 januari;236688;206;165;769;679;90;754;687;67;;56;0.02;56;0.02;236744
9776;Zuidwest-Gelderland (CR);2013 februari;236744;182;168;665;580;85;640;581;59;;39;0.02;95;0.04;236783
9777;Zuidwest-Gelderland (CR);2013 maart;236783;214;182;663;600;63;675;618;57;;20;0.01;115;0.05;236803
9778;Zuidwest-Gelderland (CR);2013 april;236803;195;153;583;526;57;638;566;72;;-13;-0.01;102;0.04;236790
9779;Zuidwest-Gelderland (CR);2013 mei;236790;178;149;652;555;97;696;615;81;;-15;-0.01;87;0.04;236775
9780;Zuidwest-Gelderland (CR);2013 juni;236775;180;128;721;597;124;598;554;44;;175;0.07;262;0.11;236950
9781;Zuidwest-Gelderland (CR);2013 juli;236950;234;149;783;657;126;779;687;92;;89;0.04;351;0.15;237039
9782;Zuidwest-Gelderland (CR);2013 augustus;237039;215;136;802;708;94;936;859;77;;-55;-0.02;296;0.13;236984
9783;Zuidwest-Gelderland (CR);2013 september;236984;230;129;754;641;113;792;726;66;;63;0.03;359;0.15;237047
9784;Zuidwest-Gelderland (CR);2013 oktober;237047;216;116;656;556;100;757;656;101;;-1;0.0;358;0.15;237046
9785;Zuidwest-Gelderland (CR);2013 november;237046;200;142;723;609;114;678;614;64;;103;0.04;461;0.19;237149
9786;Zuidwest-Gelderland (CR);2013 december;237149;198;144;630;555;75;754;693;61;-3.0;-73;-0.03;388;0.16;237076
9787;Zuidwest-Gelderland (CR);2013;236688;2448;1761;8401;7263;1138;8697;7856;841;-3.0;388;0.16;388;0.16;237076
9788;Zuidwest-Gelderland (CR);2014 januari;237076;220;150;800;665;135;826;768;58;;44;0.02;44;0.02;237120
9789;Zuidwest-Gelderland (CR);2014 februari;237120;193;128;720;633;87;715;650;65;;70;0.03;114;0.05;237190
9790;Zuidwest-Gelderland (CR);2014 maart;237190;178;147;658;540;118;696;641;55;;-7;0.0;107;0.05;237183
9791;Zuidwest-Gelderland (CR);2014 april;237183;203;144;676;570;106;682;621;61;;53;0.02;160;0.07;237236
9792;Zuidwest-Gelderland (CR);2014 mei;237236;220;149;650;585;65;629;537;92;;92;0.04;252;0.11;237328
9793;Zuidwest-Gelderland (CR);2014 juni;237328;189;167;710;593;117;641;563;78;;91;0.04;343;0.14;237419
9794;Zuidwest-Gelderland (CR);2014 juli;237419;212;145;863;746;117;900;816;84;;30;0.01;373;0.16;237449
9795;Zuidwest-Gelderland (CR);2014 augustus;237449;221;157;849;735;114;866;793;73;;47;0.02;420;0.18;237496
9796;Zuidwest-Gelderland (CR);2014 september;237496;196;153;844;710;134;933;863;70;;-46;-0.02;374;0.16;237450
9797;Zuidwest-Gelderland (CR);2014 oktober;237450;218;146;783;685;98;787;697;90;;68;0.03;442;0.19;237518
9798;Zuidwest-Gelderland (CR);2014 november;237518;181;169;678;599;79;700;621;79;;-10;0.0;432;0.18;237508
9799;Zuidwest-Gelderland (CR);2014 december;237508;215;172;814;742;72;822;736;86;5.0;40;0.02;472;0.2;237548
9800;Zuidwest-Gelderland (CR);2014;237076;2446;1827;9045;7803;1242;9197;8306;891;5.0;472;0.2;472;0.2;237548
9801;Zuidwest-Gelderland (CR);2015 januari;237548;225;198;836;742;94;854;785;69;;9;0.0;9;0.0;237557
9802;Zuidwest-Gelderland (CR);2015 februari;237557;177;196;744;652;92;799;740;59;;-74;-0.03;-65;-0.03;237483
9803;Zuidwest-Gelderland (CR);2015 maart;237483;182;159;847;770;77;787;707;80;;83;0.03;18;0.01;237566
9804;Zuidwest-Gelderland (CR);2015 april;237566;183;141;678;610;68;620;553;67;;100;0.04;118;0.05;237666
9805;Zuidwest-Gelderland (CR);2015 mei;237666;187;161;698;618;80;654;601;53;;70;0.03;188;0.08;237736
9806;Zuidwest-Gelderland (CR);2015 juni;237736;202;139;857;728;129;762;688;74;;158;0.07;346;0.15;237894
9807;Zuidwest-Gelderland (CR);2015 juli;237894;209;149;917;776;141;875;761;114;;102;0.04;448;0.19;237996
9808;Zuidwest-Gelderland (CR);2015 augustus;237996;232;172;894;773;121;979;904;75;;-25;-0.01;423;0.18;237971
9809;Zuidwest-Gelderland (CR);2015 september;237971;236;153;811;694;117;857;773;84;;37;0.02;460;0.19;238008
9810;Zuidwest-Gelderland (CR);2015 oktober;238008;188;156;860;727;133;790;675;115;;102;0.04;562;0.24;238110
9811;Zuidwest-Gelderland (CR);2015 november;238110;158;163;879;766;113;775;699;76;;99;0.04;661;0.28;238209
9812;Zuidwest-Gelderland (CR);2015 december;238209;189;164;878;777;101;814;714;100;7.0;96;0.04;757;0.32;238305
9813;Zuidwest-Gelderland (CR);2015;237548;2368;1951;9899;8633;1266;9566;8600;966;7.0;757;0.32;757;0.32;238305
9814;Zuidwest-Gelderland (CR);2016 januari;238305;183;176;770;679;91;762;717;45;;15;0.01;15;0.01;238320
9815;Zuidwest-Gelderland (CR);2016 februari;238320;181;151;761;673;88;805;732;73;;-14;-0.01;1;0.0;238306
9816;Zuidwest-Gelderland (CR);2016 maart;238306;199;162;771;701;70;774;686;88;;34;0.01;35;0.01;238340
9817;Zuidwest-Gelderland (CR);2016 april;238340;229;168;834;761;73;782;693;89;;113;0.05;148;0.06;238453
9818;Zuidwest-Gelderland (CR);2016 mei;238453;215;161;832;735;97;734;676;58;;152;0.06;300;0.13;238605
9819;Zuidwest-Gelderland (CR);2016 juni;238605;195;144;895;794;101;708;635;73;;238;0.1;538;0.23;238843
9820;Zuidwest-Gelderland (CR);2016 juli;238843;226;134;1097;985;112;924;842;82;;265;0.11;803;0.34;239108
9821;Zuidwest-Gelderland (CR);2016 augustus;239108;203;120;1123;966;157;1025;908;117;;181;0.08;984;0.41;239289
9822;Zuidwest-Gelderland (CR);2016 september;239289;207;143;1040;919;121;940;876;64;;164;0.07;1148;0.48;239453
9823;Zuidwest-Gelderland (CR);2016 oktober;239453;185;153;905;783;122;830;769;61;;107;0.04;1255;0.53;239560
9824;Zuidwest-Gelderland (CR);2016 november;239560;197;162;967;853;114;858;779;79;;144;0.06;1399;0.59;239704
9825;Zuidwest-Gelderland (CR);2016 december;239704;208;173;1151;1058;93;987;924;63;-13.0;186;0.08;1585;0.67;239890
9826;Zuidwest-Gelderland (CR);2016;238305;2428;1847;11146;9907;1239;10129;9237;892;-13.0;1585;0.67;1585;0.67;239890
9827;Zuidwest-Gelderland (CR);2017 januari;239890;205;199;1028;910;118;1022;922;100;;12;0.01;12;0.01;239902
9828;Zuidwest-Gelderland (CR);2017 februari;239902;192;188;966;853;113;851;786;65;;119;0.05;131;0.05;240021
9829;Zuidwest-Gelderland (CR);2017 maart;240021;192;144;927;815;112;870;793;77;;105;0.04;236;0.1;240126
9830;Zuidwest-Gelderland (CR);2017 april;240126;174;160;809;763;46;863;781;82;;-40;-0.02;196;0.08;240086
9831;Zuidwest-Gelderland (CR);2017 mei;240086;204;154;909;786;123;930;862;68;;29;0.01;225;0.09;240115
9832;Zuidwest-Gelderland (CR);2017 juni;240115;204;166;1047;938;109;1018;927;91;;67;0.03;292;0.12;240182
9833;Zuidwest-Gelderland (CR);2017 juli;240182;215;145;1296;1148;148;1087;968;119;;279;0.12;571;0.24;240461
9834;Zuidwest-Gelderland (CR);2017 augustus;240461;228;146;1243;1094;149;1061;954;107;;264;0.11;835;0.35;240725
9835;Zuidwest-Gelderland (CR);2017 september;240725;186;156;1084;976;108;1000;932;68;;114;0.05;949;0.4;240839
9836;Zuidwest-Gelderland (CR);2017 oktober;240839;195;144;1014;902;112;928;839;89;;137;0.06;1086;0.45;240976
9837;Zuidwest-Gelderland (CR);2017 november;240976;232;159;946;845;101;857;793;64;;162;0.07;1248;0.52;241138
9838;Zuidwest-Gelderland (CR);2017 december;241138;212;208;995;900;95;890;805;85;-3.0;106;0.04;1354;0.56;241244
9839;Zuidwest-Gelderland (CR);2017;239890;2439;1969;12264;10930;1334;11377;10362;1015;-3.0;1354;0.56;1354;0.56;241244
9840;Zuidwest-Gelderland (CR);2018 januari;241244;205;214;1000;843;157;825;750;75;;166;0.07;166;0.07;241410
9841;Zuidwest-Gelderland (CR);2018 februari;241410;187;171;1033;821;212;814;749;65;;235;0.1;401;0.17;241645
9842;Zuidwest-Gelderland (CR);2018 maart;241645;202;229;1036;854;182;907;812;95;;102;0.04;503;0.21;241747
9843;Zuidwest-Gelderland (CR);2018 april;241747;197;162;1077;840;237;834;772;62;;278;0.11;781;0.32;242025
9844;Zuidwest-Gelderland (CR);2018 mei;242025;210;150;1171;836;335;919;854;65;;312;0.13;1093;0.45;242337
9845;Zuidwest-Gelderland (CR);2018 juni;242337;209;153;1053;856;197;919;843;76;;190;0.08;1283;0.53;242527
9846;Zuidwest-Gelderland (CR);2018 juli;242527;212;156;1275;1077;198;948;858;90;;383;0.16;1666;0.69;242910
9847;Zuidwest-Gelderland (CR);2018 augustus;242910;216;145;1235;1028;207;1162;1023;139;;144;0.06;1810;0.75;243054
9848;Zuidwest-Gelderland (CR);2018 september;243054;197;136;985;810;175;876;791;85;;170;0.07;1980;0.82;243224
9849;Zuidwest-Gelderland (CR);2018 oktober;243224;200;167;1157;912;245;968;860;108;;222;0.09;2202;0.91;243446
9850;Zuidwest-Gelderland (CR);2018 november;243446;191;148;1053;820;233;886;785;101;;210;0.09;2412;1.0;243656
9851;Zuidwest-Gelderland (CR);2018 december;243656;219;163;1229;835;394;897;794;103;8.0;396;0.16;2808;1.16;244052
9852;Zuidwest-Gelderland (CR);2018;241244;2445;1994;13304;10532;2772;10955;9891;1064;8.0;2808;1.16;2808;1.16;244052
9853;Zuidwest-Gelderland (CR);2019 januari;244052;200;184;1091;903;188;927;805;122;;180;0.07;180;0.07;244232
9854;Zuidwest-Gelderland (CR);2019 februari;244232;182;160;1023;789;234;836;736;100;;209;0.09;389;0.16;244441
9855;Zuidwest-Gelderland (CR);2019 maart;244441;190;162;1000;821;179;810;715;95;;218;0.09;607;0.25;244659
9856;Zuidwest-Gelderland (CR);2019 april;244659;187;172;965;766;199;850;757;93;;130;0.05;737;0.3;244789
9857;Zuidwest-Gelderland (CR);2019 mei;244789;222;172;1026;823;203;920;795;125;;156;0.06;893;0.37;244945
9858;Zuidwest-Gelderland (CR);2019 juni;244945;197;154;943;724;219;783;655;128;;203;0.08;1096;0.45;245148
9859;Zuidwest-Gelderland (CR);2019 juli;245148;232;145;1353;1096;257;1068;900;168;;372;0.15;1468;0.6;245520
9860;Zuidwest-Gelderland (CR);2019 augustus;245520;205;155;1161;924;237;1124;1023;101;;87;0.04;1555;0.64;245607
9861;Zuidwest-Gelderland (CR);2019 september;245607;214;149;1004;828;176;929;770;159;;140;0.06;1695;0.69;245747
9862;Zuidwest-Gelderland (CR);2019 oktober;245747;218;167;1165;931;234;940;813;127;;276;0.11;1971;0.81;246023
9863;Zuidwest-Gelderland (CR);2019 november;246023;187;184;1220;860;360;955;771;184;;268;0.11;2239;0.92;246291
9864;Zuidwest-Gelderland (CR);2019 december;246291;196;163;1189;959;230;934;790;144;-14.0;274;0.11;2513;1.03;246565
9865;Zuidwest-Gelderland (CR);2019;244052;2430;1967;13140;10424;2716;11076;9530;1546;-14.0;2513;1.03;2513;1.03;246565
9866;Zuidwest-Gelderland (CR);2020 januari;246565;245;179;1191;923;268;1025;834;191;;232;0.09;232;0.09;246797
9867;Zuidwest-Gelderland (CR);2020 februari;246797;189;181;1140;823;317;965;799;166;;183;0.07;415;0.17;246980
9868;Zuidwest-Gelderland (CR);2020 maart;246980;187;214;1090;866;224;1033;811;222;;30;0.01;445;0.18;247010
9869;Zuidwest-Gelderland (CR);2020 april;247010;192;275;1035;827;208;908;770;138;;44;0.02;489;0.2;247054
9870;Zuidwest-Gelderland (CR);2020 mei;247054;201;188;977;782;195;839;742;97;;151;0.06;640;0.26;247205
9871;Zuidwest-Gelderland (CR);2020 juni;247205;202;138;1113;840;273;861;694;167;;316;0.13;956;0.39;247521
9872;Zuidwest-Gelderland (CR);2020 juli;247521;248;158;1495;1118;377;1186;934;252;;399;0.16;1355;0.55;247920
9873;Zuidwest-Gelderland (CR);2020 augustus;247920;219;165;1243;1001;242;1142;921;221;;155;0.06;1510;0.61;248075
9874;Zuidwest-Gelderland (CR);2020 september;248075;224;155;1276;1015;261;1060;949;111;;285;0.11;1795;0.73;248360
9875;Zuidwest-Gelderland (CR);2020 oktober;248360;230;211;1327;1057;270;1278;962;316;;68;0.03;1863;0.76;248428
9876;Zuidwest-Gelderland (CR);2020 november;248428;219;223;1100;885;215;898;739;159;;198;0.08;2061;0.84;248626
9877;Zuidwest-Gelderland (CR);2020 december;248626;186;240;1168;929;239;1059;855;204;-7.0;48;0.02;2109;0.86;248674
9878;Zuidwest-Gelderland (CR);2020;246565;2542;2327;14155;11066;3089;12254;10010;2244;-7.0;2109;0.86;2109;0.86;248674
9879;Zuidwest-Gelderland (CR);2021 januari;248674;215;251;1125;922;203;1079;879;200;0.0;10;0.0;10;0.0;248684
9880;Zuidwest-Gelderland (CR);2021 februari;248684;213;222;1127;863;264;952;777;175;0.0;166;0.07;176;0.07;248850
9881;Zuidwest-Gelderland (CR);2021 maart;248850;237;199;1260;1036;224;1124;923;201;0.0;174;0.07;350;0.14;249024
9882;Zuidwest-Gelderland (CR);2021 april;249024;221;185;1152;912;240;994;820;174;0.0;194;0.08;544;0.22;249218
9883;Zuidwest-Gelderland (CR);2021 mei;249218;232;181;971;803;168;823;709;114;0.0;199;0.08;743;0.3;249417
9884;Zuidwest-Gelderland (CR);2021 juni;249417;238;184;1160;916;244;945;798;147;0.0;269;0.11;1012;0.41;249686
9885;Zuidwest-Gelderland (CR);2021 juli;249686;235;167;1392;1095;297;1088;889;199;0.0;372;0.15;1384;0.56;250058
9886;Zuidwest-Gelderland (CR);2021 augustus;250058;243;150;1198;947;251;1089;893;196;0.0;202;0.08;1586;0.64;250260
9887;Zuidwest-Gelderland (CR);2021 september;250260;256;168;1229;897;332;978;838;140;0.0;339;0.14;1925;0.77;250599
9888;Zuidwest-Gelderland (CR);2021 oktober;250599;255;212;1110;872;238;1012;791;221;0.0;141;0.06;2066;0.83;250740
9889;Zuidwest-Gelderland (CR);2021 november;250740;235;235;1133;828;305;913;726;187;0.0;220;0.09;2286;0.92;250960
9890;Zuidwest-Gelderland (CR);2021 december;250960;192;212;1093;873;220;1066;796;270;1.0;8;0.0;2294;0.92;250968
9891;Zuidwest-Gelderland (CR);2021;248674;2772;2366;13950;10964;2986;12063;9839;2224;1.0;2294;0.92;2294;0.92;250968
9892;Zuidwest-Gelderland (CR);2022 januari;250968;193;190;1142;831;311;1011;844;167;;134;0.05;134;0.05;251102
9893;Zuidwest-Gelderland (CR);2022 februari;251102;202;178;1053;748;305;983;792;191;;94;0.04;228;0.09;251196
9894;Zuidwest-Gelderland (CR);2022 maart;251196;225;188;1386;790;596;1072;770;302;;351;0.14;579;0.23;251547
9895;Zuidwest-Gelderland (CR);2022 april;251547;174;177;1757;875;882;979;769;210;;775;0.31;1354;0.54;252322
9896;Zuidwest-Gelderland (CR);2022 mei;252322;221;179;1470;914;556;1003;727;276;;509;0.2;1863;0.74;252831
9897;Zuidwest-Gelderland (CR);2022 juni;252831;218;164;1314;795;519;1008;737;271;;360;0.14;2223;0.89;253191
9898;Zuidwest-Gelderland (CR);2022 juli;253191;237;175;1308;963;345;1151;852;299;;219;0.09;2442;0.97;253410
9899;Zuidwest-Gelderland (CR);2022 augustus;253410;221;179;1475;969;506;1197;893;304;;320;0.13;2762;1.1;253730
9900;Zuidwest-Gelderland (CR);2022 september;253730;205;193;1392;938;454;1133;839;294;;271;0.11;3033;1.21;254001
9901;Zuidwest-Gelderland (CR);2022 oktober;254001;216;200;1370;1003;367;1011;797;214;;375;0.15;3408;1.36;254376
9902;Zuidwest-Gelderland (CR);2022 november;254376;207;225;1271;898;373;1072;789;283;;181;0.07;3589;1.43;254557
9903;Zuidwest-Gelderland (CR);2022 december;254557;209;226;1165;954;211;1036;845;191;-9.0;103;0.04;3692;1.47;254660
9904;Zuidwest-Gelderland (CR);2022;250968;2528;2274;16103;10678;5425;12656;9654;3002;-9.0;3692;1.47;3692;1.47;254660
9905;Zuidwest-Gelderland (CR);2023 januari;254660;224;213;1159;878;281;1069;874;195;0.0;101;0.04;101;0.04;254761
9906;Zuidwest-Gelderland (CR);2023 februari;254761;217;171;1082;789;293;1026;765;261;0.0;102;0.04;203;0.08;254863
9907;Zuidwest-Gelderland (CR);2023 maart;254863;214;196;1271;885;386;1190;905;285;0.0;99;0.04;302;0.12;254962
9908;Zuidwest-Gelderland (CR);2023 april;254962;207;178;1038;759;279;918;686;232;0.0;149;0.06;451;0.18;255111
9909;Zuidwest-Gelderland (CR);2023 mei;255111;204;173;1117;760;357;945;735;210;0.0;203;0.08;654;0.26;255314
9910;Zuidwest-Gelderland (CR);2023 juni;255314;193;169;1255;881;374;1194;971;223;0.0;85;0.03;739;0.29;255399
9911;Zuidwest-Gelderland (CR);2023 juli;255399;225;152;1296;948;348;1312;972;340;0.0;57;0.02;796;0.31;255456
9912;Zuidwest-Gelderland (CR);2023 augustus;255456;247;176;1351;1039;312;1539;1010;529;0.0;-117;-0.05;679;0.27;255339
9913;Zuidwest-Gelderland (CR);2023 september;255339;201;166;1160;904;256;1097;843;254;0.0;98;0.04;777;0.31;255437
9914;Zuidwest-Gelderland (CR);2023 oktober;255437;204;160;1150;861;289;1116;845;271;0.0;78;0.03;855;0.34;255515
9915;Zuidwest-Gelderland (CR);2023 november;255515;210;208;1058;868;190;977;789;188;0.0;83;0.03;938;0.37;255598
9916;Zuidwest-Gelderland (CR);2023 december;255598;205;197;1119;934;185;1062;834;228;-8.0;57;0.02;995;0.39;255655
9917;Zuidwest-Gelderland (CR);2023;254660;2551;2159;14056;10506;3550;13445;10229;3216;-8.0;995;0.39;995;0.39;255655
9918;Zuidwest-Gelderland (CR);2024 januari;255655;193;214;1173;939;234;1013;818;195;;139;0.05;139;0.05;255794
9919;Zuidwest-Gelderland (CR);2024 februari;255794;194;198;1152;878;274;924;737;187;;224;0.09;363;0.14;256018
9920;Zuidwest-Gelderland (CR);2024 maart;256018;214;195;1090;824;266;941;763;178;;168;0.07;531;0.21;256186
9921;Zuidwest-Gelderland (CR);2024 april;256186;198;199;1093;770;323;969;774;195;;123;0.05;654;0.26;256309
9922;Zuidwest-Gelderland (CR);2024 mei;256309;209;191;1128;840;288;926;706;220;;220;0.09;874;0.34;256529
9923;Zuidwest-Gelderland (CR);2024 juni;256529;226;177;1031;803;228;1112;760;352;;-32;-0.01;842;0.33;256497
9924;Zuidwest-Gelderland (CR);2024 juli;256497;231;187;1290;1012;278;1121;843;278;;213;0.08;1055;0.41;256710
9925;Zuidwest-Gelderland (CR);2024 augustus;256710;248;164;1133;898;235;1123;892;231;;94;0.04;1149;0.45;256804
9926;Zuidwest-Gelderland (CR);2024 september;256804;242;164;1052;842;210;974;767;207;;156;0.06;1305;0.51;256960
9927;Zuidwest-Gelderland (CR);2024 oktober;256960;220;209;1148;867;281;1170;852;318;;-11;0.0;1294;0.51;256949
9928;Zuidwest-Gelderland (CR);2024 november;256949;203;185;1027;775;252;901;719;182;;144;0.06;1438;0.56;257093
9929;Zuidwest-Gelderland (CR);2024 december;257093;245;190;1105;883;222;1046;799;247;0.0;114;0.04;1552;0.61;257207
9930;Zuidwest-Gelderland (CR);2024;255655;2623;2273;13422;10331;3091;12220;9430;2790;0.0;1552;0.61;1552;0.61;257207
9931;Zuidwest-Gelderland (CR);2025 januari;257207;226;228;1104;899;205;1086;868;218;;16;0.01;16;0.01;257223
9932;Zuidwest-Gelderland (CR);2025 februari;257223;210;201;1039;766;273;969;728;241;;79;0.03;95;0.04;257302
9933;Utrecht (CR);2002 januari;1139925;1304;878;5534;4801;733;4996;4483;513;;964;0.08;964;0.08;1140889
9934;Utrecht (CR);2002 februari;1140889;1186;753;4557;4025;532;4257;3848;409;;733;0.06;1697;0.15;1141622
9935;Utrecht (CR);2002 maart;1141622;1324;861;4935;4396;539;4567;4122;445;;831;0.07;2528;0.22;1142453
9936;Utrecht (CR);2002 april;1142453;1293;797;4612;4028;584;4172;3714;458;;936;0.08;3464;0.3;1143389
9937;Utrecht (CR);2002 mei;1143389;1359;749;4789;4313;476;4366;4035;331;;1033;0.09;4497;0.39;1144422
9938;Utrecht (CR);2002 juni;1144422;1275;689;4413;3895;518;4287;3787;500;;712;0.06;5209;0.46;1145134
9939;Utrecht (CR);2002 juli;1145134;1440;730;5811;5235;576;5641;4861;780;;880;0.08;6089;0.53;1146014
9940;Utrecht (CR);2002 augustus;1146014;1402;703;6396;5569;827;5519;5041;478;;1576;0.14;7665;0.67;1147590
9941;Utrecht (CR);2002 september;1147590;1415;644;6474;5359;1115;5154;4529;625;;2091;0.18;9756;0.86;1149681
9942;Utrecht (CR);2002 oktober;1149681;1465;724;5391;4886;505;4995;4435;560;;1137;0.1;10893;0.96;1150818
9943;Utrecht (CR);2002 november;1150818;1302;712;4918;4478;440;4696;4191;505;;812;0.07;11705;1.03;1151630
9944;Utrecht (CR);2002 december;1151630;1336;815;4625;4188;437;4609;4059;550;51.0;588;0.05;12293;1.08;1152218
9945;Utrecht (CR);2002;1139925;16101;9055;62455;55173;7282;57259;51105;6154;51.0;12293;1.08;12293;1.08;1152218
9946;Utrecht (CR);2003 januari;1152218;1362;771;5189;4649;540;5073;4550;523;;707;0.06;707;0.06;1152925
9947;Utrecht (CR);2003 februari;1152925;1266;740;4251;3737;514;4015;3563;452;;762;0.07;1469;0.13;1153687
9948;Utrecht (CR);2003 maart;1153687;1314;798;4445;3978;467;4160;3615;545;;801;0.07;2270;0.2;1154488
9949;Utrecht (CR);2003 april;1154488;1341;768;4285;3877;408;4080;3530;550;;778;0.07;3048;0.26;1155266
9950;Utrecht (CR);2003 mei;1155266;1397;798;4191;3804;387;3911;3591;320;;879;0.08;3927;0.34;1156145
9951;Utrecht (CR);2003 juni;1156145;1288;687;4317;3843;474;4265;3838;427;;653;0.06;4580;0.4;1156798
9952;Utrecht (CR);2003 juli;1156798;1446;739;5317;4751;566;5389;4776;613;;635;0.05;5215;0.45;1157433
9953;Utrecht (CR);2003 augustus;1157433;1406;773;5690;4988;702;5241;4614;627;;1082;0.09;6297;0.55;1158515
9954;Utrecht (CR);2003 september;1158515;1374;728;6210;5223;987;5393;4626;767;;1463;0.13;7760;0.67;1159978
9955;Utrecht (CR);2003 oktober;1159978;1430;715;5213;4691;522;5231;4491;740;;697;0.06;8457;0.73;1160675
9956;Utrecht (CR);2003 november;1160675;1333;758;4307;3954;353;4468;3903;565;;414;0.04;8871;0.77;1161089
9957;Utrecht (CR);2003 december;1161089;1265;840;4742;4335;407;4639;4251;388;641.0;1169;0.1;10040;0.87;1162258
9958;Utrecht (CR);2003;1152218;16222;9115;58157;51830;6327;55865;49348;6517;641.0;10040;0.87;10040;0.87;1162258
9959;Utrecht (CR);2004 januari;1162258;1290;888;4640;4221;419;4665;4199;466;;377;0.03;377;0.03;1162635
9960;Utrecht (CR);2004 februari;1162635;1273;696;4514;4044;470;4222;3666;556;;869;0.07;1246;0.11;1163504
9961;Utrecht (CR);2004 maart;1163504;1278;743;4938;4525;413;5019;4253;766;;454;0.04;1700;0.15;1163958
9962;Utrecht (CR);2004 april;1163958;1287;709;4360;4060;300;4480;3931;549;;458;0.04;2158;0.19;1164416
9963;Utrecht (CR);2004 mei;1164416;1256;743;4141;3793;348;4055;3613;442;;599;0.05;2757;0.24;1165015
9964;Utrecht (CR);2004 juni;1165015;1383;740;4852;4384;468;4934;4245;689;;561;0.05;3318;0.29;1165576
9965;Utrecht (CR);2004 juli;1165576;1488;756;5605;5148;457;6006;5204;802;;331;0.03;3649;0.31;1165907
9966;Utrecht (CR);2004 augustus;1165907;1334;728;6322;5715;607;5748;5095;653;;1180;0.1;4829;0.42;1167087
9967;Utrecht (CR);2004 september;1167087;1370;710;6863;5814;1049;5593;4977;616;;1930;0.17;6759;0.58;1169017
9968;Utrecht (CR);2004 oktober;1169017;1338;689;5024;4563;461;4815;4223;592;;858;0.07;7617;0.66;1169875
9969;Utrecht (CR);2004 november;1169875;1224;697;4863;4436;427;4651;4181;470;;739;0.06;8356;0.72;1170614
9970;Utrecht (CR);2004 december;1170614;1250;776;4840;4423;417;5065;4410;655;428.0;677;0.06;9033;0.78;1171291
9971;Utrecht (CR);2004;1162258;15771;8875;60962;55126;5836;59253;51997;7256;428.0;9033;0.78;9033;0.78;1171291
9972;Utrecht (CR);2005 januari;1171291;1304;806;4847;4442;405;4691;4174;517;;654;0.06;654;0.06;1171945
9973;Utrecht (CR);2005 februari;1171945;1173;744;4668;4112;556;4479;4015;464;;618;0.05;1272;0.11;1172563
9974;Utrecht (CR);2005 maart;1172563;1278;847;4661;4262;399;4922;4272;650;;170;0.01;1442;0.12;1172733
9975;Utrecht (CR);2005 april;1172733;1321;735;4687;4291;396;4548;4123;425;;725;0.06;2167;0.19;1173458
9976;Utrecht (CR);2005 mei;1173458;1313;725;4154;3824;330;4075;3672;403;;667;0.06;2834;0.24;1174125
9977;Utrecht (CR);2005 juni;1174125;1322;744;4792;4464;328;5098;4366;732;;272;0.02;3106;0.27;1174397
9978;Utrecht (CR);2005 juli;1174397;1261;652;5738;5261;477;5945;5123;822;;402;0.03;3508;0.3;1174799
9979;Utrecht (CR);2005 augustus;1174799;1309;650;6749;6098;651;6359;5455;904;;1049;0.09;4557;0.39;1175848
9980;Utrecht (CR);2005 september;1175848;1359;638;7255;6183;1072;6161;5267;894;;1815;0.15;6372;0.54;1177663
9981;Utrecht (CR);2005 oktober;1177663;1376;686;5725;5257;468;5527;4858;669;;888;0.08;7260;0.62;1178551
9982;Utrecht (CR);2005 november;1178551;1158;684;5325;4915;410;5062;4448;614;;737;0.06;7997;0.68;1179288
9983;Utrecht (CR);2005 december;1179288;1221;740;5071;4732;339;5268;4616;652;467.0;751;0.06;8748;0.75;1180039
9984;Utrecht (CR);2005;1171291;15395;8651;63672;57841;5831;62135;54389;7746;467.0;8748;0.75;8748;0.75;1180039
9985;Utrecht (CR);2006 januari;1180039;1252;767;5705;5150;555;5599;4921;678;;591;0.05;591;0.05;1180630
9986;Utrecht (CR);2006 februari;1180630;1202;753;5235;4668;567;5086;4447;639;;598;0.05;1189;0.1;1181228
9987;Utrecht (CR);2006 maart;1181228;1300;778;5569;5107;462;5531;4758;773;;560;0.05;1749;0.15;1181788
9988;Utrecht (CR);2006 april;1181788;1271;766;4585;4141;444;4322;3718;604;;768;0.06;2517;0.21;1182556
9989;Utrecht (CR);2006 mei;1182556;1337;717;4924;4379;545;4796;4277;519;;748;0.06;3265;0.28;1183304
9990;Utrecht (CR);2006 juni;1183304;1250;656;5002;4581;421;4933;4363;570;;663;0.06;3928;0.33;1183967
9991;Utrecht (CR);2006 juli;1183967;1315;746;5700;5170;530;5928;5180;748;;341;0.03;4269;0.36;1184308
9992;Utrecht (CR);2006 augustus;1184308;1380;647;7266;6454;812;6469;5681;788;;1530;0.13;5799;0.49;1185838
9993;Utrecht (CR);2006 september;1185838;1304;727;7279;6040;1239;5841;5058;783;;2015;0.17;7814;0.66;1187853
9994;Utrecht (CR);2006 oktober;1187853;1368;677;5805;5246;559;5413;4762;651;;1083;0.09;8897;0.75;1188936
9995;Utrecht (CR);2006 november;1188936;1206;706;5911;5504;407;5467;4910;557;;944;0.08;9841;0.83;1189880
9996;Utrecht (CR);2006 december;1189880;1238;773;4800;4438;362;4887;4334;553;346.0;724;0.06;10565;0.9;1190604
9997;Utrecht (CR);2006;1180039;15423;8713;67781;60878;6903;64272;56409;7863;346.0;10565;0.9;10565;0.9;1190604
9998;Utrecht (CR);2007 januari;1190604;1297;754;5777;5204;573;5425;4836;589;;895;0.08;895;0.08;1191499
9999;Utrecht (CR);2007 februari;1191499;1170;647;5223;4554;669;4819;4211;608;;927;0.08;1822;0.15;1192426
