ID;LandenGroepen;Perioden;Invoerwaarde_1;Uitvoerwaarde_2;Handelsbalans_3
0;1;1996 januari;903503;1099603;196100
1;1;1996 februari;811466;1061134;249668
2;1;1996 maart;867150;1165039;297889
3;1;1996 april;964179;980238;16059
4;1;1996 mei;921470;933001;11531
5;1;1996 juni;818394;871592;53198
6;1;1996 juli;946131;917465;-28666
7;1;1996 augustus;956910;829509;-127401
8;1;1996 september;961854;993086;31232
9;1;1996 oktober;1183195;1043720;-139475
10;1;1996 november;1243199;1163253;-79946
11;1;1996 december;1244352;1443278;198926
12;1;1996;11821803;12500918;679115
13;1;1997 januari;1263841;1483250;219409
14;1;1997 februari;1126235;1125072;-1163
15;1;1997 maart;1040007;1118335;78328
16;1;1997 april;1110823;1093773;-17050
17;1;1997 mei;1066906;1049745;-17161
18;1;1997 juni;1027141;977179;-49962
19;1;1997 juli;1162268;999311;-162957
20;1;1997 augustus;1229566;1029595;-199971
21;1;1997 september;1030813;997239;-33574
22;1;1997 oktober;1137364;1106574;-30790
23;1;1997 november;1035745;1165709;129964
24;1;1997 december;950523;1201012;250489
25;1;1997;13181232;13346794;165562
26;1;1998 januari;1008858;1176331;167473
27;1;1998 februari;923306;987442;64136
28;1;1998 maart;934228;1101516;167288
29;1;1998 april;919551;959304;39753
30;1;1998 mei;860100;834851;-25249
31;1;1998 juni;811871;801711;-10160
32;1;1998 juli;831350;845805;14455
33;1;1998 augustus;845891;793236;-52655
34;1;1998 september;836796;787705;-49091
35;1;1998 oktober;795463;846102;50639
36;1;1998 november;659308;920790;261482
37;1;1998 december;683001;945665;262664
38;1;1998;10109723;11000458;890735
39;1;1999 januari;782082;868630;86548
40;1;1999 februari;662335;829362;167027
41;1;1999 maart;863192;940820;77628
42;1;1999 april;904446;864601;-39845
43;1;1999 mei;941917;784177;-157740
44;1;1999 juni;946044;801348;-144696
45;1;1999 juli;1166749;867312;-299437
46;1;1999 augustus;1067870;969127;-98743
47;1;1999 september;1245919;1022887;-223032
48;1;1999 oktober;1210834;1153668;-57166
49;1;1999 november;1368457;1363257;-5200
50;1;1999 december;1498540;1572161;73621
51;1;1999;12658385;12037350;-621035
52;1;2000 januari;1676335;1635747;-40588
53;1;2000 februari;1779021;1695070;-83951
54;1;2000 maart;1633954;1736994;103040
55;1;2000 april;1624734;1554095;-70639
56;1;2000 mei;1726188;1651107;-75081
57;1;2000 juni;2030601;1661442;-369159
58;1;2000 juli;2011802;1751461;-260341
59;1;2000 augustus;1837650;1718696;-118954
60;1;2000 september;2294625;1834643;-459982
61;1;2000 oktober;2122927;1991927;-131000
62;1;2000 november;2163549;2184815;21266
63;1;2000 december;2023991;2026988;2997
64;1;2000;22925377;21442985;-1482392
65;1;2001 januari;2061056;2316325;255269
66;1;2001 februari;1791399;2057360;265961
67;1;2001 maart;2028620;2131895;103275
68;1;2001 april;1928278;2216432;288154
69;1;2001 mei;2234956;2216017;-18939
70;1;2001 juni;2043682;1864355;-179327
71;1;2001 juli;2067987;1806194;-261793
72;1;2001 augustus;1975651;1767091;-208560
73;1;2001 september;1794104;1888455;94351
74;1;2001 oktober;1578711;1778113;199402
75;1;2001 november;1676300;1772509;96209
76;1;2001 december;1597022;1831337;234315
77;1;2001;22777766;23646083;868317
78;1;2002 januari;1588485;1802156;213671
79;1;2002 februari;1688543;1630870;-57673
80;1;2002 maart;1964577;1847180;-117397
81;1;2002 april;1815000;1765670;-49330
82;1;2002 mei;1942141;1684053;-258088
83;1;2002 juni;1846152;1691290;-154862
84;1;2002 juli;1544338;1542671;-1667
85;1;2002 augustus;1785750;1513088;-272662
86;1;2002 september;1828098;1764082;-64016
87;1;2002 oktober;1946125;1854750;-91375
88;1;2002 november;1741686;1635558;-106128
89;1;2002 december;2039320;2173731;134411
90;1;2002;21730215;20905099;-825116
91;1;2003 januari;1939184;2185080;245896
92;1;2003 februari;1940689;2136917;196228
93;1;2003 maart;2175570;2121789;-53781
94;1;2003 april;1941544;1588809;-352735
95;1;2003 mei;1761422;1524219;-237203
96;1;2003 juni;1790178;1532435;-257743
97;1;2003 juli;1788330;1527532;-260798
98;1;2003 augustus;2029570;1486054;-543516
99;1;2003 september;1731192;1483832;-247360
100;1;2003 oktober;1801022;1950319;149297
101;1;2003 november;1709818;1813506;103688
102;1;2003 december;1876421;1964054;87633
103;1;2003;22484940;21314546;-1170394
104;1;2004 januari;1921389;2010577;89188
105;1;2004 februari;1868096;1874054;5958
106;1;2004 maart;2130672;2078311;-52361
107;1;2004 april;2052718;1824085;-228633
108;1;2004 mei;2283554;1928987;-354567
109;1;2004 juni;2377168;1782864;-594304
110;1;2004 juli;2452264;2013819;-438445
111;1;2004 augustus;2768416;2056934;-711482
112;1;2004 september;2609345;2135515;-473830
113;1;2004 oktober;2694922;2379893;-315029
114;1;2004 november;2531748;2391715;-140033
115;1;2004 december;2427331;2435514;8183
116;1;2004;28117623;24912268;-3205355
117;1;2005 januari;2548585;2613809;65224
118;1;2005 februari;2478658;2441823;-36835
119;1;2005 maart;3067190;2520903;-546287
120;1;2005 april;2884094;2628895;-255199
121;1;2005 mei;2919182;2535766;-383416
122;1;2005 juni;3012669;2380371;-632298
123;1;2005 juli;3370679;2515873;-854806
124;1;2005 augustus;3426580;2721101;-705479
125;1;2005 september;3541570;2998720;-542850
126;1;2005 oktober;3639614;3101015;-538599
127;1;2005 november;3668338;3505450;-162888
128;1;2005 december;3701985;3623138;-78847
129;1;2005;38259144;33586864;-4672280
130;1;2006 januari;4024177;3932760;-91417
131;1;2006 februari;3523597;3785515;261918
132;1;2006 maart;4122623;4434634;312011
133;1;2006 april;3883684;3756251;-127433
134;1;2006 mei;4407970;3563252;-844718
135;1;2006 juni;4338637;3585101;-753536
136;1;2006 juli;4478830;3426354;-1052476
137;1;2006 augustus;4698177;3813223;-884954
138;1;2006 september;4165039;3196458;-968581
139;1;2006 oktober;4227432;3670283;-557149
140;1;2006 november;3770741;3730721;-40020
141;1;2006 december;3678331;3974107;295776
142;1;2006;49319238;44868659;-4450579
143;1;2007 januari;3651605;3521142;-130463
144;1;2007 februari;3603218;3326239;-276979
145;1;2007 maart;3978032;3513457;-464575
146;1;2007 april;4063375;3582759;-480616
147;1;2007 mei;4645687;3498197;-1147490
148;1;2007 juni;4183116;3559222;-623894
149;1;2007 juli;4333949;3707030;-626919
150;1;2007 augustus;4406154;3639606;-766548
151;1;2007 september;4390434;3793288;-597146
152;1;2007 oktober;4217665;4313129;95464
153;1;2007 november;5091177;4844425;-246752
154;1;2007 december;4857710;5034958;177248
155;1;2007;51422122;46333452;-5088670
156;1;2008 januari;5119676;4903668;-216008
157;1;2008 februari;4737614;5027883;290269
158;1;2008 maart;5425255;5145502;-279753
159;1;2008 april;5195396;5370230;174834
160;1;2008 mei;5779583;4767547;-1012036
161;1;2008 juni;6298652;5455023;-843629
162;1;2008 juli;6175944;5237924;-938020
163;1;2008 augustus;6217653;5357557;-860096
164;1;2008 september;6086619;5403917;-682702
165;1;2008 oktober;5060250;5437243;376993
166;1;2008 november;3950207;4408174;457967
167;1;2008 december;3096398;3867326;770928
168;1;2008;63143247;60381994;-2761253
169;1;2009 januari;3287215;4120723;833508
170;1;2009 februari;2970037;3651816;681779
171;1;2009 maart;3436547;3345040;-91507
172;1;2009 april;3339099;3002763;-336336
173;1;2009 mei;3661160;3090877;-570283
174;1;2009 juni;3675026;2821673;-853353
175;1;2009 juli;3917675;3212056;-705619
176;1;2009 augustus;3942501;3352410;-590091
177;1;2009 september;3848079;3206144;-641935
178;1;2009 oktober;3993974;3464947;-529027
179;1;2009 november;3977059;3820635;-156424
180;1;2009 december;4406890;3959591;-447299
181;1;2009;44455262;41048675;-3406587
182;1;2010 januari;4827736;4183320;-644416
183;1;2010 februari;4507189;4285128;-222061
184;1;2010 maart;5249062;4874043;-375019
185;1;2010 april;5009908;4317950;-691958
186;1;2010 mei;5195771;4374064;-821707
187;1;2010 juni;5079423;4178154;-901269
188;1;2010 juli;5531062;4417888;-1113174
189;1;2010 augustus;5109363;4458840;-650523
190;1;2010 september;4773753;4419393;-354360
191;1;2010 oktober;5347125;4625557;-721568
192;1;2010 november;5379543;5126943;-252600
193;1;2010 december;6114549;5842767;-271782
194;1;2010;62124484;55104047;-7020437
195;1;2011 januari;6346091;6002001;-344090
196;1;2011 februari;5900935;6050704;149769
197;1;2011 maart;7265533;6562786;-702747
198;1;2011 april;6115096;6374603;259507
199;1;2011 mei;7062343;5710285;-1352058
200;1;2011 juni;7027841;5449212;-1578629
201;1;2011 juli;6644644;5671972;-972672
202;1;2011 augustus;7359822;5678734;-1681088
203;1;2011 september;7192534;5673383;-1519151
204;1;2011 oktober;7065705;5988141;-1077564
205;1;2011 november;7788175;6916246;-871929
206;1;2011 december;6934803;6997338;62535
207;1;2011;82703522;73075405;-9628117
208;1;2012 januari;7492202;7420119;-72083
209;1;2012 februari;8478866;7757720;-721146
210;1;2012 maart;8748316;7426572;-1321744
211;1;2012 april;8382956;7621181;-761775
212;1;2012 mei;8414863;7201402;-1213461
213;1;2012 juni;7501787;6378168;-1123619
214;1;2012 juli;8031203;6741755;-1289448
215;1;2012 augustus;9198243;6600515;-2597728
216;1;2012 september;8500998;7133484;-1367514
217;1;2012 oktober;9260617;8128271;-1132346
218;1;2012 november;9494903;7937433;-1557470
219;1;2012 december;8791918;7760865;-1031053
220;1;2012;102296872;88107485;-14189387
221;1;2013 januari;8568871;8074259;-494612
222;1;2013 februari;8570003;7662976;-907027
223;1;2013 maart;8066695;8285029;218334
224;1;2013 april;7800532;7152252;-648280
225;1;2013 mei;8136832;7593728;-543104
226;1;2013 juni;7713840;6720641;-993199
227;1;2013 juli;7986953;7060205;-926748
228;1;2013 augustus;7479868;6776619;-703249
229;1;2013 september;7917564;6361591;-1555973
230;1;2013 oktober;8055845;7466450;-589395
231;1;2013 november;7490221;7460457;-29764
232;1;2013 december;7648110;7121340;-526770
233;1;2013;95435334;87735547;-7699787
234;1;2014 januari;7736798;7651490;-85308
235;1;2014 februari;6895711;6837525;-58186
236;1;2014 maart;7500660;6512368;-988292
237;1;2014 april;7265998;6726057;-539941
238;1;2014 mei;7831918;5986591;-1845327
239;1;2014 juni;6964027;6007523;-956504
240;1;2014 juli;7660324;6155017;-1505307
241;1;2014 augustus;7037419;5478583;-1558836
242;1;2014 september;6750410;5945955;-804455
243;1;2014 oktober;6423873;6313637;-110236
244;1;2014 november;5632715;6040224;407509
245;1;2014 december;5455917;5834772;378855
246;1;2014;83155770;75489742;-7666028
247;1;2015 januari;4806528;5239361;432833
248;1;2015 februari;4855472;5337947;482475
249;1;2015 maart;5990350;5854190;-136160
250;1;2015 april;6000597;5354040;-646557
251;1;2015 mei;6532479;4942080;-1590399
252;1;2015 juni;6104264;5323956;-780308
253;1;2015 juli;5951165;4867608;-1083557
254;1;2015 augustus;5389324;4384429;-1004895
255;1;2015 september;5161036;4220160;-940876
256;1;2015 oktober;5109199;4383726;-725473
257;1;2015 november;4295486;4034767;-260719
258;1;2015 december;4406008;4456398;50390
259;1;2015;64601908;58398662;-6203246
260;1;2016 januari;3792689;3924378;131689
261;1;2016 februari;3725896;3746787;20891
262;1;2016 maart;3967283;4012188;44905
263;1;2016 april;4351035;4052452;-298583
264;1;2016 mei;4770482;4213972;-556510
265;1;2016 juni;4634293;4197597;-436696
266;1;2016 juli;4768976;4175021;-593955
267;1;2016 augustus;4439980;4136808;-303172
268;1;2016 september;4665125;4208019;-457106
269;1;2016 oktober;5281941;4906891;-375050
270;1;2016 november;5089095;5209583;120488
271;1;2016 december;5541510;5494503;-47007
272;1;2016;55028305;52278199;-2750106
273;1;2017 januari;6149254;5832585;-316669
274;1;2017 februari;5715797;5888592;172795
275;1;2017 maart;6031454;5661682;-369772
276;1;2017 april;5589153;4815660;-773493
277;1;2017 mei;5418389;5163336;-255053
278;1;2017 juni;5175274;4865816;-309458
279;1;2017 juli;4856460;4646994;-209466
280;1;2017 augustus;5149131;4333729;-815402
281;1;2017 september;4973549;4875544;-98005
282;1;2017 oktober;5146399;4924944;-221455
283;1;2017 november;6159098;5451230;-707868
284;1;2017 december;6256430;5790470;-465960
285;1;2017;66620388;62250582;-4369806
286;1;2018 januari;6807265;5862183;-945082
287;1;2018 februari;6377224;5828935;-548289
288;1;2018 maart;6360635;5721427;-639208
289;1;2018 april;6027614;5156774;-870840
290;1;2018 mei;6410691;6212165;-198526
291;1;2018 juni;6429141;5445514;-983627
292;1;2018 januari-juni;38412570;34226998;-4185572
293;2;1996 januari;211355;965898;754543
294;2;1996 februari;190252;951004;760752
295;2;1996 maart;245754;1042346;796592
296;2;1996 april;233501;840424;606923
297;2;1996 mei;232133;786083;553950
298;2;1996 juni;212624;750883;538259
299;2;1996 juli;198595;782666;584071
300;2;1996 augustus;187904;689816;501912
301;2;1996 september;257561;873798;616237
302;2;1996 oktober;273938;925969;652031
303;2;1996 november;276483;1021253;744770
304;2;1996 december;300314;1306990;1006676
305;2;1996;2820414;10937130;8116716
306;2;1997 januari;339188;1340709;1001521
307;2;1997 februari;323567;1024141;700574
308;2;1997 maart;299224;981018;681794
309;2;1997 april;314038;942485;628447
310;2;1997 mei;339386;888266;548880
311;2;1997 juni;281445;850445;569000
312;2;1997 juli;290798;856789;565991
313;2;1997 augustus;279652;888504;608852
314;2;1997 september;320750;867160;546410
315;2;1997 oktober;307500;987228;679728
316;2;1997 november;307323;1050169;742846
317;2;1997 december;298954;1085539;786585
318;2;1997;3701825;11762453;8060628
319;2;1998 januari;249772;1034283;784511
320;2;1998 februari;263180;889558;626378
321;2;1998 maart;304970;967890;662920
322;2;1998 april;321066;841377;520311
323;2;1998 mei;276439;706362;429923
324;2;1998 juni;261846;650547;388701
325;2;1998 juli;283304;713404;430100
326;2;1998 augustus;262294;671998;409704
327;2;1998 september;224857;680449;455592
328;2;1998 oktober;270930;724027;453097
329;2;1998 november;221558;823628;602070
330;2;1998 december;231894;833110;601216
331;2;1998;3172110;9536633;6364523
332;2;1999 januari;254351;768652;514301
333;2;1999 februari;252225;737976;485751
334;2;1999 maart;276713;839972;563259
335;2;1999 april;288165;759182;471017
336;2;1999 mei;302829;682910;380081
337;2;1999 juni;281001;688808;407807
338;2;1999 juli;356070;762080;406010
339;2;1999 augustus;369231;879079;509848
340;2;1999 september;442236;925700;483464
341;2;1999 oktober;405351;1020295;614944
342;2;1999 november;465259;1243385;778126
343;2;1999 december;546615;1446679;900064
344;2;1999;4240046;10754718;6514672
345;2;2000 januari;642139;1469041;826902
346;2;2000 februari;593875;1525961;932086
347;2;2000 maart;682216;1558171;875955
348;2;2000 april;692118;1374195;682077
349;2;2000 mei;690832;1470399;779567
350;2;2000 juni;655842;1453845;798003
351;2;2000 juli;696830;1552475;855645
352;2;2000 augustus;678618;1539073;860455
353;2;2000 september;601493;1570971;969478
354;2;2000 oktober;766298;1778543;1012245
355;2;2000 november;832032;1976561;1144529
356;2;2000 december;842801;1810440;967639
357;2;2000;8375094;19079675;10704581
358;2;2001 januari;809451;2128173;1318722
359;2;2001 februari;718951;1815095;1096144
360;2;2001 maart;658536;1943025;1284489
361;2;2001 april;645618;2011657;1366039
362;2;2001 mei;792075;1988519;1196444
363;2;2001 juni;680508;1648608;968100
364;2;2001 juli;640864;1622584;981720
365;2;2001 augustus;689471;1584246;894775
366;2;2001 september;683101;1679735;996634
367;2;2001 oktober;586374;1644591;1058217
368;2;2001 november;609424;1640032;1030608
369;2;2001 december;619221;1700093;1080872
370;2;2001;8133594;21406358;13272764
371;2;2002 januari;669622;1646904;977282
372;2;2002 februari;710136;1438685;728549
373;2;2002 maart;857027;1653595;796568
374;2;2002 april;839611;1457505;617894
375;2;2002 mei;733457;1409088;675631
376;2;2002 juni;837977;1418975;580998
377;2;2002 juli;593647;1270632;676985
378;2;2002 augustus;731788;1275033;543245
379;2;2002 september;859316;1523740;664424
380;2;2002 oktober;729506;1533769;804263
381;2;2002 november;691317;1402708;711391
382;2;2002 december;973575;1966434;992859
383;2;2002;9226979;17997068;8770089
384;2;2003 januari;777063;1867466;1090403
385;2;2003 februari;833215;1885764;1052549
386;2;2003 maart;1061743;1860706;798963
387;2;2003 april;807785;1328357;520572
388;2;2003 mei;741844;1244533;502689
389;2;2003 juni;760151;1305863;545712
390;2;2003 juli;774124;1263355;489231
391;2;2003 augustus;786530;1236233;449703
392;2;2003 september;663761;1227266;563505
393;2;2003 oktober;771845;1666481;894636
394;2;2003 november;834151;1601603;767452
395;2;2003 december;841260;1727947;886687
396;2;2003;9653472;18215574;8562102
397;2;2004 januari;829669;1714525;884856
398;2;2004 februari;830392;1594650;764258
399;2;2004 maart;921545;1681121;759576
400;2;2004 april;916604;1529792;613188
401;2;2004 mei;971548;1548064;576516
402;2;2004 juni;1113403;1429651;316248
403;2;2004 juli;1000499;1686796;686297
404;2;2004 augustus;1262332;1692716;430384
405;2;2004 september;1153247;1837007;683760
406;2;2004 oktober;1173083;2042080;868997
407;2;2004 november;1098996;2037736;938740
408;2;2004 december;1042083;2189531;1147448
409;2;2004;12313401;20983669;8670268
410;2;2005 januari;1211930;2210587;998657
411;2;2005 februari;1020803;2108273;1087470
412;2;2005 maart;1332336;2243585;911249
413;2;2005 april;1313557;2148021;834464
414;2;2005 mei;1271640;1838403;566763
415;2;2005 juni;1215307;1877867;662560
416;2;2005 juli;1336791;1967986;631195
417;2;2005 augustus;1258939;2056123;797184
418;2;2005 september;1401190;2326453;925263
419;2;2005 oktober;1547214;2507425;960211
420;2;2005 november;1454092;2830195;1376103
421;2;2005 december;1574997;3083780;1508783
422;2;2005;15938796;27198698;11259902
423;2;2006 januari;1821768;3291390;1469622
424;2;2006 februari;1509825;3153987;1644162
425;2;2006 maart;1842740;3700216;1857476
426;2;2006 april;2017727;2867402;849675
427;2;2006 mei;2314143;2570099;255956
428;2;2006 juni;1929023;2621508;692485
429;2;2006 juli;2262004;2519699;257695
430;2;2006 augustus;2072082;2914258;842176
431;2;2006 september;1829259;2556130;726871
432;2;2006 oktober;1859189;2945068;1085879
433;2;2006 november;1670998;3043577;1372579
434;2;2006 december;1704939;3188276;1483337
435;2;2006;22833697;35371610;12537913
436;2;2007 januari;1659836;2864778;1204942
437;2;2007 februari;1702874;2623901;921027
438;2;2007 maart;2019310;2626379;607069
439;2;2007 april;1999523;2513351;513828
440;2;2007 mei;2201754;2489479;287725
441;2;2007 juni;2129001;2377005;248004
442;2;2007 juli;2098450;2624048;525598
443;2;2007 augustus;2161789;2606794;445005
444;2;2007 september;2089273;2770540;681267
445;2;2007 oktober;1959861;3251208;1291347
446;2;2007 november;2425512;3835166;1409654
447;2;2007 december;2097028;4101505;2004477
448;2;2007;24544211;34684154;10139943
449;2;2008 januari;2007229;4018312;2011083
450;2;2008 februari;1976224;3886939;1910715
451;2;2008 maart;2061721;4137989;2076268
452;2;2008 april;1875500;3841177;1965677
453;2;2008 mei;2226957;3591775;1364818
454;2;2008 juni;2241090;3686210;1445120
455;2;2008 juli;2314821;4025072;1710251
456;2;2008 augustus;2197270;3905901;1708631
457;2;2008 september;2188000;3952838;1764838
458;2;2008 oktober;1981045;4199528;2218483
459;2;2008 november;1418642;3716685;2298043
460;2;2008 december;1105385;3185491;2080106
461;2;2008;23593884;46147917;22554033
462;2;2009 januari;1110115;3295800;2185685
463;2;2009 februari;1245177;2967309;1722132
464;2;2009 maart;1287427;2522820;1235393
465;2;2009 april;1165690;2129477;963787
466;2;2009 mei;1312752;2026279;713527
467;2;2009 juni;1475347;1949583;474236
468;2;2009 juli;1554008;1992109;438101
469;2;2009 augustus;1452565;2070353;617788
470;2;2009 september;1476306;2164365;688059
471;2;2009 oktober;1505867;2536466;1030599
472;2;2009 november;1392078;2782588;1390510
473;2;2009 december;1708329;2958935;1250606
474;2;2009;16685661;29396084;12710423
475;2;2010 januari;1668039;3228125;1560086
476;2;2010 februari;1874881;3138656;1263775
477;2;2010 maart;2145075;3623314;1478239
478;2;2010 april;1957804;3064293;1106489
479;2;2010 mei;2105763;3077243;971480
480;2;2010 juni;2053461;2817969;764508
481;2;2010 juli;2115591;2875189;759598
482;2;2010 augustus;1884213;2793462;909249
483;2;2010 september;1838120;2884305;1046185
484;2;2010 oktober;1783609;3289505;1505896
485;2;2010 november;2130684;4027254;1896570
486;2;2010 december;2158554;4564293;2405739
487;2;2010;23715794;39383608;15667814
488;2;2011 januari;2256865;4531736;2274871
489;2;2011 februari;2777541;4551377;1773836
490;2;2011 maart;2750452;5008744;2258292
491;2;2011 april;2243311;4319974;2076663
492;2;2011 mei;2745844;4045133;1299289
493;2;2011 juni;2687289;3910731;1223442
494;2;2011 juli;2602030;3949916;1347886
495;2;2011 augustus;2862158;4073348;1211190
496;2;2011 september;2559781;4093959;1534178
497;2;2011 oktober;2640000;4630353;1990353
498;2;2011 november;2787941;5035641;2247700
499;2;2011 december;2575937;5330392;2754455
500;2;2011;31489149;53481304;21992155
501;2;2012 januari;2584156;5245748;2661592
502;2;2012 februari;2942447;5574707;2632260
503;2;2012 maart;3394917;5467585;2072668
504;2;2012 april;3118855;4877961;1759106
505;2;2012 mei;3162388;4688608;1526220
506;2;2012 juni;3058817;4177746;1118929
507;2;2012 juli;3180779;4895667;1714888
508;2;2012 augustus;3349102;4655269;1306167
509;2;2012 september;3496358;4963383;1467025
510;2;2012 oktober;3462220;5952186;2489966
511;2;2012 november;3607530;6101473;2493943
512;2;2012 december;3499125;5680531;2181406
513;2;2012;38856694;62280864;23424170
514;2;2013 januari;3478404;5671605;2193201
515;2;2013 februari;3484380;5381784;1897404
516;2;2013 maart;3217030;5660775;2443745
517;2;2013 april;2972393;4950539;1978146
518;2;2013 mei;3235501;4896206;1660705
519;2;2013 juni;3146691;4793121;1646430
520;2;2013 juli;3047102;4711964;1664862
521;2;2013 augustus;2706549;4585658;1879109
522;2;2013 september;2534776;4755793;2221017
523;2;2013 oktober;2331500;5687924;3356424
524;2;2013 november;2496391;5572465;3076074
525;2;2013 december;2997936;5624090;2626154
526;2;2013;35648653;62291924;26643271
527;2;2014 januari;2897989;5580836;2682847
528;2;2014 februari;2733045;4719723;1986678
529;2;2014 maart;2870656;4547684;1677028
530;2;2014 april;3036448;4787563;1751115
531;2;2014 mei;3042646;4160907;1118261
532;2;2014 juni;2510919;4275605;1764686
533;2;2014 juli;2701013;4321537;1620524
534;2;2014 augustus;2221954;3912877;1690923
535;2;2014 september;2524633;4298967;1774334
536;2;2014 oktober;2442258;4315462;1873204
537;2;2014 november;2163406;4296537;2133131
538;2;2014 december;1937536;4342831;2405295
539;2;2014;31082503;53560529;22478026
540;2;2015 januari;1909909;3822556;1912647
541;2;2015 februari;1654930;3963780;2308850
542;2;2015 maart;2254318;4139496;1885178
543;2;2015 april;2116527;3505298;1388771
544;2;2015 mei;2424495;3217240;792745
545;2;2015 juni;2304325;3535115;1230790
546;2;2015 juli;2249440;3280754;1031314
547;2;2015 augustus;2008858;3017939;1009081
548;2;2015 september;1919184;3041549;1122365
549;2;2015 oktober;1905281;2965294;1060013
550;2;2015 november;1608368;2925150;1316782
551;2;2015 december;1797995;3123891;1325896
552;2;2015;24153630;40538062;16384432
553;2;2016 januari;1619988;2719395;1099407
554;2;2016 februari;1545968;2650244;1104276
555;2;2016 maart;1705176;2888181;1183005
556;2;2016 april;1656208;2629954;973746
557;2;2016 mei;1787995;2673332;885337
558;2;2016 juni;1799031;2725923;926892
559;2;2016 juli;1876531;2643839;767308
560;2;2016 augustus;1942502;2546588;604086
561;2;2016 september;1723223;2594932;871709
562;2;2016 oktober;1889022;3149886;1260864
563;2;2016 november;1909468;3483505;1574037
564;2;2016 december;2036065;3691519;1655454
565;2;2016;21491177;34397298;12906121
566;2;2017 januari;2206250;3765717;1559467
567;2;2017 februari;2012738;3792018;1779280
568;2;2017 maart;2346389;3633120;1286731
569;2;2017 april;2044893;2802095;757202
570;2;2017 mei;2120945;3094011;973066
571;2;2017 juni;1978322;2861416;883094
572;2;2017 juli;2231749;2867987;636238
573;2;2017 augustus;2147935;2691587;543652
574;2;2017 september;2003079;2805893;802814
575;2;2017 oktober;1876764;3063145;1186381
576;2;2017 november;2807461;3512816;705355
577;2;2017 december;2735162;3607758;872596
578;2;2017;26511687;38497563;11985876
579;2;2018 januari;2641188;3665770;1024582
580;2;2018 februari;2701604;3495398;793794
581;2;2018 maart;2844119;3658001;813882
582;2;2018 april;2255509;3432841;1177332
583;2;2018 mei;2379642;3890315;1510673
584;2;2018 juni;2680427;3447396;766969
585;2;2018 januari-juni;15502489;21589721;6087232
586;3;1996 januari;692148;133705;-558443
587;3;1996 februari;621214;110130;-511084
588;3;1996 maart;621396;122693;-498703
589;3;1996 april;730678;139814;-590864
590;3;1996 mei;689337;146918;-542419
591;3;1996 juni;605770;120709;-485061
592;3;1996 juli;747536;134799;-612737
593;3;1996 augustus;769006;139693;-629313
594;3;1996 september;704293;119288;-585005
595;3;1996 oktober;909257;117751;-791506
596;3;1996 november;966716;142000;-824716
597;3;1996 december;944038;136288;-807750
598;3;1996;9001389;1563788;-7437601
599;3;1997 januari;924653;142541;-782112
600;3;1997 februari;802668;100931;-701737
601;3;1997 maart;740783;137317;-603466
602;3;1997 april;796785;151288;-645497
603;3;1997 mei;727520;161479;-566041
604;3;1997 juni;745696;126734;-618962
605;3;1997 juli;871470;142522;-728948
606;3;1997 augustus;949914;141091;-808823
607;3;1997 september;710063;130079;-579984
608;3;1997 oktober;829864;119346;-710518
609;3;1997 november;728422;115540;-612882
610;3;1997 december;651569;115473;-536096
611;3;1997;9479407;1584341;-7895066
612;3;1998 januari;759086;142048;-617038
613;3;1998 februari;660126;97884;-562242
614;3;1998 maart;629258;133626;-495632
615;3;1998 april;598485;117927;-480558
616;3;1998 mei;583661;128489;-455172
617;3;1998 juni;550025;151164;-398861
618;3;1998 juli;548046;132401;-415645
619;3;1998 augustus;583597;121238;-462359
620;3;1998 september;611939;107256;-504683
621;3;1998 oktober;524533;122075;-402458
622;3;1998 november;437750;97162;-340588
623;3;1998 december;451107;112555;-338552
624;3;1998;6937613;1463825;-5473788
625;3;1999 januari;527731;99978;-427753
626;3;1999 februari;410110;91386;-318724
627;3;1999 maart;586479;100848;-485631
628;3;1999 april;616281;105419;-510862
629;3;1999 mei;639088;101267;-537821
630;3;1999 juni;665043;112540;-552503
631;3;1999 juli;810679;105232;-705447
632;3;1999 augustus;698639;90048;-608591
633;3;1999 september;803683;97187;-706496
634;3;1999 oktober;805483;133373;-672110
635;3;1999 november;903198;119872;-783326
636;3;1999 december;951925;125482;-826443
637;3;1999;8418339;1282632;-7135707
638;3;2000 januari;1034196;166706;-867490
639;3;2000 februari;1185146;169109;-1016037
640;3;2000 maart;951738;178823;-772915
641;3;2000 april;932616;179900;-752716
642;3;2000 mei;1035356;180708;-854648
643;3;2000 juni;1374759;207597;-1167162
644;3;2000 juli;1314972;198986;-1115986
645;3;2000 augustus;1159032;179623;-979409
646;3;2000 september;1693132;263672;-1429460
647;3;2000 oktober;1356629;213384;-1143245
648;3;2000 november;1331517;208254;-1123263
649;3;2000 december;1181190;216548;-964642
650;3;2000;14550283;2363310;-12186973
651;3;2001 januari;1251605;188152;-1063453
652;3;2001 februari;1072448;242265;-830183
653;3;2001 maart;1370084;188870;-1181214
654;3;2001 april;1282660;204775;-1077885
655;3;2001 mei;1442881;227498;-1215383
656;3;2001 juni;1363174;215747;-1147427
657;3;2001 juli;1427123;183610;-1243513
658;3;2001 augustus;1286180;182845;-1103335
659;3;2001 september;1111003;208720;-902283
660;3;2001 oktober;992337;133522;-858815
661;3;2001 november;1066876;132477;-934399
662;3;2001 december;977801;131244;-846557
663;3;2001;14644172;2239725;-12404447
664;3;2002 januari;918863;155252;-763611
665;3;2002 februari;978407;192185;-786222
666;3;2002 maart;1107550;193585;-913965
667;3;2002 april;975389;308165;-667224
668;3;2002 mei;1208684;274965;-933719
669;3;2002 juni;1008175;272315;-735860
670;3;2002 juli;950691;272039;-678652
671;3;2002 augustus;1053962;238055;-815907
672;3;2002 september;968782;240342;-728440
673;3;2002 oktober;1216619;320981;-895638
674;3;2002 november;1050369;232850;-817519
675;3;2002 december;1065745;207297;-858448
676;3;2002;12503236;2908031;-9595205
677;3;2003 januari;1162121;317614;-844507
678;3;2003 februari;1107474;251153;-856321
679;3;2003 maart;1113827;261083;-852744
680;3;2003 april;1133759;260452;-873307
681;3;2003 mei;1019578;279686;-739892
682;3;2003 juni;1030027;226572;-803455
683;3;2003 juli;1014206;264177;-750029
684;3;2003 augustus;1243040;249821;-993219
685;3;2003 september;1067431;256566;-810865
686;3;2003 oktober;1029177;283838;-745339
687;3;2003 november;875667;211903;-663764
688;3;2003 december;1035161;236107;-799054
689;3;2003;12831468;3098972;-9732496
690;3;2004 januari;1091720;296052;-795668
691;3;2004 februari;1037704;279404;-758300
692;3;2004 maart;1209127;397190;-811937
693;3;2004 april;1136114;294293;-841821
694;3;2004 mei;1312006;380923;-931083
695;3;2004 juni;1263765;353213;-910552
696;3;2004 juli;1451765;327023;-1124742
697;3;2004 augustus;1506084;364218;-1141866
698;3;2004 september;1456098;298508;-1157590
699;3;2004 oktober;1521839;337813;-1184026
700;3;2004 november;1432752;353979;-1078773
701;3;2004 december;1385248;245983;-1139265
702;3;2004;15804222;3928599;-11875623
703;3;2005 januari;1336655;403222;-933433
704;3;2005 februari;1457855;333550;-1124305
705;3;2005 maart;1734854;277318;-1457536
706;3;2005 april;1570537;480874;-1089663
707;3;2005 mei;1647542;697363;-950179
708;3;2005 juni;1797362;502504;-1294858
709;3;2005 juli;2033888;547887;-1486001
710;3;2005 augustus;2167641;664978;-1502663
711;3;2005 september;2140380;672267;-1468113
712;3;2005 oktober;2092400;593590;-1498810
713;3;2005 november;2214246;675255;-1538991
714;3;2005 december;2126988;539358;-1587630
715;3;2005;22320348;6388166;-15932182
716;3;2006 januari;2202409;641370;-1561039
717;3;2006 februari;2013772;631528;-1382244
718;3;2006 maart;2279883;734418;-1545465
719;3;2006 april;1865957;888849;-977108
720;3;2006 mei;2093827;993153;-1100674
721;3;2006 juni;2409614;963593;-1446021
722;3;2006 juli;2216826;906655;-1310171
723;3;2006 augustus;2626095;898965;-1727130
724;3;2006 september;2335780;640328;-1695452
725;3;2006 oktober;2368243;725215;-1643028
726;3;2006 november;2099743;687144;-1412599
727;3;2006 december;1973392;785831;-1187561
728;3;2006;26485541;9497049;-16988492
729;3;2007 januari;1991769;656364;-1335405
730;3;2007 februari;1900344;702338;-1198006
731;3;2007 maart;1958722;887078;-1071644
732;3;2007 april;2063852;1069408;-994444
733;3;2007 mei;2443933;1008718;-1435215
734;3;2007 juni;2054115;1182217;-871898
735;3;2007 juli;2235499;1082982;-1152517
736;3;2007 augustus;2244365;1032812;-1211553
737;3;2007 september;2301161;1022748;-1278413
738;3;2007 oktober;2257804;1061921;-1195883
739;3;2007 november;2665665;1009259;-1656406
740;3;2007 december;2760682;933453;-1827229
741;3;2007;26877911;11649298;-15228613
742;3;2008 januari;3112447;885356;-2227091
743;3;2008 februari;2761390;1140944;-1620446
744;3;2008 maart;3363534;1007513;-2356021
745;3;2008 april;3319896;1529053;-1790843
746;3;2008 mei;3552626;1175772;-2376854
747;3;2008 juni;4057562;1768813;-2288749
748;3;2008 juli;3861123;1212852;-2648271
749;3;2008 augustus;4020383;1451656;-2568727
750;3;2008 september;3898619;1451079;-2447540
751;3;2008 oktober;3079205;1237715;-1841490
752;3;2008 november;2531565;691489;-1840076
753;3;2008 december;1991013;681835;-1309178
754;3;2008;39549363;14234077;-25315286
755;3;2009 januari;2177100;824923;-1352177
756;3;2009 februari;1724860;684507;-1040353
757;3;2009 maart;2149120;822220;-1326900
758;3;2009 april;2173409;873286;-1300123
759;3;2009 mei;2348408;1064598;-1283810
760;3;2009 juni;2199679;872090;-1327589
761;3;2009 juli;2363667;1219947;-1143720
762;3;2009 augustus;2489936;1282057;-1207879
763;3;2009 september;2371773;1041779;-1329994
764;3;2009 oktober;2488107;928481;-1559626
765;3;2009 november;2584981;1038047;-1546934
766;3;2009 december;2698561;1000656;-1697905
767;3;2009;27769601;11652591;-16117010
768;3;2010 januari;3159697;955195;-2204502
769;3;2010 februari;2632308;1146472;-1485836
770;3;2010 maart;3103987;1250729;-1853258
771;3;2010 april;3052104;1253657;-1798447
772;3;2010 mei;3090008;1296821;-1793187
773;3;2010 juni;3025962;1360185;-1665777
774;3;2010 juli;3415471;1542699;-1872772
775;3;2010 augustus;3225150;1665378;-1559772
776;3;2010 september;2935633;1535088;-1400545
777;3;2010 oktober;3563516;1336052;-2227464
778;3;2010 november;3248859;1099689;-2149170
779;3;2010 december;3955995;1278474;-2677521
780;3;2010;38408690;15720439;-22688251
781;3;2011 januari;4089226;1470265;-2618961
782;3;2011 februari;3123394;1499327;-1624067
783;3;2011 maart;4515081;1554042;-2961039
784;3;2011 april;3871785;2054629;-1817156
785;3;2011 mei;4316499;1665152;-2651347
786;3;2011 juni;4340552;1538481;-2802071
787;3;2011 juli;4042614;1722056;-2320558
788;3;2011 augustus;4497664;1605386;-2892278
789;3;2011 september;4632753;1579424;-3053329
790;3;2011 oktober;4425705;1357788;-3067917
791;3;2011 november;5000234;1880605;-3119629
792;3;2011 december;4358866;1666946;-2691920
793;3;2011;51214373;19594101;-31620272
794;3;2012 januari;4908046;2174371;-2733675
795;3;2012 februari;5536419;2183013;-3353406
796;3;2012 maart;5353399;1958987;-3394412
797;3;2012 april;5264101;2743220;-2520881
798;3;2012 mei;5252475;2512794;-2739681
799;3;2012 juni;4442970;2200422;-2242548
800;3;2012 juli;4850424;1846088;-3004336
801;3;2012 augustus;5849141;1945246;-3903895
802;3;2012 september;5004640;2170101;-2834539
803;3;2012 oktober;5798397;2176085;-3622312
804;3;2012 november;5887373;1835960;-4051413
805;3;2012 december;5292793;2080334;-3212459
806;3;2012;63440178;25826621;-37613557
807;3;2013 januari;5090467;2402654;-2687813
808;3;2013 februari;5085623;2281192;-2804431
809;3;2013 maart;4849665;2624254;-2225411
810;3;2013 april;4828139;2201713;-2626426
811;3;2013 mei;4901331;2697522;-2203809
812;3;2013 juni;4567149;1927520;-2639629
813;3;2013 juli;4939851;2348241;-2591610
814;3;2013 augustus;4773319;2190961;-2582358
815;3;2013 september;5382788;1605798;-3776990
816;3;2013 oktober;5724345;1778526;-3945819
817;3;2013 november;4993830;1887992;-3105838
818;3;2013 december;4650174;1497250;-3152924
819;3;2013;59786681;25443623;-34343058
820;3;2014 januari;4838809;2070654;-2768155
821;3;2014 februari;4162666;2117802;-2044864
822;3;2014 maart;4630004;1964684;-2665320
823;3;2014 april;4229550;1938494;-2291056
824;3;2014 mei;4789272;1825684;-2963588
825;3;2014 juni;4453108;1731918;-2721190
826;3;2014 juli;4959311;1833480;-3125831
827;3;2014 augustus;4815465;1565706;-3249759
828;3;2014 september;4225777;1646988;-2578789
829;3;2014 oktober;3981615;1998175;-1983440
830;3;2014 november;3469309;1743687;-1725622
831;3;2014 december;3518381;1491941;-2026440
832;3;2014;52073267;21929213;-30144054
833;3;2015 januari;2896619;1416805;-1479814
834;3;2015 februari;3200542;1374167;-1826375
835;3;2015 maart;3736032;1714694;-2021338
836;3;2015 april;3884070;1848742;-2035328
837;3;2015 mei;4107984;1724840;-2383144
838;3;2015 juni;3799939;1788841;-2011098
839;3;2015 juli;3701725;1586854;-2114871
840;3;2015 augustus;3380466;1366490;-2013976
841;3;2015 september;3241852;1178611;-2063241
842;3;2015 oktober;3203918;1418432;-1785486
843;3;2015 november;2687118;1109617;-1577501
844;3;2015 december;2608013;1332507;-1275506
845;3;2015;40448278;17860600;-22587678
846;3;2016 januari;2172701;1204983;-967718
847;3;2016 februari;2179928;1096543;-1083385
848;3;2016 maart;2262107;1124007;-1138100
849;3;2016 april;2694827;1422498;-1272329
850;3;2016 mei;2982487;1540640;-1441847
851;3;2016 juni;2835262;1471674;-1363588
852;3;2016 juli;2892445;1531182;-1361263
853;3;2016 augustus;2497478;1590220;-907258
854;3;2016 september;2941902;1613087;-1328815
855;3;2016 oktober;3392919;1757005;-1635914
856;3;2016 november;3179627;1726078;-1453549
857;3;2016 december;3505445;1802984;-1702461
858;3;2016;33537128;17880901;-15656227
859;3;2017 januari;3943004;2066868;-1876136
860;3;2017 februari;3703059;2096574;-1606485
861;3;2017 maart;3685065;2028562;-1656503
862;3;2017 april;3544260;2013565;-1530695
863;3;2017 mei;3297444;2069325;-1228119
864;3;2017 juni;3196952;2004400;-1192552
865;3;2017 juli;2624711;1779007;-845704
866;3;2017 augustus;3001196;1642142;-1359054
867;3;2017 september;2970470;2069651;-900819
868;3;2017 oktober;3269635;1861799;-1407836
869;3;2017 november;3351637;1938414;-1413223
870;3;2017 december;3521268;2182712;-1338556
871;3;2017;40108701;23753019;-16355682
872;3;2018 januari;4166077;2196413;-1969664
873;3;2018 februari;3675620;2333537;-1342083
874;3;2018 maart;3516516;2063426;-1453090
875;3;2018 april;3772105;1723933;-2048172
876;3;2018 mei;4031049;2321850;-1709199
877;3;2018 juni;3748714;1998118;-1750596
878;3;2018 januari-juni;22910081;12637277;-10272804
