ID;Perioden;JongensEnMeisjes_1;Jongens_2;Meisjes_3;MannenEnVrouwen_4;Mannen_5;Vrouwen_6;TotaalHuwelijken_7;TussenManEnVrouw_8;TussenMannen_9;TussenVrouwen_10;TotaalPartnerschappen_11;TussenManEnVrouw_12;TussenMannen_13;TussenVrouwen_14;EchtScheidingen_15;TotaalVerhuisdePersonen_16;BinnenGemeentenVerhuisdePersonen_17;TussenGemeentenVerhuisdePersonen_18;Immigratie_19;EmigratieExclusiefAdministratieveC_20;Nationaliteitswijzigingen_21
0;Totaal 1995;190513;97560;92953;135675;68229;67446;81469;81469;;;;;;;34170;1717362;1111359;606003;96099;63321;
1;Totaal januari 1995;16436;8318;8118;11974;5964;6010;2947;2947;;;;;;;2938;148917;97967;50950;8362;5332;
2;Zondag 1 januari 1995;368;186;182;394;200;194;7;7;;;;;;;0;1624;1322;302;15;42;
3;Maandag 2 januari 1995;439;230;209;393;180;213;72;72;;;;;;;83;14359;9562;4797;436;589;
4;Dinsdag 3 januari 1995;529;265;264;403;200;203;65;65;;;;;;;105;7531;4769;2762;397;246;
5;Woensdag 4 januari 1995;569;300;269;344;166;178;98;98;;;;;;;127;6060;3800;2260;415;159;
6;Donderdag 5 januari 1995;565;304;261;413;202;211;132;132;;;;;;;112;6715;4248;2467;410;220;
7;Vrijdag 6 januari 1995;573;287;286;409;194;215;213;213;;;;;;;147;5775;3577;2198;237;176;
8;Zaterdag 7 januari 1995;460;230;230;369;191;178;27;27;;;;;;;1;154;98;56;3;3;
9;Zondag 8 januari 1995;411;226;185;388;192;196;9;9;;;;;;;0;67;48;19;7;7;
10;Maandag 9 januari 1995;535;277;258;409;199;210;96;96;;;;;;;119;7824;5167;2657;442;282;
11;Dinsdag 10 januari 1995;609;310;299;400;201;199;84;84;;;;;;;129;6351;4009;2342;364;181;
12;Woensdag 11 januari 1995;564;269;295;411;206;205;100;100;;;;;;;135;5936;3862;2074;384;165;
13;Donderdag 12 januari 1995;618;316;302;412;196;216;130;130;;;;;;;143;5547;3574;1973;430;164;
14;Vrijdag 13 januari 1995;544;261;283;408;211;197;158;158;;;;;;;155;5779;3695;2084;313;199;
15;Zaterdag 14 januari 1995;419;204;215;408;189;219;40;40;;;;;;;0;243;174;69;7;9;
16;Zondag 15 januari 1995;416;210;206;375;191;184;8;8;;;;;;;2;318;225;93;2;12;
17;Maandag 16 januari 1995;557;265;292;366;185;181;80;80;;;;;;;131;9337;6477;2860;421;328;
18;Dinsdag 17 januari 1995;534;267;267;375;184;191;83;83;;;;;;;161;5495;3562;1933;393;200;
19;Woensdag 18 januari 1995;587;299;288;374;189;185;90;90;;;;;;;137;5457;3655;1802;395;144;
20;Donderdag 19 januari 1995;621;303;318;414;204;210;112;112;;;;;;;151;5453;3537;1916;371;179;
21;Vrijdag 20 januari 1995;588;314;274;365;170;195;360;360;;;;;;;125;5782;3900;1882;306;171;
22;Zaterdag 21 januari 1995;435;228;207;377;189;188;34;34;;;;;;;1;225;147;78;7;1;
23;Zondag 22 januari 1995;460;231;229;338;158;180;9;9;;;;;;;0;56;35;21;11;3;
24;Maandag 23 januari 1995;551;296;255;356;185;171;71;71;;;;;;;118;7167;4815;2352;404;232;
25;Dinsdag 24 januari 1995;575;291;284;382;194;188;81;81;;;;;;;136;5287;3513;1774;360;216;
26;Woensdag 25 januari 1995;647;334;313;381;207;174;111;111;;;;;;;145;5160;3465;1695;361;243;
27;Donderdag 26 januari 1995;597;284;313;389;189;200;161;161;;;;;;;151;4998;3297;1701;378;230;
28;Vrijdag 27 januari 1995;547;280;267;392;205;187;321;321;;;;;;;141;5624;3668;1956;251;258;
29;Zaterdag 28 januari 1995;452;209;243;397;204;193;34;34;;;;;;;3;369;233;136;13;15;
30;Zondag 29 januari 1995;478;251;227;367;182;185;4;4;;;;;;;0;44;28;16;3;19;
31;Maandag 30 januari 1995;605;298;307;343;182;161;88;88;;;;;;;142;7717;5218;2499;429;300;
32;Dinsdag 31 januari 1995;583;293;290;422;219;203;69;69;;;;;;;138;6463;4287;2176;397;339;
33;Totaal februari 1995;14824;7705;7119;10106;5118;4988;3121;3121;;;;;;;2909;142125;95917;46208;6621;4278;
34;Woensdag 1 februari 1995;597;320;277;386;217;169;97;97;;;;;;;152;19720;13870;5850;473;472;
35;Donderdag 2 februari 1995;572;294;278;351;185;166;126;126;;;;;;;134;6404;3968;2436;373;185;
36;Vrijdag 3 februari 1995;546;297;249;344;168;176;239;239;;;;;;;155;5824;3694;2130;290;194;
37;Zaterdag 4 februari 1995;464;236;228;368;178;190;22;22;;;;;;;0;206;151;55;9;5;
38;Zondag 5 februari 1995;426;210;216;363;192;171;3;3;;;;;;;1;43;26;17;3;4;
39;Maandag 6 februari 1995;549;280;269;368;166;202;79;79;;;;;;;134;7407;4967;2440;361;253;
40;Dinsdag 7 februari 1995;558;270;288;345;166;179;83;83;;;;;;;137;5809;3837;1972;314;162;
41;Woensdag 8 februari 1995;586;315;271;360;184;176;78;78;;;;;;;157;5368;3587;1781;296;204;
42;Donderdag 9 februari 1995;582;301;281;380;184;196;126;126;;;;;;;163;5360;3538;1822;403;176;
43;Vrijdag 10 februari 1995;572;289;283;379;191;188;298;298;;;;;;;130;5794;3850;1944;215;172;
44;Zaterdag 11 februari 1995;427;208;219;358;168;190;38;38;;;;;;;0;206;143;63;4;11;
45;Zondag 12 februari 1995;431;216;215;346;189;157;3;3;;;;;;;0;37;16;21;6;6;
46;Maandag 13 februari 1995;498;258;240;391;203;188;60;60;;;;;;;154;7008;4779;2229;350;233;
47;Dinsdag 14 februari 1995;608;326;282;354;169;185;258;258;;;;;;;149;5934;4082;1852;346;216;
48;Woensdag 15 februari 1995;620;317;303;358;175;183;108;108;;;;;;;122;7836;5459;2377;359;205;
49;Donderdag 16 februari 1995;553;300;253;339;173;166;137;137;;;;;;;171;5851;3921;1930;282;212;
50;Vrijdag 17 februari 1995;556;302;254;416;215;201;300;300;;;;;;;121;5487;3726;1761;304;161;
51;Zaterdag 18 februari 1995;445;224;221;342;171;171;29;29;;;;;;;0;301;234;67;6;8;
52;Zondag 19 februari 1995;477;247;230;351;194;157;1;1;;;;;;;0;42;31;11;8;3;
53;Maandag 20 februari 1995;590;304;286;355;197;158;90;90;;;;;;;167;8628;6002;2626;372;271;
54;Dinsdag 21 februari 1995;588;301;287;345;185;160;101;101;;;;;;;162;5736;3810;1926;320;159;
55;Woensdag 22 februari 1995;540;279;261;366;172;194;130;130;;;;;;;129;5754;3908;1846;336;156;
56;Donderdag 23 februari 1995;537;283;254;359;176;183;175;175;;;;;;;152;5927;3929;1998;327;177;
57;Vrijdag 24 februari 1995;552;282;270;363;179;184;323;323;;;;;;;178;6639;4377;2262;256;265;
58;Zaterdag 25 februari 1995;436;229;207;364;172;192;31;31;;;;;;;0;492;331;161;13;8;
59;Zondag 26 februari 1995;476;253;223;358;187;171;3;3;;;;;;;0;60;45;15;0;4;
60;Maandag 27 februari 1995;499;267;232;327;172;155;81;81;;;;;;;120;7570;5045;2525;284;176;
61;Dinsdag 28 februari 1995;539;297;242;370;190;180;102;102;;;;;;;121;6682;4591;2091;311;180;
62;Totaal maart 1995;16205;8286;7919;12069;6084;5985;4514;4514;;;;;;;3141;156273;104376;51897;7596;5284;
63;Woensdag 1 maart 1995;584;299;285;354;177;177;111;111;;;;;;;91;24035;16895;7140;526;590;
64;Donderdag 2 maart 1995;594;296;298;360;183;177;152;152;;;;;;;127;7045;4664;2381;362;207;
65;Vrijdag 3 maart 1995;553;272;281;382;192;190;350;350;;;;;;;115;6106;3887;2219;271;201;
66;Zaterdag 4 maart 1995;435;231;204;330;162;168;35;35;;;;;;;1;201;141;60;2;12;
67;Zondag 5 maart 1995;412;219;193;367;187;180;2;2;;;;;;;1;61;40;21;4;5;
68;Maandag 6 maart 1995;521;260;261;398;209;189;106;106;;;;;;;134;7885;5128;2757;377;206;
69;Dinsdag 7 maart 1995;627;333;294;418;213;205;90;90;;;;;;;117;5796;3604;2192;349;182;
70;Woensdag 8 maart 1995;535;286;249;400;189;211;76;76;;;;;;;141;5551;3693;1858;288;151;
71;Donderdag 9 maart 1995;569;297;272;395;210;185;139;139;;;;;;;131;5663;3731;1932;355;166;
72;Vrijdag 10 maart 1995;551;268;283;369;194;175;366;366;;;;;;;149;6049;4059;1990;313;168;
73;Zaterdag 11 maart 1995;452;229;223;410;198;212;26;26;;;;;;;0;268;177;91;4;10;
74;Zondag 12 maart 1995;393;187;206;380;181;199;2;2;;;;;;;0;35;20;15;4;9;
75;Maandag 13 maart 1995;540;280;260;430;223;207;63;63;;;;;;;150;6925;4655;2270;346;257;
76;Dinsdag 14 maart 1995;574;299;275;416;189;227;101;101;;;;;;;159;4917;3155;1762;301;156;
77;Woensdag 15 maart 1995;554;273;281;409;203;206;143;143;;;;;;;148;7963;5656;2307;349;266;
78;Donderdag 16 maart 1995;554;298;256;388;183;205;152;152;;;;;;;117;5073;3237;1836;345;208;
79;Vrijdag 17 maart 1995;530;277;253;373;202;171;399;399;;;;;;;116;4744;3106;1638;233;218;
80;Zaterdag 18 maart 1995;432;208;224;393;197;196;43;43;;;;;;;1;298;230;68;1;19;
81;Zondag 19 maart 1995;403;201;202;391;199;192;7;7;;;;;;;0;35;29;6;2;11;
82;Maandag 20 maart 1995;540;296;244;383;200;183;108;108;;;;;;;139;7042;4737;2305;342;215;
83;Dinsdag 21 maart 1995;550;270;280;389;205;184;185;185;;;;;;;138;4572;2935;1637;332;178;
84;Woensdag 22 maart 1995;518;279;239;376;184;192;122;122;;;;;;;157;4498;2956;1542;323;172;
85;Donderdag 23 maart 1995;594;283;311;428;196;232;163;163;;;;;;;154;4586;2901;1685;295;187;
86;Vrijdag 24 maart 1995;565;306;259;446;229;217;489;489;;;;;;;130;5323;3523;1800;263;190;
87;Zaterdag 25 maart 1995;459;219;240;425;202;223;54;54;;;;;;;1;555;401;154;4;12;
88;Zondag 26 maart 1995;403;217;186;339;178;161;6;6;;;;;;;0;54;41;13;0;13;
89;Maandag 27 maart 1995;545;264;281;394;204;190;91;91;;;;;;;167;7179;4996;2183;381;277;
90;Dinsdag 28 maart 1995;569;290;279;385;190;195;91;91;;;;;;;136;4738;3097;1641;282;223;
91;Woensdag 29 maart 1995;539;288;251;385;218;167;107;107;;;;;;;153;4543;2978;1565;309;182;
92;Donderdag 30 maart 1995;577;292;285;368;178;190;180;180;;;;;;;149;5591;3657;1934;347;249;
93;Vrijdag 31 maart 1995;533;269;264;388;209;179;555;555;;;;;;;119;8942;6047;2895;286;344;
94;Totaal april 1995;14906;7573;7333;11412;5742;5670;5708;5708;;;;;;;2427;124171;81948;42223;6288;4292;
95;Zaterdag 1 april 1995;434;219;215;381;183;198;116;116;;;;;;;0;3897;2718;1179;29;93;
96;Zondag 2 april 1995;401;196;205;333;166;167;4;4;;;;;;;0;58;43;15;4;7;
97;Maandag 3 april 1995;526;272;254;420;228;192;80;80;;;;;;;139;19805;13491;6314;429;487;
98;Dinsdag 4 april 1995;590;293;297;392;195;197;97;97;;;;;;;106;5712;3677;2035;368;230;
99;Woensdag 5 april 1995;540;266;274;415;211;204;123;123;;;;;;;116;5241;3231;2010;321;184;
100;Donderdag 6 april 1995;531;260;271;395;201;194;196;196;;;;;;;123;4972;3122;1850;399;202;
101;Vrijdag 7 april 1995;531;268;263;373;175;198;681;681;;;;;;;134;4804;3047;1757;281;164;
102;Zaterdag 8 april 1995;414;223;191;351;163;188;62;62;;;;;;;0;399;293;106;4;13;
103;Zondag 9 april 1995;389;181;208;371;182;189;3;3;;;;;;;0;44;32;12;7;10;
104;Maandag 10 april 1995;545;274;271;385;199;186;110;110;;;;;;;136;7327;4909;2418;349;251;
105;Dinsdag 11 april 1995;587;285;302;376;195;181;97;97;;;;;;;123;4555;2950;1605;353;205;
106;Woensdag 12 april 1995;554;291;263;389;209;180;153;153;;;;;;;138;4510;2832;1678;294;169;
107;Donderdag 13 april 1995;565;280;285;405;213;192;249;249;;;;;;;135;5395;3438;1957;334;198;
108;Vrijdag 14 april 1995;508;281;227;400;213;187;48;48;;;;;;;17;1364;1000;364;47;47;
109;Zaterdag 15 april 1995;414;196;218;345;169;176;32;32;;;;;;;1;1060;726;334;1;19;
110;Zondag 16 april 1995;444;229;215;345;185;160;5;5;;;;;;;0;125;94;31;6;1;
111;Maandag 17 april 1995;393;198;195;342;161;181;10;10;;;;;;;3;220;150;70;1;9;
112;Dinsdag 18 april 1995;519;243;276;396;202;194;147;147;;;;;;;193;10399;7185;3214;437;305;
113;Woensdag 19 april 1995;562;282;280;397;193;204;145;145;;;;;;;138;4846;3068;1778;377;149;
114;Donderdag 20 april 1995;560;271;289;370;184;186;289;289;;;;;;;104;5336;3399;1937;337;195;
115;Vrijdag 21 april 1995;552;276;276;408;203;205;978;978;;;;;;;128;5134;3318;1816;289;158;
116;Zaterdag 22 april 1995;416;219;197;403;206;197;93;93;;;;;;;1;509;384;125;11;9;
117;Zondag 23 april 1995;406;214;192;375;189;186;4;4;;;;;;;0;55;20;35;1;5;
118;Maandag 24 april 1995;541;287;254;414;211;203;163;163;;;;;;;119;7507;4999;2508;338;275;
119;Dinsdag 25 april 1995;581;325;256;402;192;210;148;148;;;;;;;127;4577;2983;1594;322;208;
120;Woensdag 26 april 1995;542;303;239;375;192;183;210;210;;;;;;;151;4474;2940;1534;357;184;
121;Donderdag 27 april 1995;534;276;258;360;187;173;369;369;;;;;;;145;4719;2991;1728;336;182;
122;Vrijdag 28 april 1995;544;267;277;352;164;188;1043;1043;;;;;;;150;6566;4481;2085;250;306;
123;Zaterdag 29 april 1995;393;206;187;405;214;191;47;47;;;;;;;0;325;249;76;2;9;
124;Zondag 30 april 1995;390;192;198;337;157;180;6;6;;;;;;;0;236;178;58;4;18;
125;Totaal mei 1995;16167;8312;7855;11180;5640;5540;9794;9794;;;;;;;3059;136854;90720;46134;6672;4612;
126;Maandag 1 mei 1995;553;273;280;364;191;173;112;112;;;;;;;92;23218;15480;7738;330;563;
127;Dinsdag 2 mei 1995;539;258;281;379;193;186;147;147;;;;;;;169;7254;4930;2324;376;279;
128;Woensdag 3 mei 1995;629;328;301;372;190;182;245;245;;;;;;;144;4943;3181;1762;310;205;
129;Donderdag 4 mei 1995;558;306;252;364;178;186;127;127;;;;;;;132;5359;3456;1903;316;158;
130;Vrijdag 5 mei 1995;479;238;241;393;199;194;47;47;;;;;;;0;240;192;48;10;9;
131;Zaterdag 6 mei 1995;488;232;256;364;204;160;121;121;;;;;;;0;217;149;68;1;7;
132;Zondag 7 mei 1995;456;227;229;392;183;209;8;8;;;;;;;0;52;38;14;1;9;
133;Maandag 8 mei 1995;563;289;274;398;213;185;134;134;;;;;;;137;7725;5030;2695;382;269;
134;Dinsdag 9 mei 1995;594;296;298;354;174;180;239;239;;;;;;;196;4405;2808;1597;337;182;
135;Woensdag 10 mei 1995;562;291;271;345;179;166;242;242;;;;;;;172;4962;3363;1599;350;189;
136;Donderdag 11 mei 1995;529;283;246;365;178;187;477;477;;;;;;;145;4627;2933;1694;312;152;
137;Vrijdag 12 mei 1995;585;296;289;365;193;172;1499;1499;;;;;;;136;4839;3232;1607;275;135;
138;Zaterdag 13 mei 1995;429;243;186;318;164;154;101;101;;;;;;;1;287;205;82;7;16;
139;Zondag 14 mei 1995;405;205;200;341;169;172;5;5;;;;;;;1;69;46;23;5;7;
140;Maandag 15 mei 1995;524;281;243;350;181;169;157;157;;;;;;;138;10486;7298;3188;364;286;
141;Dinsdag 16 mei 1995;585;306;279;361;192;169;138;138;;;;;;;192;4867;3115;1752;387;163;
142;Woensdag 17 mei 1995;601;307;294;394;198;196;252;252;;;;;;;168;3820;2443;1377;266;129;
143;Donderdag 18 mei 1995;523;275;248;370;177;193;588;588;;;;;;;147;4655;3076;1579;323;169;
144;Vrijdag 19 mei 1995;521;281;240;339;177;162;1692;1692;;;;;;;139;4663;3083;1580;232;172;
145;Zaterdag 20 mei 1995;423;206;217;368;172;196;228;228;;;;;;;0;550;383;167;0;17;
146;Zondag 21 mei 1995;398;214;184;300;150;150;5;5;;;;;;;4;83;50;33;2;4;
147;Maandag 22 mei 1995;543;264;279;346;151;195;173;173;;;;;;;148;7128;4957;2171;364;219;
148;Dinsdag 23 mei 1995;599;306;293;336;185;151;246;246;;;;;;;149;4442;2869;1573;314;147;
149;Woensdag 24 mei 1995;593;279;314;379;196;183;1375;1375;;;;;;;124;4974;3127;1847;307;196;
150;Donderdag 25 mei 1995;508;267;241;373;190;183;15;15;;;;;;;3;294;207;87;6;13;
151;Vrijdag 26 mei 1995;493;284;209;390;175;215;605;605;;;;;;;16;1265;882;383;20;56;
152;Zaterdag 27 mei 1995;436;227;209;327;173;154;127;127;;;;;;;0;443;309;134;4;8;
153;Zondag 28 mei 1995;429;220;209;317;153;164;10;10;;;;;;;0;80;39;41;1;8;
154;Maandag 29 mei 1995;475;241;234;366;188;178;190;190;;;;;;;139;9029;6186;2843;427;373;
155;Dinsdag 30 mei 1995;552;273;279;376;182;194;189;189;;;;;;;201;5836;3798;2038;324;216;
156;Woensdag 31 mei 1995;595;316;279;374;192;182;300;300;;;;;;;166;6042;3855;2187;319;256;
157;Totaal juni 1995;16124;8262;7862;10508;5322;5186;12427;12427;;;;;;;2918;138235;90251;47984;7195;5069;
158;Donderdag 1 juni 1995;563;290;273;322;174;148;621;621;;;;;;;106;24526;16640;7886;384;453;
159;Vrijdag 2 juni 1995;560;266;294;345;172;173;1458;1458;;;;;;;119;5089;3195;1894;267;198;
160;Zaterdag 3 juni 1995;414;208;206;357;180;177;154;154;;;;;;;0;256;184;72;1;11;
161;Zondag 4 juni 1995;383;194;189;345;171;174;7;7;;;;;;;1;28;16;12;1;6;
162;Maandag 5 juni 1995;452;235;217;307;162;145;15;15;;;;;;;3;202;129;73;11;11;
163;Dinsdag 6 juni 1995;567;296;271;360;188;172;169;169;;;;;;;95;6522;4367;2155;399;240;
164;Woensdag 7 juni 1995;631;327;304;334;161;173;230;230;;;;;;;141;4846;3121;1725;364;171;
165;Donderdag 8 juni 1995;587;317;270;316;164;152;465;465;;;;;;;147;5577;3815;1762;349;199;
166;Vrijdag 9 juni 1995;565;291;274;345;175;170;1390;1390;;;;;;;110;4878;3294;1584;262;193;
167;Zaterdag 10 juni 1995;450;233;217;324;150;174;186;186;;;;;;;3;580;454;126;7;16;
168;Zondag 11 juni 1995;436;232;204;333;180;153;5;5;;;;;;;0;38;22;16;1;5;
169;Maandag 12 juni 1995;538;273;265;354;183;171;170;170;;;;;;;159;6697;4452;2245;449;231;
170;Dinsdag 13 juni 1995;547;298;249;326;163;163;102;102;;;;;;;175;4275;2736;1539;326;180;
171;Woensdag 14 juni 1995;596;303;293;338;181;157;236;236;;;;;;;147;3948;2505;1443;242;149;
172;Donderdag 15 juni 1995;580;310;270;308;165;143;432;432;;;;;;;153;7365;5043;2322;333;248;
173;Vrijdag 16 juni 1995;583;297;286;357;166;191;1412;1412;;;;;;;163;5195;3478;1717;262;193;
174;Zaterdag 17 juni 1995;466;220;246;333;172;161;186;186;;;;;;;1;345;243;102;9;19;
175;Zondag 18 juni 1995;415;235;180;336;177;159;6;6;;;;;;;1;58;46;12;14;18;
176;Maandag 19 juni 1995;572;274;298;368;173;195;129;129;;;;;;;138;6363;4009;2354;357;223;
177;Dinsdag 20 juni 1995;607;319;288;390;201;189;159;159;;;;;;;142;4582;2934;1648;338;182;
178;Woensdag 21 juni 1995;621;323;298;348;170;178;334;334;;;;;;;131;4025;2518;1507;313;133;
179;Donderdag 22 juni 1995;563;291;272;326;173;153;453;453;;;;;;;117;4189;2541;1648;358;160;
180;Vrijdag 23 juni 1995;589;276;313;364;185;179;1393;1393;;;;;;;112;5035;3252;1783;290;241;
181;Zaterdag 24 juni 1995;464;237;227;354;185;169;166;166;;;;;;;0;670;441;229;2;17;
182;Zondag 25 juni 1995;436;200;236;348;184;164;5;5;;;;;;;0;172;116;56;9;9;
183;Maandag 26 juni 1995;560;300;260;404;201;203;175;175;;;;;;;119;7393;4719;2674;404;335;
184;Dinsdag 27 juni 1995;620;316;304;385;185;200;178;178;;;;;;;132;4502;2731;1771;337;231;
185;Woensdag 28 juni 1995;591;301;290;389;201;188;277;277;;;;;;;120;4680;2853;1827;291;260;
186;Donderdag 29 juni 1995;587;297;290;388;175;213;474;474;;;;;;;205;5358;3410;1948;453;279;
187;Vrijdag 30 juni 1995;581;303;278;404;205;199;1440;1440;;;;;;;178;10841;6987;3854;362;458;
188;Totaal juli 1995;16698;8627;8071;11288;5552;5736;6825;6825;;;;;;;2901;148393;92919;55474;8628;6738;
189;Zaterdag 1 juli 1995;463;240;223;333;153;180;186;186;;;;;;;1;7384;4850;2534;61;180;
190;Zondag 2 juli 1995;442;216;226;360;182;178;4;4;;;;;;;0;69;45;24;6;36;
191;Maandag 3 juli 1995;549;267;282;330;156;174;148;148;;;;;;;161;20790;13523;7267;515;720;
192;Dinsdag 4 juli 1995;558;285;273;370;169;201;153;153;;;;;;;155;6095;3644;2451;539;254;
193;Woensdag 5 juli 1995;583;295;288;350;191;159;197;197;;;;;;;173;5583;3229;2354;395;298;
194;Donderdag 6 juli 1995;568;295;273;367;176;191;359;359;;;;;;;143;5350;3204;2146;375;227;
195;Vrijdag 7 juli 1995;624;306;318;337;171;166;1183;1183;;;;;;;116;5556;3380;2176;303;260;
196;Zaterdag 8 juli 1995;471;255;216;379;195;184;133;133;;;;;;;0;526;340;186;12;17;
197;Zondag 9 juli 1995;501;248;253;356;190;166;6;6;;;;;;;0;28;10;18;9;7;
198;Maandag 10 juli 1995;550;288;262;450;213;237;152;152;;;;;;;151;7599;4875;2724;517;363;
199;Dinsdag 11 juli 1995;635;311;324;467;234;233;140;140;;;;;;;139;4822;2976;1846;334;188;
200;Woensdag 12 juli 1995;635;343;292;368;187;181;193;193;;;;;;;162;4666;2809;1857;392;238;
201;Donderdag 13 juli 1995;586;312;274;391;182;209;222;222;;;;;;;123;4796;2898;1898;374;258;
202;Vrijdag 14 juli 1995;563;285;278;399;195;204;973;973;;;;;;;119;6658;4067;2591;297;298;
203;Zaterdag 15 juli 1995;481;256;225;382;175;207;97;97;;;;;;;2;1677;1126;551;18;47;
204;Zondag 16 juli 1995;414;221;193;351;157;194;2;2;;;;;;;0;179;130;49;6;20;
205;Maandag 17 juli 1995;517;275;242;371;168;203;120;120;;;;;;;137;10872;7279;3593;474;397;
206;Dinsdag 18 juli 1995;586;292;294;341;177;164;145;145;;;;;;;149;4713;2867;1846;394;269;
207;Woensdag 19 juli 1995;573;299;274;348;169;179;151;151;;;;;;;144;4562;2776;1786;413;240;
208;Donderdag 20 juli 1995;568;284;284;357;185;172;260;260;;;;;;;138;5346;3286;2060;411;254;
209;Vrijdag 21 juli 1995;595;305;290;410;194;216;572;572;;;;;;;111;4893;3012;1881;323;205;
210;Zaterdag 22 juli 1995;488;248;240;323;169;154;67;67;;;;;;;1;620;398;222;8;7;
211;Zondag 23 juli 1995;408;218;190;301;165;136;9;9;;;;;;;1;75;38;37;9;2;
212;Maandag 24 juli 1995;551;312;239;383;195;188;151;151;;;;;;;151;7581;4998;2583;470;317;
213;Dinsdag 25 juli 1995;601;320;281;344;175;169;145;145;;;;;;;159;4988;2986;2002;399;255;
214;Woensdag 26 juli 1995;569;294;275;326;168;158;160;160;;;;;;;152;4089;2449;1640;335;275;
215;Donderdag 27 juli 1995;591;321;270;352;152;200;207;207;;;;;;;111;4702;2729;1973;364;279;
216;Vrijdag 28 juli 1995;558;283;275;336;167;169;472;472;;;;;;;96;5496;3487;2009;271;293;
217;Zaterdag 29 juli 1995;469;232;237;348;175;173;66;66;;;;;;;1;427;278;149;0;28;
218;Zondag 30 juli 1995;451;224;227;377;194;183;8;8;;;;;;;0;171;115;56;8;18;
219;Maandag 31 juli 1995;550;297;253;381;173;208;144;144;;;;;;;105;8080;5115;2965;596;488;
220;Totaal augustus 1995;16491;8429;8062;10928;5429;5499;8630;8630;;;;;;;2823;146576;88298;58278;10334;6705;
221;Dinsdag 1 augustus 1995;603;301;302;419;185;234;176;176;;;;;;;155;28705;18667;10038;625;845;
222;Woensdag 2 augustus 1995;575;293;282;420;200;220;137;137;;;;;;;106;4864;2751;2113;432;244;
223;Donderdag 3 augustus 1995;571;308;263;438;211;227;197;197;;;;;;;125;4886;2992;1894;424;186;
224;Vrijdag 4 augustus 1995;544;266;278;366;181;185;578;578;;;;;;;146;4859;2894;1965;350;216;
225;Zaterdag 5 augustus 1995;489;248;241;373;184;189;113;113;;;;;;;0;344;230;114;2;20;
226;Zondag 6 augustus 1995;430;214;216;347;176;171;13;13;;;;;;;0;55;25;30;3;8;
227;Maandag 7 augustus 1995;526;253;273;344;162;182;152;152;;;;;;;125;6619;4146;2473;518;305;
228;Dinsdag 8 augustus 1995;606;305;301;367;193;174;184;184;;;;;;;113;4629;2665;1964;531;201;
229;Woensdag 9 augustus 1995;561;294;267;327;166;161;152;152;;;;;;;137;4142;2443;1699;403;231;
230;Donderdag 10 augustus 1995;556;286;270;404;192;212;227;227;;;;;;;128;4829;2886;1943;394;208;
231;Vrijdag 11 augustus 1995;561;277;284;310;166;144;682;682;;;;;;;106;4452;2639;1813;395;203;
232;Zaterdag 12 augustus 1995;493;238;255;374;171;203;101;101;;;;;;;0;457;289;168;8;41;
233;Zondag 13 augustus 1995;489;272;217;347;164;183;5;5;;;;;;;0;56;35;21;1;15;
234;Maandag 14 augustus 1995;523;274;249;323;152;171;155;155;;;;;;;113;7194;4312;2882;512;420;
235;Dinsdag 15 augustus 1995;567;299;268;350;185;165;169;169;;;;;;;162;8406;5099;3307;404;353;
236;Woensdag 16 augustus 1995;545;276;269;355;176;179;184;184;;;;;;;114;4821;2858;1963;455;242;
237;Donderdag 17 augustus 1995;561;298;263;315;152;163;328;328;;;;;;;120;4443;2533;1910;550;225;
238;Vrijdag 18 augustus 1995;576;296;280;370;190;180;1089;1089;;;;;;;102;4804;2804;2000;324;216;
239;Zaterdag 19 augustus 1995;427;238;189;326;154;172;123;123;;;;;;;1;391;221;170;4;27;
240;Zondag 20 augustus 1995;451;221;230;341;162;179;4;4;;;;;;;0;262;126;136;7;10;
241;Maandag 21 augustus 1995;539;275;264;333;164;169;168;168;;;;;;;72;6936;4112;2824;447;373;
242;Dinsdag 22 augustus 1995;566;267;299;348;184;164;159;159;;;;;;;103;4075;2174;1901;463;191;
243;Woensdag 23 augustus 1995;611;319;292;383;202;181;216;216;;;;;;;97;3819;2163;1656;368;207;
244;Donderdag 24 augustus 1995;547;289;258;330;185;145;456;456;;;;;;;116;4183;2413;1770;444;202;
245;Vrijdag 25 augustus 1995;554;283;271;371;167;204;1489;1489;;;;;;;87;5254;3126;2128;394;251;
246;Zaterdag 26 augustus 1995;431;208;223;354;175;179;182;182;;;;;;;1;560;353;207;5;18;
247;Zondag 27 augustus 1995;404;205;199;308;154;154;9;9;;;;;;;0;88;46;42;3;22;
248;Maandag 28 augustus 1995;519;250;269;329;176;153;182;182;;;;;;;116;6837;4195;2642;538;372;
249;Dinsdag 29 augustus 1995;530;278;252;314;167;147;163;163;;;;;;;162;4577;2610;1967;461;244;
250;Woensdag 30 augustus 1995;552;293;259;303;163;140;273;273;;;;;;;148;4725;2713;2012;437;298;
251;Donderdag 31 augustus 1995;584;305;279;339;170;169;564;564;;;;;;;168;6304;3778;2526;432;311;
252;Totaal september 1995;16222;8302;7920;10199;5177;5022;12108;12108;;;;;;;2798;142530;87034;55496;9083;6000;
253;Vrijdag 1 september 1995;583;288;295;365;193;172;1754;1754;;;;;;;129;27911;17378;10533;433;889;
254;Zaterdag 2 september 1995;409;211;198;309;159;150;215;215;;;;;;;0;277;187;90;9;18;
255;Zondag 3 september 1995;475;250;225;319;142;177;6;6;;;;;;;1;67;20;47;7;13;
256;Maandag 4 september 1995;514;259;255;352;190;162;167;167;;;;;;;164;7014;4083;2931;582;373;
257;Dinsdag 5 september 1995;594;278;316;327;143;184;244;244;;;;;;;149;5409;2910;2499;475;213;
258;Woensdag 6 september 1995;579;301;278;342;178;164;299;299;;;;;;;147;4595;2392;2203;502;208;
259;Donderdag 7 september 1995;583;303;280;317;158;159;551;551;;;;;;;159;4933;2849;2084;486;190;
260;Vrijdag 8 september 1995;540;272;268;346;161;185;1455;1455;;;;;;;121;4891;2919;1972;340;190;
261;Zaterdag 9 september 1995;443;222;221;344;175;169;202;202;;;;;;;0;435;319;116;3;21;
262;Zondag 10 september 1995;452;243;209;334;171;163;7;7;;;;;;;0;216;154;62;4;17;
263;Maandag 11 september 1995;604;304;300;319;157;162;134;134;;;;;;;115;6524;4045;2479;457;320;
264;Dinsdag 12 september 1995;595;306;289;350;180;170;157;157;;;;;;;135;4451;2563;1888;401;221;
265;Woensdag 13 september 1995;601;297;304;360;196;164;181;181;;;;;;;139;4207;2469;1738;404;191;
266;Donderdag 14 september 1995;498;257;241;332;166;166;503;503;;;;;;;140;5047;2978;2069;442;193;
267;Vrijdag 15 september 1995;589;293;296;329;165;164;1428;1428;;;;;;;131;9054;5949;3105;341;253;
268;Zaterdag 16 september 1995;436;224;212;310;155;155;180;180;;;;;;;1;688;509;179;6;26;
269;Zondag 17 september 1995;464;226;238;348;185;163;6;6;;;;;;;0;76;43;33;2;11;
270;Maandag 18 september 1995;539;278;261;363;191;172;163;163;;;;;;;131;6800;4395;2405;430;301;
271;Dinsdag 19 september 1995;589;281;308;356;176;180;140;140;;;;;;;125;4455;2551;1904;435;209;
272;Woensdag 20 september 1995;582;318;264;342;166;176;248;248;;;;;;;156;4847;2914;1933;407;229;
273;Donderdag 21 september 1995;557;294;263;325;160;165;475;475;;;;;;;86;4487;2668;1819;432;203;
274;Vrijdag 22 september 1995;567;294;273;330;182;148;1276;1276;;;;;;;110;4925;3092;1833;385;208;
275;Zaterdag 23 september 1995;433;220;213;370;197;173;128;128;;;;;;;0;954;674;280;2;22;
276;Zondag 24 september 1995;502;259;243;351;170;181;6;6;;;;;;;0;120;88;32;4;18;
277;Maandag 25 september 1995;583;292;291;325;164;161;137;137;;;;;;;122;7646;4908;2738;469;359;
278;Dinsdag 26 september 1995;624;311;313;342;177;165;132;132;;;;;;;121;4295;2606;1689;460;243;
279;Woensdag 27 september 1995;545;280;265;358;176;182;209;209;;;;;;;154;4350;2666;1684;369;229;
280;Donderdag 28 september 1995;655;371;284;363;197;166;405;405;;;;;;;124;5161;3073;2088;437;270;
281;Vrijdag 29 september 1995;622;313;309;339;176;163;1160;1160;;;;;;;136;7302;4621;2681;343;308;
282;Zaterdag 30 september 1995;465;257;208;332;171;161;140;140;;;;;;;2;1393;1011;382;16;54;
283;Totaal oktober 1995;16508;8419;8089;11030;5604;5426;6411;6411;;;;;;;2892;146527;93638;52889;9211;5560;
284;Zondag 1 oktober 1995;443;231;212;307;162;145;9;9;;;;;;;1;8328;5488;2840;32;160;
285;Maandag 2 oktober 1995;570;303;267;340;184;156;131;131;;;;;;;158;17578;11717;5861;507;558;
286;Dinsdag 3 oktober 1995;659;331;328;356;182;174;112;112;;;;;;;115;5406;3288;2118;565;215;
287;Woensdag 4 oktober 1995;640;338;302;370;173;197;177;177;;;;;;;140;5042;3022;2020;409;216;
288;Donderdag 5 oktober 1995;597;300;297;365;193;172;318;318;;;;;;;126;4979;3103;1876;413;191;
289;Vrijdag 6 oktober 1995;598;307;291;358;173;185;962;962;;;;;;;102;5111;3200;1911;348;197;
290;Zaterdag 7 oktober 1995;423;217;206;379;212;167;116;116;;;;;;;0;758;558;200;3;26;
291;Zondag 8 oktober 1995;455;243;212;357;185;172;5;5;;;;;;;0;144;106;38;3;8;
292;Maandag 9 oktober 1995;566;278;288;392;202;190;122;122;;;;;;;118;6357;4167;2190;506;270;
293;Dinsdag 10 oktober 1995;622;321;301;361;205;156;134;134;;;;;;;107;5199;3308;1891;486;239;
294;Woensdag 11 oktober 1995;624;299;325;382;206;176;164;164;;;;;;;124;4353;2617;1736;362;156;
295;Donderdag 12 oktober 1995;582;297;285;382;205;177;251;251;;;;;;;157;4697;2877;1820;440;175;
296;Vrijdag 13 oktober 1995;537;276;261;360;174;186;561;561;;;;;;;155;5039;3177;1862;331;210;
297;Zaterdag 14 oktober 1995;437;232;205;368;179;189;99;99;;;;;;;0;952;667;285;2;36;
298;Zondag 15 oktober 1995;441;220;221;355;178;177;6;6;;;;;;;0;1589;1132;457;9;53;
299;Maandag 16 oktober 1995;542;273;269;338;189;149;130;130;;;;;;;134;9973;6606;3367;459;352;
300;Dinsdag 17 oktober 1995;547;290;257;357;176;181;119;119;;;;;;;153;4910;3055;1855;500;205;
301;Woensdag 18 oktober 1995;590;304;286;364;182;182;163;163;;;;;;;194;4127;2532;1595;411;181;
302;Donderdag 19 oktober 1995;568;303;265;348;185;163;266;266;;;;;;;116;4358;2719;1639;409;187;
303;Vrijdag 20 oktober 1995;536;286;250;356;170;186;897;897;;;;;;;148;5869;3766;2103;232;186;
304;Zaterdag 21 oktober 1995;453;234;219;313;156;157;77;77;;;;;;;0;1037;723;314;1;19;
305;Zondag 22 oktober 1995;420;206;214;341;163;178;3;3;;;;;;;1;138;80;58;1;13;
306;Maandag 23 oktober 1995;532;266;266;332;157;175;105;105;;;;;;;130;6814;4336;2478;382;229;
307;Dinsdag 24 oktober 1995;591;287;304;374;195;179;108;108;;;;;;;129;4596;2753;1843;398;227;
308;Woensdag 25 oktober 1995;556;278;278;368;182;186;156;156;;;;;;;134;4754;3012;1742;379;151;
309;Donderdag 26 oktober 1995;537;272;265;357;166;191;241;241;;;;;;;106;4576;2821;1755;401;205;
310;Vrijdag 27 oktober 1995;549;278;271;347;165;182;696;696;;;;;;;90;5337;3358;1979;343;244;
311;Zaterdag 28 oktober 1995;411;187;224;354;186;168;60;60;;;;;;;1;1207;809;398;0;31;
312;Zondag 29 oktober 1995;402;209;193;323;172;151;4;4;;;;;;;0;117;83;34;2;20;
313;Maandag 30 oktober 1995;545;279;266;354;167;187;115;115;;;;;;;117;7480;4934;2546;497;355;
314;Dinsdag 31 oktober 1995;535;274;261;372;180;192;104;104;;;;;;;136;5702;3624;2078;380;245;
315;Totaal november 1995;15199;7814;7385;11234;5677;5557;4045;4045;;;;;;;2967;144268;94387;49881;8868;4761;
316;Woensdag 1 november 1995;590;296;294;367;172;195;118;118;;;;;;;141;25683;17323;8360;428;498;
317;Donderdag 2 november 1995;520;276;244;376;206;170;136;136;;;;;;;149;5309;3333;1976;425;328;
318;Vrijdag 3 november 1995;552;267;285;373;196;177;427;427;;;;;;;140;4874;3099;1775;303;220;
319;Zaterdag 4 november 1995;462;242;220;343;181;162;49;49;;;;;;;0;603;408;195;4;25;
320;Zondag 5 november 1995;428;223;205;388;206;182;2;2;;;;;;;0;215;179;36;2;19;
321;Maandag 6 november 1995;495;255;240;375;191;184;88;88;;;;;;;123;6701;4473;2228;451;245;
322;Dinsdag 7 november 1995;560;272;288;358;179;179;82;82;;;;;;;138;4743;3064;1679;374;216;
323;Woensdag 8 november 1995;553;286;267;368;195;173;104;104;;;;;;;120;4142;2623;1519;406;183;
324;Donderdag 9 november 1995;537;276;261;356;191;165;130;130;;;;;;;139;4226;2509;1717;434;177;
325;Vrijdag 10 november 1995;563;291;272;373;183;190;477;477;;;;;;;115;5021;3090;1931;364;166;
326;Zaterdag 11 november 1995;422;223;199;343;190;153;46;46;;;;;;;0;912;669;243;5;14;
327;Zondag 12 november 1995;418;227;191;360;181;179;2;2;;;;;;;0;129;83;46;4;4;
328;Maandag 13 november 1995;485;239;246;385;197;188;77;77;;;;;;;136;6176;4004;2172;404;177;
329;Dinsdag 14 november 1995;566;288;278;422;211;211;99;99;;;;;;;144;4534;2863;1671;443;126;
330;Woensdag 15 november 1995;580;299;281;406;180;226;139;139;;;;;;;156;8828;5832;2996;429;239;0.0
331;Donderdag 16 november 1995;547;293;254;394;188;206;144;144;;;;;;;137;5098;3262;1836;415;174;
332;Vrijdag 17 november 1995;482;246;236;381;206;175;420;420;;;;;;;136;4763;3076;1687;297;180;
333;Zaterdag 18 november 1995;448;228;220;361;158;203;37;37;;;;;;;1;1079;769;310;3;20;
334;Zondag 19 november 1995;376;177;199;342;189;153;2;2;;;;;;;0;109;91;18;3;7;
335;Maandag 20 november 1995;497;257;240;378;207;171;94;94;;;;;;;114;7545;5176;2369;464;187;
336;Dinsdag 21 november 1995;548;282;266;358;180;178;97;97;;;;;;;131;4388;2784;1604;423;175;
337;Woensdag 22 november 1995;563;288;275;368;183;185;110;110;;;;;;;154;4140;2598;1542;420;165;
338;Donderdag 23 november 1995;528;253;275;382;185;197;171;171;;;;;;;143;4549;2814;1735;383;132;
339;Vrijdag 24 november 1995;502;270;232;403;214;189;436;436;;;;;;;125;5302;3551;1751;328;174;
340;Zaterdag 25 november 1995;433;225;208;350;182;168;41;41;;;;;;;0;1760;1272;488;10;13;
341;Zondag 26 november 1995;420;226;194;374;180;194;2;2;;;;;;;0;203;140;63;8;10;
342;Maandag 27 november 1995;484;229;255;410;194;216;92;92;;;;;;;127;7357;4919;2438;447;325;
343;Dinsdag 28 november 1995;548;294;254;405;198;207;111;111;;;;;;;138;4490;2861;1629;391;159;
344;Woensdag 29 november 1995;560;286;274;354;189;165;136;136;;;;;;;131;4307;2785;1522;378;191;
345;Donderdag 30 november 1995;532;300;232;381;165;216;176;176;;;;;;;129;7082;4737;2345;422;212;
346;Totaal december 1995;14733;7513;7220;13747;6920;6827;4939;4939;;;;;;;2397;142493;93904;48589;7241;4690;
347;Vrijdag 1 december 1995;493;235;258;392;201;191;513;513;;;;;;;101;27102;18362;8740;366;469;
348;Zaterdag 2 december 1995;392;201;191;361;186;175;36;36;;;;;;;1;741;498;243;3;15;
349;Zondag 3 december 1995;350;199;151;343;184;159;2;2;;;;;;;0;91;72;19;1;13;
350;Maandag 4 december 1995;492;265;227;385;200;185;110;110;;;;;;;151;6450;4168;2282;383;235;
351;Dinsdag 5 december 1995;461;230;231;391;197;194;105;105;;;;;;;114;4809;3101;1708;439;169;
352;Woensdag 6 december 1995;521;254;267;394;209;185;115;115;;;;;;;144;4255;2585;1670;346;170;
353;Donderdag 7 december 1995;534;275;259;393;198;195;122;122;;;;;;;159;4567;2895;1672;384;171;
354;Vrijdag 8 december 1995;523;279;244;427;216;211;363;363;;;;;;;123;5056;3335;1721;361;201;
355;Zaterdag 9 december 1995;407;219;188;446;221;225;29;29;;;;;;;0;1104;825;279;7;36;
356;Zondag 10 december 1995;384;205;179;390;204;186;2;2;;;;;;;0;457;336;121;10;24;
357;Maandag 11 december 1995;511;278;233;422;209;213;121;121;;;;;;;147;6784;4717;2067;412;225;
358;Dinsdag 12 december 1995;541;298;243;448;238;210;178;178;;;;;;;128;4707;2981;1726;434;204;
359;Woensdag 13 december 1995;526;247;279;452;228;224;121;121;;;;;;;126;4386;2724;1662;396;185;
360;Donderdag 14 december 1995;536;256;280;436;217;219;212;212;;;;;;;107;5044;3316;1728;407;150;
361;Vrijdag 15 december 1995;563;287;276;433;201;232;571;571;;;;;;;108;11778;8337;3441;344;288;
362;Zaterdag 16 december 1995;438;244;194;452;216;236;67;67;;;;;;;0;2057;1479;578;6;17;
363;Zondag 17 december 1995;378;185;193;455;235;220;3;3;;;;;;;0;252;176;76;2;13;
364;Maandag 18 december 1995;532;271;261;448;219;229;186;186;;;;;;;155;8569;5596;2973;428;234;
365;Dinsdag 19 december 1995;532;275;257;490;255;235;179;179;;;;;;;127;4778;2953;1825;503;216;
366;Woensdag 20 december 1995;568;271;297;485;235;250;237;237;;;;;;;129;5974;3920;2054;415;235;
367;Donderdag 21 december 1995;495;264;231;436;227;209;352;352;;;;;;;141;5322;3439;1883;407;222;
368;Vrijdag 22 december 1995;565;292;273;532;258;274;579;579;;;;;;;109;6375;4047;2328;326;180;
369;Zaterdag 23 december 1995;454;224;230;451;225;226;48;48;;;;;;;0;1248;864;384;2;21;
370;Zondag 24 december 1995;408;197;211;449;226;223;2;2;;;;;;;0;219;155;64;3;4;
371;Maandag 25 december 1995;385;182;203;498;262;236;2;2;;;;;;;1;154;119;35;2;4;
372;Dinsdag 26 december 1995;358;176;182;491;255;236;9;9;;;;;;;1;66;50;16;2;14;
373;Woensdag 27 december 1995;454;215;239;490;239;251;141;141;;;;;;;111;6108;3968;2140;308;307;
374;Donderdag 28 december 1995;565;302;263;515;251;264;215;215;;;;;;;116;6229;3853;2376;291;268;
375;Vrijdag 29 december 1995;546;261;285;466;223;243;277;277;;;;;;;96;6163;3976;2187;250;280;
376;Zaterdag 30 december 1995;431;228;203;499;250;249;35;35;;;;;;;2;907;591;316;1;32;
377;Zondag 31 december 1995;390;198;192;477;235;242;7;7;;;;;;;0;741;466;275;2;88;
378;Totaal op zondag in 1995;22538;11556;10982;18931;9588;9343;273;273;;;;;;;15;17768;12108;5660;272;878;
379;Totaal op maandag in 1995;27454;14035;13419;19391;9786;9605;6049;6049;;;;;;;6502;427578;282275;145303;21017;15655;
380;Totaal op dinsdag in 1995;29652;15078;14574;19715;9948;9767;6993;6993;;;;;;;7176;295187;187337;107850;20343;11502;
381;Totaal op woensdag in 1995;29893;15338;14555;19503;9871;9632;9974;9974;;;;;;;7283;314561;202994;111567;19324;11490;
382;Totaal op donderdag in 1995;29224;15164;14060;19409;9681;9728;14128;14128;;;;;;;6923;287088;182238;104850;19714;10766;
383;Totaal op vrijdag in 1995;28786;14664;14122;19678;9849;9829;39347;39347;;;;;;;6241;331626;214292;117334;15077;11832;
384;Totaal op zaterdag in 1995;22966;11725;11241;19048;9506;9542;4705;4705;;;;;;;30;43554;30115;13439;352;1198;
385;Totaal 1996;189521;97576;91945;137561;69008;68553;85140;85140;;;;;;;34871;1714185;1084411;629774;108749;65325;82687.0
386;Totaal januari 1996;15272;7868;7404;13912;6902;7010;2900;2900;;;;;;;3458;145382;93682;51700;9296;5342;5645.0
387;Maandag 1 januari 1996;408;211;197;507;257;250;5;5;;;;;;;0;11872;7781;4091;39;284;3.0
388;Dinsdag 2 januari 1996;503;269;234;498;237;261;104;104;;;;;;;108;10512;6929;3583;580;471;20.0
389;Woensdag 3 januari 1996;556;261;295;509;258;251;103;103;;;;;;;138;6534;3944;2590;538;285;243.0
390;Donderdag 4 januari 1996;564;299;265;537;275;262;116;116;;;;;;;108;6540;4091;2449;493;220;150.0
391;Vrijdag 5 januari 1996;554;287;267;496;242;254;194;194;;;;;;;120;6368;3925;2443;380;252;19.0
392;Zaterdag 6 januari 1996;389;193;196;483;229;254;27;27;;;;;;;1;881;642;239;14;20;2.0
393;Zondag 7 januari 1996;377;194;183;516;256;260;2;2;;;;;;;0;176;126;50;5;25;1.0
394;Maandag 8 januari 1996;556;269;287;481;207;274;93;93;;;;;;;143;7498;4758;2740;447;276;19.0
395;Dinsdag 9 januari 1996;559;277;282;468;234;234;97;97;;;;;;;170;4866;2947;1919;419;164;28.0
396;Woensdag 10 januari 1996;553;278;275;500;235;265;110;110;;;;;;;157;5281;3308;1973;423;198;17.0
397;Donderdag 11 januari 1996;529;290;239;475;232;243;105;105;;;;;;;204;4652;2924;1728;400;149;17.0
398;Vrijdag 12 januari 1996;523;285;238;459;229;230;256;256;;;;;;;179;5264;3440;1824;316;182;1236.0
399;Zaterdag 13 januari 1996;379;195;184;454;223;231;29;29;;;;;;;1;833;593;240;1;18;1.0
400;Zondag 14 januari 1996;391;203;188;420;212;208;14;14;;;;;;;0;245;175;70;6;13;4.0
401;Maandag 15 januari 1996;493;231;262;447;235;212;85;85;;;;;;;185;11131;7468;3663;469;294;22.0
402;Dinsdag 16 januari 1996;557;268;289;461;226;235;64;64;;;;;;;156;5201;3395;1806;424;200;9.0
403;Woensdag 17 januari 1996;486;266;220;439;209;230;93;93;;;;;;;161;4320;2741;1579;401;159;18.0
404;Donderdag 18 januari 1996;497;239;258;407;205;202;130;130;;;;;;;125;4644;2989;1655;431;163;17.0
405;Vrijdag 19 januari 1996;513;273;240;412;204;208;238;238;;;;;;;177;4563;2928;1635;350;230;431.0
406;Zaterdag 20 januari 1996;418;218;200;403;208;195;46;46;;;;;;;0;1495;1070;425;2;18;0.0
407;Zondag 21 januari 1996;388;208;180;401;197;204;3;3;;;;;;;2;150;103;47;7;19;1.0
408;Maandag 22 januari 1996;522;250;272;396;196;200;83;83;;;;;;;183;6238;4022;2216;377;198;327.0
409;Dinsdag 23 januari 1996;539;287;252;383;198;185;82;82;;;;;;;208;4313;2768;1545;450;192;713.0
410;Woensdag 24 januari 1996;495;236;259;412;230;182;104;104;;;;;;;168;4063;2581;1482;413;127;489.0
411;Donderdag 25 januari 1996;538;289;249;422;202;220;135;135;;;;;;;175;4647;2966;1681;385;163;807.0
412;Vrijdag 26 januari 1996;567;312;255;431;223;208;309;309;;;;;;;122;4801;3050;1751;278;157;12.0
413;Zaterdag 27 januari 1996;408;218;190;418;198;220;33;33;;;;;;;0;1291;939;352;2;47;2.0
414;Zondag 28 januari 1996;402;215;187;393;198;195;2;2;;;;;;;0;280;171;109;3;21;4.0
415;Maandag 29 januari 1996;526;273;253;420;219;201;77;77;;;;;;;142;5832;3806;2026;438;247;542.0
416;Dinsdag 30 januari 1996;561;306;255;430;203;227;74;74;;;;;;;153;4845;3060;1785;395;208;333.0
417;Woensdag 31 januari 1996;521;268;253;434;225;209;87;87;;;;;;;172;6046;4042;2004;410;342;158.0
418;Totaal februari 1996;14972;7743;7229;12376;6116;6260;3367;3367;;;;;;;3024;120567;75175;45392;7617;4599;3598.0
419;Donderdag 1 februari 1996;547;292;255;430;210;220;114;114;;;;;;;144;23550;15767;7783;418;448;459.0
420;Vrijdag 2 februari 1996;539;273;266;422;200;222;257;257;;;;;;;151;4785;2941;1844;301;207;459.0
421;Zaterdag 3 februari 1996;459;237;222;449;228;221;32;32;;;;;;;3;582;394;188;6;19;0.0
422;Zondag 4 februari 1996;436;219;217;407;197;210;2;2;;;;;;;0;110;69;41;4;19;0.0
423;Maandag 5 februari 1996;521;291;230;446;215;231;85;85;;;;;;;138;6196;3873;2323;448;326;22.0
424;Dinsdag 6 februari 1996;587;300;287;443;224;219;62;62;;;;;;;167;4583;2763;1820;471;210;276.0
425;Woensdag 7 februari 1996;536;280;256;418;218;200;96;96;;;;;;;150;4137;2440;1697;393;158;12.0
426;Donderdag 8 februari 1996;504;257;247;448;214;234;103;103;;;;;;;126;3946;2394;1552;367;191;20.0
427;Vrijdag 9 februari 1996;503;270;233;420;218;202;239;239;;;;;;;142;2809;1250;1559;271;153;952.0
428;Zaterdag 10 februari 1996;459;231;228;436;210;226;26;26;;;;;;;0;481;151;330;2;27;983.0
429;Zondag 11 februari 1996;445;210;235;478;227;251;6;6;;;;;;;2;80;24;56;2;12;0.0
430;Maandag 12 februari 1996;519;282;237;467;223;244;94;94;;;;;;;145;2700;709;1991;390;199;18.0
431;Dinsdag 13 februari 1996;602;320;282;439;222;217;63;63;;;;;;;170;2219;675;1544;431;182;19.0
432;Woensdag 14 februari 1996;536;268;268;436;216;220;296;296;;;;;;;157;3951;2403;1548;318;184;12.0
433;Donderdag 15 februari 1996;539;292;247;426;220;206;129;129;;;;;;;133;7891;5322;2569;373;215;21.0
434;Vrijdag 16 februari 1996;543;279;264;431;203;228;245;245;;;;;;;158;5030;3271;1759;249;147;20.0
435;Zaterdag 17 februari 1996;479;233;246;431;231;200;22;22;;;;;;;2;864;601;263;0;37;1.0
436;Zondag 18 februari 1996;436;221;215;416;210;206;3;3;;;;;;;1;163;122;41;1;10;1.0
437;Maandag 19 februari 1996;556;298;258;399;183;216;79;79;;;;;;;158;4682;3023;1659;323;148;15.0
438;Dinsdag 20 februari 1996;565;291;274;377;180;197;72;72;;;;;;;116;3838;2476;1362;276;128;12.0
439;Woensdag 21 februari 1996;567;295;272;430;204;226;104;104;;;;;;;151;4198;2692;1506;330;202;25.0
440;Donderdag 22 februari 1996;512;251;261;439;217;222;145;145;;;;;;;142;4452;2837;1615;335;182;18.0
441;Vrijdag 23 februari 1996;541;277;264;422;210;212;266;266;;;;;;;125;5032;3229;1803;272;195;14.0
442;Zaterdag 24 februari 1996;457;239;218;411;198;213;29;29;;;;;;;2;1748;1232;516;9;32;0.0
443;Zondag 25 februari 1996;412;212;200;409;223;186;10;10;;;;;;;1;373;251;122;4;21;0.0
444;Maandag 26 februari 1996;520;261;259;398;195;203;112;112;;;;;;;122;6772;4358;2414;444;265;21.0
445;Dinsdag 27 februari 1996;564;306;258;408;206;202;101;101;;;;;;;150;4555;2858;1697;441;222;28.0
446;Woensdag 28 februari 1996;589;309;280;428;211;217;155;155;;;;;;;137;5132;3313;1819;371;225;95.0
447;Donderdag 29 februari 1996;499;249;250;412;203;209;420;420;;;;;;;131;5708;3737;1971;367;235;95.0
448;Totaal maart 1996;15531;8002;7529;12264;6057;6207;4580;4580;;;;;;;3100;134151;86917;47234;8162;4939;12321.0
449;Vrijdag 1 maart 1996;560;278;282;393;188;205;458;458;;;;;;;145;26189;17406;8783;381;537;636.0
450;Zaterdag 2 maart 1996;397;199;198;419;226;193;61;61;;;;;;;0;597;419;178;1;27;1.0
451;Zondag 3 maart 1996;417;229;188;420;219;201;3;3;;;;;;;0;124;71;53;4;19;2.0
452;Maandag 4 maart 1996;523;279;244;382;189;193;119;119;;;;;;;181;6616;4128;2488;477;246;25.0
453;Dinsdag 5 maart 1996;573;274;299;411;197;214;92;92;;;;;;;182;5024;3128;1896;418;181;1811.0
454;Woensdag 6 maart 1996;516;256;260;384;170;214;114;114;;;;;;;168;4582;2892;1690;379;183;953.0
455;Donderdag 7 maart 1996;509;244;265;384;190;194;144;144;;;;;;;164;4859;3114;1745;375;171;666.0
456;Vrijdag 8 maart 1996;509;265;244;383;196;187;325;325;;;;;;;139;4779;3009;1770;281;167;710.0
457;Zaterdag 9 maart 1996;400;214;186;380;180;200;46;46;;;;;;;1;893;649;244;11;17;0.0
458;Zondag 10 maart 1996;464;233;231;390;221;169;3;3;;;;;;;0;359;262;97;2;26;2.0
459;Maandag 11 maart 1996;503;255;248;376;184;192;99;99;;;;;;;145;5892;3886;2006;442;195;21.0
460;Dinsdag 12 maart 1996;557;289;268;443;234;209;99;99;;;;;;;177;3991;2462;1529;407;119;10.0
461;Woensdag 13 maart 1996;499;256;243;385;212;173;89;89;;;;;;;153;4007;2520;1487;358;197;1111.0
462;Donderdag 14 maart 1996;582;315;267;391;195;196;166;166;;;;;;;125;4195;2651;1544;435;190;958.0
463;Vrijdag 15 maart 1996;526;268;258;434;208;226;395;395;;;;;;;131;8531;5724;2807;300;205;20.0
464;Zaterdag 16 maart 1996;424;231;193;382;173;209;49;49;;;;;;;2;1202;855;347;11;33;1.0
465;Zondag 17 maart 1996;389;203;186;396;194;202;2;2;;;;;;;1;126;87;39;5;14;1.0
466;Maandag 18 maart 1996;560;303;257;388;188;200;93;93;;;;;;;115;5978;3786;2192;413;349;516.0
467;Dinsdag 19 maart 1996;543;291;252;393;188;205;87;87;;;;;;;126;4075;2605;1470;424;192;519.0
468;Woensdag 20 maart 1996;517;255;262;389;200;189;147;147;;;;;;;136;4281;2808;1473;355;203;585.0
469;Donderdag 21 maart 1996;567;295;272;418;207;211;301;301;;;;;;;120;3946;2497;1449;365;169;178.0
470;Vrijdag 22 maart 1996;515;266;249;399;189;210;473;473;;;;;;;134;4650;3035;1615;294;184;991.0
471;Zaterdag 23 maart 1996;444;217;227;399;190;209;51;51;;;;;;;1;1406;1034;372;8;25;0.0
472;Zondag 24 maart 1996;405;212;193;398;173;225;7;7;;;;;;;0;165;109;56;4;17;2.0
473;Maandag 25 maart 1996;537;269;268;376;181;195;120;120;;;;;;;138;6460;4171;2289;446;257;467.0
474;Dinsdag 26 maart 1996;600;328;272;382;187;195;126;126;;;;;;;134;4167;2544;1623;430;249;535.0
475;Woensdag 27 maart 1996;543;270;273;390;200;190;132;132;;;;;;;160;3879;2420;1459;355;172;562.0
476;Donderdag 28 maart 1996;583;311;272;398;189;209;192;192;;;;;;;182;4788;3087;1701;462;281;561.0
477;Vrijdag 29 maart 1996;531;273;258;424;221;203;522;522;;;;;;;140;6200;4003;2197;314;211;476.0
478;Zaterdag 30 maart 1996;412;210;202;365;180;185;60;60;;;;;;;0;1339;970;369;1;43;1.0
479;Zondag 31 maart 1996;426;214;212;392;188;204;5;5;;;;;;;0;851;585;266;4;60;0.0
480;Totaal april 1996;15090;7669;7421;11675;5870;5805;5492;5492;;;;;;;2904;129642;84428;45214;7770;4686;10780.0
481;Maandag 1 april 1996;564;295;269;419;219;200;282;282;;;;;;;143;28027;18711;9316;563;667;808.0
482;Dinsdag 2 april 1996;584;310;274;417;199;218;110;110;;;;;;;152;5243;3203;2040;450;217;612.0
483;Woensdag 3 april 1996;554;266;288;408;189;219;153;153;;;;;;;147;4486;2729;1757;420;202;1359.0
484;Donderdag 4 april 1996;566;290;276;385;192;193;305;305;;;;;;;156;5506;3500;2006;473;193;584.0
485;Vrijdag 5 april 1996;543;250;293;415;212;203;56;56;;;;;;;15;1308;928;380;39;58;2.0
486;Zaterdag 6 april 1996;423;208;215;364;195;169;36;36;;;;;;;0;771;529;242;2;18;0.0
487;Zondag 7 april 1996;408;227;181;357;179;178;9;9;;;;;;;0;157;112;45;1;12;3.0
488;Maandag 8 april 1996;395;194;201;338;176;162;9;9;;;;;;;0;395;304;91;5;16;1.0
489;Dinsdag 9 april 1996;514;266;248;383;199;184;118;118;;;;;;;203;6625;4374;2251;511;286;32.0
490;Woensdag 10 april 1996;560;283;277;385;212;173;146;146;;;;;;;155;5285;3429;1856;452;236;142.0
491;Donderdag 11 april 1996;539;266;273;389;193;196;183;183;;;;;;;126;4594;2898;1696;439;230;21.0
492;Vrijdag 12 april 1996;567;267;300;368;189;179;654;654;;;;;;;117;5045;3265;1780;338;234;2027.0
493;Zaterdag 13 april 1996;433;229;204;396;202;194;43;43;;;;;;;2;846;626;220;7;16;5.0
494;Zondag 14 april 1996;433;220;213;383;181;202;6;6;;;;;;;0;185;125;60;0;11;0.0
495;Maandag 15 april 1996;509;252;257;386;196;190;112;112;;;;;;;153;10433;6920;3513;487;278;12.0
496;Dinsdag 16 april 1996;553;288;265;391;201;190;114;114;;;;;;;151;4650;2902;1748;426;167;1137.0
497;Woensdag 17 april 1996;587;309;278;411;190;221;146;146;;;;;;;178;3887;2436;1451;362;142;481.0
498;Donderdag 18 april 1996;537;264;273;417;204;213;224;224;;;;;;;203;4189;2671;1518;392;210;11.0
499;Vrijdag 19 april 1996;540;270;270;416;186;230;677;677;;;;;;;129;4464;2850;1614;326;185;1139.0
500;Zaterdag 20 april 1996;438;242;196;411;213;198;105;105;;;;;;;0;1656;1229;427;1;19;2.0
501;Zondag 21 april 1996;450;213;237;424;214;210;5;5;;;;;;;0;183;122;61;4;22;4.0
502;Maandag 22 april 1996;538;270;268;391;193;198;113;113;;;;;;;186;5881;3889;1992;443;230;25.0
503;Dinsdag 23 april 1996;562;306;256;411;225;186;132;132;;;;;;;172;4011;2531;1480;398;172;1159.0
504;Woensdag 24 april 1996;493;261;232;408;212;196;207;207;;;;;;;173;4036;2567;1469;332;147;691.0
505;Donderdag 25 april 1996;506;257;249;379;189;190;337;337;;;;;;;161;4899;3183;1716;400;224;486.0
506;Vrijdag 26 april 1996;524;268;256;359;177;182;921;921;;;;;;;133;5417;3471;1946;336;222;14.0
507;Zaterdag 27 april 1996;406;200;206;401;197;204;119;119;;;;;;;2;1755;1248;507;2;61;2.0
508;Zondag 28 april 1996;418;210;208;354;180;174;7;7;;;;;;;0;263;172;91;1;17;2.0
509;Maandag 29 april 1996;494;265;229;384;198;186;149;149;;;;;;;43;4266;2618;1648;159;135;17.0
510;Dinsdag 30 april 1996;452;223;229;325;158;167;14;14;;;;;;;4;1179;886;293;1;59;2.0
511;Totaal mei 1996;15901;8206;7695;11271;5733;5538;11722;11722;;;;;;;3056;143951;93635;50316;7955;4628;11115.0
512;Woensdag 1 mei 1996;522;265;257;354;186;168;189;189;;;;;;;97;24547;16486;8061;425;490;11.0
513;Donderdag 2 mei 1996;541;264;277;379;199;180;330;330;;;;;;;188;6787;4367;2420;518;192;1976.0
514;Vrijdag 3 mei 1996;572;299;273;343;167;176;966;966;;;;;;;126;5497;3390;2107;378;192;770.0
515;Zaterdag 4 mei 1996;477;251;226;356;187;169;42;42;;;;;;;0;716;514;202;5;26;0.0
516;Zondag 5 mei 1996;425;239;186;357;177;180;7;7;;;;;;;1;256;188;68;3;17;3.0
517;Maandag 6 mei 1996;504;272;232;364;182;182;199;199;;;;;;;134;7211;4733;2478;490;225;23.0
518;Dinsdag 7 mei 1996;573;285;288;353;186;167;181;181;;;;;;;168;4963;3124;1839;396;137;21.0
519;Woensdag 8 mei 1996;522;256;266;339;169;170;200;200;;;;;;;158;4395;2745;1650;336;169;18.0
520;Donderdag 9 mei 1996;543;274;269;349;181;168;402;402;;;;;;;187;4694;2921;1773;385;213;15.0
521;Vrijdag 10 mei 1996;521;271;250;347;186;161;1326;1326;;;;;;;153;5430;3597;1833;308;222;15.0
522;Zaterdag 11 mei 1996;454;236;218;386;192;194;163;163;;;;;;;4;1061;771;290;0;22;0.0
523;Zondag 12 mei 1996;395;199;196;381;185;196;9;9;;;;;;;0;217;164;53;0;8;3.0
524;Maandag 13 mei 1996;529;273;256;374;193;181;126;126;;;;;;;186;5590;3726;1864;429;165;1675.0
525;Dinsdag 14 mei 1996;572;291;281;378;189;189;239;239;;;;;;;164;4476;2790;1686;371;156;172.0
526;Woensdag 15 mei 1996;592;316;276;331;179;152;1284;1284;;;;;;;114;8896;5939;2957;357;226;1338.0
527;Donderdag 16 mei 1996;468;227;241;365;178;187;18;18;;;;;;;0;681;476;205;3;30;0.0
528;Vrijdag 17 mei 1996;510;265;245;398;215;183;474;474;;;;;;;15;1652;1105;547;38;41;3.0
529;Zaterdag 18 mei 1996;467;246;221;394;203;191;144;144;;;;;;;0;962;668;294;2;6;0.0
530;Zondag 19 mei 1996;409;193;216;358;167;191;6;6;;;;;;;0;104;78;26;8;15;2.0
531;Maandag 20 mei 1996;554;289;265;363;183;180;233;233;;;;;;;186;8524;5616;2908;488;260;522.0
532;Dinsdag 21 mei 1996;564;300;264;346;167;179;187;187;;;;;;;168;4839;3038;1801;376;199;1027.0
533;Woensdag 22 mei 1996;565;289;276;365;183;182;290;290;;;;;;;154;4422;2756;1666;381;157;9.0
534;Donderdag 23 mei 1996;545;286;259;363;189;174;558;558;;;;;;;178;4555;2804;1751;394;181;14.0
535;Vrijdag 24 mei 1996;529;291;238;369;185;184;1501;1501;;;;;;;118;5291;3372;1919;296;176;1438.0
536;Zaterdag 25 mei 1996;442;220;222;354;179;175;176;176;;;;;;;2;1978;1369;609;5;37;1.0
537;Zondag 26 mei 1996;422;220;202;354;177;177;9;9;;;;;;;2;237;175;62;0;19;1.0
538;Maandag 27 mei 1996;409;221;188;367;204;163;9;9;;;;;;;2;364;274;90;21;31;4.0
539;Dinsdag 28 mei 1996;540;267;273;356;177;179;220;220;;;;;;;115;6587;4183;2404;433;256;45.0
540;Woensdag 29 mei 1996;585;303;282;368;187;181;237;237;;;;;;;161;4751;2950;1801;377;203;16.0
541;Donderdag 30 mei 1996;575;302;273;374;195;179;522;522;;;;;;;137;5893;3757;2136;419;226;1969.0
542;Vrijdag 31 mei 1996;575;296;279;386;186;200;1475;1475;;;;;;;138;8375;5559;2816;313;331;24.0
543;Totaal juni 1996;15567;8068;7499;10672;5306;5366;11681;11681;;;;;;;2771;137427;88143;49284;7964;5296;8123.0
544;Zaterdag 1 juni 1996;430;232;198;351;159;192;255;255;;;;;;;0;14657;9928;4729;29;322;1.0
545;Zondag 2 juni 1996;375;185;190;321;157;164;5;5;;;;;;;0;131;91;40;9;26;0.0
546;Maandag 3 juni 1996;524;259;265;357;158;199;181;181;;;;;;;150;10936;7233;3703;547;292;26.0
547;Dinsdag 4 juni 1996;572;295;277;351;184;167;184;184;;;;;;;150;5296;3309;1987;383;173;172.0
548;Woensdag 5 juni 1996;570;303;267;374;184;190;255;255;;;;;;;138;4669;2867;1802;367;148;705.0
549;Donderdag 6 juni 1996;546;281;265;390;195;195;732;732;;;;;;;156;4801;3007;1794;374;219;467.0
550;Vrijdag 7 juni 1996;555;291;264;418;206;212;1395;1395;;;;;;;132;4405;2854;1551;308;213;19.0
551;Zaterdag 8 juni 1996;469;249;220;455;219;236;175;175;;;;;;;1;1193;834;359;4;25;0.0
552;Zondag 9 juni 1996;430;208;222;407;197;210;10;10;;;;;;;0;173;112;61;3;8;5.0
553;Maandag 10 juni 1996;534;270;264;350;179;171;164;164;;;;;;;161;6575;4312;2263;459;184;1415.0
554;Dinsdag 11 juni 1996;635;318;317;392;210;182;166;166;;;;;;;134;3990;2496;1494;416;202;22.0
555;Woensdag 12 juni 1996;576;300;276;365;189;176;230;230;;;;;;;122;4070;2476;1594;350;151;895.0
556;Donderdag 13 juni 1996;499;250;249;348;178;170;310;310;;;;;;;135;4285;2669;1616;391;144;19.0
557;Vrijdag 14 juni 1996;509;255;254;342;177;165;1454;1454;;;;;;;136;5802;3698;2104;250;185;348.0
558;Zaterdag 15 juni 1996;404;204;200;353;173;180;202;202;;;;;;;1;3627;2544;1083;9;75;1.0
559;Zondag 16 juni 1996;427;223;204;356;183;173;3;3;;;;;;;0;455;321;134;2;29;4.0
560;Maandag 17 juni 1996;581;308;273;333;159;174;169;169;;;;;;;128;7296;4857;2439;475;205;588.0
561;Dinsdag 18 juni 1996;548;277;271;341;164;177;163;163;;;;;;;162;4706;2870;1836;402;219;568.0
562;Woensdag 19 juni 1996;507;282;225;345;167;178;264;264;;;;;;;122;4134;2514;1620;395;130;15.0
563;Donderdag 20 juni 1996;526;300;226;324;153;171;543;543;;;;;;;153;5587;3546;2041;415;251;41.0
564;Vrijdag 21 juni 1996;588;314;274;364;181;183;1699;1699;;;;;;;132;5538;3557;1981;332;206;654.0
565;Zaterdag 22 juni 1996;472;247;225;349;189;160;197;197;;;;;;;1;1680;1165;515;4;13;2.0
566;Zondag 23 juni 1996;409;212;197;310;151;159;8;8;;;;;;;0;272;192;80;7;30;0.0
567;Maandag 24 juni 1996;552;300;252;331;158;173;197;197;;;;;;;136;6844;4459;2385;479;291;18.0
568;Dinsdag 25 juni 1996;600;310;290;345;170;175;189;189;;;;;;;151;5248;3240;2008;390;314;21.0
569;Woensdag 26 juni 1996;594;290;304;348;170;178;281;281;;;;;;;124;4646;2729;1917;426;343;22.0
570;Donderdag 27 juni 1996;618;297;321;364;176;188;549;549;;;;;;;121;5625;3424;2201;372;365;2084.0
571;Vrijdag 28 juni 1996;565;303;262;347;182;165;1488;1488;;;;;;;123;7684;4698;2986;346;357;11.0
572;Zaterdag 29 juni 1996;487;263;224;292;154;138;204;204;;;;;;;2;1583;1072;511;8;69;0.0
573;Zondag 30 juni 1996;465;242;223;349;184;165;9;9;;;;;;;0;1519;1069;450;12;107;0.0
574;Totaal juli 1996;16561;8515;8046;10933;5412;5521;7745;7745;;;;;;;2897;168803;103871;64932;10402;7322;3039.0
575;Maandag 1 juli 1996;570;288;282;352;165;187;188;188;;;;;;;115;34756;22086;12670;654;1003;30.0
576;Dinsdag 2 juli 1996;571;311;260;333;182;151;163;163;;;;;;;133;6079;3544;2535;508;266;23.0
577;Woensdag 3 juli 1996;574;301;273;337;170;167;220;220;;;;;;;128;5605;3354;2251;513;224;1833.0
578;Donderdag 4 juli 1996;579;297;282;386;193;193;381;381;;;;;;;123;5494;3357;2137;489;256;18.0
579;Vrijdag 5 juli 1996;565;267;298;352;172;180;1124;1124;;;;;;;128;6177;3824;2353;415;272;12.0
580;Zaterdag 6 juli 1996;448;234;214;342;173;169;175;175;;;;;;;2;1179;767;412;4;42;1.0
581;Zondag 7 juli 1996;407;198;209;331;153;178;6;6;;;;;;;0;248;153;95;3;48;1.0
582;Maandag 8 juli 1996;564;304;260;357;164;193;189;189;;;;;;;121;7475;4579;2896;553;348;21.0
583;Dinsdag 9 juli 1996;601;322;279;365;184;181;136;136;;;;;;;123;4969;2895;2074;464;229;24.0
584;Woensdag 10 juli 1996;613;313;300;321;151;170;205;205;;;;;;;129;5465;3339;2126;430;262;21.0
585;Donderdag 11 juli 1996;599;304;295;352;180;172;311;311;;;;;;;154;5092;3093;1999;445;223;844.0
586;Vrijdag 12 juli 1996;589;308;281;393;198;195;885;885;;;;;;;151;5880;3546;2334;349;313;7.0
587;Zaterdag 13 juli 1996;435;222;213;358;165;193;96;96;;;;;;;1;1190;778;412;1;40;0.0
588;Zondag 14 juli 1996;440;238;202;344;173;171;13;13;;;;;;;0;344;224;120;15;34;7.0
589;Maandag 15 juli 1996;589;302;287;354;184;170;174;174;;;;;;;140;12491;7829;4662;529;415;9.0
590;Dinsdag 16 juli 1996;580;304;276;348;159;189;170;170;;;;;;;144;5416;3288;2128;420;181;17.0
591;Woensdag 17 juli 1996;531;274;257;353;170;183;230;230;;;;;;;128;4466;2594;1872;378;191;8.0
592;Donderdag 18 juli 1996;609;319;290;369;185;184;270;270;;;;;;;169;4815;2937;1878;409;242;26.0
593;Vrijdag 19 juli 1996;594;298;296;345;173;172;652;652;;;;;;;130;4961;3152;1809;374;203;14.0
594;Zaterdag 20 juli 1996;426;218;208;341;176;165;108;108;;;;;;;3;1792;1212;580;5;61;0.0
595;Zondag 21 juli 1996;431;233;198;357;173;184;18;18;;;;;;;0;275;181;94;4;21;1.0
596;Maandag 22 juli 1996;547;241;306;357;181;176;208;208;;;;;;;118;6914;4266;2648;510;378;17.0
597;Dinsdag 23 juli 1996;553;296;257;375;188;187;159;159;;;;;;;102;4628;2625;2003;392;191;43.0
598;Woensdag 24 juli 1996;544;283;261;387;175;212;191;191;;;;;;;100;4120;2547;1573;434;220;15.0
599;Donderdag 25 juli 1996;523;255;268;364;184;180;271;271;;;;;;;102;4968;3026;1942;425;253;10.0
600;Vrijdag 26 juli 1996;505;262;243;381;198;183;523;523;;;;;;;117;4958;2966;1992;296;274;8.0
601;Zaterdag 27 juli 1996;466;224;242;317;159;158;108;108;;;;;;;0;1512;1038;474;12;60;0.0
602;Zondag 28 juli 1996;419;209;210;319;162;157;22;22;;;;;;;0;297;165;132;5;34;0.0
603;Maandag 29 juli 1996;533;274;259;347;168;179;217;217;;;;;;;115;6577;4078;2499;511;358;12.0
604;Dinsdag 30 juli 1996;580;312;268;351;175;176;160;160;;;;;;;110;4942;2893;2049;449;312;11.0
605;Woensdag 31 juli 1996;576;304;272;345;179;166;172;172;;;;;;;111;5718;3535;2183;406;368;6.0
606;Totaal augustus 1996;16680;8560;8120;10379;5253;5126;10288;10288;;;;;;;2772;151328;89178;62150;11502;6691;5050.0
607;Donderdag 1 augustus 1996;575;318;257;326;165;161;282;282;;;;;;;117;30419;18964;11455;589;785;12.0
608;Vrijdag 2 augustus 1996;531;283;248;328;166;162;555;555;;;;;;;100;5058;2955;2103;391;245;5.0
609;Zaterdag 3 augustus 1996;442;209;233;295;149;146;103;103;;;;;;;1;704;452;252;4;55;0.0
610;Zondag 4 augustus 1996;408;207;201;293;155;138;22;22;;;;;;;0;136;64;72;3;27;2.0
611;Maandag 5 augustus 1996;591;306;285;335;172;163;188;188;;;;;;;93;6557;3970;2587;578;338;9.0
612;Dinsdag 6 augustus 1996;592;301;291;355;168;187;202;202;;;;;;;110;4762;2790;1972;649;182;16.0
613;Woensdag 7 augustus 1996;561;283;278;371;194;177;209;209;;;;;;;126;4377;2505;1872;509;193;11.0
614;Donderdag 8 augustus 1996;609;303;306;322;166;156;260;260;;;;;;;151;4912;2864;2048;512;263;9.0
615;Vrijdag 9 augustus 1996;547;285;262;367;182;185;703;703;;;;;;;129;4317;2484;1833;381;200;17.0
616;Zaterdag 10 augustus 1996;492;252;240;351;181;170;110;110;;;;;;;0;1422;921;501;9;43;0.0
617;Zondag 11 augustus 1996;416;218;198;348;187;161;14;14;;;;;;;0;134;81;53;10;29;0.0
618;Maandag 12 augustus 1996;542;268;274;342;164;178;199;199;;;;;;;114;6618;3831;2787;646;250;21.0
619;Dinsdag 13 augustus 1996;577;290;287;354;191;163;154;154;;;;;;;127;4477;2529;1948;568;226;6.0
620;Woensdag 14 augustus 1996;592;326;266;340;163;177;230;230;;;;;;;115;4479;2550;1929;492;230;24.0
621;Donderdag 15 augustus 1996;585;304;281;341;165;176;356;356;;;;;;;115;9190;5357;3833;480;374;11.0
622;Vrijdag 16 augustus 1996;581;303;278;341;185;156;1031;1031;;;;;;;114;5654;3258;2396;443;195;15.0
623;Zaterdag 17 augustus 1996;441;214;227;322;159;163;140;140;;;;;;;1;948;585;363;10;51;1.0
624;Zondag 18 augustus 1996;432;219;213;317;146;171;9;9;;;;;;;1;249;159;90;7;44;2.0
625;Maandag 19 augustus 1996;573;292;281;364;190;174;178;178;;;;;;;122;6498;3726;2772;624;311;233.0
626;Dinsdag 20 augustus 1996;587;285;302;354;176;178;179;179;;;;;;;104;4815;2739;2076;572;297;1061.0
627;Woensdag 21 augustus 1996;653;335;318;342;177;165;273;273;;;;;;;135;4090;2368;1722;444;175;1164.0
628;Donderdag 22 augustus 1996;584;314;270;318;150;168;438;438;;;;;;;119;4664;2505;2159;465;232;1024.0
629;Vrijdag 23 augustus 1996;568;286;282;340;171;169;1310;1310;;;;;;;102;4888;2983;1905;394;213;16.0
630;Zaterdag 24 augustus 1996;469;243;226;333;174;159;199;199;;;;;;;2;1309;866;443;13;42;1.0
631;Zondag 25 augustus 1996;439;236;203;313;151;162;10;10;;;;;;;0;412;261;151;14;45;0.0
632;Maandag 26 augustus 1996;542;283;259;336;174;162;202;202;;;;;;;153;6646;3751;2895;703;374;25.0
633;Dinsdag 27 augustus 1996;585;302;283;317;165;152;165;165;;;;;;;154;4504;2461;2043;539;266;430.0
634;Woensdag 28 augustus 1996;609;325;284;355;179;176;261;261;;;;;;;185;4897;2789;2108;525;278;222.0
635;Donderdag 29 augustus 1996;572;276;296;320;168;152;490;490;;;;;;;141;5032;2760;2272;527;288;428.0
636;Vrijdag 30 augustus 1996;538;256;282;331;157;174;1566;1566;;;;;;;140;7472;4529;2943;391;344;285.0
637;Zaterdag 31 augustus 1996;447;238;209;308;163;145;250;250;;;;;;;1;1688;1121;567;10;96;0.0
638;Totaal september 1996;16430;8483;7947;10187;5166;5021;10928;10928;;;;;;;2857;143274;87047;56227;10967;6003;6714.0
639;Zondag 1 september 1996;433;217;216;306;148;158;4;4;;;;;;;0;14457;9011;5446;48;519;0.0
640;Maandag 2 september 1996;489;270;219;308;156;152;183;183;;;;;;;113;13140;7823;5317;808;418;19.0
641;Dinsdag 3 september 1996;563;272;291;300;154;146;182;182;;;;;;;120;5959;3306;2653;700;235;1662.0
642;Woensdag 4 september 1996;523;256;267;307;150;157;309;309;;;;;;;151;5185;2893;2292;608;189;396.0
643;Donderdag 5 september 1996;557;267;290;324;175;149;576;576;;;;;;;130;5282;2986;2296;659;263;415.0
644;Vrijdag 6 september 1996;544;269;275;311;150;161;1825;1825;;;;;;;141;4944;2837;2107;430;166;226.0
645;Zaterdag 7 september 1996;461;238;223;278;131;147;275;275;;;;;;;1;925;630;295;8;46;0.0
646;Zondag 8 september 1996;476;257;219;322;165;157;9;9;;;;;;;0;181;114;67;2;33;0.0
647;Maandag 9 september 1996;557;283;274;346;159;187;193;193;;;;;;;134;6211;3708;2503;563;307;608.0
648;Dinsdag 10 september 1996;617;316;301;322;160;162;165;165;;;;;;;124;5064;2935;2129;592;239;222.0
649;Woensdag 11 september 1996;571;303;268;317;148;169;228;228;;;;;;;141;4172;2410;1762;529;160;20.0
650;Donderdag 12 september 1996;616;312;304;318;166;152;516;516;;;;;;;158;4771;2863;1908;562;209;161.0
651;Vrijdag 13 september 1996;600;313;287;332;157;175;1071;1071;;;;;;;129;4754;2930;1824;350;219;11.0
652;Zaterdag 14 september 1996;482;266;216;334;164;170;192;192;;;;;;;0;1355;944;411;26;54;0.0
653;Zondag 15 september 1996;427;236;191;306;157;149;7;7;;;;;;;0;2132;1489;643;17;65;0.0
654;Maandag 16 september 1996;532;293;239;367;189;178;181;181;;;;;;;143;8714;5482;3232;630;408;492.0
655;Dinsdag 17 september 1996;637;326;311;307;157;150;166;166;;;;;;;133;4377;2563;1814;483;178;12.0
656;Woensdag 18 september 1996;615;351;264;371;189;182;237;237;;;;;;;103;4462;2638;1824;446;188;564.0
657;Donderdag 19 september 1996;606;316;290;377;176;201;430;430;;;;;;;127;4495;2639;1856;493;173;630.0
658;Vrijdag 20 september 1996;609;314;295;407;217;190;1461;1461;;;;;;;133;5576;3566;2010;397;188;12.0
659;Zaterdag 21 september 1996;493;267;226;371;193;178;188;188;;;;;;;0;1291;925;366;0;32;0.0
660;Zondag 22 september 1996;450;227;223;323;157;166;10;10;;;;;;;0;231;162;69;2;34;0.0
661;Maandag 23 september 1996;613;309;304;364;192;172;150;150;;;;;;;120;6038;3753;2285;487;307;412.0
662;Dinsdag 24 september 1996;628;297;331;355;192;163;165;165;;;;;;;145;4226;2456;1770;424;174;333.0
663;Woensdag 25 september 1996;624;325;299;422;241;181;203;203;;;;;;;138;4778;2858;1920;384;237;13.0
664;Donderdag 26 september 1996;641;312;329;360;192;168;407;407;;;;;;;153;4798;2930;1868;445;254;479.0
665;Vrijdag 27 september 1996;536;291;245;394;190;204;1276;1276;;;;;;;162;5117;3275;1842;363;236;12.0
666;Zaterdag 28 september 1996;488;239;249;340;184;156;151;151;;;;;;;0;1670;1183;487;5;46;0.0
667;Zondag 29 september 1996;435;220;215;347;175;172;6;6;;;;;;;0;251;150;101;4;42;0.0
668;Maandag 30 september 1996;607;321;286;351;182;169;162;162;;;;;;;158;8718;5588;3130;502;384;15.0
669;Totaal oktober 1996;16412;8387;8025;10747;5483;5264;6843;6843;;;;;;;3020;152063;95983;56080;10690;5422;6773.0
670;Dinsdag 1 oktober 1996;592;312;280;372;184;188;148;148;;;;;;;140;26474;17243;9231;738;637;23.0
671;Woensdag 2 oktober 1996;614;326;288;362;172;190;142;142;;;;;;;132;4917;2842;2075;600;268;15.0
672;Donderdag 3 oktober 1996;594;312;282;339;169;170;275;275;;;;;;;125;5094;2978;2116;559;214;11.0
673;Vrijdag 4 oktober 1996;554;296;258;383;186;197;904;904;;;;;;;107;4963;3041;1922;423;249;8.0
674;Zaterdag 5 oktober 1996;446;215;231;306;159;147;120;120;;;;;;;1;1065;791;274;0;45;0.0
675;Zondag 6 oktober 1996;402;196;206;354;195;159;7;7;;;;;;;1;168;133;35;12;24;0.0
676;Maandag 7 oktober 1996;566;310;256;387;195;192;139;139;;;;;;;116;6491;4097;2394;597;266;1529.0
677;Dinsdag 8 oktober 1996;563;266;297;340;166;174;124;124;;;;;;;135;4622;2860;1762;477;152;13.0
678;Woensdag 9 oktober 1996;564;294;270;350;179;171;140;140;;;;;;;112;4026;2392;1634;465;177;17.0
679;Donderdag 10 oktober 1996;560;295;265;327;169;158;344;344;;;;;;;138;5508;3401;2107;470;190;898.0
680;Vrijdag 11 oktober 1996;579;302;277;324;167;157;852;852;;;;;;;141;4631;2847;1784;396;205;11.0
681;Zaterdag 12 oktober 1996;460;240;220;343;177;166;72;72;;;;;;;3;1538;1117;421;6;29;1176.0
682;Zondag 13 oktober 1996;430;221;209;346;167;179;4;4;;;;;;;0;172;120;52;2;19;1.0
683;Maandag 14 oktober 1996;552;270;282;344;189;155;138;138;;;;;;;141;6693;4278;2415;538;248;14.0
684;Dinsdag 15 oktober 1996;581;292;289;365;173;192;144;144;;;;;;;142;8540;5637;2903;409;284;22.0
685;Woensdag 16 oktober 1996;559;294;265;313;159;154;191;191;;;;;;;200;4815;3023;1792;388;171;18.0
686;Donderdag 17 oktober 1996;562;282;280;361;186;175;248;248;;;;;;;132;4824;2900;1924;398;166;131.0
687;Vrijdag 18 oktober 1996;546;281;265;337;175;162;795;795;;;;;;;117;4905;3103;1802;330;158;14.0
688;Zaterdag 19 oktober 1996;452;229;223;330;171;159;102;102;;;;;;;0;1489;1031;458;1;43;1.0
689;Zondag 20 oktober 1996;407;188;219;327;166;161;6;6;;;;;;;0;627;426;201;6;37;2.0
690;Maandag 21 oktober 1996;530;272;258;358;191;167;145;145;;;;;;;102;6640;4298;2342;439;209;873.0
691;Dinsdag 22 oktober 1996;547;286;261;362;181;181;134;134;;;;;;;157;4551;2721;1830;422;144;537.0
692;Woensdag 23 oktober 1996;549;278;271;362;186;176;151;151;;;;;;;132;4317;2632;1685;444;155;14.0
693;Donderdag 24 oktober 1996;586;286;300;352;190;162;200;200;;;;;;;111;4623;2845;1778;443;173;614.0
694;Vrijdag 25 oktober 1996;517;252;265;352;175;177;687;687;;;;;;;131;5500;3528;1972;323;156;13.0
695;Zaterdag 26 oktober 1996;467;238;229;343;163;180;73;73;;;;;;;0;2036;1427;609;3;37;465.0
696;Zondag 27 oktober 1996;410;220;190;336;177;159;6;6;;;;;;;0;266;166;100;3;29;1.0
697;Maandag 28 oktober 1996;534;273;261;342;186;156;144;144;;;;;;;129;6780;4329;2451;472;251;21.0
698;Dinsdag 29 oktober 1996;580;292;288;338;171;167;97;97;;;;;;;135;4366;2600;1766;424;185;12.0
699;Woensdag 30 oktober 1996;545;285;260;337;165;172;125;125;;;;;;;126;5130;3160;1970;440;232;12.0
700;Donderdag 31 oktober 1996;564;284;280;355;194;161;186;186;;;;;;;114;6292;4017;2275;462;269;307.0
701;Totaal november 1996;15508;8085;7423;10970;5561;5409;4660;4660;;;;;;;2648;145166;93740;51426;9084;4873;5584.0
702;Vrijdag 1 november 1996;578;290;288;374;200;174;524;524;;;;;;;92;26900;17853;9047;506;593;5.0
703;Zaterdag 2 november 1996;476;242;234;345;182;163;47;47;;;;;;;1;806;578;228;4;44;1.0
704;Zondag 3 november 1996;427;243;184;313;147;166;4;4;;;;;;;0;141;74;67;3;27;0.0
705;Maandag 4 november 1996;504;276;228;396;194;202;123;123;;;;;;;86;6625;4104;2521;502;248;24.0
706;Dinsdag 5 november 1996;554;273;281;345;159;186;106;106;;;;;;;116;5091;3092;1999;466;172;851.0
707;Woensdag 6 november 1996;566;302;264;363;188;175;114;114;;;;;;;103;4495;2772;1723;439;147;1.0
708;Donderdag 7 november 1996;568;321;247;379;203;176;150;150;;;;;;;127;5108;3136;1972;429;181;525.0
709;Vrijdag 8 november 1996;562;274;288;346;177;169;424;424;;;;;;;110;4999;3175;1824;347;180;504.0
710;Zaterdag 9 november 1996;447;221;226;306;154;152;33;33;;;;;;;0;1343;977;366;0;20;0.0
711;Zondag 10 november 1996;419;219;200;378;182;196;4;4;;;;;;;0;527;410;117;1;23;4.0
712;Maandag 11 november 1996;532;285;247;376;186;190;138;138;;;;;;;124;6388;4124;2264;509;242;15.0
713;Dinsdag 12 november 1996;588;314;274;363;187;176;110;110;;;;;;;145;4482;2784;1698;493;183;499.0
714;Woensdag 13 november 1996;582;312;270;333;166;167;87;87;;;;;;;126;3932;2397;1535;390;150;270.0
715;Donderdag 14 november 1996;538;267;271;366;192;174;174;174;;;;;;;162;4802;3055;1747;425;186;17.0
716;Vrijdag 15 november 1996;587;294;293;382;177;205;465;465;;;;;;;130;9309;6285;3024;362;226;245.0
717;Zaterdag 16 november 1996;434;207;227;370;180;190;43;43;;;;;;;3;1753;1222;531;3;25;290.0
718;Zondag 17 november 1996;388;208;180;347;174;173;5;5;;;;;;;0;182;114;68;3;13;2.0
719;Maandag 18 november 1996;517;278;239;378;195;183;107;107;;;;;;;134;6795;4408;2387;524;220;24.0
720;Dinsdag 19 november 1996;593;316;277;375;190;185;101;101;;;;;;;110;4412;2749;1663;474;151;239.0
721;Woensdag 20 november 1996;559;284;275;370;179;191;137;137;;;;;;;113;4833;3038;1795;393;206;7.0
722;Donderdag 21 november 1996;535;287;248;356;173;183;180;180;;;;;;;137;4271;2684;1587;465;175;519.0
723;Vrijdag 22 november 1996;515;295;220;415;225;190;463;463;;;;;;;145;5207;3399;1808;352;180;12.0
724;Zaterdag 23 november 1996;429;218;211;381;189;192;35;35;;;;;;;3;2138;1513;625;3;29;0.0
725;Zondag 24 november 1996;432;206;226;361;178;183;0;0;;;;;;;0;241;166;75;4;28;0.0
726;Maandag 25 november 1996;546;287;259;366;202;164;147;147;;;;;;;149;7088;4730;2358;463;255;347.0
727;Dinsdag 26 november 1996;551;277;274;364;191;173;107;107;;;;;;;136;4273;2639;1634;379;183;116.0
728;Woensdag 27 november 1996;557;286;271;360;192;168;145;145;;;;;;;127;4309;2656;1653;412;192;648.0
729;Donderdag 28 november 1996;560;284;276;380;191;189;181;181;;;;;;;161;5434;3424;2010;420;228;13.0
730;Vrijdag 29 november 1996;506;277;229;408;202;206;464;464;;;;;;;108;6647;4301;2346;313;301;406.0
731;Zaterdag 30 november 1996;458;242;216;374;206;168;42;42;;;;;;;0;2635;1881;754;0;65;0.0
732;Totaal december 1996;15597;7990;7607;12175;6149;6026;4934;4934;;;;;;;2364;142431;92612;49819;7340;5524;3945.0
733;Zondag 1 december 1996;431;224;207;339;184;155;5;5;;;;;;;0;14361;9772;4589;48;261;1.0
734;Maandag 2 december 1996;537;261;276;361;185;176;138;138;;;;;;;133;12474;8359;4115;473;388;255.0
735;Dinsdag 3 december 1996;559;277;282;379;182;197;111;111;;;;;;;146;5467;3360;2107;421;198;14.0
736;Woensdag 4 december 1996;566;299;267;356;177;179;109;109;;;;;;;123;4799;2945;1854;439;194;17.0
737;Donderdag 5 december 1996;496;261;235;326;154;172;96;96;;;;;;;109;4301;2729;1572;345;228;519.0
738;Vrijdag 6 december 1996;522;273;249;389;195;194;345;345;;;;;;;157;4928;3147;1781;330;246;152.0
739;Zaterdag 7 december 1996;413;214;199;417;217;200;44;44;;;;;;;1;1561;1119;442;2;20;0.0
740;Zondag 8 december 1996;399;209;190;376;203;173;5;5;;;;;;;0;317;222;95;2;26;1.0
741;Maandag 9 december 1996;573;291;282;377;193;184;128;128;;;;;;;119;6421;4048;2373;461;265;250.0
742;Dinsdag 10 december 1996;594;281;313;404;220;184;140;140;;;;;;;155;4876;3163;1713;396;266;10.0
743;Woensdag 11 december 1996;555;275;280;354;168;186;147;147;;;;;;;105;4213;2691;1522;384;195;496.0
744;Donderdag 12 december 1996;569;300;269;397;197;200;278;278;;;;;;;138;5148;3306;1842;362;199;18.0
745;Vrijdag 13 december 1996;520;271;249;392;179;213;336;336;;;;;;;111;5106;3326;1780;312;209;147.0
746;Zaterdag 14 december 1996;401;212;189;415;220;195;60;60;;;;;;;0;2444;1745;699;3;47;84.0
747;Zondag 15 december 1996;439;208;231;369;180;189;1;1;;;;;;;0;2980;2181;799;7;73;2.0
748;Maandag 16 december 1996;519;259;260;431;233;198;167;167;;;;;;;138;10478;7084;3394;419;347;13.0
749;Dinsdag 17 december 1996;611;314;297;399;194;205;162;162;;;;;;;116;4863;3040;1823;406;196;153.0
750;Woensdag 18 december 1996;562;295;267;395;205;190;250;250;;;;;;;88;4598;2917;1681;395;208;107.0
751;Donderdag 19 december 1996;588;300;288;416;200;216;340;340;;;;;;;101;4532;2723;1809;389;185;172.0
752;Vrijdag 20 december 1996;562;292;270;360;177;183;820;820;;;;;;;84;7459;4963;2496;318;282;17.0
753;Zaterdag 21 december 1996;433;213;220;397;213;184;87;87;;;;;;;1;2299;1583;716;2;48;0.0
754;Zondag 22 december 1996;379;194;185;375;184;191;5;5;;;;;;;1;360;239;121;1;19;0.0
755;Maandag 23 december 1996;551;279;272;414;216;198;308;308;;;;;;;227;7847;4999;2848;473;341;943.0
756;Dinsdag 24 december 1996;576;318;258;424;218;206;207;207;;;;;;;142;4470;2774;1696;226;159;15.0
757;Woensdag 25 december 1996;431;228;203;442;221;221;15;15;;;;;;;1;167;122;45;0;12;2.0
758;Donderdag 26 december 1996;385;213;172;386;195;191;19;19;;;;;;;0;74;49;25;0;8;0.0
759;Vrijdag 27 december 1996;504;261;243;424;218;206;108;108;;;;;;;15;2129;1344;785;66;109;6.0
760;Zaterdag 28 december 1996;458;222;236;393;196;197;68;68;;;;;;;1;1226;883;343;1;55;509.0
761;Zondag 29 december 1996;440;236;204;410;199;211;2;2;;;;;;;0;200;125;75;2;26;1.0
762;Maandag 30 december 1996;523;263;260;440;211;229;220;220;;;;;;;76;7479;4668;2811;448;363;23.0
763;Dinsdag 31 december 1996;501;247;254;418;215;203;213;213;;;;;;;76;4854;2986;1868;209;351;18.0
764;Totaal op zondag in 1996;21870;11251;10619;19004;9485;9519;359;359;;;;;;;13;47243;31438;15805;329;2177;73.0
765;Totaal op maandag in 1996;28264;14578;13686;20090;10086;10004;7741;7741;;;;;;;6836;425761;271417;154344;24814;15505;13406.0
766;Totaal op dinsdag in 1996;30240;15541;14699;20009;10047;9962;7210;7210;;;;;;;7391;279561;172228;107333;23219;11512;15685.0
767;Totaal op woensdag in 1996;28936;14958;13978;19620;9848;9772;10233;10233;;;;;;;7029;259000;160694;98306;21311;10601;15903.0
768;Totaal op donderdag in 1996;28739;14770;13969;19630;9859;9771;14872;14872;;;;;;;7094;299857;187127;112730;21848;11672;19465.0
769;Totaal op vrijdag in 1996;28381;14639;13742;19906;9949;9957;39432;39432;;;;;;;6454;317348;202172;115176;16947;11611;14620.0
770;Totaal op zaterdag in 1996;23091;11839;11252;19302;9734;9568;5293;5293;;;;;;;54;85415;59335;26080;281;2247;3535.0
771;Totaal 1997;192443;98254;94189;135783;67243;68540;85059;85059;;;;;;;33740;1740189;1106833;633356;109860;62218;59831.0
772;Totaal januari 1997;16377;8340;8037;14200;6936;7264;3075;3075;;;;;;;3194;144338;91939;52399;9684;5548;3732.0
773;Woensdag 1 januari 1997;380;191;189;388;210;178;14;14;;;;;;;0;11149;7165;3984;110;348;0.0
774;Donderdag 2 januari 1997;522;246;276;445;215;230;79;79;;;;;;;94;9869;6380;3489;450;557;20.0
775;Vrijdag 3 januari 1997;631;337;294;486;237;249;127;127;;;;;;;103;5947;3615;2332;323;241;13.0
776;Zaterdag 4 januari 1997;505;265;240;492;257;235;25;25;;;;;;;1;863;598;265;9;42;1.0
777;Zondag 5 januari 1997;395;205;190;457;234;223;6;6;;;;;;;3;337;222;115;4;55;3.0
778;Maandag 6 januari 1997;577;303;274;459;223;236;139;139;;;;;;;132;8117;5058;3059;600;301;24.0
779;Dinsdag 7 januari 1997;603;310;293;491;248;243;108;108;;;;;;;133;5760;3439;2321;518;196;13.0
780;Woensdag 8 januari 1997;576;315;261;459;215;244;100;100;;;;;;;157;5037;3112;1925;410;163;26.0
781;Donderdag 9 januari 1997;598;294;304;447;201;246;128;128;;;;;;;133;4916;3031;1885;543;197;437.0
782;Vrijdag 10 januari 1997;571;288;283;512;229;283;230;230;;;;;;;141;5778;3727;2051;308;178;8.0
783;Zaterdag 11 januari 1997;444;231;213;461;219;242;32;32;;;;;;;1;1109;759;350;3;23;1.0
784;Zondag 12 januari 1997;403;209;194;461;217;244;3;3;;;;;;;0;240;148;92;4;15;1.0
785;Maandag 13 januari 1997;569;281;288;471;235;236;79;79;;;;;;;100;6257;3958;2299;541;212;56.0
786;Dinsdag 14 januari 1997;597;331;266;464;235;229;85;85;;;;;;;147;4761;2890;1871;452;176;253.0
787;Woensdag 15 januari 1997;535;279;256;445;227;218;94;94;;;;;;;135;8406;5769;2637;547;198;33.0
788;Donderdag 16 januari 1997;567;295;272;484;226;258;123;123;;;;;;;181;5282;3220;2062;449;157;239.0
789;Vrijdag 17 januari 1997;511;247;264;477;210;267;227;227;;;;;;;129;4841;3018;1823;325;281;172.0
790;Zaterdag 18 januari 1997;467;242;225;455;234;221;32;32;;;;;;;2;1151;867;284;5;28;0.0
791;Zondag 19 januari 1997;465;232;233;453;219;234;5;5;;;;;;;0;159;111;48;2;17;0.0
792;Maandag 20 januari 1997;596;315;281;436;211;225;104;104;;;;;;;191;6973;4584;2389;459;170;16.0
793;Dinsdag 21 januari 1997;558;289;269;461;225;236;97;97;;;;;;;179;4311;2723;1588;420;151;271.0
794;Woensdag 22 januari 1997;517;248;269;489;248;241;106;106;;;;;;;165;4027;2488;1539;427;136;25.0
795;Donderdag 23 januari 1997;553;286;267;455;203;252;109;109;;;;;;;209;4586;2845;1741;401;179;15.0
796;Vrijdag 24 januari 1997;541;268;273;435;236;199;258;258;;;;;;;152;4662;2991;1671;317;178;19.0
797;Zaterdag 25 januari 1997;443;228;215;478;239;239;42;42;;;;;;;1;2035;1453;582;5;38;1.0
798;Zondag 26 januari 1997;408;172;236;431;223;208;4;4;;;;;;;0;226;165;61;12;20;6.0
799;Maandag 27 januari 1997;535;284;251;460;231;229;109;109;;;;;;;166;6156;3932;2224;485;301;152.0
800;Dinsdag 28 januari 1997;572;283;289;439;216;223;101;101;;;;;;;155;4532;2819;1713;422;201;25.0
801;Woensdag 29 januari 1997;617;285;332;446;205;241;98;98;;;;;;;128;4137;2485;1652;405;260;14.0
802;Donderdag 30 januari 1997;578;297;281;389;178;211;129;129;;;;;;;133;5288;3413;1875;399;225;165.0
803;Vrijdag 31 januari 1997;543;284;259;474;230;244;282;282;;;;;;;123;7426;4954;2472;329;304;1723.0
804;Totaal februari 1997;15053;7668;7385;11676;5823;5853;3428;3428;;;;;;;3013;124972;81346;43626;7656;4302;1915.0
805;Zaterdag 1 februari 1997;423;210;213;433;221;212;41;41;;;;;;;1;14477;10094;4383;44;282;0.0
806;Zondag 2 februari 1997;461;245;216;420;210;210;3;3;;;;;;;0;192;125;67;0;23;5.0
807;Maandag 3 februari 1997;534;252;282;430;213;217;85;85;;;;;;;131;9629;6435;3194;546;281;17.0
808;Dinsdag 4 februari 1997;600;319;281;454;220;234;94;94;;;;;;;165;4754;2888;1866;427;138;363.0
809;Woensdag 5 februari 1997;602;317;285;452;230;222;92;92;;;;;;;199;4487;2727;1760;390;174;172.0
810;Donderdag 6 februari 1997;569;278;291;434;222;212;98;98;;;;;;;153;4536;2845;1691;386;149;259.0
811;Vrijdag 7 februari 1997;566;282;284;411;215;196;201;201;;;;;;;180;4502;2741;1761;330;174;383.0
812;Zaterdag 8 februari 1997;465;239;226;435;226;209;22;22;;;;;;;3;1030;724;306;2;27;0.0
813;Zondag 9 februari 1997;384;201;183;396;190;206;3;3;;;;;;;0;117;63;54;2;20;0.0
814;Maandag 10 februari 1997;521;268;253;441;241;200;94;94;;;;;;;154;5305;3514;1791;397;185;7.0
815;Dinsdag 11 februari 1997;606;315;291;460;235;225;80;80;;;;;;;150;3577;2312;1265;319;171;23.0
816;Woensdag 12 februari 1997;606;304;302;464;236;228;101;101;;;;;;;165;4140;2626;1514;340;161;12.0
817;Donderdag 13 februari 1997;575;301;274;407;212;195;93;93;;;;;;;177;4127;2657;1470;345;177;23.0
818;Vrijdag 14 februari 1997;589;316;273;411;217;194;663;663;;;;;;;126;5423;3519;1904;349;167;440.0
819;Zaterdag 15 februari 1997;452;248;204;399;186;213;28;28;;;;;;;0;3171;2315;856;15;67;0.0
820;Zondag 16 februari 1997;433;230;203;398;185;213;4;4;;;;;;;0;418;311;107;4;11;0.0
821;Maandag 17 februari 1997;539;276;263;406;195;211;141;141;;;;;;;131;6680;4272;2408;453;222;17.0
822;Dinsdag 18 februari 1997;620;318;302;410;197;213;123;123;;;;;;;158;4187;2630;1557;387;144;23.0
823;Woensdag 19 februari 1997;613;320;293;397;192;205;142;142;;;;;;;131;3903;2480;1423;341;178;14.0
824;Donderdag 20 februari 1997;587;292;295;378;183;195;159;159;;;;;;;142;5176;3299;1877;411;163;10.0
825;Vrijdag 21 februari 1997;573;292;281;399;214;185;302;302;;;;;;;110;4650;3003;1647;281;186;8.0
826;Zaterdag 22 februari 1997;433;207;226;426;210;216;32;32;;;;;;;0;1853;1253;600;0;27;0.0
827;Zondag 23 februari 1997;398;201;197;391;205;186;4;4;;;;;;;0;233;164;69;3;28;1.0
828;Maandag 24 februari 1997;563;279;284;413;213;200;108;108;;;;;;;185;6118;4043;2075;493;247;24.0
829;Dinsdag 25 februari 1997;628;333;295;427;196;231;111;111;;;;;;;156;4566;2860;1706;403;189;46.0
830;Woensdag 26 februari 1997;595;310;285;383;185;198;121;121;;;;;;;147;4329;2752;1577;363;204;28.0
831;Donderdag 27 februari 1997;543;244;299;395;190;205;158;158;;;;;;;146;5067;3169;1898;350;220;24.0
832;Vrijdag 28 februari 1997;575;271;304;406;184;222;325;325;;;;;;;103;8325;5525;2800;275;287;16.0
833;Totaal maart 1997;15798;7970;7828;11258;5609;5649;3974;3974;;;;;;;2560;128548;84204;44344;7283;4556;5586.0
834;Zaterdag 1 maart 1997;429;215;214;433;222;211;55;55;;;;;;;1;15379;10674;4705;32;245;1.0
835;Zondag 2 maart 1997;458;234;224;335;182;153;10;10;;;;;;;0;115;75;40;4;34;0.0
836;Maandag 3 maart 1997;503;239;264;393;194;199;134;134;;;;;;;96;10458;6852;3606;508;297;28.0
837;Dinsdag 4 maart 1997;559;297;262;360;198;162;100;100;;;;;;;133;5225;3195;2030;430;165;28.0
838;Woensdag 5 maart 1997;564;279;285;387;198;189;135;135;;;;;;;123;4812;3034;1778;423;190;1314.0
839;Donderdag 6 maart 1997;564;289;275;393;200;193;162;162;;;;;;;139;5207;3227;1980;364;157;402.0
840;Vrijdag 7 maart 1997;527;281;246;400;199;201;342;342;;;;;;;117;4851;3130;1721;298;168;374.0
841;Zaterdag 8 maart 1997;448;222;226;365;188;177;50;50;;;;;;;0;1079;770;309;3;37;3.0
842;Zondag 9 maart 1997;453;241;212;342;159;183;9;9;;;;;;;1;99;60;39;2;10;2.0
843;Maandag 10 maart 1997;552;303;249;392;195;197;117;117;;;;;;;112;6444;4238;2206;442;283;21.0
844;Dinsdag 11 maart 1997;573;275;298;376;196;180;105;105;;;;;;;138;4241;2708;1533;365;128;138.0
845;Woensdag 12 maart 1997;509;248;261;358;185;173;102;102;;;;;;;132;3838;2480;1358;367;145;645.0
846;Donderdag 13 maart 1997;568;281;287;357;178;179;104;104;;;;;;;148;4302;2699;1603;386;181;395.0
847;Vrijdag 14 maart 1997;576;272;304;378;196;182;387;387;;;;;;;105;5100;3303;1797;281;145;12.0
848;Zaterdag 15 maart 1997;397;189;208;343;161;182;47;47;;;;;;;1;3692;2714;978;4;69;1.0
849;Zondag 16 maart 1997;387;216;171;325;160;165;6;6;;;;;;;0;396;278;118;2;22;0.0
850;Maandag 17 maart 1997;570;294;276;366;172;194;109;109;;;;;;;172;6738;4470;2268;451;299;430.0
851;Dinsdag 18 maart 1997;551;275;276;355;176;179;111;111;;;;;;;150;4535;2914;1621;408;226;168.0
852;Woensdag 19 maart 1997;557;281;276;327;146;181;110;110;;;;;;;167;3692;2320;1372;295;137;389.0
853;Donderdag 20 maart 1997;536;275;261;384;195;189;202;202;;;;;;;152;4871;3189;1682;377;229;11.0
854;Vrijdag 21 maart 1997;520;245;275;326;152;174;730;730;;;;;;;132;4852;3196;1656;265;174;649.0
855;Zaterdag 22 maart 1997;451;251;200;354;183;171;42;42;;;;;;;1;1719;1266;453;2;36;4.0
856;Zondag 23 maart 1997;397;212;185;355;185;170;7;7;;;;;;;0;235;149;86;5;25;0.0
857;Maandag 24 maart 1997;539;275;264;345;179;166;159;159;;;;;;;126;6207;3961;2246;410;259;172.0
858;Dinsdag 25 maart 1997;596;288;308;335;163;172;126;126;;;;;;;162;4941;3158;1783;400;241;11.0
859;Woensdag 26 maart 1997;601;293;308;382;174;208;144;144;;;;;;;122;4335;2642;1693;352;172;21.0
860;Donderdag 27 maart 1997;557;268;289;362;163;199;286;286;;;;;;;113;5974;3917;2057;361;294;356.0
861;Vrijdag 28 maart 1997;572;286;286;376;190;186;45;45;;;;;;;16;2603;1701;902;28;81;3.0
862;Zaterdag 29 maart 1997;453;221;232;337;161;176;30;30;;;;;;;0;1220;848;372;7;17;3.0
863;Zondag 30 maart 1997;400;208;192;346;166;180;1;1;;;;;;;0;340;269;71;1;28;4.0
864;Maandag 31 maart 1997;431;217;214;371;193;178;7;7;;;;;;;1;1048;767;281;10;62;1.0
865;Totaal april 1997;16215;8337;7878;10872;5471;5401;6103;6103;;;;;;;3074;140568;91564;49004;8502;4827;4394.0
866;Dinsdag 1 april 1997;499;270;229;410;203;207;311;311;;;;;;;144;27685;18796;8889;675;649;16.0
867;Woensdag 2 april 1997;597;302;295;394;206;188;132;132;;;;;;;166;5924;3671;2253;461;238;16.0
868;Donderdag 3 april 1997;599;317;282;380;184;196;171;171;;;;;;;146;5667;3372;2295;463;213;18.0
869;Vrijdag 4 april 1997;626;306;320;344;170;174;552;552;;;;;;;117;5091;3233;1858;328;172;15.0
870;Zaterdag 5 april 1997;421;211;210;348;176;172;56;56;;;;;;;1;1164;858;306;5;29;298.0
871;Zondag 6 april 1997;444;223;221;299;139;160;7;7;;;;;;;0;172;110;62;0;27;1.0
872;Maandag 7 april 1997;551;288;263;339;175;164;173;173;;;;;;;129;6182;4037;2145;471;204;304.0
873;Dinsdag 8 april 1997;595;316;279;391;195;196;107;107;;;;;;;134;4682;2954;1728;397;162;399.0
874;Woensdag 9 april 1997;599;301;298;326;161;165;117;117;;;;;;;154;3807;2396;1411;409;166;16.0
875;Donderdag 10 april 1997;594;310;284;366;190;176;198;198;;;;;;;145;5280;3423;1857;325;174;14.0
876;Vrijdag 11 april 1997;532;278;254;361;182;179;490;490;;;;;;;154;4295;2668;1627;259;210;13.0
877;Zaterdag 12 april 1997;456;242;214;337;176;161;60;60;;;;;;;0;1467;1053;414;8;42;3.0
878;Zondag 13 april 1997;401;209;192;331;152;179;3;3;;;;;;;1;118;82;36;3;15;3.0
879;Maandag 14 april 1997;575;318;257;386;196;190;118;118;;;;;;;209;6232;4025;2207;445;215;553.0
880;Dinsdag 15 april 1997;606;279;327;346;176;170;92;92;;;;;;;140;7463;5130;2333;448;231;16.0
881;Woensdag 16 april 1997;543;274;269;328;171;157;166;166;;;;;;;138;4224;2744;1480;373;156;816.0
882;Donderdag 17 april 1997;546;264;282;332;163;169;199;199;;;;;;;156;4315;2761;1554;380;149;257.0
883;Vrijdag 18 april 1997;580;303;277;364;176;188;648;648;;;;;;;120;4238;2648;1590;247;132;495.0
884;Zaterdag 19 april 1997;419;212;207;372;198;174;76;76;;;;;;;0;1450;1088;362;1;24;2.0
885;Zondag 20 april 1997;458;236;222;327;162;165;5;5;;;;;;;2;614;448;166;4;27;6.0
886;Maandag 21 april 1997;592;327;265;359;185;174;138;138;;;;;;;155;6050;3875;2175;495;223;106.0
887;Dinsdag 22 april 1997;599;310;289;400;191;209;140;140;;;;;;;185;3977;2494;1483;361;167;400.0
888;Woensdag 23 april 1997;607;304;303;409;217;192;196;196;;;;;;;138;3831;2407;1424;353;137;14.0
889;Donderdag 24 april 1997;582;277;305;379;208;171;309;309;;;;;;;135;4574;2871;1703;370;166;16.0
890;Vrijdag 25 april 1997;541;295;246;392;198;194;908;908;;;;;;;157;5661;3708;1953;288;221;536.0
891;Zaterdag 26 april 1997;473;254;219;356;166;190;113;113;;;;;;;2;2219;1511;708;1;45;6.0
892;Zondag 27 april 1997;459;231;228;354;170;184;8;8;;;;;;;0;263;175;88;3;14;5.0
893;Maandag 28 april 1997;572;291;281;394;203;191;204;204;;;;;;;116;6895;4457;2438;484;278;33.0
894;Dinsdag 29 april 1997;635;320;315;373;192;181;380;380;;;;;;;127;5608;3536;2072;442;246;17.0
895;Woensdag 30 april 1997;514;269;245;375;190;185;26;26;;;;;;;3;1420;1033;387;3;95;0.0
896;Totaal mei 1997;16483;8482;8001;11148;5525;5623;11380;11380;;;;;;;2746;139952;92535;47417;7393;4210;4647.0
897;Donderdag 1 mei 1997;548;282;266;384;191;193;384;384;;;;;;;129;25619;17621;7998;427;487;702.0
898;Vrijdag 2 mei 1997;628;322;306;383;179;204;1055;1055;;;;;;;100;4967;3140;1827;299;183;12.0
899;Zaterdag 3 mei 1997;501;268;233;341;150;191;147;147;;;;;;;2;982;698;284;0;44;2.0
900;Zondag 4 mei 1997;438;210;228;396;179;217;5;5;;;;;;;0;144;106;38;3;26;1.0
901;Maandag 5 mei 1997;480;244;236;357;180;177;21;21;;;;;;;3;1213;937;276;15;29;5.0
902;Dinsdag 6 mei 1997;577;315;262;346;188;158;253;253;;;;;;;226;6979;4546;2433;503;191;21.0
903;Woensdag 7 mei 1997;646;329;317;355;187;168;1100;1100;;;;;;;135;5875;3759;2116;415;145;30.0
904;Donderdag 8 mei 1997;531;249;282;346;158;188;10;10;;;;;;;3;394;277;117;7;19;0.0
905;Vrijdag 9 mei 1997;522;265;257;354;169;185;470;470;;;;;;;19;1766;1206;560;50;81;10.0
906;Zaterdag 10 mei 1997;447;238;209;331;168;163;114;114;;;;;;;0;1477;1117;360;1;17;0.0
907;Zondag 11 mei 1997;430;226;204;348;167;181;6;6;;;;;;;0;126;83;43;1;11;3.0
908;Maandag 12 mei 1997;564;296;268;370;183;187;242;242;;;;;;;180;8759;5615;3144;522;253;23.0
909;Dinsdag 13 mei 1997;603;302;301;386;185;201;146;146;;;;;;;163;5123;3128;1995;465;180;15.0
910;Woensdag 14 mei 1997;597;290;307;340;168;172;276;276;;;;;;;157;4835;2982;1853;396;196;11.0
911;Donderdag 15 mei 1997;592;313;279;395;189;206;505;505;;;;;;;180;9066;6184;2882;391;266;1620.0
912;Vrijdag 16 mei 1997;594;321;273;366;183;183;1289;1289;;;;;;;113;6038;3897;2141;359;160;208.0
913;Zaterdag 17 mei 1997;493;255;238;406;200;206;149;149;;;;;;;0;1417;1032;385;5;31;1.0
914;Zondag 18 mei 1997;471;254;217;348;172;176;1;1;;;;;;;0;164;123;41;2;23;3.0
915;Maandag 19 mei 1997;420;213;207;360;189;171;10;10;;;;;;;5;368;287;81;2;12;1.0
916;Dinsdag 20 mei 1997;533;279;254;386;192;194;201;201;;;;;;;131;6604;4324;2280;462;159;19.0
917;Woensdag 21 mei 1997;609;302;307;369;167;202;256;256;;;;;;;183;4800;3013;1787;411;176;21.0
918;Donderdag 22 mei 1997;554;268;286;327;152;175;464;464;;;;;;;153;4997;3304;1693;431;135;21.0
919;Vrijdag 23 mei 1997;564;294;270;356;178;178;1288;1288;;;;;;;140;5271;3485;1786;301;217;736.0
920;Zaterdag 24 mei 1997;481;246;235;339;167;172;174;174;;;;;;;0;1759;1302;457;1;29;3.0
921;Zondag 25 mei 1997;404;209;195;346;169;177;3;3;;;;;;;0;498;339;159;4;43;1.0
922;Maandag 26 mei 1997;595;297;298;365;194;171;190;190;;;;;;;141;6392;4205;2187;409;187;29.0
923;Dinsdag 27 mei 1997;506;259;247;359;199;160;191;191;;;;;;;169;4641;2904;1737;345;180;13.0
924;Woensdag 28 mei 1997;582;309;273;351;180;171;269;269;;;;;;;124;4960;3199;1761;420;205;652.0
925;Donderdag 29 mei 1997;567;299;268;341;177;164;474;474;;;;;;;149;5145;3233;1912;425;166;13.0
926;Vrijdag 30 mei 1997;534;281;253;351;184;167;1474;1474;;;;;;;141;7293;4873;2420;318;265;471.0
927;Zaterdag 31 mei 1997;472;247;225;346;181;165;213;213;;;;;;;0;2280;1616;664;3;94;0.0
928;Totaal juni 1997;16019;8101;7918;10690;5294;5396;11042;11042;;;;;;;2846;147940;96013;51927;8574;5227;6115.0
929;Zondag 1 juni 1997;398;203;195;313;167;146;10;10;;;;;;;0;14167;9784;4383;40;303;5.0
930;Maandag 2 juni 1997;535;266;269;394;212;182;196;196;;;;;;;120;11372;7480;3892;514;260;30.0
931;Dinsdag 3 juni 1997;594;297;297;398;176;222;157;157;;;;;;;140;5709;3504;2205;402;134;20.0
932;Woensdag 4 juni 1997;589;292;297;362;198;164;218;218;;;;;;;143;4581;2851;1730;390;139;1609.0
933;Donderdag 5 juni 1997;604;305;299;350;150;200;473;473;;;;;;;139;5394;3466;1928;406;206;14.0
934;Vrijdag 6 juni 1997;598;285;313;378;200;178;1527;1527;;;;;;;117;4957;3112;1845;267;159;313.0
935;Zaterdag 7 juni 1997;476;245;231;439;212;227;217;217;;;;;;;2;1469;1077;392;8;31;0.0
936;Zondag 8 juni 1997;447;207;240;388;185;203;4;4;;;;;;;0;217;166;51;3;15;0.0
937;Maandag 9 juni 1997;493;261;232;346;175;171;161;161;;;;;;;132;6005;3795;2210;432;212;26.0
938;Dinsdag 10 juni 1997;580;277;303;373;194;179;186;186;;;;;;;149;5224;3427;1797;390;161;23.0
939;Woensdag 11 juni 1997;576;288;288;398;181;217;209;209;;;;;;;120;4257;2788;1469;367;159;780.0
940;Donderdag 12 juni 1997;556;280;276;347;171;176;470;470;;;;;;;120;4988;3196;1792;422;182;23.0
941;Vrijdag 13 juni 1997;560;304;256;359;192;167;1008;1008;;;;;;;128;4833;3113;1720;263;179;17.0
942;Zaterdag 14 juni 1997;451;219;232;363;168;195;208;208;;;;;;;2;1672;1174;498;1;62;1.0
943;Zondag 15 juni 1997;416;224;192;369;192;177;7;7;;;;;;;1;2396;1795;601;11;75;2.0
944;Maandag 16 juni 1997;543;277;266;341;164;177;194;194;;;;;;;123;8776;5988;2788;460;236;172.0
945;Dinsdag 17 juni 1997;555;295;260;367;176;191;163;163;;;;;;;158;4566;2834;1732;370;186;388.0
946;Woensdag 18 juni 1997;613;311;302;308;149;159;241;241;;;;;;;135;4388;2663;1725;365;203;30.0
947;Donderdag 19 juni 1997;581;298;283;393;209;184;443;443;;;;;;;142;5105;3271;1834;400;183;630.0
948;Vrijdag 20 juni 1997;553;275;278;327;164;163;1580;1580;;;;;;;98;5761;3752;2009;251;224;528.0
949;Zaterdag 21 juni 1997;467;213;254;315;154;161;290;290;;;;;;;0;1944;1387;557;6;25;167.0
950;Zondag 22 juni 1997;453;232;221;340;174;166;6;6;;;;;;;0;264;200;64;1;39;2.0
951;Maandag 23 juni 1997;586;305;281;333;167;166;201;201;;;;;;;150;6296;3987;2309;481;273;35.0
952;Dinsdag 24 juni 1997;589;296;293;326;162;164;188;188;;;;;;;163;4423;2738;1685;423;242;33.0
953;Woensdag 25 juni 1997;564;281;283;324;165;159;287;287;;;;;;;136;4662;2971;1691;471;197;456.0
954;Donderdag 26 juni 1997;548;287;261;332;149;183;501;501;;;;;;;152;5656;3544;2112;463;305;266.0
955;Vrijdag 27 juni 1997;595;303;292;356;176;180;1470;1470;;;;;;;120;6264;3864;2400;340;252;383.0
956;Zaterdag 28 juni 1997;489;255;234;352;165;187;213;213;;;;;;;1;2381;1550;831;10;58;0.0
957;Zondag 29 juni 1997;442;243;199;349;176;173;4;4;;;;;;;0;281;190;91;3;38;3.0
958;Maandag 30 juni 1997;568;277;291;350;171;179;210;210;;;;;;;155;9932;6346;3586;614;489;159.0
959;Totaal juli 1997;17211;8780;8431;10684;5216;5468;8560;8560;;;;;;;3184;170699;106122;64577;10345;6810;2873.0
960;Dinsdag 1 juli 1997;620;314;306;338;164;174;224;224;;;;;;;170;33336;21744;11592;618;759;18.0
961;Woensdag 2 juli 1997;563;277;286;349;180;169;221;221;;;;;;;124;5665;3340;2325;489;205;685.0
962;Donderdag 3 juli 1997;609;322;287;363;163;200;362;362;;;;;;;185;5968;3534;2434;471;256;19.0
963;Vrijdag 4 juli 1997;616;308;308;365;180;185;1194;1194;;;;;;;133;5827;3491;2336;359;289;19.0
964;Zaterdag 5 juli 1997;472;222;250;327;174;153;188;188;;;;;;;0;1472;1011;461;12;79;1359.0
965;Zondag 6 juli 1997;429;244;185;317;167;150;8;8;;;;;;;0;210;159;51;4;41;0.0
966;Maandag 7 juli 1997;581;308;273;349;171;178;365;365;;;;;;;155;7737;4676;3061;615;340;26.0
967;Dinsdag 8 juli 1997;596;302;294;350;168;182;171;171;;;;;;;144;5420;3183;2237;458;285;21.0
968;Woensdag 9 juli 1997;649;318;331;353;159;194;304;304;;;;;;;166;4731;2845;1886;429;197;18.0
969;Donderdag 10 juli 1997;571;280;291;370;176;194;305;305;;;;;;;141;6185;3793;2392;468;236;21.0
970;Vrijdag 11 juli 1997;618;297;321;371;183;188;944;944;;;;;;;124;5215;3204;2011;355;194;9.0
971;Zaterdag 12 juli 1997;491;239;252;339;175;164;128;128;;;;;;;2;1845;1287;558;2;51;0.0
972;Zondag 13 juli 1997;457;244;213;354;159;195;11;11;;;;;;;0;177;137;40;11;26;0.0
973;Maandag 14 juli 1997;580;309;271;364;183;181;181;181;;;;;;;157;7270;4470;2800;586;301;14.0
974;Dinsdag 15 juli 1997;594;313;281;369;172;197;184;184;;;;;;;140;9761;6211;3550;475;294;18.0
975;Woensdag 16 juli 1997;615;303;312;331;172;159;209;209;;;;;;;147;5335;3216;2119;394;199;15.0
976;Donderdag 17 juli 1997;543;269;274;339;166;173;314;314;;;;;;;136;5318;3254;2064;491;185;11.0
977;Vrijdag 18 juli 1997;551;296;255;346;184;162;727;727;;;;;;;119;5148;3180;1968;334;224;459.0
978;Zaterdag 19 juli 1997;488;239;249;337;165;172;126;126;;;;;;;1;1467;1046;421;4;39;0.0
979;Zondag 20 juli 1997;451;237;214;316;160;156;18;18;;;;;;;0;711;491;220;5;33;0.0
980;Maandag 21 juli 1997;516;270;246;348;162;186;220;220;;;;;;;102;7230;4504;2726;480;267;24.0
981;Dinsdag 22 juli 1997;614;315;299;358;178;180;190;190;;;;;;;132;4826;2916;1910;420;273;23.0
982;Woensdag 23 juli 1997;601;302;299;312;145;167;192;192;;;;;;;107;4506;2617;1889;408;194;14.0
983;Donderdag 24 juli 1997;582;315;267;316;144;172;243;243;;;;;;;154;4781;2869;1912;351;191;12.0
984;Vrijdag 25 juli 1997;589;296;293;362;182;180;631;631;;;;;;;90;5621;3493;2128;285;273;16.0
985;Zaterdag 26 juli 1997;477;240;237;347;176;171;82;82;;;;;;;1;1818;1135;683;6;45;2.0
986;Zondag 27 juli 1997;477;231;246;326;157;169;12;12;;;;;;;0;298;196;102;4;62;1.0
987;Maandag 28 juli 1997;562;301;261;334;165;169;201;201;;;;;;;92;6898;4360;2538;535;277;17.0
988;Dinsdag 29 juli 1997;569;288;281;362;170;192;193;193;;;;;;;151;4538;2661;1877;450;273;8.0
989;Woensdag 30 juli 1997;586;288;298;335;164;171;195;195;;;;;;;161;4937;3025;1912;407;300;25.0
990;Donderdag 31 juli 1997;544;293;251;337;152;185;217;217;;;;;;;150;6448;4074;2374;419;422;19.0
991;Totaal augustus 1997;16406;8477;7929;11658;5709;5949;10010;10010;;;;;;;2354;145970;86080;59890;11915;6015;1664.0
992;Vrijdag 1 augustus 1997;553;287;266;313;141;172;637;637;;;;;;;99;31341;19409;11932;524;786;10.0
993;Zaterdag 2 augustus 1997;487;254;233;341;168;173;105;105;;;;;;;2;799;496;303;15;36;333.0
994;Zondag 3 augustus 1997;430;248;182;330;145;185;18;18;;;;;;;0;162;99;63;8;58;4.0
995;Maandag 4 augustus 1997;531;275;256;320;163;157;219;219;;;;;;;121;6914;4096;2818;692;290;20.0
996;Dinsdag 5 augustus 1997;626;314;312;341;172;169;200;200;;;;;;;140;5223;2977;2246;697;213;19.0
997;Woensdag 6 augustus 1997;592;310;282;335;169;166;180;180;;;;;;;119;4554;2787;1767;572;191;12.0
998;Donderdag 7 augustus 1997;575;293;282;358;181;177;251;251;;;;;;;111;4720;2743;1977;509;160;8.0
999;Vrijdag 8 augustus 1997;576;300;276;360;186;174;756;756;;;;;;;89;4913;2940;1973;377;186;12.0
1000;Zaterdag 9 augustus 1997;479;258;221;341;171;170;108;108;;;;;;;0;934;580;354;11;26;0.0
1001;Zondag 10 augustus 1997;432;226;206;379;168;211;12;12;;;;;;;0;523;349;174;3;48;1.0
1002;Maandag 11 augustus 1997;531;274;257;397;186;211;213;213;;;;;;;99;5807;3345;2462;645;273;15.0
1003;Dinsdag 12 augustus 1997;600;303;297;430;210;220;195;195;;;;;;;122;4455;2496;1959;536;180;13.0
1004;Woensdag 13 augustus 1997;577;298;279;454;216;238;174;174;;;;;;;123;3748;2067;1681;417;208;14.0
1005;Donderdag 14 augustus 1997;568;301;267;429;215;214;358;358;;;;;;;108;5350;2922;2428;515;169;18.0
1006;Vrijdag 15 augustus 1997;556;282;274;409;191;218;942;942;;;;;;;95;9301;5700;3601;424;411;20.0
1007;Zaterdag 16 augustus 1997;439;233;206;415;201;214;138;138;;;;;;;0;1292;814;478;14;68;0.0
1008;Zondag 17 augustus 1997;461;230;231;409;203;206;10;10;;;;;;;0;176;111;65;4;28;6.0
1009;Maandag 18 augustus 1997;567;281;286;416;201;215;209;209;;;;;;;96;6900;3980;2920;698;267;64.0
1010;Dinsdag 19 augustus 1997;572;304;268;425;201;224;167;167;;;;;;;122;4498;2490;2008;698;198;48.0
1011;Woensdag 20 augustus 1997;538;279;259;358;182;176;247;247;;;;;;;89;4839;2718;2121;565;212;16.0
1012;Donderdag 21 augustus 1997;574;294;280;430;202;228;387;387;;;;;;;101;4724;2702;2022;548;172;217.0
1013;Vrijdag 22 augustus 1997;591;295;296;376;171;205;1317;1317;;;;;;;115;4692;2816;1876;437;239;16.0
1014;Zaterdag 23 augustus 1997;478;262;216;402;195;207;193;193;;;;;;;0;1328;883;445;6;31;2.0
1015;Zondag 24 augustus 1997;419;204;215;402;201;201;8;8;;;;;;;0;208;115;93;15;33;2.0
1016;Maandag 25 augustus 1997;534;283;251;416;208;208;199;199;;;;;;;91;6431;3777;2654;677;345;382.0
1017;Dinsdag 26 augustus 1997;555;274;281;373;182;191;192;192;;;;;;;148;4649;2517;2132;545;265;116.0
1018;Woensdag 27 augustus 1997;546;256;290;353;169;184;296;296;;;;;;;125;4363;2396;1967;556;283;251.0
1019;Donderdag 28 augustus 1997;599;330;269;358;177;181;543;543;;;;;;;122;5224;3028;2196;572;206;21.0
1020;Vrijdag 29 augustus 1997;541;280;261;323;172;151;1480;1480;;;;;;;116;5644;3250;2394;469;277;21.0
1021;Zaterdag 30 augustus 1997;443;217;226;344;180;164;249;249;;;;;;;1;1351;871;480;151;63;3.0
1022;Zondag 31 augustus 1997;436;232;204;321;182;139;7;7;;;;;;;0;907;606;301;15;93;0.0
1023;Totaal september 1997;16552;8398;8154;10178;5110;5068;11025;11025;;;;;;;3080;151631;91470;60161;12145;5980;9969.0
1024;Maandag 1 september1997;567;296;271;325;157;168;223;223;;;;;;;132;31325;19493;11832;886;942;327.0
1025;Dinsdag 2 september1997;608;315;293;304;165;139;177;177;;;;;;;152;5704;3086;2618;754;189;22.0
1026;Woensdag 3 september1997;565;307;258;332;156;176;245;245;;;;;;;100;5306;2831;2475;689;164;3863.0
1027;Donderdag 4 september1997;577;298;279;331;163;168;553;553;;;;;;;129;5542;3083;2459;842;206;34.0
1028;Vrijdag 5 september1997;570;309;261;328;169;159;1574;1574;;;;;;;102;5260;2947;2313;480;207;850.0
1029;Zaterdag 6 september1997;448;230;218;341;190;151;289;289;;;;;;;0;824;553;271;7;56;0.0
1030;Zondag 7 september1997;402;202;200;346;191;155;15;15;;;;;;;0;240;165;75;3;36;0.0
1031;Maandag 8 september1997;571;292;279;347;166;181;166;166;;;;;;;105;6178;3740;2438;660;244;10.0
1032;Dinsdag 9 september1997;580;287;293;351;160;191;226;226;;;;;;;155;4867;2685;2182;560;215;22.0
1033;Woensdag 10 september1997;593;286;307;358;187;171;259;259;;;;;;;176;4802;2815;1987;581;222;649.0
1034;Donderdag 11 september1997;598;287;311;348;175;173;462;462;;;;;;;128;4872;2842;2030;490;181;18.0
1035;Vrijdag 12 september1997;551;287;264;316;154;162;1468;1468;;;;;;;131;4589;2733;1856;398;208;15.0
1036;Zaterdag 13 september1997;466;230;236;341;171;170;160;160;;;;;;;0;961;641;320;2;49;0.0
1037;Zondag 14 september1997;425;208;217;341;178;163;8;8;;;;;;;1;258;179;79;8;52;0.0
1038;Maandag 15 september1997;581;293;288;371;202;169;168;168;;;;;;;144;10614;6938;3676;586;368;26.0
1039;Dinsdag 16 september1997;584;281;303;345;185;160;163;163;;;;;;;180;4946;2960;1986;502;198;22.0
1040;Woensdag 17 september1997;595;315;280;372;176;196;248;248;;;;;;;138;4359;2521;1838;459;166;656.0
1041;Donderdag 18 september1997;581;290;291;358;167;191;434;434;;;;;;;128;4668;2698;1970;518;216;17.0
1042;Vrijdag 19 september1997;598;291;307;339;168;171;1338;1338;;;;;;;149;4316;2562;1754;366;215;1068.0
1043;Zaterdag 20 september1997;444;220;224;324;167;157;202;202;;;;;;;0;1752;1220;532;0;33;1.0
1044;Zondag 21 september1997;436;235;201;324;162;162;7;7;;;;;;;0;215;158;57;4;35;0.0
1045;Maandag 22 september1997;585;290;295;338;152;186;166;166;;;;;;;109;6229;3816;2413;627;242;18.0
1046;Dinsdag 23 september1997;614;321;293;308;143;165;148;148;;;;;;;149;4688;2683;2005;453;230;24.0
1047;Woensdag 24 september1997;632;323;309;328;169;159;209;209;;;;;;;130;4142;2410;1732;412;207;1263.0
1048;Donderdag 25 september1997;608;313;295;343;163;180;404;404;;;;;;;141;5215;3102;2113;436;233;30.0
1049;Vrijdag 26 september1997;639;316;323;365;183;182;1238;1238;;;;;;;149;4963;3161;1802;339;234;23.0
1050;Zaterdag 27 september1997;480;245;235;342;179;163;178;178;;;;;;;2;1793;1272;521;6;39;1.0
1051;Zondag 28 september1997;434;232;202;336;170;166;1;1;;;;;;;0;326;227;99;0;37;1.0
1052;Maandag 29 september1997;597;298;299;355;181;174;148;148;;;;;;;149;6503;3970;2533;549;277;977.0
1053;Dinsdag 30 september1997;623;301;322;321;161;160;148;148;;;;;;;201;6174;3979;2195;528;279;32.0
1054;Totaal oktober 1997;15975;8133;7842;10981;5491;5490;7243;7243;;;;;;;2963;152653;95770;56883;10336;5428;5560.0
1055;Woensdag 1 oktober 1997;606;302;304;342;150;192;225;225;;;;;;;146;26852;17917;8935;535;739;455.0
1056;Donderdag 2 oktober 1997;541;264;277;329;163;166;280;280;;;;;;;126;5264;3046;2218;538;164;16.0
1057;Vrijdag 3 oktober 1997;580;301;279;333;169;164;841;841;;;;;;;134;4170;2240;1930;348;172;325.0
1058;Zaterdag 4 oktober 1997;430;230;200;375;197;178;131;131;;;;;;;1;984;693;291;3;54;0.0
1059;Zondag 5 oktober 1997;419;208;211;331;179;152;6;6;;;;;;;0;263;197;66;3;32;6.0
1060;Maandag 6 oktober 1997;539;270;269;395;209;186;126;126;;;;;;;109;6198;3848;2350;548;240;865.0
1061;Dinsdag 7 oktober 1997;588;294;294;364;178;186;152;152;;;;;;;149;4704;2785;1919;546;160;14.0
1062;Woensdag 8 oktober 1997;554;292;262;378;188;190;176;176;;;;;;;165;4422;2668;1754;618;136;13.0
1063;Donderdag 9 oktober 1997;588;307;281;370;188;182;292;292;;;;;;;137;4436;2547;1889;461;168;16.0
1064;Vrijdag 10 oktober 1997;547;276;271;364;173;191;949;949;;;;;;;136;5601;3502;2099;371;185;10.0
1065;Zaterdag 11 oktober 1997;434;215;219;356;166;190;93;93;;;;;;;3;1351;993;358;4;39;0.0
1066;Zondag 12 oktober 1997;403;204;199;330;167;163;7;7;;;;;;;0;259;160;99;2;30;1.0
1067;Maandag 13 oktober 1997;528;277;251;345;188;157;112;112;;;;;;;118;5850;3713;2137;523;222;979.0
1068;Dinsdag 14 oktober 1997;576;275;301;301;158;143;164;164;;;;;;;105;4606;2740;1866;440;194;21.0
1069;Woensdag 15 oktober 1997;556;279;277;355;189;166;168;168;;;;;;;109;8565;5486;3079;424;262;407.0
1070;Donderdag 16 oktober 1997;550;275;275;360;191;169;252;252;;;;;;;109;5316;3296;2020;460;181;18.0
1071;Vrijdag 17 oktober 1997;539;285;254;394;185;209;725;725;;;;;;;113;4899;2972;1927;341;167;9.0
1072;Zaterdag 18 oktober 1997;440;221;219;339;164;175;94;94;;;;;;;1;1555;1167;388;6;51;0.0
1073;Zondag 19 oktober 1997;375;196;179;347;161;186;6;6;;;;;;;0;155;103;52;1;33;0.0
1074;Maandag 20 oktober 1997;518;272;246;374;193;181;151;151;;;;;;;100;7173;4430;2743;497;265;19.0
1075;Dinsdag 21 oktober 1997;567;305;262;390;201;189;122;122;;;;;;;142;4578;2739;1839;416;170;17.0
1076;Woensdag 22 oktober 1997;533;281;252;357;175;182;166;166;;;;;;;136;4114;2397;1717;368;131;23.0
1077;Donderdag 23 oktober 1997;549;266;283;366;159;207;212;212;;;;;;;145;4497;2718;1779;458;208;16.0
1078;Vrijdag 24 oktober 1997;501;271;230;394;201;193;615;615;;;;;;;114;5083;3202;1881;319;170;11.0
1079;Zaterdag 25 oktober 1997;412;211;201;337;154;183;67;67;;;;;;;0;2551;1801;750;5;40;3.0
1080;Zondag 26 oktober 1997;428;211;217;331;170;161;3;3;;;;;;;0;313;221;92;4;23;0.0
1081;Maandag 27 oktober 1997;493;248;245;366;190;176;124;124;;;;;;;119;6280;3974;2306;539;276;25.0
1082;Dinsdag 28 oktober 1997;563;291;272;349;173;176;138;138;;;;;;;129;4443;2623;1820;364;207;1359.0
1083;Woensdag 29 oktober 1997;561;273;288;321;174;147;137;137;;;;;;;170;4454;2688;1766;432;181;14.0
1084;Donderdag 30 oktober 1997;535;270;265;352;177;175;201;201;;;;;;;136;5745;3710;2035;379;255;386.0
1085;Vrijdag 31 oktober 1997;522;263;259;336;161;175;508;508;;;;;;;111;7972;5194;2778;383;273;532.0
1086;Totaal november 1997;14774;7598;7176;10773;5343;5430;4094;4094;;;;;;;2430;139495;90018;49477;8200;4373;8184.0
1087;Zaterdag 1 november 1997;424;199;225;384;186;198;63;63;;;;;;;1;18271;12471;5800;49;341;0.0
1088;Zondag 2 november 1997;405;212;193;342;162;180;5;5;;;;;;;0;120;80;40;5;36;1.0
1089;Maandag 3 november 1997;551;287;264;351;183;168;131;131;;;;;;;84;9772;6462;3310;477;250;115.0
1090;Dinsdag 4 november 1997;578;286;292;411;222;189;100;100;;;;;;;121;5439;3278;2161;502;212;245.0
1091;Woensdag 5 november 1997;549;277;272;376;175;201;105;105;;;;;;;117;4772;2918;1854;437;257;11.0
1092;Donderdag 6 november 1997;571;291;280;403;179;224;168;168;;;;;;;125;5089;3102;1987;431;143;433.0
1093;Vrijdag 7 november 1997;554;288;266;369;167;202;420;420;;;;;;;122;4937;3155;1782;306;123;540.0
1094;Zaterdag 8 november 1997;392;205;187;313;151;162;42;42;;;;;;;0;1432;1020;412;5;25;0.0
1095;Zondag 9 november 1997;390;198;192;307;156;151;4;4;;;;;;;1;151;94;57;1;22;6.0
1096;Maandag 10 november 1997;549;297;252;295;150;145;113;113;;;;;;;97;6601;4199;2402;509;208;546.0
1097;Dinsdag 11 november 1997;565;274;291;334;162;172;127;127;;;;;;;117;4556;2774;1782;464;164;10.0
1098;Woensdag 12 november 1997;509;278;231;359;174;185;90;90;;;;;;;147;3972;2427;1545;467;123;855.0
1099;Donderdag 13 november 1997;520;282;238;379;194;185;107;107;;;;;;;129;4583;2853;1730;353;133;13.0
1100;Vrijdag 14 november 1997;562;279;283;349;177;172;450;450;;;;;;;134;5828;3731;2097;278;192;1060.0
1101;Zaterdag 15 november 1997;401;202;199;352;171;181;45;45;;;;;;;0;4387;3110;1277;8;90;0.0
1102;Zondag 16 november 1997;404;195;209;340;163;177;3;3;;;;;;;0;486;336;150;6;41;3.0
1103;Maandag 17 november 1997;500;270;230;340;169;171;129;129;;;;;;;105;7671;5038;2633;458;248;20.0
1104;Dinsdag 18 november 1997;547;275;272;323;161;162;114;114;;;;;;;162;4585;2777;1808;376;146;18.0
1105;Woensdag 19 november 1997;551;268;283;368;199;169;124;124;;;;;;;172;3931;2434;1497;393;125;934.0
1106;Donderdag 20 november 1997;509;283;226;342;153;189;170;170;;;;;;;123;5377;3436;1941;424;166;11.0
1107;Vrijdag 21 november 1997;468;253;215;367;204;163;431;431;;;;;;;117;4887;3117;1770;301;191;59.0
1108;Zaterdag 22 november 1997;432;223;209;321;171;150;41;41;;;;;;;0;2213;1533;680;2;26;1.0
1109;Zondag 23 november 1997;403;198;205;385;196;189;1;1;;;;;;;0;271;171;100;4;10;0.0
1110;Maandag 24 november 1997;501;267;234;391;206;185;132;132;;;;;;;92;6287;4083;2204;451;214;415.0
1111;Dinsdag 25 november 1997;532;269;263;376;179;197;139;139;;;;;;;108;4995;3176;1819;388;215;330.0
1112;Woensdag 26 november 1997;510;270;240;365;185;180;136;136;;;;;;;120;4177;2510;1667;419;142;1557.0
1113;Donderdag 27 november 1997;551;280;271;389;194;195;179;179;;;;;;;140;5212;3250;1962;356;195;542.0
1114;Vrijdag 28 november 1997;533;278;255;382;195;187;483;483;;;;;;;92;6425;4249;2176;320;223;456.0
1115;Zaterdag 29 november 1997;407;207;200;407;185;222;42;42;;;;;;;4;1647;1160;487;2;45;1.0
1116;Zondag 30 november 1997;406;207;199;353;174;179;0;0;;;;;;;0;1421;1074;347;8;67;2.0
1117;Totaal december 1997;15580;7970;7610;11665;5716;5949;5125;5125;;;;;;;2296;153423;99772;53651;7827;4942;5192.0
1118;Maandag 1 december 1997;511;253;258;367;163;204;164;164;;;;;;;100;30792;20970;9822;578;447;17.0
1119;Dinsdag 2 december 1997;518;248;270;377;177;200;106;106;;;;;;;141;5296;3219;2077;455;154;13.0
1120;Woensdag 3 december 1997;563;267;296;372;180;192;114;114;;;;;;;122;4790;2959;1831;374;162;1859.0
1121;Donderdag 4 december 1997;563;292;271;352;165;187;142;142;;;;;;;140;5234;3397;1837;492;188;223.0
1122;Vrijdag 5 december 1997;478;253;225;370;182;188;134;134;;;;;;;73;4755;2995;1760;277;215;9.0
1123;Zaterdag 6 december 1997;390;213;177;336;199;137;52;52;;;;;;;1;1180;810;370;3;40;0.0
1124;Zondag 7 december 1997;411;219;192;364;184;180;0;0;;;;;;;0;215;168;47;3;24;2.0
1125;Maandag 8 december 1997;494;256;238;372;195;177;162;162;;;;;;;131;6471;4171;2300;469;224;423.0
1126;Dinsdag 9 december 1997;537;292;245;355;192;163;113;113;;;;;;;122;4293;2672;1621;451;154;3.0
1127;Woensdag 10 december 1997;570;300;270;411;202;209;153;153;;;;;;;116;4803;3074;1729;405;162;11.0
1128;Donderdag 11 december 1997;569;285;284;409;202;207;205;205;;;;;;;142;4516;2844;1672;383;171;1078.0
1129;Vrijdag 12 december 1997;559;276;283;397;187;210;672;672;;;;;;;107;5406;3375;2031;333;166;293.0
1130;Zaterdag 13 december 1997;462;240;222;377;201;176;54;54;;;;;;;0;1871;1372;499;0;31;1.0
1131;Zondag 14 december 1997;381;202;179;349;180;169;1;1;;;;;;;0;316;230;86;2;19;1.0
1132;Maandag 15 december 1997;532;280;252;391;209;182;168;168;;;;;;;120;13214;8993;4221;475;294;139.0
1133;Dinsdag 16 december 1997;541;282;259;387;191;196;145;145;;;;;;;133;5099;3208;1891;373;176;7.0
1134;Woensdag 17 december 1997;549;247;302;374;173;201;187;187;;;;;;;79;4141;2596;1545;310;179;6.0
1135;Donderdag 18 december 1997;578;308;270;404;206;198;294;294;;;;;;;97;4762;3016;1746;361;195;566.0
1136;Vrijdag 19 december 1997;549;272;277;441;223;218;776;776;;;;;;;95;5469;3443;2026;270;230;13.0
1137;Zaterdag 20 december 1997;400;189;211;373;170;203;123;123;;;;;;;0;4057;2792;1265;7;74;0.0
1138;Zondag 21 december 1997;427;220;207;368;182;186;4;4;;;;;;;0;346;218;128;0;29;1.0
1139;Maandag 22 december 1997;569;294;275;360;172;188;262;262;;;;;;;130;8252;5251;3001;455;234;458.0
1140;Dinsdag 23 december 1997;555;283;272;372;172;200;285;285;;;;;;;115;5449;3281;2168;363;215;14.0
1141;Woensdag 24 december 1997;557;301;256;382;161;221;210;210;;;;;;;99;4213;2662;1551;206;157;13.0
1142;Donderdag 25 december 1997;386;204;182;381;176;205;4;4;;;;;;;0;222;133;89;1;14;0.0
1143;Vrijdag 26 december 1997;397;198;199;351;175;176;6;6;;;;;;;0;74;50;24;0;26;0.0
1144;Zaterdag 27 december 1997;447;231;216;407;187;220;43;43;;;;;;;0;1208;784;424;9;27;0.0
1145;Zondag 28 december 1997;442;221;221;342;173;169;4;4;;;;;;;0;435;312;123;4;31;1.0
1146;Maandag 29 december 1997;561;288;273;375;186;189;167;167;;;;;;;67;6096;3933;2163;342;284;24.0
1147;Dinsdag 30 december 1997;607;319;288;372;176;196;185;185;;;;;;;74;5518;3572;1946;273;223;9.0
1148;Woensdag 31 december 1997;477;237;240;377;175;202;190;190;;;;;;;92;4930;3272;1658;153;397;8.0
1149;Totaal op zondag in 1997;22086;11377;10709;18608;9229;9379;313;313;;;;;;;10;31693;22097;9596;250;1943;96.0
1150;Totaal op maandag in 1997;28252;14575;13677;19479;9799;9680;8062;8062;;;;;;;6239;407295;261348;145947;25696;13829;8406.0
1151;Totaal op dinsdag in 1997;30163;15373;14790;19579;9707;9872;8224;8224;;;;;;;7579;314720;196283;118437;23739;11255;5208.0
1152;Totaal op woensdag in 1997;30205;15256;14949;19723;9735;9988;10012;10012;;;;;;;6998;273279;170153;103126;21523;10579;20791.0
1153;Totaal op donderdag in 1997;29258;14887;14371;19518;9448;10070;13770;13770;;;;;;;6952;284669;178406;106263;21859;10550;9713.0
1154;Totaal op vrijdag in 1997;29060;14838;14222;19602;9723;9879;39134;39134;;;;;;;5920;297731;187233;110498;16273;11095;13412.0
1155;Totaal op zaterdag in 1997;23419;11948;11471;19274;9602;9672;5544;5544;;;;;;;42;130802;91313;39489;520;2967;2205.0
1156;Totaal 1998;199408;102137;97271;137482;68209;69273;86956;86956;;;4626.0;1616.0;1686.0;1324.0;32459;1774011;1108216;665795;122407;60441;59173.0
1157;Totaal januari 1998;16398;8373;8025;11359;5583;5776;2688;2688;;;295.0;105.0;122.0;68.0;2416;138987;87418;51569;10327;4739;5273.0
1158;Donderdag 1 januari 1998;360;187;173;421;222;199;6;6;;;2.0;0.0;1.0;1.0;0;13047;8697;4350;126;372;4.0
1159;Vrijdag 2 januari 1998;462;235;227;386;175;211;64;64;;;0.0;0.0;0.0;0.0;2;3555;2333;1222;88;150;2.0
1160;Zaterdag 3 januari 1998;505;261;244;374;199;175;34;34;;;0.0;0.0;0.0;0.0;0;766;534;232;9;54;0.0
1161;Zondag 4 januari 1998;435;228;207;370;172;198;3;3;;;0.0;0.0;0.0;0.0;1;177;112;65;4;35;0.0
1162;Maandag 5 januari 1998;520;255;265;415;212;203;107;107;;;0.0;0.0;0.0;0.0;107;10544;6473;4071;687;300;1017.0
1163;Dinsdag 6 januari 1998;620;326;294;368;173;195;107;107;;;0.0;0.0;0.0;0.0;136;6940;4104;2836;615;238;1221.0
1164;Woensdag 7 januari 1998;551;261;290;389;199;190;117;117;;;0.0;0.0;0.0;0.0;127;5752;3382;2370;528;164;6.0
1165;Donderdag 8 januari 1998;559;297;262;332;162;170;109;109;;;0.0;0.0;0.0;0.0;89;5867;3475;2392;519;200;6.0
1166;Zaterdag 10 januari 1998;445;231;214;365;167;198;27;27;;;0.0;0.0;0.0;0.0;1;1643;1205;438;6;48;4.0
1167;Vrijdag 9 januari 1998;543;275;268;353;174;179;175;175;;;0.0;0.0;0.0;0.0;105;5376;3258;2118;481;176;7.0
1168;Zondag 11 januari 1998;409;212;197;336;170;166;5;5;;;0.0;0.0;0.0;0.0;0;167;108;59;7;18;5.0
1169;Maandag 12 januari 1998;578;294;284;314;169;145;69;69;;;0.0;0.0;0.0;0.0;72;6567;4188;2379;636;244;12.0
1170;Dinsdag 13 januari 1998;593;300;293;342;175;167;34;34;;;1.0;0.0;1.0;0.0;106;4824;2982;1842;497;183;8.0
1171;Woensdag 14 januari 1998;597;286;311;361;167;194;81;81;;;0.0;0.0;0.0;0.0;137;4425;2756;1669;474;146;4.0
1172;Donderdag 15 januari 1998;611;303;308;403;214;189;111;111;;;6.0;0.0;2.0;4.0;135;8468;5745;2723;508;225;16.0
1173;Vrijdag 16 januari 1998;574;302;272;346;155;191;220;220;;;8.0;0.0;5.0;3.0;145;5350;3523;1827;400;173;8.0
1174;Zaterdag 17 januari 1998;437;230;207;319;153;166;30;30;;;0.0;0.0;0.0;0.0;0;1152;846;306;8;32;0.0
1175;Zondag 18 januari 1998;421;229;192;333;168;165;8;8;;;0.0;0.0;0.0;0.0;0;202;137;65;9;27;1.0
1176;Maandag 19 januari 1998;563;281;282;348;169;179;54;54;;;25.0;10.0;9.0;6.0;120;5623;3602;2021;583;197;17.0
1177;Dinsdag 20 januari 1998;621;312;309;344;161;183;50;50;;;17.0;8.0;7.0;2.0;103;4065;2140;1925;544;126;7.0
1178;Woensdag 21 januari 1998;588;283;305;347;163;184;49;49;;;16.0;4.0;9.0;3.0;85;3977;2143;1834;514;108;538.0
1179;Donderdag 22 januari 1998;553;296;257;348;174;174;90;90;;;28.0;9.0;11.0;8.0;128;4743;3008;1735;493;169;1047.0
1180;Vrijdag 23 januari 1998;552;294;258;387;202;185;283;283;;;41.0;4.0;25.0;12.0;143;4765;3008;1757;342;239;7.0
1181;Zaterdag 24 januari 1998;462;235;227;411;209;202;48;48;;;0.0;0.0;0.0;0.0;4;1679;1195;484;7;36;1.0
1182;Zondag 25 januari 1998;423;207;216;345;172;173;3;3;;;0.0;0.0;0.0;0.0;0;424;283;141;3;23;0.0
1183;Maandag 26 januari 1998;566;281;285;407;197;210;123;123;;;51.0;32.0;10.0;9.0;111;6230;4049;2181;525;230;23.0
1184;Dinsdag 27 januari 1998;629;335;294;346;174;172;109;109;;;13.0;4.0;6.0;3.0;155;4323;2635;1688;461;144;715.0
1185;Woensdag 28 januari 1998;579;317;262;386;179;207;105;105;;;32.0;16.0;12.0;4.0;133;4481;2685;1796;440;198;10.0
1186;Donderdag 29 januari 1998;570;289;281;376;180;196;115;115;;;30.0;14.0;9.0;7.0;133;5144;3231;1913;478;182;570.0
1187;Vrijdag 30 januari 1998;614;299;315;387;190;197;300;300;;;24.0;4.0;14.0;6.0;138;6471;4041;2430;334;208;17.0
1188;Zaterdag 31 januari 1998;458;232;226;400;187;213;52;52;;;1.0;0.0;1.0;0.0;0;2240;1540;700;1;94;0.0
1189;Totaal februari 1998;15179;7713;7466;10716;5352;5364;3456;3456;;;490.0;156.0;214.0;120.0;2647;134139;85676;48463;7953;4591;4894.0
1190;Zondag 1 februari 1998;389;188;201;389;193;196;4;4;;;0.0;0.0;0.0;0.0;0;12982;8833;4149;40;259;1.0
1191;Maandag 2 februari 1998;578;286;292;368;183;185;127;127;;;26.0;9.0;8.0;9.0;159;10646;6955;3691;563;258;66.0
1192;Dinsdag 3 februari 1998;646;322;324;402;205;197;99;99;;;18.0;8.0;6.0;4.0;112;5218;3201;2017;457;182;18.0
1193;Woensdag 4 februari 1998;600;317;283;363;172;191;107;107;;;18.0;2.0;13.0;3.0;117;4691;2845;1846;451;160;496.0
1194;Donderdag 5 februari 1998;605;287;318;382;172;210;117;117;;;20.0;5.0;12.0;3.0;154;5282;3224;2058;453;161;518.0
1195;Vrijdag 6 februari 1998;580;301;279;371;191;180;331;331;;;18.0;3.0;8.0;7.0;127;4706;2972;1734;390;174;109.0
1196;Zaterdag 7 februari 1998;446;222;224;384;183;201;56;56;;;0.0;0.0;0.0;0.0;0;1179;838;341;1;24;818.0
1197;Zondag 8 februari 1998;434;226;208;345;168;177;6;6;;;0.0;0.0;0.0;0.0;1;212;157;55;3;21;0.0
1198;Maandag 9 februari 1998;586;292;294;393;183;210;109;109;;;41.0;16.0;17.0;8.0;115;6221;3968;2253;485;217;22.0
1199;Dinsdag 10 februari 1998;640;341;299;375;194;181;130;130;;;32.0;13.0;13.0;6.0;161;4916;3128;1788;398;201;22.0
1200;Woensdag 11 februari 1998;602;309;293;384;193;191;123;123;;;24.0;10.0;12.0;2.0;159;4425;2639;1786;355;136;20.0
1201;Donderdag 12 februari 1998;591;322;269;390;185;205;156;156;;;17.0;6.0;7.0;4.0;136;4953;3065;1888;326;175;16.0
1202;Vrijdag 13 februari 1998;602;305;297;402;202;200;211;211;;;7.0;3.0;4.0;0.0;135;4719;2936;1783;297;166;11.0
1203;Zaterdag 14 februari 1998;462;224;238;376;191;185;120;120;;;4.0;0.0;2.0;2.0;0;1811;1299;512;4;42;1037.0
1204;Zondag 15 februari 1998;407;197;210;375;197;178;3;3;;;0.0;0.0;0.0;0.0;0;2021;1502;519;6;52;2.0
1205;Maandag 16 februari 1998;552;271;281;400;216;184;156;156;;;35.0;12.0;11.0;12.0;120;7851;5124;2727;442;244;24.0
1206;Dinsdag 17 februari 1998;588;301;287;387;175;212;119;119;;;28.0;6.0;15.0;7.0;131;4664;2915;1749;404;208;17.0
1207;Woensdag 18 februari 1998;598;291;307;369;203;166;128;128;;;28.0;10.0;13.0;5.0;140;4455;2742;1713;369;232;14.0
1208;Donderdag 19 februari 1998;603;327;276;382;193;189;155;155;;;27.0;9.0;12.0;6.0;144;4737;2921;1816;391;170;10.0
1209;Vrijdag 20 februari 1998;565;281;284;419;201;218;327;327;;;15.0;1.0;8.0;6.0;130;5856;3868;1988;269;204;14.0
1210;Zaterdag 21 februari 1998;454;230;224;379;195;184;28;28;;;0.0;0.0;0.0;0.0;0;1909;1354;555;7;31;26.0
1211;Zondag 22 februari 1998;431;215;216;383;210;173;4;4;;;0.0;0.0;0.0;0.0;0;205;118;87;5;30;0.0
1212;Maandag 23 februari 1998;536;255;281;349;170;179;118;118;;;39.0;15.0;13.0;11.0;118;5891;3703;2188;407;323;15.0
1213;Dinsdag 24 februari 1998;544;276;268;389;204;185;103;103;;;24.0;4.0;15.0;5.0;105;4315;2692;1623;304;148;15.0
1214;Woensdag 25 februari 1998;623;319;304;374;179;195;121;121;;;26.0;12.0;7.0;7.0;145;5160;3107;2053;386;224;17.0
1215;Donderdag 26 februari 1998;540;292;248;393;199;194;151;151;;;28.0;10.0;10.0;8.0;135;5591;3342;2249;383;192;1570.0
1216;Vrijdag 27 februari 1998;515;276;239;405;199;206;294;294;;;13.0;1.0;7.0;5.0;101;6861;4321;2540;347;233;16.0
1217;Zaterdag 28 februari 1998;462;240;222;388;196;192;53;53;;;2.0;1.0;1.0;0.0;2;2662;1907;755;10;124;0.0
1218;Totaal maart 1998;16508;8496;8012;12928;6468;6460;4497;4497;;;506.0;190.0;192.0;124.0;2789;151983;94877;57106;9135;4960;8214.0
1219;Zondag 1 maart 1998;400;220;180;329;171;158;10;10;;;0.0;0.0;0.0;0.0;0;14236;9679;4557;60;284;2.0
1220;Maandag 2 maart 1998;553;276;277;381;198;183;145;145;;;32.0;14.0;12.0;6.0;116;11907;7796;4111;494;280;16.0
1221;Dinsdag 3 maart 1998;588;295;293;415;216;199;120;120;;;28.0;10.0;10.0;8.0;125;5648;3454;2194;426;203;8.0
1222;Woensdag 4 maart 1998;646;316;330;433;228;205;80;80;;;10.0;4.0;4.0;2.0;101;4647;2854;1793;330;153;12.0
1223;Donderdag 5 maart 1998;597;308;289;414;204;210;170;170;;;20.0;3.0;10.0;7.0;125;5836;3651;2185;487;244;15.0
1224;Vrijdag 6 maart 1998;546;281;265;404;216;188;395;395;;;18.0;1.0;10.0;7.0;124;5087;3139;1948;358;155;18.0
1225;Zaterdag 7 maart 1998;457;249;208;382;188;194;61;61;;;1.0;0.0;1.0;0.0;0;1189;893;296;11;37;1.0
1226;Zondag 8 maart 1998;430;235;195;383;199;184;2;2;;;0.0;0.0;0.0;0.0;1;211;141;70;6;8;0.0
1227;Maandag 9 maart 1998;491;249;242;386;202;184;127;127;;;29.0;12.0;10.0;7.0;113;6789;4066;2723;480;179;11.0
1228;Dinsdag 10 maart 1998;581;294;287;403;196;207;103;103;;;24.0;11.0;7.0;6.0;159;5410;3220;2190;423;191;3067.0
1229;Woensdag 11 maart 1998;574;295;279;437;229;208;130;130;;;12.0;6.0;2.0;4.0;122;4679;2769;1910;379;178;5.0
1230;Donderdag 12 maart 1998;614;299;315;397;183;214;161;161;;;19.0;8.0;5.0;6.0;142;5331;3123;2208;391;171;12.0
1231;Vrijdag 13 maart 1998;556;288;268;413;205;208;260;260;;;18.0;4.0;11.0;3.0;151;4959;2949;2010;300;175;1042.0
1232;Zaterdag 14 maart 1998;431;200;231;441;211;230;50;50;;;0.0;0.0;0.0;0.0;0;1562;1155;407;1;43;1.0
1233;Zondag 15 maart 1998;459;222;237;399;205;194;3;3;;;0.0;0.0;0.0;0.0;0;1992;1442;550;15;79;1.0
1234;Maandag 16 maart 1998;563;281;282;412;201;211;143;143;;;26.0;7.0;14.0;5.0;127;8299;5207;3092;490;242;14.0
1235;Dinsdag 17 maart 1998;593;277;316;430;206;224;94;94;;;26.0;12.0;9.0;5.0;137;4908;2821;2087;472;157;1068.0
1236;Woensdag 18 maart 1998;601;312;289;458;227;231;135;135;;;22.0;11.0;4.0;7.0;117;4720;2708;2012;424;156;434.0
1237;Donderdag 19 maart 1998;507;248;259;423;211;212;184;184;;;23.0;9.0;10.0;4.0;122;4956;2872;2084;398;201;6.0
1238;Vrijdag 20 maart 1998;576;295;281;422;224;198;571;571;;;38.0;8.0;16.0;14.0;137;5300;3391;1909;309;191;162.0
1239;Zaterdag 21 maart 1998;410;225;185;431;213;218;91;91;;;4.0;0.0;3.0;1.0;1;1648;1209;439;7;36;0.0
1240;Zondag 22 maart 1998;447;248;199;415;188;227;3;3;;;0.0;0.0;0.0;0.0;0;152;116;36;0;16;6.0
1241;Maandag 23 maart 1998;536;278;258;388;191;197;119;119;;;30.0;15.0;9.0;6.0;145;6286;3860;2426;443;224;13.0
1242;Dinsdag 24 maart 1998;611;311;300;403;194;209;126;126;;;25.0;13.0;5.0;7.0;152;4476;2670;1806;352;221;461.0
1243;Woensdag 25 maart 1998;549;293;256;422;210;212;148;148;;;22.0;12.0;7.0;3.0;124;5049;3013;2036;456;195;15.0
1244;Donderdag 26 maart 1998;582;305;277;467;227;240;176;176;;;13.0;2.0;8.0;3.0;122;5101;3021;2080;369;172;1071.0
1245;Vrijdag 27 maart 1998;575;332;243;432;208;224;534;534;;;13.0;1.0;8.0;4.0;96;5574;3373;2201;295;190;301.0
1246;Zaterdag 28 maart 1998;419;208;211;470;231;239;73;73;;;1.0;0.0;0.0;1.0;0;2419;1632;787;13;62;0.0
1247;Zondag 29 maart 1998;385;195;190;402;202;200;3;3;;;0.0;0.0;0.0;0.0;0;222;141;81;9;27;1.0
1248;Maandag 30 maart 1998;598;331;267;498;250;248;142;142;;;28.0;13.0;10.0;5.0;118;6760;4378;2382;515;257;433.0
1249;Dinsdag 31 maart 1998;633;330;303;438;234;204;138;138;;;24.0;14.0;7.0;3.0;112;6630;4134;2496;422;233;18.0
1250;Totaal april 1998;16139;8245;7894;12317;6121;6196;6473;6473;;;501.0;172.0;180.0;149.0;2685;142928;90643;52285;8223;4468;2211.0
1251;Woensdag 1 april 1998;544;269;275;439;236;203;286;286;;;31.0;15.0;7.0;9.0;157;26108;17410;8698;580;523;23.0
1252;Donderdag 2 april 1998;570;276;294;434;210;224;169;169;;;16.0;5.0;5.0;6.0;159;5840;3487;2353;380;169;658.0
1253;Vrijdag 3 april 1998;582;322;260;444;194;250;555;555;;;16.0;4.0;6.0;6.0;115;4884;2935;1949;343;225;322.0
1254;Zaterdag 4 april 1998;485;253;232;441;211;230;85;85;;;4.0;0.0;2.0;2.0;1;1244;889;355;4;28;2.0
1255;Zondag 5 april 1998;422;219;203;413;196;217;5;5;;;0.0;0.0;0.0;0.0;0;275;192;83;7;29;2.0
1256;Maandag 6 april 1998;544;274;270;430;216;214;170;170;;;37.0;19.0;8.0;10.0;127;6543;3993;2550;547;173;181.0
1257;Dinsdag 7 april 1998;610;298;312;411;191;220;120;120;;;23.0;12.0;9.0;2.0;169;4961;2915;2046;402;195;312.0
1258;Woensdag 8 april 1998;614;305;309;401;199;202;163;163;;;23.0;9.0;6.0;8.0;130;4534;2687;1847;427;174;8.0
1259;Donderdag 9 april 1998;549;275;274;414;224;190;291;291;;;22.0;7.0;13.0;2.0;123;5743;3417;2326;459;235;16.0
1260;Vrijdag 10 april 1998;555;295;260;447;222;225;68;68;;;5.0;0.0;3.0;2.0;15;2441;1663;778;41;63;4.0
1261;Zaterdag 11 april 1998;437;230;207;424;201;223;51;51;;;2.0;0.0;1.0;1.0;1;1244;908;336;0;17;2.0
1262;Zondag 12 april 1998;414;215;199;383;188;195;4;4;;;0.0;0.0;0.0;0.0;0;204;154;50;3;25;0.0
1263;Maandag 13 april 1998;417;199;218;382;172;210;13;13;;;0.0;0.0;0.0;0.0;4;371;286;85;8;15;1.0
1264;Dinsdag 14 april 1998;543;268;275;433;233;200;148;148;;;38.0;14.0;14.0;10.0;176;7089;4349;2740;518;270;24.0
1265;Woensdag 15 april 1998;591;307;284;423;208;215;187;187;;;25.0;8.0;8.0;9.0;137;8549;5570;2979;383;228;18.0
1266;Donderdag 16 april 1998;629;330;299;398;199;199;255;255;;;14.0;2.0;7.0;5.0;119;5963;3758;2205;442;216;20.0
1267;Vrijdag 17 april 1998;612;331;281;421;227;194;760;760;;;23.0;4.0;10.0;9.0;122;5212;3293;1919;337;183;17.0
1268;Zaterdag 18 april 1998;501;249;252;429;224;205;89;89;;;1.0;0.0;1.0;0.0;0;1399;999;400;7;32;4.0
1269;Zondag 19 april 1998;457;235;222;414;194;220;10;10;;;0.0;0.0;0.0;0.0;0;143;101;42;6;25;2.0
1270;Maandag 20 april 1998;562;283;279;405;205;200;179;179;;;39.0;14.0;15.0;10.0;169;7110;4524;2586;485;210;483.0
1271;Dinsdag 21 april 1998;636;336;300;362;188;174;186;186;;;26.0;9.0;11.0;6.0;175;4724;2911;1813;402;119;17.0
1272;Woensdag 22 april 1998;558;265;293;446;237;209;223;223;;;27.0;11.0;4.0;12.0;142;4401;2620;1781;395;130;12.0
1273;Donderdag 23 april 1998;631;319;312;426;220;206;309;309;;;25.0;6.0;12.0;7.0;152;4930;3108;1822;394;145;16.0
1274;Vrijdag 24 april 1998;564;282;282;417;197;220;999;999;;;33.0;8.0;13.0;12.0;101;5393;3359;2034;278;200;10.0
1275;Zaterdag 25 april 1998;408;211;197;365;181;184;140;140;;;1.0;0.0;1.0;0.0;0;2704;1815;889;7;31;6.0
1276;Zondag 26 april 1998;483;263;220;347;165;182;7;7;;;1.0;0.0;1.0;0.0;0;272;165;107;3;39;0.0
1277;Maandag 27 april 1998;545;284;261;401;189;212;221;221;;;21.0;9.0;6.0;6.0;123;6642;4138;2504;505;247;11.0
1278;Dinsdag 28 april 1998;610;299;311;393;204;189;207;207;;;28.0;11.0;12.0;5.0;139;5535;3439;2096;417;209;23.0
1279;Woensdag 29 april 1998;612;321;291;376;194;182;547;547;;;20.0;5.0;5.0;10.0;126;6789;4361;2428;438;237;17.0
1280;Donderdag 30 april 1998;454;232;222;398;196;202;26;26;;;0.0;0.0;0.0;0.0;3;1681;1197;484;5;76;0.0
1281;Totaal mei 1998;16337;8344;7993;11641;5733;5908;11339;11339;;;487.0;144.0;199.0;144.0;2666;139656;90822;48834;8073;4023;5538.0
1282;Vrijdag 1 mei 1998;541;288;253;384;190;194;700;700;;;16.0;0.0;11.0;5.0;38;21777;14738;7039;215;407;7.0
1283;Zaterdag 2 mei 1998;423;213;210;370;151;219;143;143;;;2.0;0.0;2.0;0.0;0;758;504;254;0;34;0.0
1284;Zondag 3 mei 1998;434;222;212;370;176;194;5;5;;;0.0;0.0;0.0;0.0;1;139;98;41;0;23;0.0
1285;Maandag 4 mei 1998;541;275;266;363;202;161;64;64;;;17.0;8.0;6.0;3.0;104;5905;3782;2123;395;187;20.0
1286;Dinsdag 5 mei 1998;544;251;293;371;179;192;22;22;;;2.0;1.0;1.0;0.0;7;704;474;230;10;23;5.0
1287;Woensdag 6 mei 1998;653;341;312;349;172;177;129;129;;;16.0;5.0;8.0;3.0;236;8113;5122;2991;544;246;1568.0
1288;Donderdag 7 mei 1998;572;282;290;360;180;180;404;404;;;22.0;10.0;8.0;4.0;115;7283;4569;2714;555;189;21.0
1289;Vrijdag 8 mei 1998;576;314;262;377;191;186;1169;1169;;;29.0;4.0;15.0;10.0;132;5777;3601;2176;406;116;8.0
1290;Zaterdag 9 mei 1998;472;246;226;420;201;219;143;143;;;1.0;0.0;1.0;0.0;0;1395;944;451;7;26;2.0
1291;Zondag 10 mei 1998;458;249;209;358;175;183;3;3;;;0.0;0.0;0.0;0.0;0;568;385;183;1;22;3.0
1292;Maandag 11 mei 1998;594;315;279;416;198;218;247;247;;;40.0;19.0;10.0;11.0;155;6219;3940;2279;491;174;17.0
1293;Dinsdag 12 mei 1998;648;321;327;427;216;211;222;222;;;26.0;9.0;8.0;9.0;169;4607;2844;1763;477;152;10.0
1294;Woensdag 13 mei 1998;623;311;312;455;217;238;192;192;;;22.0;8.0;8.0;6.0;189;4030;2482;1548;428;167;2044.0
1295;Donderdag 14 mei 1998;586;281;305;393;173;220;498;498;;;17.0;5.0;5.0;7.0;140;5037;3212;1825;471;155;10.0
1296;Vrijdag 15 mei 1998;562;293;269;400;201;199;1417;1417;;;34.0;7.0;17.0;10.0;117;8528;5854;2674;267;214;6.0
1297;Zaterdag 16 mei 1998;463;246;217;384;196;188;220;220;;;4.0;1.0;3.0;0.0;2;1698;1236;462;3;42;2.0
1298;Zondag 17 mei 1998;451;216;235;351;164;187;6;6;;;0.0;0.0;0.0;0.0;0;171;115;56;2;15;2.0
1299;Maandag 18 mei 1998;527;273;254;407;200;207;218;218;;;25.0;12.0;6.0;7.0;145;6226;4098;2128;521;183;187.0
1300;Dinsdag 19 mei 1998;628;319;309;378;197;181;241;241;;;27.0;9.0;11.0;7.0;146;4566;2793;1773;439;161;720.0
1301;Woensdag 20 mei 1998;590;304;286;401;191;210;1246;1246;;;44.0;10.0;15.0;19.0;173;5876;3793;2083;429;166;16.0
1302;Donderdag 21 mei 1998;426;232;194;370;204;166;17;17;;;0.0;0.0;0.0;0.0;0;483;332;151;1;29;0.0
1303;Vrijdag 22 mei 1998;494;255;239;344;172;172;734;734;;;8.0;0.0;3.0;5.0;19;2034;1401;633;76;65;5.0
1304;Zaterdag 23 mei 1998;437;219;218;341;176;165;173;173;;;3.0;0.0;2.0;1.0;1;1500;1064;436;0;10;0.0
1305;Zondag 24 mei 1998;416;232;184;347;177;170;5;5;;;0.0;0.0;0.0;0.0;0;232;170;62;3;32;1.0
1306;Maandag 25 mei 1998;555;279;276;352;184;168;209;209;;;29.0;10.0;9.0;10.0;150;8525;5648;2877;606;268;23.0
1307;Dinsdag 26 mei 1998;596;287;309;356;170;186;185;185;;;23.0;11.0;7.0;5.0;175;5594;3525;2069;505;218;334.0
1308;Woensdag 27 mei 1998;593;266;327;359;172;187;318;318;;;20.0;4.0;13.0;3.0;180;5214;3192;2022;422;165;19.0
1309;Donderdag 28 mei 1998;552;295;257;357;150;207;630;630;;;21.0;6.0;9.0;6.0;151;6599;4136;2463;463;195;485.0
1310;Vrijdag 29 mei 1998;564;282;282;376;195;181;1520;1520;;;36.0;5.0;18.0;13.0;121;7452;4881;2571;333;197;19.0
1311;Zaterdag 30 mei 1998;418;234;184;370;191;179;253;253;;;3.0;0.0;3.0;0.0;0;1896;1379;517;3;71;1.0
1312;Zondag 31 mei 1998;400;203;197;335;172;163;6;6;;;0.0;0.0;0.0;0.0;0;750;510;240;0;71;3.0
1313;Totaal juni 1998;16138;8302;7836;10459;5264;5195;11047;11047;;;439.0;137.0;157.0;145.0;2882;146742;94186;52556;9605;5196;1561.0
1314;Maandag 1 juni 1998;454;232;222;305;152;153;10;10;;;0.0;0.0;0.0;0.0;1;14565;9987;4578;47;268;3.0
1315;Dinsdag 2 juni 1998;545;286;259;351;175;176;232;232;;;27.0;10.0;7.0;10.0;145;9850;6425;3425;576;287;24.0
1316;Woensdag 3 juni 1998;594;299;295;378;194;184;248;248;;;20.0;6.0;7.0;7.0;133;5993;3700;2293;518;180;14.0
1317;Donderdag 4 juni 1998;494;255;239;360;183;177;475;475;;;23.0;10.0;7.0;6.0;144;5977;3715;2262;514;131;20.0
1318;Vrijdag 5 juni 1998;532;264;268;312;159;153;1435;1435;;;25.0;2.0;12.0;11.0;110;5530;3446;2084;352;164;11.0
1319;Zaterdag 6 juni 1998;443;232;211;327;172;155;266;266;;;3.0;0.0;2.0;1.0;2;1110;791;319;6;28;2.0
1320;Zondag 7 juni 1998;439;226;213;335;174;161;8;8;;;0.0;0.0;0.0;0.0;0;197;144;53;6;19;2.0
1321;Maandag 8 juni 1998;520;274;246;339;168;171;203;203;;;30.0;16.0;5.0;9.0;142;6612;4254;2358;531;228;17.0
1322;Dinsdag 9 juni 1998;554;273;281;325;179;146;166;166;;;21.0;5.0;8.0;8.0;159;4812;2931;1881;423;175;21.0
1323;Woensdag 10 juni 1998;586;296;290;342;172;170;232;232;;;15.0;6.0;3.0;6.0;145;4797;3107;1690;391;148;15.0
1324;Donderdag 11 juni 1998;557;298;259;387;202;185;393;393;;;19.0;5.0;6.0;8.0;134;4579;2857;1722;410;168;9.0
1325;Vrijdag 12 juni 1998;562;284;278;319;161;158;1386;1386;;;19.0;1.0;11.0;7.0;114;4985;3166;1819;286;191;14.0
1326;Zaterdag 13 juni 1998;421;225;196;329;171;158;159;159;;;1.0;0.0;1.0;0.0;1;1428;982;446;5;48;0.0
1327;Zondag 14 juni 1998;438;217;221;342;189;153;7;7;;;0.0;0.0;0.0;0.0;0;283;209;74;4;21;2.0
1328;Maandag 15 juni 1998;560;297;263;354;170;184;206;206;;;15.0;6.0;6.0;3.0;120;10321;6939;3382;530;258;33.0
1329;Dinsdag 16 juni 1998;634;331;303;364;178;186;149;149;;;17.0;3.0;7.0;7.0;183;5419;3365;2054;398;150;24.0
1330;Woensdag 17 juni 1998;574;294;280;358;182;176;231;231;;;18.0;6.0;8.0;4.0;136;4311;2609;1702;434;144;1165.0
1331;Donderdag 18 juni 1998;584;303;281;334;161;173;454;454;;;10.0;3.0;2.0;5.0;173;4923;3143;1780;421;188;23.0
1332;Vrijdag 19 juni 1998;585;285;300;386;205;181;1392;1392;;;18.0;2.0;10.0;6.0;142;4626;3004;1622;318;214;19.0
1333;Zaterdag 20 juni 1998;509;257;252;361;171;190;243;243;;;3.0;0.0;3.0;0.0;1;2397;1730;667;6;58;0.0
1334;Zondag 21 juni 1998;483;249;234;388;189;199;11;11;;;0.0;0.0;0.0;0.0;0;231;166;65;0;45;2.0
1335;Maandag 22 juni 1998;569;307;262;373;176;197;192;192;;;23.0;12.0;9.0;2.0;133;6245;3987;2258;565;206;27.0
1336;Dinsdag 23 juni 1998;626;336;290;356;163;193;165;165;;;15.0;2.0;5.0;8.0;124;4485;2760;1725;371;201;22.0
1337;Woensdag 24 juni 1998;612;307;305;381;198;183;283;283;;;27.0;12.0;8.0;7.0;153;4196;2594;1602;401;163;22.0
1338;Donderdag 25 juni 1998;572;282;290;359;163;196;458;458;;;22.0;12.0;4.0;6.0;138;5366;3313;2053;439;187;14.0
1339;Vrijdag 26 juni 1998;617;347;270;337;158;179;1455;1455;;;28.0;2.0;17.0;9.0;88;5613;3552;2061;396;220;17.0
1340;Zaterdag 27 juni 1998;503;244;259;335;167;168;209;209;;;1.0;0.0;0.0;1.0;0;2249;1575;674;3;102;1.0
1341;Zondag 28 juni 1998;436;231;205;315;166;149;9;9;;;0.0;0.0;0.0;0.0;0;487;317;170;3;44;1.0
1342;Maandag 29 juni 1998;566;289;277;348;186;162;183;183;;;23.0;11.0;4.0;8.0;117;7126;4382;2744;699;324;16.0
1343;Dinsdag 30 juni 1998;569;282;287;359;180;179;187;187;;;16.0;5.0;5.0;6.0;144;8029;5036;2993;552;636;21.0
1344;Totaal juli 1998;17805;9087;8718;10953;5431;5522;8932;8932;;;390.0;142.0;145.0;103.0;2953;170726;104286;66440;11427;7123;3472.0
1345;Woensdag 1 juli 1998;599;322;277;362;198;164;277;277;;;25.0;7.0;10.0;8.0;145;30757;19792;10965;587;676;20.0
1346;Donderdag 2 juli 1998;590;284;306;366;183;183;360;360;;;10.0;1.0;3.0;6.0;135;6288;3722;2566;507;265;441.0
1347;Vrijdag 3 juli 1998;627;300;327;326;138;188;1156;1156;;;22.0;4.0;15.0;3.0;109;5750;3396;2354;370;390;13.0
1348;Zaterdag 4 juli 1998;499;251;248;352;158;194;212;212;;;2.0;1.0;1.0;0.0;0;1440;1002;438;0;74;0.0
1349;Zondag 5 juli 1998;485;235;250;338;182;156;5;5;;;0.0;0.0;0.0;0.0;0;295;164;131;1;70;0.0
1350;Maandag 6 juli 1998;569;288;281;356;175;181;211;211;;;23.0;13.0;5.0;5.0;120;7359;4349;3010;631;390;2612.0
1351;Dinsdag 7 juli 1998;652;326;326;350;185;165;194;194;;;19.0;10.0;5.0;4.0;151;5288;3097;2191;556;228;22.0
1352;Woensdag 8 juli 1998;644;324;320;353;188;165;206;206;;;9.0;7.0;1.0;1.0;157;4970;2939;2031;510;253;10.0
1353;Donderdag 9 juli 1998;585;306;279;368;182;186;314;314;;;17.0;6.0;9.0;2.0;155;4906;2856;2050;563;216;19.0
1354;Vrijdag 10 juli 1998;588;303;285;358;182;176;1030;1030;;;22.0;4.0;9.0;9.0;115;6313;3865;2448;368;303;14.0
1355;Zaterdag 11 juli 1998;463;253;210;340;176;164;148;148;;;2.0;0.0;0.0;2.0;1;1797;1193;604;3;55;0.0
1356;Zondag 12 juli 1998;467;245;222;331;166;165;11;11;;;0.0;0.0;0.0;0.0;1;340;218;122;8;51;144.0
1357;Maandag 13 juli 1998;561;297;264;354;191;163;156;156;;;14.0;6.0;4.0;4.0;122;6790;4067;2723;630;299;18.0
1358;Dinsdag 14 juli 1998;635;309;326;361;181;180;198;198;;;21.0;8.0;7.0;6.0;138;5334;3075;2259;574;299;8.0
1359;Woensdag 15 juli 1998;602;317;285;336;179;157;212;212;;;20.0;13.0;3.0;4.0;118;9562;6116;3446;500;305;12.0
1360;Donderdag 16 juli 1998;595;282;313;316;159;157;290;290;;;20.0;6.0;9.0;5.0;124;5665;3451;2214;473;219;11.0
1361;Vrijdag 17 juli 1998;620;286;334;379;196;183;777;777;;;16.0;2.0;10.0;4.0;111;5879;3499;2380;421;230;10.0
1362;Zaterdag 18 juli 1998;465;250;215;333;149;184;131;131;;;0.0;0.0;0.0;0.0;1;1787;1240;547;2;61;0.0
1363;Zondag 19 juli 1998;442;250;192;329;179;150;8;8;;;0.0;0.0;0.0;0.0;0;158;88;70;7;38;1.0
1364;Maandag 20 juli 1998;602;303;299;411;218;193;190;190;;;23.0;7.0;9.0;7.0;123;7442;4732;2710;558;256;17.0
1365;Dinsdag 21 juli 1998;610;310;300;408;199;209;177;177;;;13.0;6.0;4.0;3.0;147;4481;2628;1853;524;211;6.0
1366;Woensdag 22 juli 1998;581;296;285;327;165;162;173;173;;;15.0;9.0;3.0;3.0;129;4721;2780;1941;463;183;7.0
1367;Donderdag 23 juli 1998;643;330;313;356;192;164;247;247;;;8.0;3.0;4.0;1.0;140;4831;2926;1905;408;204;18.0
1368;Vrijdag 24 juli 1998;592;315;277;394;169;225;667;667;;;15.0;2.0;9.0;4.0;102;5280;3226;2054;341;241;12.0
1369;Zaterdag 25 juli 1998;463;242;221;328;152;176;96;96;;;1.0;0.0;1.0;0.0;0;2574;1764;810;9;68;0.0
1370;Zondag 26 juli 1998;468;248;220;364;183;181;20;20;;;0.0;0.0;0.0;0.0;0;272;175;97;8;26;2.0
1371;Maandag 27 juli 1998;617;327;290;371;167;204;236;236;;;13.0;9.0;2.0;2.0;133;6715;3966;2749;616;307;9.0
1372;Dinsdag 28 juli 1998;651;336;315;380;178;202;197;197;;;14.0;4.0;3.0;7.0;122;5068;2870;2198;458;270;11.0
1373;Woensdag 29 juli 1998;637;318;319;320;143;177;195;195;;;14.0;5.0;6.0;3.0;145;4567;2616;1951;395;268;17.0
1374;Donderdag 30 juli 1998;596;297;299;350;157;193;246;246;;;17.0;5.0;6.0;6.0;121;5964;3598;2366;495;249;9.0
1375;Vrijdag 31 juli 1998;657;337;320;336;161;175;592;592;;;15.0;4.0;7.0;4.0;88;8133;4876;3257;441;418;9.0
1376;Totaal augustus 1998;17543;8984;8559;10703;5278;5425;10141;10141;;;317.0;105.0;106.0;106.0;2127;150039;86466;63573;13245;5826;2027.0
1377;Zaterdag 1 augustus 1998;488;265;223;344;165;179;137;137;;;1.0;0.0;1.0;0.0;1;21379;13500;7879;69;547;2.0
1378;Zondag 2 augustus 1998;455;247;208;308;157;151;19;19;;;0.0;0.0;0.0;0.0;0;166;97;69;6;32;1.0
1379;Maandag 3 augustus 1998;523;270;253;355;179;176;245;245;;;14.0;5.0;3.0;6.0;98;9900;5956;3944;758;329;11.0
1380;Dinsdag 4 augustus 1998;612;324;288;345;160;185;208;208;;;16.0;8.0;3.0;5.0;148;5557;3070;2487;662;182;7.0
1381;Woensdag 5 augustus 1998;595;302;293;346;172;174;198;198;;;8.0;7.0;0.0;1.0;91;5024;2777;2247;641;189;6.0
1382;Donderdag 6 augustus 1998;648;311;337;342;164;178;251;251;;;14.0;3.0;5.0;6.0;93;5092;2712;2380;756;205;9.0
1383;Vrijdag 7 augustus 1998;621;315;306;343;175;168;686;686;;;16.0;1.0;8.0;7.0;146;4712;2692;2020;433;177;9.0
1384;Zaterdag 8 augustus 1998;535;246;289;359;176;183;240;240;;;2.0;0.0;0.0;2.0;0;1282;845;437;3;51;3.0
1385;Zondag 9 augustus 1998;483;245;238;360;173;187;20;20;;;0.0;0.0;0.0;0.0;1;191;127;64;3;28;3.0
1386;Maandag 10 augustus 1998;618;331;287;343;165;178;264;264;;;22.0;11.0;6.0;5.0;118;7110;4090;3020;603;310;14.0
1387;Dinsdag 11 augustus 1998;675;336;339;406;194;212;218;218;;;16.0;7.0;5.0;4.0;125;4273;2387;1886;591;203;11.0
1388;Woensdag 12 augustus 1998;631;336;295;404;212;192;212;212;;;14.0;5.0;6.0;3.0;117;4303;2385;1918;537;221;12.0
1389;Donderdag 13 augustus 1998;607;307;300;371;156;215;208;208;;;14.0;4.0;6.0;4.0;137;4974;2654;2320;679;174;14.0
1390;Vrijdag 14 augustus 1998;626;317;309;367;192;175;943;943;;;12.0;0.0;9.0;3.0;88;6129;3615;2514;426;223;10.0
1391;Zaterdag 15 augustus 1998;495;259;236;330;151;179;149;149;;;3.0;0.0;3.0;0.0;0;4045;2590;1455;20;138;0.0
1392;Zondag 16 augustus 1998;440;228;212;293;158;135;20;20;;;0.0;0.0;0.0;0.0;0;464;285;179;16;48;1.0
1393;Maandag 17 augustus 1998;590;296;294;352;174;178;271;271;;;15.0;11.0;1.0;3.0;90;7260;4046;3214;756;280;8.0
1394;Dinsdag 18 augustus 1998;615;312;303;343;158;185;267;267;;;13.0;9.0;2.0;2.0;125;5005;2610;2395;598;189;15.0
1395;Woensdag 19 augustus 1998;599;294;305;340;168;172;265;265;;;14.0;4.0;4.0;6.0;101;4381;2435;1946;610;162;15.0
1396;Donderdag 20 augustus 1998;622;329;293;404;199;205;434;434;;;4.0;2.0;1.0;1.0;102;5552;3165;2387;605;241;12.0
1397;Vrijdag 21 augustus 1998;585;297;288;329;166;163;1277;1277;;;17.0;3.0;10.0;4.0;100;4887;2736;2151;429;204;11.0
1398;Zaterdag 22 augustus 1998;467;255;212;302;130;172;244;244;;;2.0;0.0;2.0;0.0;0;1440;859;581;1;25;1.0
1399;Zondag 23 augustus 1998;473;232;241;329;169;160;12;12;;;0.0;0.0;0.0;0.0;0;190;111;79;10;29;2.0
1400;Maandag 24 augustus 1998;546;266;280;325;158;167;246;246;;;16.0;5.0;6.0;5.0;109;6775;3678;3097;722;288;24.0
1401;Dinsdag 25 augustus 1998;611;326;285;321;167;154;228;228;;;8.0;2.0;1.0;5.0;100;5198;2863;2335;681;240;97.0
1402;Woensdag 26 augustus 1998;638;319;319;348;187;161;286;286;;;16.0;3.0;6.0;7.0;92;4324;2307;2017;629;177;14.0
1403;Donderdag 27 augustus 1998;640;332;308;345;175;170;490;490;;;21.0;5.0;7.0;9.0;52;5317;3034;2283;578;241;20.0
1404;Vrijdag 28 augustus 1998;595;290;305;362;188;174;1597;1597;;;19.0;2.0;5.0;12.0;36;5375;3181;2194;642;200;10.0
1405;Zaterdag 29 augustus 1998;477;258;219;333;175;158;278;278;;;4.0;1.0;2.0;1.0;1;1247;810;437;7;48;0.0
1406;Zondag 30 augustus 1998;425;223;202;309;147;162;7;7;;;0.0;0.0;0.0;0.0;0;540;351;189;7;69;1.0
1407;Maandag 31 augustus 1998;608;316;292;345;168;177;221;221;;;16.0;7.0;4.0;5.0;56;7947;4498;3449;767;376;1684.0
1408;Totaal september 1998;18137;9398;8739;10703;5291;5412;11740;11740;;;361.0;105.0;123.0;133.0;2563;148770;87997;60773;13584;5672;7693.0
1409;Dinsdag 1 september 1998;595;325;270;373;170;203;240;240;;;18.0;5.0;8.0;5.0;71;28160;17029;11131;752;877;3624.0
1410;Woensdag 2 september 1998;642;335;307;337;168;169;277;277;;;13.0;1.0;7.0;5.0;91;5412;2890;2522;696;247;213.0
1411;Donderdag 3 september 1998;656;352;304;368;200;168;554;554;;;14.0;5.0;4.0;5.0;107;5392;3023;2369;703;187;9.0
1412;Vrijdag 4 september 1998;601;303;298;347;171;176;1582;1582;;;21.0;3.0;10.0;8.0;109;5240;2925;2315;608;223;11.0
1413;Zaterdag 5 september 1998;510;254;256;360;175;185;306;306;;;5.0;0.0;4.0;1.0;0;1054;642;412;4;40;7.0
1414;Zondag 6 september 1998;487;229;258;348;158;190;5;5;;;0.0;0.0;0.0;0.0;0;217;113;104;5;44;0.0
1415;Maandag 7 september 1998;620;337;283;341;169;172;200;200;;;16.0;8.0;1.0;7.0;133;6523;3890;2633;739;234;18.0
1416;Dinsdag 8 september 1998;629;317;312;333;160;173;268;268;;;15.0;6.0;4.0;5.0;158;4785;2634;2151;722;226;1020.0
1417;Woensdag 9 september 1998;635;326;309;341;157;184;325;325;;;13.0;6.0;4.0;3.0;120;4399;2323;2076;527;145;19.0
1418;Donderdag 10 september 1998;645;342;303;379;187;192;535;535;;;7.0;2.0;3.0;2.0;142;5601;3152;2449;720;225;723.0
1419;Vrijdag 11 september 1998;700;391;309;372;186;186;1440;1440;;;21.0;0.0;9.0;12.0;102;4475;2544;1931;529;151;332.0
1420;Zaterdag 12 september 1998;534;257;277;329;168;161;267;267;;;1.0;0.0;1.0;0.0;0;1228;812;416;12;43;0.0
1421;Zondag 13 september 1998;463;235;228;335;162;173;4;4;;;0.0;0.0;0.0;0.0;0;140;95;45;16;22;0.0
1422;Maandag 14 september 1998;604;316;288;365;189;176;177;177;;;14.0;9.0;3.0;2.0;105;6061;3638;2423;699;266;8.0
1423;Dinsdag 15 september 1998;638;324;314;352;167;185;181;181;;;14.0;7.0;3.0;4.0;133;8049;4993;3056;801;270;9.0
1424;Woensdag 16 september 1998;622;315;307;343;163;180;193;193;;;16.0;6.0;2.0;8.0;118;4858;2829;2029;545;172;13.0
1425;Donderdag 17 september 1998;651;326;325;376;190;186;453;453;;;13.0;5.0;5.0;3.0;92;4965;2932;2033;527;154;13.0
1426;Vrijdag 18 september 1998;637;335;302;324;168;156;1474;1474;;;30.0;4.0;13.0;13.0;90;4706;2716;1990;424;175;14.0
1427;Zaterdag 19 september 1998;503;268;235;351;157;194;250;250;;;4.0;0.0;3.0;1.0;0;1158;776;382;14;31;0.0
1428;Zondag 20 september 1998;509;268;241;385;199;186;11;11;;;0.0;0.0;0.0;0.0;0;607;424;183;0;64;0.0
1429;Maandag 21 september 1998;583;320;263;354;167;187;184;184;;;13.0;9.0;3.0;1.0;97;6419;3949;2470;705;230;17.0
1430;Dinsdag 22 september 1998;628;318;310;361;186;175;159;159;;;14.0;3.0;6.0;5.0;115;4466;2584;1882;541;174;443.0
1431;Woensdag 23 september 1998;681;354;327;332;169;163;194;194;;;14.0;3.0;3.0;8.0;132;4206;2440;1766;609;176;14.0
1432;Donderdag 24 september 1998;706;330;376;353;180;173;422;422;;;8.0;3.0;2.0;3.0;142;4616;2712;1904;505;204;730.0
1433;Vrijdag 25 september 1998;691;371;320;370;203;167;1321;1321;;;32.0;4.0;13.0;15.0;93;5431;3392;2039;392;186;9.0
1434;Zaterdag 26 september 1998;536;279;257;377;176;201;196;196;;;2.0;0.0;1.0;1.0;0;1933;1307;626;5;52;0.0
1435;Zondag 27 september 1998;498;271;227;377;189;188;6;6;;;0.0;0.0;0.0;0.0;1;312;211;101;3;40;2.0
1436;Maandag 28 september 1998;584;293;291;391;180;211;168;168;;;22.0;10.0;6.0;6.0;122;6795;4203;2592;664;277;22.0
1437;Dinsdag 29 september 1998;687;360;327;368;189;179;139;139;;;13.0;5.0;2.0;6.0;137;4878;2736;2142;579;258;412.0
1438;Woensdag 30 september 1998;662;347;315;361;188;173;209;209;;;8.0;1.0;3.0;4.0;153;6684;4083;2601;538;279;11.0
1439;Totaal oktober 1998;17222;8746;8476;11101;5557;5544;7248;7248;;;288.0;105.0;93.0;90.0;3061;151117;94665;56452;11350;4890;5204.0
1440;Donderdag 1 oktober 1998;622;321;301;331;161;170;321;321;;;11.0;1.0;4.0;6.0;134;26812;17460;9352;691;644;9.0
1441;Vrijdag 2 oktober 1998;615;300;315;318;154;164;896;896;;;21.0;3.0;7.0;11.0;114;5265;3084;2181;481;246;18.0
1442;Zaterdag 3 oktober 1998;462;208;254;361;198;163;139;139;;;1.0;0.0;1.0;0.0;3;900;652;248;3;57;1.0
1443;Zondag 4 oktober 1998;465;246;219;341;166;175;3;3;;;0.0;0.0;0.0;0.0;1;157;116;41;3;36;0.0
1444;Maandag 5 oktober 1998;581;312;269;364;188;176;153;153;;;11.0;5.0;4.0;2.0;137;6477;4051;2426;630;224;14.0
1445;Dinsdag 6 oktober 1998;631;333;298;379;184;195;128;128;;;14.0;6.0;4.0;4.0;149;4826;2808;2018;562;179;1700.0
1446;Woensdag 7 oktober 1998;628;315;313;350;168;182;169;169;;;14.0;7.0;5.0;2.0;136;4378;2604;1774;485;130;14.0
1447;Donderdag 8 oktober 1998;598;305;293;347;165;182;241;241;;;7.0;2.0;2.0;3.0;157;4870;2863;2007;586;195;15.0
1448;Vrijdag 9 oktober 1998;648;339;309;334;145;189;788;788;;;19.0;6.0;7.0;6.0;105;4633;2835;1798;404;166;262.0
1449;Zaterdag 10 oktober 1998;520;270;250;370;178;192;146;146;;;2.0;0.0;1.0;1.0;1;2206;1585;621;4;42;650.0
1450;Zondag 11 oktober 1998;442;224;218;340;167;173;3;3;;;0.0;0.0;0.0;0.0;1;171;107;64;1;37;0.0
1451;Maandag 12 oktober 1998;593;322;271;375;188;187;152;152;;;10.0;2.0;3.0;5.0;142;5975;3720;2255;560;213;15.0
1452;Dinsdag 13 oktober 1998;580;309;271;361;176;185;118;118;;;8.0;5.0;2.0;1.0;131;4290;2524;1766;577;127;12.0
1453;Woensdag 14 oktober 1998;587;294;293;379;179;200;190;190;;;13.0;5.0;6.0;2.0;127;4457;2674;1783;497;147;7.0
1454;Donderdag 15 oktober 1998;581;287;294;367;194;173;248;248;;;13.0;7.0;2.0;4.0;169;8743;5567;3176;533;238;23.0
1455;Vrijdag 16 oktober 1998;588;293;295;380;199;181;744;744;;;18.0;4.0;5.0;9.0;102;5631;3581;2050;410;162;12.0
1456;Zaterdag 17 oktober 1998;476;238;238;406;215;191;111;111;;;2.0;0.0;1.0;1.0;0;1609;1077;532;2;42;1.0
1457;Zondag 18 oktober 1998;448;221;227;355;178;177;6;6;;;0.0;0.0;0.0;0.0;0;237;165;72;2;23;1.0
1458;Maandag 19 oktober 1998;562;284;278;336;158;178;143;143;;;16.0;10.0;4.0;2.0;125;6606;4139;2467;593;236;571.0
1459;Dinsdag 20 oktober 1998;601;297;304;362;181;181;142;142;;;8.0;3.0;4.0;1.0;173;5210;3137;2073;621;171;168.0
1460;Woensdag 21 oktober 1998;623;315;308;389;207;182;169;169;;;10.0;6.0;2.0;2.0;193;4441;2697;1744;461;146;390.0
1461;Donderdag 22 oktober 1998;599;301;298;348;175;173;231;231;;;11.0;4.0;5.0;2.0;149;4903;2950;1953;458;176;11.0
1462;Vrijdag 23 oktober 1998;531;249;282;382;194;188;626;626;;;13.0;2.0;2.0;9.0;100;4969;3008;1961;348;177;13.0
1463;Zaterdag 24 oktober 1998;435;220;215;346;174;172;98;98;;;0.0;0.0;0.0;0.0;0;1946;1394;552;3;42;0.0
1464;Zondag 25 oktober 1998;464;223;241;374;188;186;6;6;;;0.0;0.0;0.0;0.0;0;578;393;185;3;17;2.0
1465;Maandag 26 oktober 1998;532;270;262;373;194;179;172;172;;;15.0;8.0;4.0;3.0;118;6269;3951;2318;493;216;507.0
1466;Dinsdag 27 oktober 1998;575;289;286;368;191;177;131;131;;;11.0;6.0;3.0;2.0;159;4595;2749;1846;507;184;159.0
1467;Woensdag 28 oktober 1998;611;335;276;334;181;153;150;150;;;17.0;8.0;3.0;6.0;169;4728;2968;1760;459;173;26.0
1468;Donderdag 29 oktober 1998;622;322;300;345;170;175;166;166;;;9.0;2.0;4.0;3.0;152;5252;3217;2035;552;163;593.0
1469;Vrijdag 30 oktober 1998;564;277;287;332;169;163;559;559;;;12.0;3.0;6.0;3.0;114;7694;5010;2684;421;205;8.0
1470;Zaterdag 31 oktober 1998;438;227;211;354;172;182;99;99;;;2.0;0.0;2.0;0.0;0;2289;1579;710;0;76;2.0
1471;Totaal november 1998;16008;8295;7713;11334;5627;5707;4289;4289;;;240.0;109.0;69.0;62.0;2809;144050;91768;52282;10082;4243;6518.0
1472;Zondag 1 november 1998;448;226;222;347;172;175;4;4;;;1.0;0.0;1.0;0.0;1;14911;10086;4825;46;321;3.0
1473;Maandag 2 november 1998;589;304;285;368;192;176;135;135;;;16.0;7.0;6.0;3.0;137;10835;6891;3944;582;231;309.0
1474;Dinsdag 3 november 1998;610;327;283;365;181;184;113;113;;;9.0;4.0;3.0;2.0;145;5380;3175;2205;608;169;15.0
1475;Woensdag 4 november 1998;565;286;279;359;168;191;105;105;;;16.0;7.0;4.0;5.0;107;4764;2911;1853;488;113;25.0
1476;Donderdag 5 november 1998;602;303;299;382;178;204;176;176;;;9.0;6.0;2.0;1.0;143;5399;3304;2095;560;168;12.0
1477;Vrijdag 6 november 1998;595;285;310;362;174;188;467;467;;;12.0;3.0;4.0;5.0;103;5097;3116;1981;340;147;7.0
1478;Zaterdag 7 november 1998;442;242;200;387;178;209;76;76;;;1.0;0.0;1.0;0.0;0;1350;1014;336;1;35;0.0
1479;Zondag 8 november 1998;440;232;208;347;186;161;6;6;;;0.0;0.0;0.0;0.0;0;245;161;84;3;17;1.0
1480;Maandag 9 november 1998;551;284;267;373;205;168;117;117;;;9.0;7.0;1.0;1.0;151;6218;3953;2265;600;179;19.0
1481;Dinsdag 10 november 1998;633;331;302;392;206;186;102;102;;;9.0;5.0;1.0;3.0;137;5088;3127;1961;426;139;18.0
1482;Woensdag 11 november 1998;592;329;263;372;197;175;173;173;;;12.0;6.0;1.0;5.0;147;4422;2711;1711;505;174;167.0
1483;Donderdag 12 november 1998;557;306;251;411;194;217;183;183;;;6.0;1.0;3.0;2.0;148;5237;3167;2070;471;174;1250.0
1484;Vrijdag 13 november 1998;549;289;260;361;178;183;284;284;;;7.0;3.0;1.0;3.0;104;4904;3055;1849;340;153;10.0
1485;Zaterdag 14 november 1998;459;244;215;342;174;168;54;54;;;1.0;0.0;1.0;0.0;1;1942;1375;567;3;28;23.0
1486;Zondag 15 november 1998;415;207;208;370;185;185;2;2;;;0.0;0.0;0.0;0.0;1;2268;1617;651;7;72;3.0
1487;Maandag 16 november 1998;573;316;257;407;208;199;111;111;;;10.0;3.0;4.0;3.0;136;8186;5268;2918;528;216;10.0
1488;Dinsdag 17 november 1998;626;324;302;381;192;189;108;108;;;9.0;4.0;1.0;4.0;133;4448;2666;1782;512;155;1295.0
1489;Woensdag 18 november 1998;600;314;286;400;193;207;124;124;;;13.0;9.0;3.0;1.0;145;4298;2617;1681;471;110;10.0
1490;Donderdag 19 november 1998;541;272;269;394;196;198;157;157;;;8.0;4.0;3.0;1.0;163;4323;2594;1729;396;157;2924.0
1491;Vrijdag 20 november 1998;603;325;278;393;202;191;509;509;;;8.0;2.0;4.0;2.0;123;5432;3510;1922;326;191;312.0
1492;Zaterdag 21 november 1998;406;223;183;354;193;161;51;51;;;2.0;0.0;2.0;0.0;1;1834;1366;468;2;46;0.0
1493;Zondag 22 november 1998;393;212;181;368;181;187;2;2;;;1.0;0.0;0.0;1.0;0;315;227;88;4;19;4.0
1494;Maandag 23 november 1998;502;248;254;345;188;157;123;123;;;11.0;3.0;2.0;6.0;127;6344;4132;2212;512;187;12.0
1495;Dinsdag 24 november 1998;570;291;279;399;186;213;109;109;;;9.0;4.0;2.0;3.0;118;4314;2611;1703;470;183;13.0
1496;Woensdag 25 november 1998;583;288;295;360;172;188;148;148;;;15.0;6.0;4.0;5.0;159;4675;2932;1743;502;186;15.0
1497;Donderdag 26 november 1998;582;280;302;416;202;214;204;204;;;16.0;5.0;6.0;5.0;121;5106;3178;1928;472;200;12.0
1498;Vrijdag 27 november 1998;580;292;288;393;187;206;458;458;;;10.0;5.0;4.0;1.0;117;5460;3434;2026;374;191;15.0
1499;Zaterdag 28 november 1998;439;242;197;386;184;202;64;64;;;1.0;1.0;0.0;0.0;0;2486;1860;626;2;37;0.0
1500;Zondag 29 november 1998;420;200;220;414;200;214;0;0;;;0.0;0.0;0.0;0.0;0;319;228;91;4;21;0.0
1501;Maandag 30 november 1998;543;273;270;386;175;211;124;124;;;19.0;14.0;5.0;0.0;141;8450;5482;2968;527;224;34.0
1502;Totaal december 1998;15994;8154;7840;13268;6504;6764;5106;5106;;;312.0;146.0;86.0;80.0;2861;154874;99412;55462;9403;4710;6568.0
1503;Dinsdag 1 december 1998;578;317;261;409;202;207;167;167;;;16.0;7.0;5.0;4.0;164;26357;17821;8536;556;457;844.0
1504;Woensdag 2 december 1998;581;292;289;395;181;214;111;111;;;7.0;5.0;0.0;2.0;186;5137;3047;2090;494;172;481.0
1505;Donderdag 3 december 1998;545;276;269;405;214;191;126;126;;;13.0;4.0;4.0;5.0;134;5273;3298;1975;513;174;424.0
1506;Vrijdag 4 december 1998;549;270;279;421;207;214;266;266;;;7.0;2.0;4.0;1.0;121;4736;2884;1852;343;118;10.0
1507;Zaterdag 5 december 1998;371;200;171;426;230;196;27;27;;;1.0;0.0;1.0;0.0;0;1310;949;361;1;27;0.0
1508;Zondag 6 december 1998;441;243;198;424;219;205;4;4;;;0.0;0.0;0.0;0.0;0;198;138;60;3;29;0.0
1509;Maandag 7 december 1998;541;289;252;415;194;221;149;149;;;11.0;5.0;3.0;3.0;153;6273;3939;2334;618;171;223.0
1510;Dinsdag 8 december 1998;532;284;248;439;212;227;123;123;;;14.0;8.0;4.0;2.0;159;4720;2912;1808;507;127;903.0
1511;Woensdag 9 december 1998;549;280;269;465;226;239;119;119;;;11.0;8.0;2.0;1.0;146;4107;2576;1531;487;139;159.0
1512;Donderdag 10 december 1998;562;272;290;409;192;217;202;202;;;6.0;3.0;1.0;2.0;126;5644;3557;2087;495;143;18.0
1513;Vrijdag 11 december 1998;541;275;266;424;220;204;519;519;;;14.0;5.0;6.0;3.0;118;5062;3209;1853;333;147;17.0
1514;Zaterdag 12 december 1998;430;215;215;431;213;218;78;78;;;3.0;1.0;2.0;0.0;4;2756;2001;755;8;42;0.0
1515;Zondag 13 december 1998;426;228;198;451;217;234;1;1;;;0.0;0.0;0.0;0.0;0;271;196;75;3;33;6.0
1516;Maandag 14 december 1998;540;280;260;442;222;220;157;157;;;18.0;11.0;4.0;3.0;157;7200;4669;2531;543;247;1079.0
1517;Dinsdag 15 december 1998;621;307;314;450;223;227;163;163;;;16.0;10.0;2.0;4.0;150;9504;6339;3165;505;278;25.0
1518;Woensdag 16 december 1998;564;285;279;445;228;217;195;195;;;11.0;6.0;2.0;3.0;107;5283;3267;2016;491;151;16.0
1519;Donderdag 17 december 1998;543;268;275;422;187;235;264;264;;;16.0;8.0;4.0;4.0;119;4941;3116;1825;470;148;388.0
1520;Vrijdag 18 december 1998;599;309;290;419;199;220;709;709;;;12.0;5.0;2.0;5.0;103;6012;3836;2176;326;239;5.0
1521;Zaterdag 19 december 1998;473;238;235;465;214;251;114;114;;;3.0;0.0;1.0;2.0;0;2869;1979;890;4;37;0.0
1522;Zondag 20 december 1998;424;218;206;415;203;212;8;8;;;0.0;0.0;0.0;0.0;0;1182;852;330;5;42;0.0
1523;Maandag 21 december 1998;530;250;280;409;206;203;219;219;;;20.0;9.0;5.0;6.0;154;8051;4989;3062;489;238;411.0
1524;Dinsdag 22 december 1998;590;309;281;428;220;208;223;223;;;27.0;14.0;5.0;8.0;157;5352;3297;2055;354;200;13.0
1525;Woensdag 23 december 1998;521;254;267;436;234;202;268;268;;;14.0;3.0;5.0;6.0;141;5296;3259;2037;333;186;486.0
1526;Donderdag 24 december 1998;523;284;239;407;209;198;180;180;;;10.0;4.0;2.0;4.0;107;4096;2581;1515;264;128;8.0
1527;Vrijdag 25 december 1998;395;193;202;411;199;212;9;9;;;0.0;0.0;0.0;0.0;0;171;120;51;3;16;0.0
1528;Zaterdag 26 december 1998;429;226;203;423;196;227;2;2;;;0.0;0.0;0.0;0.0;0;64;38;26;3;13;1.0
1529;Zondag 27 december 1998;449;235;214;450;210;240;4;4;;;0.0;0.0;0.0;0.0;0;341;224;117;0;26;1.0
1530;Maandag 28 december 1998;510;261;249;443;196;247;150;150;;;18.0;7.0;8.0;3.0;104;6553;4280;2273;419;224;414.0
1531;Dinsdag 29 december 1998;564;266;298;429;202;227;153;153;;;19.0;10.0;5.0;4.0;90;4950;2994;1956;327;198;14.0
1532;Woensdag 30 december 1998;603;289;314;402;195;207;203;203;;;15.0;5.0;7.0;3.0;88;6029;3814;2215;322;231;313.0
1533;Donderdag 31 december 1998;470;241;229;458;234;224;193;193;;;10.0;6.0;2.0;2.0;73;5136;3231;1905;184;329;309.0
1534;Totaal op zondag in 1998;22971;11870;11101;18904;9434;9470;340;340;;;3.0;0.0;2.0;1.0;11;62240;42464;19776;379;2543;217.0
1535;Totaal op maandag in 1998;28946;14864;14082;19633;9773;9860;8328;8328;;;1066.0;492.0;313.0;261.0;6239;378557;237853;140704;28622;12584;10782.0
1536;Totaal op dinsdag in 1998;31579;16114;15465;19791;9810;9981;8016;8016;;;912.0;370.0;300.0;242.0;7140;316288;192599;123689;25836;11425;19066.0
1537;Totaal op woensdag in 1998;31227;15865;15362;19767;9907;9860;10955;10955;;;885.0;350.0;285.0;250.0;7104;309555;189679;119876;24678;10232;9004.0
1538;Totaal op donderdag in 1998;30599;15586;15013;20254;9986;10268;13776;13776;;;756.0;253.0;283.0;220.0;6553;308358;189639;118719;24440;10538;14177.0
1539;Totaal op vrijdag in 1998;30103;15462;14641;19628;9736;9892;38931;38931;;;914.0;145.0;441.0;328.0;5381;290207;181350;108857;18131;10172;3326.0
1540;Totaal op zaterdag in 1998;23983;12376;11607;19505;9563;9942;6610;6610;;;90.0;6.0;62.0;22.0;31;108806;74632;34174;321;2947;2601.0
1541;Totaal 1999;200445;102896;97549;140487;68872;71615;89428;89428;;;3257.0;1500.0;894.0;863.0;33571;1695702;1058308;637394;119151;59023;62093.0
1542;Totaal januari 1999;16218;8392;7826;13145;6404;6741;3109;3109;;;191.0;91.0;46.0;54.0;2781;133453;84456;48997;9330;4680;3984.0
1543;Vrijdag 1 januari 1999;394;214;180;439;226;213;6;6;;;0.0;0.0;0.0;0.0;3;13011;8456;4555;73;397;0.0
1544;Zaterdag 2 januari 1999;457;253;204;394;199;195;26;26;;;2.0;0.0;0.0;2.0;0;952;607;345;18;52;1.0
1545;Zondag 3 januari 1999;451;228;223;417;201;216;4;4;;;0.0;0.0;0.0;0.0;0;144;96;48;2;38;2.0
1546;Maandag 4 januari 1999;585;310;275;448;208;240;97;97;;;12.0;6.0;2.0;4.0;77;9463;6056;3407;642;325;16.0
1547;Dinsdag 5 januari 1999;608;312;296;447;210;237;97;97;;;15.0;6.0;5.0;4.0;138;6201;3585;2616;540;261;13.0
1548;Woensdag 6 januari 1999;566;309;257;468;223;245;104;104;;;14.0;7.0;4.0;3.0;165;5622;3359;2263;487;208;15.0
1549;Donderdag 7 januari 1999;540;298;242;438;215;223;96;96;;;12.0;5.0;1.0;6.0;152;5855;3500;2355;535;212;10.0
1550;Vrijdag 8 januari 1999;583;309;274;468;220;248;220;220;;;9.0;4.0;1.0;4.0;99;5224;3183;2041;382;177;18.0
1551;Zaterdag 9 januari 1999;421;216;205;396;191;205;54;54;;;2.0;0.0;1.0;1.0;0;1244;876;368;8;25;0.0
1552;Zondag 10 januari 1999;414;210;204;441;212;229;5;5;;;0.0;0.0;0.0;0.0;1;547;409;138;1;20;3.0
1553;Maandag 11 januari 1999;544;273;271;434;203;231;109;109;;;14.0;11.0;3.0;0.0;107;6171;3849;2322;561;212;17.0
1554;Dinsdag 12 januari 1999;589;277;312;439;209;230;105;105;;;4.0;1.0;1.0;2.0;118;4587;2816;1771;398;155;38.0
1555;Woensdag 13 januari 1999;596;315;281;421;212;209;92;92;;;4.0;2.0;0.0;2.0;121;4066;2512;1554;409;159;15.0
1556;Donderdag 14 januari 1999;609;299;310;442;228;214;128;128;;;4.0;1.0;1.0;2.0;171;5139;3228;1911;476;201;483.0
1557;Vrijdag 15 januari 1999;588;310;278;412;197;215;280;280;;;9.0;3.0;4.0;2.0;156;8699;5844;2855;361;200;1077.0
1558;Zaterdag 16 januari 1999;449;208;241;430;198;232;47;47;;;0.0;0.0;0.0;0.0;0;1697;1243;454;6;33;4.0
1559;Zondag 17 januari 1999;432;213;219;427;206;221;9;9;;;0.0;0.0;0.0;0.0;3;175;119;56;2;28;4.0
1560;Maandag 18 januari 1999;539;273;266;436;216;220;97;97;;;11.0;5.0;4.0;2.0;170;6428;4099;2329;508;208;21.0
1561;Dinsdag 19 januari 1999;596;323;273;459;232;227;116;116;;;10.0;7.0;0.0;3.0;156;4205;2678;1527;437;162;19.0
1562;Woensdag 20 januari 1999;560;298;262;449;205;244;106;106;;;11.0;4.0;0.0;7.0;137;5030;3156;1874;407;148;462.0
1563;Donderdag 21 januari 1999;578;327;251;403;199;204;139;139;;;4.0;4.0;0.0;0.0;165;4795;2910;1885;508;185;379.0
1564;Vrijdag 22 januari 1999;554;276;278;405;192;213;280;280;;;7.0;2.0;3.0;2.0;153;4727;2945;1782;393;171;165.0
1565;Zaterdag 23 januari 1999;442;227;215;414;206;208;56;56;;;0.0;0.0;0.0;0.0;1;1723;1234;489;4;22;5.0
1566;Zondag 24 januari 1999;428;230;198;352;163;189;6;6;;;0.0;0.0;0.0;0.0;0;242;178;64;0;32;3.0
1567;Maandag 25 januari 1999;556;295;261;429;226;203;117;117;;;14.0;6.0;5.0;3.0;129;6000;3884;2116;564;175;18.0
1568;Dinsdag 26 januari 1999;592;304;288;420;225;195;128;128;;;12.0;7.0;3.0;2.0;138;4476;2762;1714;456;198;587.0
1569;Woensdag 27 januari 1999;570;273;297;398;183;215;106;106;;;8.0;4.0;2.0;2.0;138;4099;2517;1582;414;164;577.0
1570;Donderdag 28 januari 1999;609;302;307;411;204;207;143;143;;;5.0;3.0;2.0;0.0;129;5089;3175;1914;417;217;10.0
1571;Vrijdag 29 januari 1999;559;297;262;411;202;209;277;277;;;8.0;3.0;4.0;1.0;154;5477;3507;1970;314;186;16.0
1572;Zaterdag 30 januari 1999;397;198;199;412;204;208;51;51;;;0.0;0.0;0.0;0.0;0;1397;982;415;7;48;1.0
1573;Zondag 31 januari 1999;412;215;197;385;189;196;8;8;;;0.0;0.0;0.0;0.0;0;968;691;277;0;61;5.0
1574;Totaal februari 1999;15191;7726;7465;12334;5991;6343;3414;3414;;;201.0;92.0;63.0;46.0;2555;130003;82580;47423;8386;3886;6319.0
1575;Maandag 1 februari 1999;549;283;266;401;207;194;123;123;;;18.0;12.0;4.0;2.0;149;24646;16379;8267;565;486;567.0
1576;Dinsdag 2 februari 1999;554;287;267;393;177;216;132;132;;;12.0;4.0;4.0;4.0;176;5450;3369;2081;456;143;17.0
1577;Woensdag 3 februari 1999;564;277;287;452;216;236;85;85;;;6.0;3.0;3.0;0.0;141;4676;2875;1801;423;148;18.0
1578;Donderdag 4 februari 1999;598;296;302;449;220;229;127;127;;;8.0;4.0;1.0;3.0;130;5239;3277;1962;451;161;33.0
1579;Vrijdag 5 februari 1999;605;308;297;424;214;210;297;297;;;6.0;2.0;3.0;1.0;127;4803;2918;1885;343;129;16.0
1580;Zaterdag 6 februari 1999;449;240;209;419;199;220;43;43;;;1.0;0.0;1.0;0.0;0;949;709;240;3;16;0.0
1581;Zondag 7 februari 1999;461;239;222;434;218;216;4;4;;;0.0;0.0;0.0;0.0;0;226;164;62;3;30;0.0
1582;Maandag 8 februari 1999;574;335;239;443;218;225;114;114;;;12.0;6.0;3.0;3.0;93;5520;3577;1943;543;184;10.0
1583;Dinsdag 9 februari 1999;606;286;320;439;192;247;109;109;;;14.0;10.0;2.0;2.0;143;4296;2568;1728;435;148;13.0
1584;Woensdag 10 februari 1999;598;308;290;436;216;220;133;133;;;9.0;5.0;3.0;1.0;113;4399;2720;1679;363;126;16.0
1585;Donderdag 11 februari 1999;590;298;292;434;202;232;150;150;;;8.0;2.0;3.0;3.0;125;4775;2860;1915;424;187;13.0
1586;Vrijdag 12 februari 1999;588;285;303;453;212;241;279;279;;;15.0;5.0;7.0;3.0;137;4860;3059;1801;341;155;10.0
1587;Zaterdag 13 februari 1999;452;219;233;453;221;232;29;29;;;2.0;0.0;2.0;0.0;1;1189;846;343;0;19;0.0
1588;Zondag 14 februari 1999;424;205;219;447;227;220;14;14;;;0.0;0.0;0.0;0.0;0;325;202;123;7;33;0.0
1589;Maandag 15 februari 1999;572;302;270;393;192;201;116;116;;;11.0;7.0;4.0;0.0;105;8791;5899;2892;418;204;610.0
1590;Dinsdag 16 februari 1999;613;280;333;469;235;234;117;117;;;4.0;2.0;0.0;2.0;129;4387;2699;1688;418;116;15.0
1591;Woensdag 17 februari 1999;605;303;302;466;209;257;97;97;;;8.0;5.0;2.0;1.0;137;4216;2596;1620;404;154;15.0
1592;Donderdag 18 februari 1999;551;284;267;471;229;242;129;129;;;9.0;0.0;1.0;8.0;123;5058;3134;1924;427;153;16.0
1593;Vrijdag 19 februari 1999;528;267;261;439;215;224;311;311;;;7.0;1.0;3.0;3.0;107;4773;2983;1790;280;162;18.0
1594;Zaterdag 20 februari 1999;492;243;249;459;241;218;45;45;;;0.0;0.0;0.0;0.0;1;2326;1631;695;3;42;2913.0
1595;Zondag 21 februari 1999;436;222;214;426;200;226;8;8;;;0.0;0.0;0.0;0.0;0;248;168;80;2;22;0.0
1596;Maandag 22 februari 1999;597;279;318;425;215;210;145;145;;;13.0;5.0;6.0;2.0;110;6337;3936;2401;483;223;27.0
1597;Dinsdag 23 februari 1999;655;341;314;448;205;243;110;110;;;14.0;7.0;4.0;3.0;134;4559;2741;1818;500;160;40.0
1598;Woensdag 24 februari 1999;594;337;257;462;229;233;129;129;;;10.0;8.0;2.0;0.0;129;4146;2475;1671;351;149;477.0
1599;Donderdag 25 februari 1999;557;303;254;434;203;231;156;156;;;6.0;2.0;3.0;1.0;138;5445;3339;2106;402;219;1461.0
1600;Vrijdag 26 februari 1999;535;268;267;469;231;238;348;348;;;8.0;2.0;2.0;4.0;107;5839;3717;2122;334;188;14.0
1601;Zaterdag 27 februari 1999;427;224;203;451;239;212;57;57;;;0.0;0.0;0.0;0.0;0;1392;924;468;3;54;0.0
1602;Zondag 28 februari 1999;417;207;210;445;209;236;7;7;;;0.0;0.0;0.0;0.0;0;1133;815;318;4;75;0.0
1603;Totaal maart 1999;16818;8518;8300;13153;6481;6672;4600;4600;;;275.0;140.0;67.0;68.0;3206;146572;93760;52812;9767;4669;6609.0
1604;Maandag 1 maart 1999;571;287;284;475;253;222;179;179;;;24.0;21.0;0.0;3.0;151;26950;18009;8941;583;573;495.0
1605;Dinsdag 2 maart 1999;585;295;290;451;236;215;106;106;;;12.0;7.0;2.0;3.0;143;5518;3341;2177;456;195;419.0
1606;Woensdag 3 maart 1999;604;309;295;484;257;227;116;116;;;6.0;4.0;2.0;0.0;151;4984;3012;1972;359;168;10.0
1607;Donderdag 4 maart 1999;618;316;302;481;239;242;136;136;;;6.0;4.0;1.0;1.0;133;5636;3410;2226;481;148;15.0
1608;Vrijdag 5 maart 1999;572;293;279;472;225;247;374;374;;;11.0;2.0;4.0;5.0;155;5209;3254;1955;343;121;984.0
1609;Zaterdag 6 maart 1999;447;234;213;447;207;240;55;55;;;2.0;0.0;1.0;1.0;0;1055;766;289;13;21;2.0
1610;Zondag 7 maart 1999;448;238;210;431;208;223;3;3;;;0.0;0.0;0.0;0.0;0;179;107;72;0;15;0.0
1611;Maandag 8 maart 1999;534;263;271;463;216;247;140;140;;;17.0;7.0;4.0;6.0;142;6188;3924;2264;611;179;8.0
1612;Dinsdag 9 maart 1999;606;325;281;433;206;227;128;128;;;12.0;5.0;5.0;2.0;148;4242;2647;1595;544;172;409.0
1613;Woensdag 10 maart 1999;578;281;297;447;204;243;117;117;;;14.0;8.0;3.0;3.0;104;4472;2773;1699;415;153;19.0
1614;Donderdag 11 maart 1999;560;289;271;438;212;226;133;133;;;11.0;7.0;2.0;2.0;156;4455;2677;1778;483;139;470.0
1615;Vrijdag 12 maart 1999;536;285;251;450;221;229;375;375;;;9.0;3.0;4.0;2.0;139;4901;3089;1812;287;141;544.0
1616;Zaterdag 13 maart 1999;471;250;221;434;223;211;39;39;;;2.0;0.0;1.0;1.0;1;1019;724;295;3;13;5.0
1617;Zondag 14 maart 1999;416;201;215;413;195;218;1;1;;;0.0;0.0;0.0;0.0;0;222;151;71;5;32;2.0
1618;Maandag 15 maart 1999;554;295;259;420;229;191;123;123;;;13.0;7.0;2.0;4.0;154;10014;6694;3320;535;188;19.0
1619;Dinsdag 16 maart 1999;612;315;297;426;199;227;108;108;;;7.0;4.0;3.0;0.0;150;4614;2908;1706;316;140;165.0
1620;Woensdag 17 maart 1999;569;286;283;413;206;207;126;126;;;12.0;4.0;4.0;4.0;143;4089;2549;1540;367;161;504.0
1621;Donderdag 18 maart 1999;583;315;268;372;195;177;152;152;;;6.0;3.0;1.0;2.0;136;4113;2586;1527;360;152;23.0
1622;Vrijdag 19 maart 1999;545;281;264;397;210;187;440;440;;;9.0;1.0;6.0;2.0;103;4457;2735;1722;322;150;470.0
1623;Zaterdag 20 maart 1999;437;214;223;374;198;176;93;93;;;1.0;0.0;1.0;0.0;3;1848;1341;507;4;65;6.0
1624;Zondag 21 maart 1999;406;212;194;395;205;190;9;9;;;0.0;0.0;0.0;0.0;0;282;217;65;3;19;7.0
1625;Maandag 22 maart 1999;567;285;282;412;214;198;129;129;;;24.0;16.0;4.0;4.0;139;5629;3673;1956;453;234;26.0
1626;Dinsdag 23 maart 1999;597;271;326;384;169;215;129;129;;;17.0;9.0;4.0;4.0;134;4024;2511;1513;419;185;226.0
1627;Woensdag 24 maart 1999;593;285;308;407;179;228;139;139;;;4.0;2.0;0.0;2.0;93;3876;2474;1402;366;135;756.0
1628;Donderdag 25 maart 1999;568;269;299;450;222;228;196;196;;;9.0;5.0;0.0;4.0;119;4770;2965;1805;356;161;18.0
1629;Vrijdag 26 maart 1999;573;292;281;421;200;221;532;532;;;9.0;3.0;1.0;5.0;128;4697;2926;1771;311;189;714.0
1630;Zaterdag 27 maart 1999;453;222;231;398;192;206;61;61;;;3.0;0.0;2.0;1.0;1;2123;1528;595;9;31;238.0
1631;Zondag 28 maart 1999;420;205;215;352;172;180;5;5;;;0.0;0.0;0.0;0.0;0;370;267;103;9;43;3.0
1632;Maandag 29 maart 1999;563;274;289;395;195;200;140;140;;;14.0;9.0;3.0;2.0;176;5932;3684;2248;466;224;19.0
1633;Dinsdag 30 maart 1999;638;328;310;408;195;213;151;151;;;11.0;4.0;4.0;3.0;165;4667;2886;1781;507;268;17.0
1634;Woensdag 31 maart 1999;594;303;291;410;199;211;165;165;;;10.0;5.0;3.0;2.0;139;6037;3932;2105;381;254;16.0
1635;Totaal april 1999;16880;8630;8250;11289;5634;5655;6462;6462;;;245.0;107.0;64.0;74.0;2570;133918;86528;47390;8019;4224;5086.0
1636;Donderdag 1 april 1999;588;287;301;368;190;178;475;475;;;16.0;6.0;6.0;4.0;133;26909;17969;8940;592;620;14.0
1637;Vrijdag 2 april 1999;574;311;263;398;198;200;69;69;;;1.0;0.0;0.0;1.0;11;1321;808;513;51;55;2.0
1638;Zaterdag 3 april 1999;475;250;225;373;192;181;39;39;;;1.0;0.0;1.0;0.0;0;817;611;206;5;39;1076.0
1639;Zondag 4 april 1999;444;245;199;361;177;184;4;4;;;0.0;0.0;0.0;0.0;1;147;98;49;0;24;2.0
1640;Maandag 5 april 1999;468;243;225;396;195;201;24;24;;;0.0;0.0;0.0;0.0;2;333;234;99;5;33;1.0
1641;Dinsdag 6 april 1999;555;294;261;384;201;183;159;159;;;21.0;14.0;3.0;4.0;158;6921;4449;2472;523;226;16.0
1642;Woensdag 7 april 1999;632;315;317;361;180;181;163;163;;;10.0;6.0;0.0;4.0;140;5112;3133;1979;472;180;14.0
1643;Donderdag 8 april 1999;593;300;293;376;169;207;185;185;;;9.0;7.0;2.0;0.0;119;5221;3213;2008;480;184;277.0
1644;Vrijdag 9 april 1999;638;345;293;380;201;179;590;590;;;13.0;3.0;2.0;8.0;116;4783;3025;1758;362;182;592.0
1645;Zaterdag 10 april 1999;445;221;224;408;207;201;98;98;;;1.0;0.0;0.0;1.0;1;1694;1283;411;5;48;2.0
1646;Zondag 11 april 1999;419;201;218;366;174;192;2;2;;;0.0;0.0;0.0;0.0;1;146;104;42;2;27;2.0
1647;Maandag 12 april 1999;604;304;300;364;186;178;182;182;;;12.0;6.0;6.0;0.0;123;5780;3661;2119;469;212;18.0
1648;Dinsdag 13 april 1999;625;318;307;349;175;174;122;122;;;12.0;3.0;3.0;6.0;160;4066;2454;1612;452;123;13.0
1649;Woensdag 14 april 1999;600;313;287;395;184;211;174;174;;;14.0;7.0;5.0;2.0;97;4375;2687;1688;358;140;17.0
1650;Donderdag 15 april 1999;571;307;264;335;156;179;227;227;;;6.0;2.0;3.0;1.0;150;7886;5175;2711;378;230;13.0
1651;Vrijdag 16 april 1999;641;313;328;382;191;191;652;652;;;5.0;1.0;2.0;2.0;101;5240;3399;1841;326;165;16.0
1652;Zaterdag 17 april 1999;485;248;237;352;179;173;115;115;;;0.0;0.0;0.0;0.0;1;1252;919;333;4;33;0.0
1653;Zondag 18 april 1999;494;254;240;356;174;182;3;3;;;0.0;0.0;0.0;0.0;1;232;190;42;5;25;1.0
1654;Maandag 19 april 1999;571;297;274;349;188;161;137;137;;;14.0;6.0;2.0;6.0;104;5536;3561;1975;390;135;15.0
1655;Dinsdag 20 april 1999;642;334;308;368;182;186;146;146;;;8.0;3.0;2.0;3.0;144;4888;3157;1731;511;177;10.0
1656;Woensdag 21 april 1999;624;320;304;377;181;196;154;154;;;10.0;6.0;2.0;2.0;132;3891;2443;1448;340;128;14.0
1657;Donderdag 22 april 1999;625;326;299;398;199;199;246;246;;;12.0;6.0;3.0;3.0;169;4416;2723;1693;438;115;2275.0
1658;Vrijdag 23 april 1999;616;305;311;401;206;195;815;815;;;14.0;1.0;4.0;9.0;137;4673;2973;1700;302;139;13.0
1659;Zaterdag 24 april 1999;490;267;223;401;207;194;142;142;;;0.0;0.0;0.0;0.0;0;2317;1597;720;8;40;3.0
1660;Zondag 25 april 1999;426;216;210;352;167;185;13;13;;;0.0;0.0;0.0;0.0;1;514;351;163;1;26;3.0
1661;Maandag 26 april 1999;556;261;295;380;188;192;160;160;;;19.0;6.0;6.0;7.0;146;6192;4007;2185;399;224;50.0
1662;Dinsdag 27 april 1999;650;318;332;413;211;202;180;180;;;14.0;7.0;4.0;3.0;164;4765;3004;1761;388;200;521.0
1663;Woensdag 28 april 1999;656;345;311;363;173;190;299;299;;;17.0;9.0;5.0;3.0;142;5112;3123;1989;323;172;30.0
1664;Donderdag 29 april 1999;638;310;328;375;185;190;860;860;;;16.0;8.0;3.0;5.0;111;7525;4879;2646;414;227;76.0
1665;Vrijdag 30 april 1999;535;262;273;408;218;190;27;27;;;0.0;0.0;0.0;0.0;5;1854;1298;556;16;95;0.0
1666;Totaal mei 1999;16379;8430;7949;11374;5586;5788;10812;10812;;;284.0;117.0;88.0;79.0;2410;129563;83896;45667;7540;3764;3064.0
1667;Zaterdag 1 mei 1999;471;241;230;351;182;169;150;150;;;1.0;0.0;0.0;1.0;1;15505;10606;4899;37;312;1.0
1668;Zondag 2 mei 1999;500;254;246;346;180;166;5;5;;;0.0;0.0;0.0;0.0;1;128;79;49;5;35;0.0
1669;Maandag 3 mei 1999;601;322;279;415;217;198;207;207;;;18.0;12.0;6.0;0.0;112;8907;5883;3024;528;227;22.0
1670;Dinsdag 4 mei 1999;608;314;294;388;184;204;97;97;;;10.0;8.0;1.0;1.0;145;4974;3049;1925;459;135;23.0
1671;Woensdag 5 mei 1999;539;288;251;383;188;195;35;35;;;0.0;0.0;0.0;0.0;4;525;329;196;8;42;1.0
1672;Donderdag 6 mei 1999;623;311;312;402;199;203;405;405;;;7.0;2.0;2.0;3.0;190;6898;4293;2605;561;207;16.0
1673;Vrijdag 7 mei 1999;622;314;308;388;184;204;1268;1268;;;10.0;4.0;4.0;2.0;112;5231;3302;1929;395;160;582.0
1674;Zaterdag 8 mei 1999;549;297;252;369;193;176;221;221;;;2.0;0.0;2.0;0.0;1;1231;891;340;7;22;0.0
1675;Zondag 9 mei 1999;439;221;218;329;163;166;4;4;;;0.0;0.0;0.0;0.0;1;164;109;55;1;12;1.0
1676;Maandag 10 mei 1999;553;267;286;351;167;184;271;271;;;13.0;8.0;2.0;3.0;105;6518;4196;2322;431;165;25.0
1677;Dinsdag 11 mei 1999;602;313;289;371;189;182;239;239;;;22.0;14.0;5.0;3.0;134;4569;2879;1690;454;138;1079.0
1678;Woensdag 12 mei 1999;600;280;320;370;174;196;1132;1132;;;23.0;8.0;10.0;5.0;179;5381;3372;2009;372;141;26.0
1679;Donderdag 13 mei 1999;467;261;206;367;184;183;21;21;;;0.0;0.0;0.0;0.0;1;398;253;145;3;41;0.0
1680;Vrijdag 14 mei 1999;504;245;259;343;170;173;715;715;;;12.0;1.0;6.0;5.0;14;2225;1579;646;78;62;7.0
1681;Zaterdag 15 mei 1999;451;237;214;346;159;187;197;197;;;2.0;0.0;1.0;1.0;1;3365;2425;940;4;74;0.0
1682;Zondag 16 mei 1999;392;199;193;359;180;179;5;5;;;0.0;0.0;0.0;0.0;1;355;271;84;3;23;1.0
1683;Maandag 17 mei 1999;545;293;252;344;175;169;221;221;;;17.0;9.0;4.0;4.0;152;8547;5430;3117;536;209;64.0
1684;Dinsdag 18 mei 1999;603;317;286;395;199;196;197;197;;;18.0;6.0;3.0;9.0;127;5118;3200;1918;431;178;27.0
1685;Woensdag 19 mei 1999;567;317;250;352;176;176;254;254;;;16.0;11.0;3.0;2.0;142;4617;2876;1741;363;112;145.0
1686;Donderdag 20 mei 1999;608;299;309;380;205;175;519;519;;;15.0;7.0;3.0;5.0;164;5658;3557;2101;403;145;16.0
1687;Vrijdag 21 mei 1999;563;296;267;429;207;222;1509;1509;;;18.0;3.0;9.0;6.0;124;4928;3156;1772;264;136;9.0
1688;Zaterdag 22 mei 1999;492;260;232;357;167;190;218;218;;;3.0;0.0;1.0;2.0;0;1686;1138;548;1;29;2.0
1689;Zondag 23 mei 1999;406;210;196;332;151;181;3;3;;;0.0;0.0;0.0;0.0;0;179;141;38;1;14;3.0
1690;Maandag 24 mei 1999;440;241;199;339;157;182;17;17;;;1.0;1.0;0.0;0.0;2;500;368;132;3;46;2.0
1691;Dinsdag 25 mei 1999;504;249;255;353;173;180;236;236;;;14.0;5.0;5.0;4.0;140;6401;4114;2287;484;208;19.0
1692;Woensdag 26 mei 1999;555;290;265;345;173;172;237;237;;;13.0;6.0;3.0;4.0;145;4797;3017;1780;433;183;642.0
1693;Donderdag 27 mei 1999;589;300;289;394;178;216;455;455;;;15.0;4.0;6.0;5.0;167;5252;3228;2024;427;181;317.0
1694;Vrijdag 28 mei 1999;581;296;285;401;181;220;1509;1509;;;17.0;2.0;8.0;7.0;131;5614;3520;2094;317;190;9.0
1695;Zaterdag 29 mei 1999;444;220;224;380;202;178;237;237;;;2.0;0.0;1.0;1.0;1;1568;1094;474;6;39;0.0
1696;Zondag 30 mei 1999;439;223;216;349;170;179;9;9;;;0.0;0.0;0.0;0.0;0;528;343;185;2;51;2.0
1697;Maandag 31 mei 1999;522;255;267;346;159;187;219;219;;;15.0;6.0;3.0;6.0;113;7796;5198;2598;523;247;23.0
1698;Totaal juni 1999;16941;8630;8311;10914;5380;5534;11065;11065;;;331.0;135.0;95.0;101.0;3195;144978;92845;52133;9082;5031;6746.0
1699;Dinsdag 1 juni 1999;595;322;273;346;167;179;236;236;;;24.0;10.0;7.0;7.0;147;24233;16205;8028;489;534;206.0
1700;Woensdag 2 juni 1999;580;270;310;368;192;176;200;200;;;16.0;4.0;4.0;8.0;148;5102;3241;1861;435;138;13.0
1701;Donderdag 3 juni 1999;621;310;311;383;194;189;459;459;;;15.0;7.0;3.0;5.0;128;5477;3337;2140;457;154;15.0
1702;Vrijdag 4 juni 1999;590;283;307;377;183;194;1361;1361;;;15.0;0.0;11.0;4.0;133;4882;3024;1858;326;164;9.0
1703;Zaterdag 5 juni 1999;461;237;224;368;186;182;265;265;;;0.0;0.0;0.0;0.0;9;1186;839;347;5;27;0.0
1704;Zondag 6 juni 1999;507;276;231;346;162;184;10;10;;;0.0;0.0;0.0;0.0;0;233;180;53;9;14;2.0
1705;Maandag 7 juni 1999;580;282;298;369;186;183;185;185;;;23.0;10.0;9.0;4.0;158;6442;3994;2448;441;174;17.0
1706;Dinsdag 8 juni 1999;624;322;302;365;169;196;157;157;;;17.0;6.0;4.0;7.0;154;4788;2994;1794;382;129;2701.0
1707;Woensdag 9 juni 1999;563;286;277;403;194;209;221;221;;;10.0;5.0;3.0;2.0;112;4289;2676;1613;344;116;15.0
1708;Donderdag 10 juni 1999;661;330;331;378;181;197;333;333;;;6.0;2.0;2.0;2.0;160;5111;3195;1916;369;150;14.0
1709;Vrijdag 11 juni 1999;574;276;298;333;150;183;1290;1290;;;19.0;7.0;7.0;5.0;108;4705;3009;1696;350;153;1101.0
1710;Zaterdag 12 juni 1999;446;217;229;386;193;193;222;222;;;0.0;0.0;0.0;0.0;0;1585;1141;444;12;37;0.0
1711;Zondag 13 juni 1999;501;274;227;341;175;166;9;9;;;1.0;0.0;0.0;1.0;0;150;104;46;2;18;4.0
1712;Maandag 14 juni 1999;568;281;287;362;174;188;200;200;;;17.0;9.0;6.0;2.0;115;6471;4129;2342;449;220;15.0
1713;Dinsdag 15 juni 1999;633;325;308;334;158;176;207;207;;;9.0;7.0;1.0;1.0;178;7325;4744;2581;420;231;16.0
1714;Woensdag 16 juni 1999;619;324;295;361;169;192;249;249;;;11.0;6.0;2.0;3.0;171;4605;2829;1776;402;164;469.0
1715;Donderdag 17 juni 1999;613;302;311;380;179;201;408;408;;;9.0;2.0;2.0;5.0;137;4672;2891;1781;341;145;647.0
1716;Vrijdag 18 juni 1999;539;282;257;379;185;194;1414;1414;;;16.0;4.0;4.0;8.0;151;4683;3047;1636;306;156;17.0
1717;Zaterdag 19 juni 1999;489;244;245;378;189;189;231;231;;;1.0;0.0;0.0;1.0;0;1522;1070;452;8;35;0.0
1718;Zondag 20 juni 1999;495;261;234;389;206;183;8;8;;;0.0;0.0;0.0;0.0;0;652;485;167;2;110;0.0
1719;Maandag 21 juni 1999;556;290;266;355;195;160;266;266;;;19.0;8.0;4.0;7.0;138;6278;3988;2290;486;196;332.0
1720;Dinsdag 22 juni 1999;615;323;292;360;180;180;177;177;;;20.0;14.0;4.0;2.0;133;4484;2772;1712;432;249;459.0
1721;Woensdag 23 juni 1999;606;313;293;326;164;162;215;215;;;7.0;2.0;3.0;2.0;152;4210;2614;1596;418;139;17.0
1722;Donderdag 24 juni 1999;584;316;268;368;193;175;425;425;;;10.0;5.0;3.0;2.0;142;4743;2930;1813;398;179;28.0
1723;Vrijdag 25 juni 1999;622;342;280;339;170;169;1444;1444;;;22.0;5.0;6.0;11.0;117;5653;3655;1998;382;254;137.0
1724;Zaterdag 26 juni 1999;445;239;206;355;186;169;252;252;;;1.0;0.0;1.0;0.0;0;2213;1550;663;2;65;1.0
1725;Zondag 27 juni 1999;462;213;249;359;172;187;12;12;;;0.0;0.0;0.0;0.0;1;262;171;91;3;47;0.0
1726;Maandag 28 juni 1999;627;329;298;363;174;189;192;192;;;18.0;12.0;2.0;4.0;172;6714;4185;2529;517;353;19.0
1727;Dinsdag 29 juni 1999;563;270;293;385;187;198;170;170;;;11.0;6.0;2.0;3.0;181;4851;2979;1872;456;271;410.0
1728;Woensdag 30 juni 1999;602;291;311;358;167;191;247;247;;;14.0;4.0;5.0;5.0;150;7457;4867;2590;439;409;82.0
1729;Totaal juli 1999;17638;9131;8507;11299;5522;5777;9259;9259;;;288.0;128.0;76.0;84.0;2736;159588;97089;62499;11200;6868;4106.0
1730;Donderdag 1 juli 1999;578;319;259;372;169;203;435;435;;;18.0;7.0;2.0;9.0;140;30153;19325;10828;570;775;157.0
1731;Vrijdag 2 juli 1999;677;355;322;420;201;219;1161;1161;;;15.0;5.0;3.0;7.0;120;5674;3259;2415;366;246;998.0
1732;Zaterdag 3 juli 1999;561;303;258;360;166;194;231;231;;;1.0;0.0;1.0;0.0;2;1303;856;447;2;78;3.0
1733;Zondag 4 juli 1999;471;235;236;372;192;180;3;3;;;0.0;0.0;0.0;0.0;0;196;114;82;10;55;1.0
1734;Maandag 5 juli 1999;639;315;324;326;155;171;204;204;;;21.0;8.0;7.0;6.0;140;7237;4308;2929;613;310;24.0
1735;Dinsdag 6 juli 1999;570;297;273;322;169;153;175;175;;;16.0;6.0;6.0;4.0;151;5228;3021;2207;583;238;558.0
1736;Woensdag 7 juli 1999;613;307;306;390;179;211;306;306;;;16.0;9.0;4.0;3.0;114;5061;3032;2029;541;187;163.0
1737;Donderdag 8 juli 1999;589;310;279;361;179;182;335;335;;;10.0;5.0;1.0;4.0;139;5269;3138;2131;518;234;467.0
1738;Vrijdag 9 juli 1999;606;320;286;353;177;176;1054;1054;;;11.0;2.0;5.0;4.0;99;4849;2972;1877;444;230;13.0
1739;Zaterdag 10 juli 1999;501;259;242;364;182;182;160;160;;;2.0;0.0;1.0;1.0;0;2289;1588;701;10;93;1.0
1740;Zondag 11 juli 1999;440;214;226;369;184;185;8;8;;;0.0;0.0;0.0;0.0;0;202;135;67;3;54;0.0
1741;Maandag 12 juli 1999;591;320;271;422;210;212;195;195;;;6.0;6.0;0.0;0.0;112;6628;3884;2744;627;306;19.0
1742;Dinsdag 13 juli 1999;570;311;259;373;180;193;153;153;;;13.0;6.0;2.0;5.0;119;4435;2491;1944;588;204;18.0
1743;Woensdag 14 juli 1999;628;324;304;394;194;200;258;258;;;14.0;9.0;2.0;3.0;154;4569;2679;1890;497;206;11.0
1744;Donderdag 15 juli 1999;601;322;279;329;165;164;289;289;;;5.0;2.0;2.0;1.0;154;9254;5676;3578;540;344;10.0
1745;Vrijdag 16 juli 1999;582;306;276;357;187;170;845;845;;;16.0;2.0;10.0;4.0;106;5963;3645;2318;409;262;14.0
1746;Zaterdag 17 juli 1999;444;239;205;384;184;200;155;155;;;0.0;0.0;0.0;0.0;0;1771;1240;531;2;101;728.0
1747;Zondag 18 juli 1999;444;225;219;352;161;191;15;15;;;0.0;0.0;0.0;0.0;1;261;163;98;5;38;7.0
1748;Maandag 19 juli 1999;586;308;278;389;191;198;206;206;;;15.0;9.0;2.0;4.0;119;6532;3836;2696;593;287;20.0
1749;Dinsdag 20 juli 1999;625;321;304;424;205;219;210;210;;;13.0;9.0;2.0;2.0;112;5364;3209;2155;539;260;22.0
1750;Woensdag 21 juli 1999;662;349;313;357;178;179;198;198;;;9.0;5.0;3.0;1.0;115;4447;2622;1825;465;178;16.0
1751;Donderdag 22 juli 1999;546;298;248;348;174;174;268;268;;;13.0;7.0;4.0;2.0;131;4977;2905;2072;463;233;23.0
1752;Vrijdag 23 juli 1999;570;290;280;343;174;169;721;721;;;11.0;0.0;5.0;6.0;90;4948;2944;2004;384;275;8.0
1753;Zaterdag 24 juli 1999;483;241;242;324;159;165;108;108;;;2.0;0.0;1.0;1.0;0;1974;1344;630;5;39;0.0
1754;Zondag 25 juli 1999;455;247;208;363;171;192;15;15;;;0.0;0.0;0.0;0.0;0;660;416;244;3;52;1.0
1755;Maandag 26 juli 1999;607;293;314;310;148;162;208;208;;;13.0;9.0;3.0;1.0;104;6598;3952;2646;566;334;17.0
1756;Dinsdag 27 juli 1999;599;337;262;332;162;170;204;204;;;8.0;6.0;1.0;1.0;174;4775;2775;2000;521;235;9.0
1757;Woensdag 28 juli 1999;628;297;331;326;160;166;209;209;;;19.0;10.0;3.0;6.0;135;4737;2777;1960;469;269;775.0
1758;Donderdag 29 juli 1999;628;305;323;375;185;190;250;250;;;10.0;5.0;3.0;2.0;129;5151;3021;2130;457;221;12.0
1759;Vrijdag 30 juli 1999;647;309;338;389;195;194;574;574;;;10.0;1.0;3.0;6.0;76;6904;4256;2648;391;337;7.0
1760;Zaterdag 31 juli 1999;497;255;242;399;186;213;106;106;;;1.0;0.0;0.0;1.0;0;2179;1506;673;16;187;4.0
1761;Totaal augustus 1999;17713;9090;8623;11284;5437;5847;9635;9635;;;282.0;140.0;65.0;77.0;2743;148289;85293;62996;13008;6143;4863.0
1762;Zondag 1 augustus 1999;481;270;211;355;176;179;16;16;;;0.0;0.0;0.0;0.0;0;17723;10997;6726;82;585;4.0
1763;Maandag 2 augustus 1999;597;317;280;406;202;204;269;269;;;18.0;9.0;4.0;5.0;82;10147;6084;4063;643;396;10.0
1764;Dinsdag 3 augustus 1999;648;325;323;391;197;194;215;215;;;12.0;5.0;3.0;4.0;101;5335;2991;2344;594;218;9.0
1765;Woensdag 4 augustus 1999;628;307;321;412;189;223;200;200;;;12.0;6.0;3.0;3.0;132;4635;2548;2087;577;175;14.0
1766;Donderdag 5 augustus 1999;622;326;296;391;184;207;292;292;;;6.0;4.0;1.0;1.0;130;4971;2825;2146;651;194;10.0
1767;Vrijdag 6 augustus 1999;615;325;290;427;188;239;660;660;;;2.0;0.0;1.0;1.0;88;4810;2744;2066;460;207;6.0
1768;Zaterdag 7 augustus 1999;484;249;235;367;172;195;175;175;;;1.0;0.0;0.0;1.0;0;1008;662;346;4;40;1.0
1769;Zondag 8 augustus 1999;475;238;237;359;165;194;26;26;;;0.0;0.0;0.0;0.0;0;281;193;88;6;41;2.0
1770;Maandag 9 augustus 1999;596;297;299;359;166;193;244;244;;;21.0;8.0;6.0;7.0;114;6506;3753;2753;696;201;2686.0
1771;Dinsdag 10 augustus 1999;613;337;276;364;176;188;249;249;;;8.0;3.0;2.0;3.0;115;5018;2959;2059;597;145;11.0
1772;Woensdag 11 augustus 1999;566;307;259;352;184;168;222;222;;;9.0;5.0;3.0;1.0;125;4207;2367;1840;513;181;8.0
1773;Donderdag 12 augustus 1999;627;337;290;359;162;197;307;307;;;11.0;4.0;3.0;4.0;151;5131;2673;2458;514;230;12.0
1774;Vrijdag 13 augustus 1999;609;296;313;373;192;181;567;567;;;5.0;1.0;1.0;3.0;136;4819;2717;2102;443;228;5.0
1775;Zaterdag 14 augustus 1999;470;256;214;337;161;176;192;192;;;1.0;0.0;1.0;0.0;0;1496;987;509;26;82;0.0
1776;Zondag 15 augustus 1999;449;228;221;308;145;163;16;16;;;0.0;0.0;0.0;0.0;1;2313;1504;809;17;77;1.0
1777;Maandag 16 augustus 1999;635;320;315;350;165;185;256;256;;;11.0;7.0;2.0;2.0;95;8697;5021;3676;690;314;1112.0
1778;Dinsdag 17 augustus 1999;613;317;296;386;187;199;209;209;;;13.0;11.0;1.0;1.0;128;4754;2658;2096;597;209;10.0
1779;Woensdag 18 augustus 1999;612;298;314;342;158;184;246;246;;;7.0;5.0;1.0;1.0;126;4551;2483;2068;477;192;17.0
1780;Donderdag 19 augustus 1999;659;351;308;332;161;171;375;375;;;13.0;8.0;1.0;4.0;106;4579;2530;2049;576;182;661.0
1781;Vrijdag 20 augustus 1999;601;302;299;390;169;221;1264;1264;;;18.0;4.0;8.0;6.0;112;5626;3201;2425;444;193;9.0
1782;Zaterdag 21 augustus 1999;459;230;229;359;193;166;229;229;;;1.0;0.0;1.0;0.0;2;1152;722;430;4;57;0.0
1783;Zondag 22 augustus 1999;436;203;233;291;127;164;16;16;;;0.0;0.0;0.0;0.0;0;304;149;155;13;30;1.0
1784;Maandag 23 augustus 1999;563;282;281;338;156;182;201;201;;;19.0;10.0;5.0;4.0;155;6596;3642;2954;663;235;14.0
1785;Dinsdag 24 augustus 1999;639;340;299;385;201;184;192;192;;;14.0;9.0;4.0;1.0;171;4477;2357;2120;632;227;169.0
1786;Woensdag 25 augustus 1999;601;316;285;372;190;182;249;249;;;16.0;5.0;2.0;9.0;137;4751;2660;2091;516;254;18.0
1787;Donderdag 26 augustus 1999;605;304;301;408;191;217;518;518;;;18.0;13.0;4.0;1.0;138;4760;2619;2141;645;248;21.0
1788;Vrijdag 27 augustus 1999;632;316;316;369;191;178;1459;1459;;;12.0;3.0;2.0;7.0;90;5022;2905;2117;529;188;10.0
1789;Zaterdag 28 augustus 1999;508;246;262;345;171;174;341;341;;;0.0;0.0;0.0;0.0;0;1688;1078;610;7;94;3.0
1790;Zondag 29 augustus 1999;421;212;209;354;158;196;18;18;;;0.0;0.0;0.0;0.0;0;208;107;101;6;70;0.0
1791;Maandag 30 augustus 1999;608;317;291;360;196;164;193;193;;;20.0;11.0;3.0;6.0;110;6861;3846;3015;676;324;20.0
1792;Dinsdag 31 augustus 1999;641;321;320;343;164;179;219;219;;;14.0;9.0;3.0;2.0;198;5863;3311;2552;710;326;19.0
1793;Totaal september 1999;17566;8999;8567;10694;5317;5377;14075;14075;;;320.0;108.0;108.0;104.0;2934;144386;84579;59807;13074;5584;4818.0
1794;Woensdag 1 september1999;646;346;300;355;178;177;452;452;;;12.0;3.0;6.0;3.0;117;26606;15714;10892;790;738;962.0
1795;Donderdag 2 september1999;588;301;287;376;173;203;556;556;;;6.0;0.0;2.0;4.0;143;6127;3287;2840;919;218;28.0
1796;Vrijdag 3 september1999;613;308;305;342;170;172;1582;1582;;;18.0;3.0;9.0;6.0;114;4835;2665;2170;438;185;747.0
1797;Zaterdag 4 september1999;499;238;261;368;178;190;354;354;;;4.0;0.0;3.0;1.0;0;972;616;356;4;62;0.0
1798;Zondag 5 september1999;433;230;203;315;160;155;13;13;;;1.0;0.0;1.0;0.0;0;276;125;151;4;44;0.0
1799;Maandag 6 september1999;604;294;310;372;189;183;225;225;;;14.0;8.0;4.0;2.0;119;6515;3629;2886;759;194;125.0
1800;Dinsdag 7 september1999;646;324;322;328;163;165;183;183;;;11.0;6.0;4.0;1.0;145;5015;2728;2287;667;191;17.0
1801;Woensdag 8 september1999;619;291;328;378;198;180;305;305;;;10.0;6.0;2.0;2.0;122;4725;2517;2208;588;153;438.0
1802;Donderdag 9 september1999;651;335;316;345;183;162;2508;2508;;;41.0;5.0;19.0;17.0;123;5128;2860;2268;641;243;16.0
1803;Vrijdag 10 september1999;614;332;282;368;197;171;1538;1538;;;19.0;1.0;9.0;9.0;132;5118;2983;2135;428;190;12.0
1804;Zaterdag 11 september1999;477;243;234;359;169;190;259;259;;;2.0;1.0;1.0;0.0;1;1042;756;286;3;51;0.0
1805;Zondag 12 september1999;533;262;271;351;181;170;10;10;;;0.0;0.0;0.0;0.0;0;215;148;67;5;44;1.0
1806;Maandag 13 september1999;566;274;292;341;164;177;148;148;;;7.0;5.0;0.0;2.0;140;5823;3357;2466;659;241;12.0
1807;Dinsdag 14 september1999;658;330;328;346;179;167;203;203;;;9.0;6.0;2.0;1.0;151;4775;2688;2087;615;212;735.0
1808;Woensdag 15 september1999;584;323;261;379;179;200;259;259;;;7.0;0.0;3.0;4.0;138;7657;4669;2988;602;260;11.0
1809;Donderdag 16 september1999;644;324;320;355;169;186;499;499;;;12.0;2.0;4.0;6.0;127;5209;3002;2207;583;208;135.0
1810;Vrijdag 17 september1999;579;311;268;351;170;181;1339;1339;;;16.0;2.0;4.0;10.0;88;4668;2621;2047;441;181;221.0
1811;Zaterdag 18 september1999;503;295;208;386;182;204;276;276;;;2.0;0.0;2.0;0.0;2;1117;783;334;6;60;1.0
1812;Zondag 19 september1999;490;259;231;369;189;180;20;20;;;0.0;0.0;0.0;0.0;0;171;103;68;3;31;1.0
1813;Maandag 20 september1999;626;322;304;369;196;173;186;186;;;18.0;9.0;5.0;4.0;157;6501;3875;2626;592;278;169.0
1814;Dinsdag 21 september1999;682;363;319;334;156;178;174;174;;;13.0;7.0;4.0;2.0;146;4585;2613;1972;626;161;20.0
1815;Woensdag 22 september1999;646;332;314;380;192;188;207;207;;;13.0;8.0;4.0;1.0;182;4087;2325;1762;478;158;17.0
1816;Donderdag 23 september1999;623;303;320;358;181;177;406;406;;;8.0;5.0;0.0;3.0;121;4424;2668;1756;559;228;435.0
1817;Vrijdag 24 september1999;631;320;311;362;185;177;1245;1245;;;21.0;3.0;7.0;11.0;115;4560;2754;1806;405;186;16.0
1818;Zaterdag 25 september1999;506;262;244;359;182;177;234;234;;;1.0;0.0;0.0;1.0;0;2199;1552;647;3;49;0.0
1819;Zondag 26 september1999;467;256;211;335;148;187;5;5;;;1.0;0.0;1.0;0.0;0;282;192;90;7;30;0.0
1820;Maandag 27 september1999;529;259;270;303;151;152;171;171;;;16.0;10.0;3.0;3.0;137;5777;3503;2274;593;254;18.0
1821;Dinsdag 28 september1999;637;324;313;350;163;187;148;148;;;14.0;6.0;4.0;4.0;145;4519;2696;1823;485;229;12.0
1822;Woensdag 29 september1999;635;325;310;374;196;178;206;206;;;14.0;6.0;4.0;4.0;138;4613;2823;1790;511;201;15.0
1823;Donderdag 30 september1999;637;313;324;386;196;190;364;364;;;10.0;6.0;1.0;3.0;131;6845;4327;2518;660;304;654.0
1824;Totaal oktober 1999;16691;8624;8067;11077;5485;5592;7347;7347;;;254.0;127.0;62.0;65.0;2668;137646;85496;52150;10194;4894;5278.0
1825;Vrijdag 1 oktober 1999;630;327;303;392;187;205;1102;1102;;;10.0;2.0;5.0;3.0;86;25772;16875;8897;492;684;16.0
1826;Zaterdag 2 oktober 1999;476;238;238;330;176;154;139;139;;;1.0;0.0;1.0;0.0;0;806;561;245;0;50;0.0
1827;Zondag 3 oktober 1999;482;248;234;323;145;178;4;4;;;0.0;0.0;0.0;0.0;0;159;102;57;7;38;0.0
1828;Maandag 4 oktober 1999;600;305;295;293;139;154;148;148;;;21.0;12.0;3.0;6.0;130;6222;3610;2612;545;240;1252.0
1829;Dinsdag 5 oktober 1999;587;295;292;336;166;170;141;141;;;19.0;11.0;2.0;6.0;163;5086;2880;2206;555;189;112.0
1830;Woensdag 6 oktober 1999;606;287;319;331;172;159;141;141;;;12.0;8.0;1.0;3.0;146;4462;2511;1951;482;147;290.0
1831;Donderdag 7 oktober 1999;552;290;262;369;197;172;243;243;;;4.0;1.0;2.0;1.0;166;4808;2834;1974;636;177;11.0
1832;Vrijdag 8 oktober 1999;543;284;259;322;159;163;823;823;;;13.0;2.0;7.0;4.0;149;4736;2851;1885;391;194;18.0
1833;Zaterdag 9 oktober 1999;436;219;217;324;173;151;180;180;;;1.0;0.0;1.0;0.0;0;1190;832;358;1;32;0.0
1834;Zondag 10 oktober 1999;458;259;199;360;166;194;9;9;;;0.0;0.0;0.0;0.0;1;598;428;170;4;30;1.0
1835;Maandag 11 oktober 1999;592;318;274;331;156;175;139;139;;;20.0;14.0;3.0;3.0;139;5642;3519;2123;581;184;330.0
1836;Dinsdag 12 oktober 1999;625;320;305;341;184;157;155;155;;;14.0;7.0;1.0;6.0;131;4219;2441;1778;557;164;423.0
1837;Woensdag 13 oktober 1999;614;310;304;372;190;182;119;119;;;8.0;4.0;4.0;0.0;115;3962;2303;1659;418;148;455.0
1838;Donderdag 14 oktober 1999;582;303;279;345;165;180;264;264;;;9.0;3.0;2.0;4.0;141;4765;2825;1940;511;185;256.0
1839;Vrijdag 15 oktober 1999;563;292;271;338;160;178;786;786;;;12.0;4.0;6.0;2.0;108;8933;5747;3186;397;232;9.0
1840;Zaterdag 16 oktober 1999;419;213;206;336;158;178;126;126;;;3.0;0.0;2.0;1.0;3;1644;1111;533;6;50;634.0
1841;Zondag 17 oktober 1999;429;232;197;340;183;157;4;4;;;0.0;0.0;0.0;0.0;0;221;132;89;10;17;1.0
1842;Maandag 18 oktober 1999;543;296;247;375;168;207;155;155;;;8.0;5.0;2.0;1.0;144;6221;3751;2470;488;213;28.0
1843;Dinsdag 19 oktober 1999;546;284;262;366;196;170;178;178;;;12.0;6.0;1.0;5.0;128;4237;2492;1745;480;151;23.0
1844;Woensdag 20 oktober 1999;553;294;259;351;190;161;186;186;;;6.0;3.0;1.0;2.0;112;4682;2891;1791;441;143;15.0
1845;Donderdag 21 oktober 1999;536;270;266;349;185;164;243;243;;;9.0;5.0;1.0;3.0;124;4749;2946;1803;730;156;17.0
1846;Vrijdag 22 oktober 1999;613;316;297;407;198;209;665;665;;;9.0;2.0;5.0;2.0;108;4582;2901;1681;362;167;12.0
1847;Zaterdag 23 oktober 1999;454;228;226;396;198;198;103;103;;;2.0;1.0;0.0;1.0;2;1839;1328;511;2;33;0.0
1848;Zondag 24 oktober 1999;420;200;220;387;181;206;4;4;;;0.0;0.0;0.0;0.0;0;208;142;66;6;22;4.0
1849;Maandag 25 oktober 1999;602;285;317;392;204;188;155;155;;;18.0;14.0;3.0;1.0;123;6476;4065;2411;464;255;716.0
1850;Dinsdag 26 oktober 1999;593;321;272;363;164;199;128;128;;;15.0;11.0;1.0;3.0;109;4200;2453;1747;428;199;14.0
1851;Woensdag 27 oktober 1999;558;291;267;360;174;186;153;153;;;9.0;6.0;1.0;2.0;127;4174;2543;1631;359;197;14.0
1852;Donderdag 28 oktober 1999;617;320;297;359;169;190;240;240;;;6.0;4.0;2.0;0.0;89;5299;3233;2066;520;208;19.0
1853;Vrijdag 29 oktober 1999;565;309;256;417;204;213;529;529;;;11.0;1.0;5.0;5.0;124;5330;3437;1893;316;255;608.0
1854;Zaterdag 30 oktober 1999;449;233;216;386;191;195;81;81;;;2.0;1.0;0.0;1.0;0;1673;1213;460;3;67;0.0
1855;Zondag 31 oktober 1999;448;237;211;386;187;199;4;4;;;0.0;0.0;0.0;0.0;0;751;539;212;2;67;0.0
1856;Totaal november 1999;15983;8172;7811;11104;5455;5649;4720;4720;;;269.0;137.0;76.0;56.0;2907;142136;89906;52230;10326;4448;4781.0
1857;Maandag 1 november 1999;532;274;258;340;155;185;184;184;;;14.0;9.0;2.0;3.0;154;26474;17399;9075;650;583;304.0
1858;Dinsdag 2 november 1999;587;307;280;354;170;184;109;109;;;15.0;9.0;3.0;3.0;138;5185;3075;2110;556;163;21.0
1859;Woensdag 3 november 1999;592;304;288;362;179;183;113;113;;;9.0;4.0;5.0;0.0;107;4816;2816;2000;464;167;14.0
1860;Donderdag 4 november 1999;549;276;273;406;199;207;173;173;;;4.0;2.0;2.0;0.0;139;5188;3112;2076;525;156;13.0
1861;Vrijdag 5 november 1999;554;271;283;391;182;209;431;431;;;7.0;1.0;5.0;1.0;147;4770;2881;1889;381;176;37.0
1862;Zaterdag 6 november 1999;458;216;242;359;176;183;69;69;;;1.0;0.0;1.0;0.0;1;1099;780;319;4;21;1.0
1863;Zondag 7 november 1999;419;214;205;353;161;192;4;4;;;0.0;0.0;0.0;0.0;0;217;149;68;1;19;0.0
1864;Maandag 8 november 1999;528;268;260;373;178;195;111;111;;;9.0;5.0;2.0;2.0;130;5657;3509;2148;484;185;704.0
1865;Dinsdag 9 november 1999;580;305;275;374;181;193;109;109;;;10.0;6.0;2.0;2.0;130;4091;2443;1648;477;150;6.0
1866;Woensdag 10 november 1999;611;309;302;373;183;190;122;122;;;16.0;10.0;2.0;4.0;109;4532;2747;1785;458;149;346.0
1867;Donderdag 11 november 1999;568;298;270;328;155;173;295;295;;;17.0;6.0;7.0;4.0;129;4576;2741;1835;486;132;12.0
1868;Vrijdag 12 november 1999;536;278;258;405;203;202;440;440;;;8.0;4.0;3.0;1.0;102;4827;3008;1819;318;162;10.0
1869;Zaterdag 13 november 1999;461;240;221;376;174;202;43;43;;;1.0;0.0;1.0;0.0;0;1158;845;313;6;51;1701.0
1870;Zondag 14 november 1999;459;239;220;354;174;180;6;6;;;0.0;0.0;0.0;0.0;0;287;198;89;0;47;4.0
1871;Maandag 15 november 1999;548;289;259;345;169;176;124;124;;;16.0;8.0;4.0;4.0;126;10165;6749;3416;521;260;23.0
1872;Dinsdag 16 november 1999;565;279;286;365;180;185;93;93;;;15.0;8.0;5.0;2.0;151;4654;2926;1728;551;144;16.0
1873;Woensdag 17 november 1999;551;266;285;365;191;174;142;142;;;12.0;7.0;4.0;1.0;112;4062;2494;1568;447;181;9.0
1874;Donderdag 18 november 1999;543;277;266;401;213;188;166;166;;;10.0;4.0;2.0;4.0;141;4429;2708;1721;479;164;6.0
1875;Vrijdag 19 november 1999;541;262;279;353;172;181;492;492;;;13.0;3.0;5.0;5.0;138;4384;2794;1590;365;144;10.0
1876;Zaterdag 20 november 1999;448;225;223;375;186;189;64;64;;;0.0;0.0;0.0;0.0;1;2089;1581;508;1;50;0.0
1877;Zondag 21 november 1999;450;227;223;367;166;201;4;4;;;0.0;0.0;0.0;0.0;0;219;160;59;3;14;1.0
1878;Maandag 22 november 1999;563;301;262;383;194;189;154;154;;;18.0;11.0;4.0;3.0;140;5899;3675;2224;501;185;15.0
1879;Dinsdag 23 november 1999;591;300;291;363;183;180;104;104;;;15.0;10.0;2.0;3.0;172;4143;2464;1679;499;150;859.0
1880;Woensdag 24 november 1999;578;288;290;382;195;187;146;146;;;16.0;10.0;2.0;4.0;133;4025;2551;1474;409;117;14.0
1881;Donderdag 25 november 1999;553;286;267;369;170;199;203;203;;;10.0;6.0;3.0;1.0;132;5124;3151;1973;386;158;101.0
1882;Vrijdag 26 november 1999;599;311;288;402;202;200;514;514;;;9.0;1.0;5.0;3.0;128;4844;3170;1674;339;168;5.0
1883;Zaterdag 27 november 1999;449;224;225;367;193;174;57;57;;;0.0;0.0;0.0;0.0;0;2204;1516;688;8;44;2.0
1884;Zondag 28 november 1999;456;252;204;365;187;178;2;2;;;0.0;0.0;0.0;0.0;1;429;282;147;2;37;1.0
1885;Maandag 29 november 1999;541;280;261;377;194;183;125;125;;;15.0;7.0;2.0;6.0;119;6081;3741;2340;476;240;529.0
1886;Dinsdag 30 november 1999;573;306;267;377;190;187;121;121;;;9.0;6.0;3.0;0.0;127;6508;4241;2267;529;231;17.0
1887;Totaal december 1999;16427;8554;7873;12820;6180;6640;4930;4930;;;317.0;178.0;84.0;55.0;2866;145170;91880;53290;9225;4832;6439.0
1888;Woensdag 1 december 1999;569;288;281;385;186;199;160;160;;;12.0;10.0;2.0;0.0;112;24828;16493;8335;462;403;8.0
1889;Donderdag 2 december 1999;580;301;279;368;179;189;115;115;;;11.0;7.0;1.0;3.0;155;5178;3185;1993;485;168;658.0
1890;Vrijdag 3 december 1999;543;276;267;396;188;208;289;289;;;10.0;3.0;6.0;1.0;141;4575;2762;1813;361;166;399.0
1891;Zaterdag 4 december 1999;452;249;203;368;159;209;48;48;;;1.0;1.0;0.0;0.0;0;1052;760;292;1;34;0.0
1892;Zondag 5 december 1999;433;222;211;347;167;180;2;2;;;0.0;0.0;0.0;0.0;0;316;221;95;0;32;1.0
1893;Maandag 6 december 1999;528;273;255;423;216;207;134;134;;;14.0;6.0;8.0;0.0;118;5810;3635;2175;532;207;210.0
1894;Dinsdag 7 december 1999;569;300;269;384;189;195;102;102;;;20.0;12.0;7.0;1.0;142;4449;2667;1782;499;156;11.0
1895;Woensdag 8 december 1999;613;334;279;367;182;185;114;114;;;6.0;0.0;3.0;3.0;121;4275;2659;1616;429;159;732.0
1896;Donderdag 9 december 1999;577;281;296;415;182;233;170;170;;;13.0;7.0;2.0;4.0;150;4523;2779;1744;502;157;844.0
1897;Vrijdag 10 december 1999;567;300;267;385;194;191;477;477;;;9.0;4.0;3.0;2.0;87;5280;3377;1903;308;167;149.0
1898;Zaterdag 11 december 1999;447;225;222;440;237;203;63;63;;;3.0;0.0;3.0;0.0;3;1804;1260;544;3;28;1.0
1899;Zondag 12 december 1999;412;208;204;377;183;194;4;4;;;0.0;0.0;0.0;0.0;0;413;313;100;8;20;2.0
1900;Maandag 13 december 1999;567;293;274;376;199;177;114;114;;;6.0;1.0;2.0;3.0;167;5983;3798;2185;503;279;373.0
1901;Dinsdag 14 december 1999;583;302;281;420;201;219;141;141;;;22.0;15.0;3.0;4.0;172;4537;2751;1786;466;160;217.0
1902;Woensdag 15 december 1999;527;277;250;403;192;211;142;142;;;14.0;7.0;6.0;1.0;127;8560;5586;2974;486;225;461.0
1903;Donderdag 16 december 1999;596;303;293;394;166;228;215;215;;;14.0;10.0;2.0;2.0;122;5119;3180;1939;469;182;2.0
1904;Vrijdag 17 december 1999;590;306;284;457;200;257;621;621;;;11.0;4.0;3.0;4.0;104;5308;3468;1840;294;195;401.0
1905;Zaterdag 18 december 1999;462;248;214;444;201;243;115;115;;;0.0;0.0;0.0;0.0;0;2682;1871;811;2;49;0.0
1906;Zondag 19 december 1999;451;231;220;391;193;198;6;6;;;1.0;0.0;1.0;0.0;0;326;207;119;11;25;1.0
1907;Maandag 20 december 1999;555;281;274;409;192;217;184;184;;;23.0;15.0;6.0;2.0;141;8251;5313;2938;549;258;16.0
1908;Dinsdag 21 december 1999;569;306;263;434;217;217;164;164;;;20.0;12.0;4.0;4.0;131;4807;2939;1868;455;169;10.0
1909;Woensdag 22 december 1999;575;315;260;406;209;197;168;168;;;17.0;11.0;1.0;5.0;120;4590;2795;1795;428;147;11.0
1910;Donderdag 23 december 1999;581;304;277;415;197;218;258;258;;;10.0;8.0;2.0;0.0;150;5177;3189;1988;397;188;19.0
1911;Vrijdag 24 december 1999;526;280;246;430;215;215;154;154;;;3.0;1.0;1.0;1.0;107;3360;2095;1265;177;133;1840.0
1912;Zaterdag 25 december 1999;400;219;181;447;224;223;6;6;;;0.0;0.0;0.0;0.0;1;184;123;61;3;20;0.0
1913;Zondag 26 december 1999;434;222;212;433;208;225;2;2;;;0.0;0.0;0.0;0.0;0;104;71;33;2;16;0.0
1914;Maandag 27 december 1999;532;268;264;460;232;228;142;142;;;20.0;14.0;2.0;4.0;101;5053;3089;1964;344;186;15.0
1915;Dinsdag 28 december 1999;576;305;271;444;205;239;171;171;;;17.0;13.0;1.0;3.0;123;4956;2965;1991;410;222;22.0
1916;Woensdag 29 december 1999;581;306;275;468;219;249;160;160;;;16.0;8.0;6.0;2.0;121;4902;2996;1906;323;189;23.0
1917;Donderdag 30 december 1999;572;292;280;472;228;244;192;192;;;11.0;4.0;6.0;1.0;120;5929;3590;2339;270;204;13.0
1918;Vrijdag 31 december 1999;460;239;221;462;220;242;297;297;;;13.0;5.0;3.0;5.0;30;2839;1743;1096;46;288;0.0
1919;Totaal op zondag in 1999;23235;11942;11293;19226;9314;9912;406;406;;;4.0;0.0;3.0;1.0;16;36091;23500;12591;294;2409;85.0
1920;Totaal op maandag in 1999;29474;15068;14406;19829;9838;9991;8485;8485;;;784.0;441.0;181.0;162.0;6460;398435;251040;147395;27117;12805;11217.0
1921;Totaal op dinsdag in 1999;31355;16140;15215;20026;9793;10233;8109;8109;;;705.0;391.0;154.0;160.0;7510;273824;166745;107079;25979;10205;10838.0
1922;Totaal op woensdag in 1999;30930;15827;15103;20211;9890;10321;10278;10278;;;588.0;300.0;151.0;137.0;6722;285701;174758;110943;22483;9715;9242.0
1923;Totaal op donderdag in 1999;30746;15804;14942;20212;9857;10355;16882;16882;;;533.0;238.0;135.0;160.0;7069;317377;195033;122344;25273;10810;11251.0
1924;Totaal op vrijdag in 1999;30565;15696;14869;21019;10289;10730;38311;38311;;;581.0;126.0;234.0;221.0;5753;289805;181186;108619;17688;10316;12120.0
1925;Totaal op zaterdag in 1999;24140;12419;11721;19964;9891;10073;6957;6957;;;62.0;4.0;36.0;22.0;41;94469;66046;28423;317;2763;7340.0
1926;Totaal 2000;206619;105637;100982;140527;68773;71754;88074;88074;;;2922.0;1322.0;815.0;785.0;34650;1586353;972256;614097;132850;61201;49968.0
1927;Totaal januari 2000;17068;8662;8406;14915;7156;7759;3095;3095;;;195.0;107.0;53.0;35.0;2983;131494;81976;49518;10035;4733;3635.0
1928;Zaterdag 1 januari 2000;416;207;209;469;228;241;53;53;;;1.0;0.0;1.0;0.0;0;12094;7917;4177;60;328;1.0
1929;Zondag 2 januari 2000;445;242;203;487;243;244;11;11;;;0.0;0.0;0.0;0.0;0;462;321;141;9;30;4.0
1930;Maandag 3 januari 2000;564;300;264;515;232;283;68;68;;;7.0;1.0;5.0;1.0;78;6315;3839;2476;423;224;24.0
1931;Dinsdag 4 januari 2000;565;278;287;493;249;244;101;101;;;8.0;5.0;0.0;3.0;157;5805;3353;2452;449;221;279.0
1932;Woensdag 5 januari 2000;630;307;323;531;250;281;96;96;;;12.0;9.0;2.0;1.0;147;5574;3336;2238;497;190;18.0
1933;Donderdag 6 januari 2000;592;309;283;541;253;288;89;89;;;8.0;4.0;2.0;2.0;155;5662;3377;2285;485;180;15.0
1934;Vrijdag 7 januari 2000;608;298;310;512;258;254;188;188;;;6.0;2.0;2.0;2.0;111;5341;3202;2139;357;156;6.0
1935;Zaterdag 8 januari 2000;495;244;251;493;221;272;49;49;;;0.0;0.0;0.0;0.0;0;1198;815;383;0;29;1.0
1936;Zondag 9 januari 2000;475;253;222;479;234;245;4;4;;;0.0;0.0;0.0;0.0;1;143;103;40;9;28;3.0
1937;Maandag 10 januari 2000;552;275;277;499;232;267;116;116;;;15.0;8.0;4.0;3.0;136;7021;4377;2644;479;257;18.0
1938;Dinsdag 11 januari 2000;611;313;298;500;246;254;109;109;;;13.0;7.0;2.0;4.0;172;4390;2547;1843;481;197;31.0
1939;Woensdag 12 januari 2000;604;320;284;498;247;251;127;127;;;11.0;8.0;2.0;1.0;153;4334;2532;1802;436;134;17.0
1940;Donderdag 13 januari 2000;538;259;279;460;210;250;83;83;;;2.0;0.0;1.0;1.0;126;4784;2891;1893;532;170;15.0
1941;Vrijdag 14 januari 2000;594;287;307;496;224;272;276;276;;;4.0;0.0;3.0;1.0;125;5502;3425;2077;371;155;13.0
1942;Zaterdag 15 januari 2000;423;217;206;478;220;258;43;43;;;1.0;0.0;1.0;0.0;0;3706;2656;1050;15;81;0.0
1943;Zondag 16 januari 2000;443;209;234;507;250;257;8;8;;;0.0;0.0;0.0;0.0;0;346;248;98;8;31;1.0
1944;Maandag 17 januari 2000;552;285;267;495;230;265;109;109;;;14.0;9.0;3.0;2.0;139;6427;4061;2366;531;262;25.0
1945;Dinsdag 18 januari 2000;704;374;330;499;245;254;87;87;;;10.0;6.0;3.0;1.0;182;4467;2780;1687;526;168;15.0
1946;Woensdag 19 januari 2000;587;307;280;476;225;251;92;92;;;7.0;1.0;3.0;3.0;158;4017;2473;1544;488;139;17.0
1947;Donderdag 20 januari 2000;571;294;277;473;229;244;144;144;;;3.0;3.0;0.0;0.0;140;5324;3312;2012;542;186;21.0
1948;Vrijdag 21 januari 2000;641;333;308;460;225;235;277;277;;;14.0;6.0;6.0;2.0;137;4237;2517;1720;325;141;553.0
1949;Zaterdag 22 januari 2000;496;251;245;458;212;246;49;49;;;1.0;1.0;0.0;0.0;0;1265;915;350;4;27;0.0
1950;Zondag 23 januari 2000;451;227;224;446;220;226;7;7;;;0.0;0.0;0.0;0.0;2;218;131;87;5;18;1.0
1951;Maandag 24 januari 2000;580;317;263;425;210;215;116;116;;;12.0;8.0;3.0;1.0;154;5508;3492;2016;575;197;19.0
1952;Dinsdag 25 januari 2000;591;291;300;468;229;239;106;106;;;11.0;5.0;5.0;1.0;150;4623;2939;1684;524;193;921.0
1953;Woensdag 26 januari 2000;593;281;312;485;233;252;105;105;;;12.0;10.0;0.0;2.0;148;3970;2357;1613;463;195;17.0
1954;Donderdag 27 januari 2000;577;279;298;423;206;217;122;122;;;4.0;2.0;1.0;1.0;137;4611;2927;1684;507;239;1271.0
1955;Vrijdag 28 januari 2000;619;321;298;444;229;215;277;277;;;9.0;5.0;2.0;2.0;134;4990;3188;1802;330;169;156.0
1956;Zaterdag 29 januari 2000;483;245;238;491;228;263;55;55;;;0.0;0.0;0.0;0.0;1;1359;911;448;4;52;4.0
1957;Zondag 30 januari 2000;466;238;228;467;229;238;10;10;;;0.0;0.0;0.0;0.0;1;436;296;140;7;28;8.0
1958;Maandag 31 januari 2000;602;301;301;447;209;238;118;118;;;10.0;7.0;2.0;1.0;139;7365;4738;2627;593;308;161.0
1959;Totaal februari 2000;16606;8490;8116;11773;5735;6038;4483;4483;;;215.0;103.0;55.0;57.0;2878;125871;79486;46385;10249;4208;5661.0
1960;Dinsdag 1 februari 2000;614;311;303;452;217;235;115;115;;;6.0;4.0;1.0;1.0;128;21880;14407;7473;565;559;28.0
1961;Woensdag 2 februari 2000;624;311;313;442;214;228;516;516;;;16.0;5.0;4.0;7.0;136;4896;2984;1912;478;140;26.0
1962;Donderdag 3 februari 2000;613;316;297;421;196;225;94;94;;;3.0;2.0;1.0;0.0;152;5108;3066;2042;496;160;1123.0
1963;Vrijdag 4 februari 2000;618;317;301;423;227;196;266;266;;;7.0;1.0;1.0;5.0;122;4641;2917;1724;331;170;148.0
1964;Zaterdag 5 februari 2000;500;280;220;403;200;203;63;63;;;1.0;0.0;1.0;0.0;0;891;646;245;12;35;0.0
1965;Zondag 6 februari 2000;469;242;227;379;164;215;11;11;;;0.0;0.0;0.0;0.0;0;165;110;55;5;23;7.0
1966;Maandag 7 februari 2000;609;307;302;387;192;195;119;119;;;9.0;5.0;3.0;1.0;143;5804;3565;2239;564;174;15.0
1967;Dinsdag 8 februari 2000;632;327;305;416;204;212;101;101;;;6.0;4.0;2.0;0.0;148;4134;2463;1671;508;140;16.0
1968;Woensdag 9 februari 2000;652;345;307;401;184;217;87;87;;;9.0;6.0;1.0;2.0;133;3843;2311;1532;468;142;17.0
1969;Donderdag 10 februari 2000;600;314;286;403;183;220;125;125;;;8.0;4.0;1.0;3.0;136;4529;2817;1712;486;159;21.0
1970;Vrijdag 11 februari 2000;631;330;301;423;205;218;245;245;;;4.0;0.0;3.0;1.0;118;4477;2783;1694;364;123;9.0
1971;Zaterdag 12 februari 2000;488;269;219;391;184;207;63;63;;;1.0;0.0;0.0;1.0;2;1112;793;319;3;24;1037.0
1972;Zondag 13 februari 2000;482;236;246;414;208;206;8;8;;;0.0;0.0;0.0;0.0;0;152;101;51;2;23;0.0
1973;Maandag 14 februari 2000;622;322;300;394;192;202;362;362;;;23.0;10.0;5.0;8.0;133;5970;3681;2289;508;204;15.0
1974;Dinsdag 15 februari 2000;583;297;286;394;195;199;103;103;;;12.0;7.0;4.0;1.0;172;6811;4352;2459;592;167;21.0
1975;Woensdag 16 februari 2000;635;304;331;390;189;201;98;98;;;11.0;6.0;2.0;3.0;148;4070;2447;1623;505;132;24.0
1976;Donderdag 17 februari 2000;592;287;305;405;189;216;130;130;;;6.0;3.0;0.0;3.0;128;4411;2756;1655;544;184;14.0
1977;Vrijdag 18 februari 2000;633;343;290;410;217;193;342;342;;;6.0;4.0;2.0;0.0;138;4254;2714;1540;406;127;14.0
1978;Zaterdag 19 februari 2000;489;262;227;390;182;208;58;58;;;1.0;0.0;1.0;0.0;1;1181;834;347;1;30;650.0
1979;Zondag 20 februari 2000;440;219;221;390;189;201;14;14;;;0.0;0.0;0.0;0.0;1;615;454;161;7;25;2.0
1980;Maandag 21 februari 2000;565;293;272;428;227;201;118;118;;;12.0;8.0;2.0;2.0;134;5353;3369;1984;473;196;43.0
1981;Dinsdag 22 februari 2000;636;317;319;407;206;201;213;213;;;14.0;8.0;3.0;3.0;145;3955;2398;1557;621;175;270.0
1982;Woensdag 23 februari 2000;581;282;299;394;190;204;124;124;;;9.0;3.0;4.0;2.0;138;3835;2384;1451;446;154;28.0
1983;Donderdag 24 februari 2000;590;286;304;427;207;220;153;153;;;7.0;3.0;2.0;2.0;151;4612;2877;1735;525;182;1042.0
1984;Vrijdag 25 februari 2000;620;316;304;431;189;242;364;364;;;9.0;3.0;4.0;2.0;137;5111;3218;1893;292;201;1007.0
1985;Zaterdag 26 februari 2000;491;248;243;413;196;217;60;60;;;1.0;0.0;0.0;1.0;2;1983;1413;570;5;61;0.0
1986;Zondag 27 februari 2000;471;234;237;369;176;193;7;7;;;0.0;0.0;0.0;0.0;0;262;160;102;0;21;0.0
1987;Maandag 28 februari 2000;589;296;293;398;208;190;144;144;;;17.0;9.0;4.0;4.0;116;6257;3937;2320;499;242;18.0
1988;Dinsdag 29 februari 2000;537;279;258;378;205;173;380;380;;;17.0;8.0;4.0;5.0;116;5559;3529;2030;543;235;66.0
1989;Totaal maart 2000;17445;8790;8655;11608;5690;5918;4623;4623;;;232.0;129.0;44.0;59.0;3225;134939;85442;49497;9964;4685;6223.0
1990;Woensdag 1 maart 2000;648;332;316;402;201;201;141;141;;;14.0;9.0;2.0;3.0;107;22666;14871;7795;527;552;12.0
1991;Donderdag 2 maart 2000;629;316;313;366;205;161;120;120;;;8.0;5.0;2.0;1.0;155;5271;3248;2023;465;178;972.0
1992;Vrijdag 3 maart 2000;607;321;286;388;187;201;353;353;;;9.0;1.0;3.0;5.0;112;4686;2861;1825;359;155;280.0
1993;Zaterdag 4 maart 2000;469;249;220;391;184;207;53;53;;;1.0;0.0;1.0;0.0;1;945;606;339;13;44;3.0
1994;Zondag 5 maart 2000;455;227;228;350;145;205;4;4;;;0.0;0.0;0.0;0.0;0;191;129;62;3;29;3.0
1995;Maandag 6 maart 2000;579;292;287;376;203;173;111;111;;;15.0;8.0;3.0;4.0;101;5027;3113;1914;421;154;8.0
1996;Dinsdag 7 maart 2000;571;300;271;399;186;213;99;99;;;11.0;8.0;1.0;2.0;142;4032;2520;1512;389;116;18.0
1997;Woensdag 8 maart 2000;575;293;282;394;194;200;124;124;;;10.0;8.0;0.0;2.0;144;4205;2528;1677;398;154;21.0
1998;Donderdag 9 maart 2000;646;344;302;408;212;196;145;145;;;9.0;5.0;0.0;4.0;147;4325;2622;1703;531;151;823.0
1999;Vrijdag 10 maart 2000;556;275;281;380;165;215;303;303;;;10.0;3.0;3.0;4.0;106;4977;3150;1827;318;152;7.0
2000;Zaterdag 11 maart 2000;444;221;223;381;186;195;45;45;;;1.0;0.0;1.0;0.0;0;1156;827;329;0;20;4.0
2001;Zondag 12 maart 2000;448;227;221;352;168;184;7;7;;;0.0;0.0;0.0;0.0;0;176;120;56;0;20;7.0
2002;Maandag 13 maart 2000;596;298;298;401;207;194;100;100;;;17.0;12.0;3.0;2.0;166;5192;3169;2023;472;197;267.0
2003;Dinsdag 14 maart 2000;645;326;319;389;191;198;119;119;;;7.0;6.0;0.0;1.0;159;4261;2621;1640;456;154;20.0
2004;Woensdag 15 maart 2000;618;306;312;368;162;206;140;140;;;9.0;6.0;2.0;1.0;137;6938;4526;2412;385;246;13.0
2005;Donderdag 16 maart 2000;579;278;301;358;165;193;149;149;;;8.0;6.0;1.0;1.0;151;4884;3031;1853;433;153;26.0
2006;Vrijdag 17 maart 2000;560;286;274;367;169;198;374;374;;;3.0;0.0;1.0;2.0;140;4232;2678;1554;356;156;9.0
2007;Zaterdag 18 maart 2000;480;235;245;412;207;205;57;57;;;1.0;0.0;0.0;1.0;0;1322;966;356;3;24;0.0
2008;Zondag 19 maart 2000;487;237;250;378;189;189;8;8;;;0.0;0.0;0.0;0.0;1;100;65;35;2;24;2.0
2009;Maandag 20 maart 2000;594;301;293;375;178;197;154;154;;;7.0;6.0;1.0;0.0;182;5799;3665;2134;442;173;1139.0
2010;Dinsdag 21 maart 2000;620;315;305;386;193;193;207;207;;;14.0;5.0;3.0;6.0;167;4000;2535;1465;503;164;804.0
2011;Woensdag 22 maart 2000;627;319;308;357;170;187;144;144;;;11.0;7.0;2.0;2.0;115;3828;2379;1449;387;163;11.0
2012;Donderdag 23 maart 2000;597;290;307;339;171;168;152;152;;;3.0;3.0;0.0;0.0;145;4236;2581;1655;476;191;250.0
2013;Vrijdag 24 maart 2000;584;297;287;385;174;211;401;401;;;6.0;1.0;4.0;1.0;115;4338;2768;1570;343;158;4.0
2014;Zaterdag 25 maart 2000;448;227;221;389;213;176;80;80;;;1.0;1.0;0.0;0.0;0;2252;1552;700;2;41;0.0
2015;Zondag 26 maart 2000;412;195;217;302;164;138;5;5;;;0.0;0.0;0.0;0.0;0;236;158;78;7;22;18.0
2016;Maandag 27 maart 2000;548;281;267;358;179;179;126;126;;;13.0;7.0;2.0;4.0;130;5279;3325;1954;504;235;324.0
2017;Dinsdag 28 maart 2000;657;310;347;353;171;182;129;129;;;15.0;8.0;2.0;5.0;168;4055;2502;1553;480;166;471.0
2018;Woensdag 29 maart 2000;575;291;284;381;190;191;137;137;;;8.0;5.0;3.0;0.0;155;4021;2447;1574;438;173;14.0
2019;Donderdag 30 maart 2000;612;309;303;364;184;180;176;176;;;5.0;4.0;0.0;1.0;167;5062;3191;1871;463;201;189.0
2020;Vrijdag 31 maart 2000;579;292;287;359;177;182;460;460;;;16.0;5.0;4.0;7.0;112;7247;4688;2559;388;319;504.0
2021;Totaal april 2000;16625;8519;8106;11468;5697;5771;6220;6220;;;213.0;87.0;72.0;54.0;2515;116689;74476;42213;8491;4151;3808.0
2022;Zaterdag 1 april 2000;496;231;265;354;170;184;192;192;;;3.0;0.0;1.0;2.0;1;16190;10953;5237;45;391;7.0
2023;Zondag 2 april 2000;447;240;207;385;197;188;7;7;;;0.0;0.0;0.0;0.0;0;174;106;68;2;49;1.0
2024;Maandag 3 april 2000;590;316;274;398;204;194;128;128;;;18.0;7.0;7.0;4.0;129;7655;4865;2790;576;259;562.0
2025;Dinsdag 4 april 2000;652;348;304;392;180;212;189;189;;;14.0;8.0;4.0;2.0;160;4810;2926;1884;473;160;119.0
2026;Woensdag 5 april 2000;632;349;283;366;182;184;139;139;;;12.0;4.0;5.0;3.0;147;4361;2654;1707;465;161;20.0
2027;Donderdag 6 april 2000;566;264;302;348;174;174;204;204;;;6.0;1.0;5.0;0.0;160;4538;2839;1699;470;147;713.0
2028;Vrijdag 7 april 2000;561;297;264;405;205;200;590;590;;;16.0;4.0;9.0;3.0;140;4421;2751;1670;331;132;15.0
2029;Zaterdag 8 april 2000;471;243;228;401;189;212;99;99;;;2.0;0.0;1.0;1.0;0;1285;922;363;4;31;0.0
2030;Zondag 9 april 2000;467;245;222;380;191;189;5;5;;;0.0;0.0;0.0;0.0;0;150;74;76;5;14;9.0
2031;Maandag 10 april 2000;597;308;289;405;219;186;153;153;;;8.0;3.0;3.0;2.0;151;5654;3567;2087;504;207;223.0
2032;Dinsdag 11 april 2000;639;349;290;374;205;169;127;127;;;10.0;5.0;5.0;0.0;143;3925;2457;1468;512;158;174.0
2033;Woensdag 12 april 2000;634;300;334;394;198;196;176;176;;;13.0;7.0;1.0;5.0;147;3690;2258;1432;457;157;453.0
2034;Donderdag 13 april 2000;594;296;298;426;224;202;138;138;;;7.0;2.0;3.0;2.0;135;4107;2511;1596;446;154;18.0
2035;Vrijdag 14 april 2000;586;300;286;390;194;196;826;826;;;6.0;1.0;3.0;2.0;110;5129;3257;1872;338;152;15.0
2036;Zaterdag 15 april 2000;470;234;236;362;195;167;136;136;;;2.0;0.0;1.0;1.0;2;3563;2416;1147;9;77;3.0
2037;Zondag 16 april 2000;469;235;234;336;170;166;5;5;;;0.0;0.0;0.0;0.0;0;358;231;127;1;18;1.0
2038;Maandag 17 april 2000;594;296;298;386;193;193;162;162;;;15.0;8.0;3.0;4.0;110;5915;3792;2123;501;231;17.0
2039;Dinsdag 18 april 2000;619;325;294;374;179;195;161;161;;;13.0;7.0;4.0;2.0;133;3979;2438;1541;484;133;1208.0
2040;Woensdag 19 april 2000;586;295;291;381;188;193;189;189;;;14.0;4.0;5.0;5.0;140;3720;2228;1492;383;134;7.0
2041;Donderdag 20 april 2000;623;303;320;391;188;203;486;486;;;9.0;4.0;1.0;4.0;113;5694;3656;2038;463;193;14.0
2042;Vrijdag 21 april 2000;592;287;305;414;187;227;107;107;;;0.0;0.0;0.0;0.0;14;1731;1200;531;34;42;3.0
2043;Zaterdag 22 april 2000;447;230;217;403;201;202;91;91;;;0.0;0.0;0.0;0.0;1;1618;1115;503;4;31;3.0
2044;Zondag 23 april 2000;476;247;229;356;174;182;6;6;;;0.0;0.0;0.0;0.0;0;153;102;51;6;13;5.0
2045;Maandag 24 april 2000;469;256;213;355;161;194;21;21;;;0.0;0.0;0.0;0.0;2;452;324;128;4;16;3.0
2046;Dinsdag 25 april 2000;592;299;293;372;179;193;199;199;;;16.0;8.0;2.0;6.0;145;6091;3855;2236;598;282;173.0
2047;Woensdag 26 april 2000;613;340;273;391;208;183;226;226;;;13.0;8.0;4.0;1.0;155;4337;2640;1697;503;216;19.0
2048;Donderdag 27 april 2000;638;326;312;383;180;203;339;339;;;8.0;2.0;4.0;2.0;145;5247;3333;1914;533;241;13.0
2049;Vrijdag 28 april 2000;563;300;263;419;198;221;1033;1033;;;8.0;4.0;1.0;3.0;131;5760;3587;2173;333;230;8.0
2050;Zaterdag 29 april 2000;490;233;257;358;170;188;72;72;;;0.0;0.0;0.0;0.0;1;977;671;306;2;50;1.0
2051;Zondag 30 april 2000;452;227;225;369;194;175;14;14;;;0.0;0.0;0.0;0.0;0;1005;748;257;5;72;1.0
2052;Totaal mei 2000;17513;9043;8470;11511;5635;5876;11335;11335;;;313.0;118.0;104.0;91.0;3193;135767;86121;49646;9970;4129;5992.0
2053;Maandag 1 mei 2000;578;322;256;371;184;187;225;225;;;17.0;13.0;3.0;1.0;103;21821;14180;7641;411;518;1901.0
2054;Dinsdag 2 mei 2000;664;352;312;328;154;174;215;215;;;18.0;5.0;5.0;8.0;161;5420;3233;2187;535;147;379.0
2055;Woensdag 3 mei 2000;610;329;281;386;188;198;206;206;;;7.0;2.0;3.0;2.0;137;4824;2857;1967;449;117;28.0
2056;Donderdag 4 mei 2000;608;315;293;386;173;213;126;126;;;6.0;4.0;2.0;0.0;150;5185;3174;2011;504;194;16.0
2057;Vrijdag 5 mei 2000;512;250;262;393;199;194;112;112;;;2.0;1.0;1.0;0.0;1;762;532;230;10;45;1.0
2058;Zaterdag 6 mei 2000;488;233;255;346;179;167;229;229;;;3.0;0.0;3.0;0.0;1;918;632;286;4;35;0.0
2059;Zondag 7 mei 2000;460;248;212;344;172;172;4;4;;;0.0;0.0;0.0;0.0;0;185;133;52;9;25;1.0
2060;Maandag 8 mei 2000;558;256;302;419;201;218;179;179;;;9.0;4.0;3.0;2.0;131;6454;4038;2416;535;187;720.0
2061;Dinsdag 9 mei 2000;627;328;299;395;186;209;153;153;;;12.0;3.0;3.0;6.0;162;4471;2646;1825;481;150;15.0
2062;Woensdag 10 mei 2000;643;345;298;373;154;219;219;219;;;12.0;4.0;6.0;2.0;167;4717;3033;1684;459;163;350.0
2063;Donderdag 11 mei 2000;586;302;284;386;192;194;393;393;;;8.0;4.0;2.0;2.0;146;4540;2873;1667;450;161;20.0
2064;Vrijdag 12 mei 2000;607;307;300;371;169;202;1391;1391;;;14.0;2.0;6.0;6.0;96;4574;2847;1727;414;151;286.0
2065;Zaterdag 13 mei 2000;464;227;237;418;217;201;181;181;;;0.0;0.0;0.0;0.0;1;1096;818;278;6;26;1.0
2066;Zondag 14 mei 2000;476;265;211;382;189;193;8;8;;;0.0;0.0;0.0;0.0;0;225;182;43;6;15;0.0
2067;Maandag 15 mei 2000;627;304;323;420;217;203;189;189;;;16.0;10.0;4.0;2.0;120;8511;5501;3010;436;228;22.0
2068;Dinsdag 16 mei 2000;649;342;307;404;183;221;165;165;;;10.0;4.0;2.0;4.0;140;4229;2701;1528;457;99;90.0
2069;Woensdag 17 mei 2000;585;310;275;373;174;199;212;212;;;11.0;10.0;0.0;1.0;133;3746;2278;1468;364;131;185.0
2070;Donderdag 18 mei 2000;579;309;270;389;186;203;459;459;;;9.0;4.0;3.0;2.0;179;4344;2720;1624;458;94;12.0
2071;Vrijdag 19 mei 2000;572;313;259;396;211;185;1446;1446;;;20.0;4.0;7.0;9.0;110;4206;2627;1579;305;119;548.0
2072;Zaterdag 20 mei 2000;475;238;237;352;175;177;320;320;;;3.0;0.0;3.0;0.0;1;1939;1407;532;13;47;0.0
2073;Zondag 21 mei 2000;433;212;221;364;182;182;12;12;;;0.0;0.0;0.0;0.0;0;182;139;43;4;11;0.0
2074;Maandag 22 mei 2000;583;324;259;367;192;175;184;184;;;20.0;12.0;7.0;1.0;155;5351;3413;1938;492;138;22.0
2075;Dinsdag 23 mei 2000;572;276;296;368;167;201;172;172;;;11.0;5.0;2.0;4.0;167;4069;2538;1531;420;139;445.0
2076;Woensdag 24 mei 2000;571;301;270;326;155;171;273;273;;;13.0;4.0;4.0;5.0;164;4086;2506;1580;412;122;13.0
2077;Donderdag 25 mei 2000;615;314;301;368;190;178;580;580;;;10.0;2.0;2.0;6.0;183;4675;3038;1637;445;209;15.0
2078;Vrijdag 26 mei 2000;596;296;300;328;156;172;1623;1623;;;16.0;1.0;7.0;8.0;130;4460;2862;1598;350;166;601.0
2079;Zaterdag 27 mei 2000;514;261;253;363;194;169;309;309;;;6.0;0.0;4.0;2.0;1;1916;1366;550;6;31;0.0
2080;Zondag 28 mei 2000;454;227;227;335;163;172;14;14;;;0.0;0.0;0.0;0.0;0;374;260;114;6;29;2.0
2081;Maandag 29 mei 2000;572;284;288;337;165;172;223;223;;;22.0;10.0;5.0;7.0;150;5837;3673;2164;526;206;17.0
2082;Dinsdag 30 mei 2000;617;333;284;373;193;180;277;277;;;15.0;7.0;5.0;3.0;160;5120;3060;2060;494;172;23.0
2083;Woensdag 31 mei 2000;618;320;298;350;175;175;1236;1236;;;23.0;3.0;12.0;8.0;144;7530;4854;2676;509;254;279.0
2084;Totaal juni 2000;16773;8660;8113;11200;5503;5697;11530;11530;;;296.0;121.0;89.0;86.0;2663;125227;78591;46636;10135;5102;2701.0
2085;Donderdag 1 juni 2000;542;274;268;367;173;194;21;21;;;0.0;0.0;0.0;0.0;2;14406;9741;4665;45;349;3.0
2086;Vrijdag 2 juni 2000;534;289;245;395;196;199;833;833;;;5.0;0.0;4.0;1.0;24;1674;1057;617;47;78;5.0
2087;Zaterdag 3 juni 2000;512;277;235;329;172;157;223;223;;;3.0;0.0;2.0;1.0;1;632;401;231;2;22;0.0
2088;Zondag 4 juni 2000;483;218;265;362;161;201;7;7;;;1.0;0.0;0.0;1.0;0;142;102;40;5;20;0.0
2089;Maandag 5 juni 2000;572;298;274;344;174;170;229;229;;;14.0;9.0;3.0;2.0;145;8152;4932;3220;767;286;27.0
2090;Dinsdag 6 juni 2000;601;308;293;342;176;166;266;266;;;21.0;13.0;3.0;5.0;152;5452;3389;2063;612;198;20.0
2091;Woensdag 7 juni 2000;627;330;297;352;184;168;258;258;;;5.0;5.0;0.0;0.0;173;4499;2733;1766;455;135;23.0
2092;Donderdag 8 juni 2000;551;274;277;340;186;154;485;485;;;10.0;2.0;4.0;4.0;153;5379;3302;2077;528;157;18.0
2093;Vrijdag 9 juni 2000;631;316;315;398;203;195;1338;1338;;;26.0;3.0;12.0;11.0;185;4838;2932;1906;414;156;10.0
2094;Zaterdag 10 juni 2000;515;263;252;362;180;182;252;252;;;2.0;0.0;2.0;0.0;1;1637;1223;414;3;41;2.0
2095;Zondag 11 juni 2000;441;228;213;346;174;172;7;7;;;0.0;0.0;0.0;0.0;0;145;79;66;2;20;1.0
2096;Maandag 12 juni 2000;422;223;199;318;168;150;19;19;;;1.0;0.0;1.0;0.0;2;461;345;116;8;26;7.0
2097;Dinsdag 13 juni 2000;615;315;300;380;173;207;155;155;;;13.0;9.0;3.0;1.0;118;5127;3081;2046;598;174;1266.0
2098;Woensdag 14 juni 2000;631;341;290;324;144;180;236;236;;;17.0;10.0;4.0;3.0;130;4635;2912;1723;546;155;21.0
2099;Donderdag 15 juni 2000;611;333;278;380;192;188;398;398;;;11.0;4.0;2.0;5.0;135;7954;5106;2848;571;291;10.0
2100;Vrijdag 16 juni 2000;619;314;305;363;189;174;1306;1306;;;16.0;3.0;8.0;5.0;129;5037;3226;1811;413;219;10.0
2101;Zaterdag 17 juni 2000;485;262;223;317;158;159;252;252;;;0.0;0.0;0.0;0.0;0;1316;949;367;3;58;0.0
2102;Zondag 18 juni 2000;470;242;228;370;188;182;13;13;;;0.0;0.0;0.0;0.0;0;213;150;63;5;22;0.0
2103;Maandag 19 juni 2000;613;307;306;450;206;244;201;201;;;21.0;15.0;1.0;5.0;126;5353;3184;2169;500;235;279.0
2104;Dinsdag 20 juni 2000;670;315;355;484;203;281;191;191;;;15.0;8.0;3.0;4.0;150;4456;2768;1688;510;159;63.0
2105;Woensdag 21 juni 2000;613;335;278;467;200;267;348;348;;;21.0;7.0;6.0;8.0;145;3721;2259;1462;410;235;82.0
2106;Donderdag 22 juni 2000;589;307;282;401;181;220;382;382;;;4.0;1.0;1.0;2.0;127;4513;2670;1843;526;168;18.0
2107;Vrijdag 23 juni 2000;555;289;266;421;229;192;1386;1386;;;20.0;5.0;8.0;7.0;152;4453;2831;1622;436;202;9.0
2108;Zaterdag 24 juni 2000;480;243;237;385;180;205;260;260;;;2.0;0.0;2.0;0.0;1;1894;1313;581;9;41;1.0
2109;Zondag 25 juni 2000;411;201;210;361;186;175;10;10;;;0.0;0.0;0.0;0.0;0;472;323;149;9;63;1.0
2110;Maandag 26 juni 2000;595;320;275;340;174;166;174;174;;;12.0;10.0;1.0;1.0;125;5878;3580;2298;584;237;29.0
2111;Dinsdag 27 juni 2000;616;324;292;407;210;197;175;175;;;15.0;6.0;3.0;6.0;115;4571;2829;1742;623;266;25.0
2112;Woensdag 28 juni 2000;573;295;278;369;186;183;198;198;;;11.0;3.0;4.0;4.0;132;4723;2798;1925;511;273;750.0
2113;Donderdag 29 juni 2000;583;305;278;350;165;185;413;413;;;8.0;5.0;2.0;1.0;139;5097;3095;2002;564;298;11.0
2114;Vrijdag 30 juni 2000;613;314;299;376;192;184;1494;1494;;;22.0;3.0;10.0;9.0;101;8397;5281;3116;429;518;10.0
2115;Totaal juli 2000;17694;8989;8705;11164;5499;5665;8802;8802;;;241.0;108.0;64.0;69.0;2908;143355;85313;58042;12269;6778;3328.0
2116;Zaterdag 1 juli 2000;455;236;219;381;183;198;328;328;;;1.0;0.0;0.0;1.0;0;17870;11413;6457;65;621;0.0
2117;Zondag 2 juli 2000;453;223;230;409;198;211;16;16;;;0.0;0.0;0.0;0.0;0;174;91;83;5;91;2.0
2118;Maandag 3 juli 2000;575;288;287;379;190;189;196;196;;;17.0;11.0;4.0;2.0;147;8590;5075;3515;833;351;21.0
2119;Dinsdag 4 juli 2000;626;313;313;408;188;220;201;201;;;15.0;6.0;4.0;5.0;148;5516;3149;2367;752;256;152.0
2120;Woensdag 5 juli 2000;608;313;295;367;172;195;214;214;;;15.0;5.0;6.0;4.0;145;5115;2920;2195;546;253;17.0
2121;Donderdag 6 juli 2000;629;311;318;356;175;181;356;356;;;10.0;3.0;2.0;5.0;145;5714;3338;2376;615;246;18.0
2122;Vrijdag 7 juli 2000;591;306;285;386;180;206;1423;1423;;;16.0;1.0;7.0;8.0;132;5355;3016;2339;479;229;15.0
2123;Zaterdag 8 juli 2000;472;226;246;353;169;184;252;252;;;4.0;1.0;3.0;0.0;1;1470;961;509;2;80;0.0
2124;Zondag 9 juli 2000;470;230;240;323;163;160;8;8;;;0.0;0.0;0.0;0.0;0;180;115;65;2;50;1.0
2125;Maandag 10 juli 2000;605;317;288;344;172;172;198;198;;;19.0;9.0;3.0;7.0;147;6805;4062;2743;688;345;25.0
2126;Dinsdag 11 juli 2000;588;300;288;374;180;194;171;171;;;6.0;5.0;1.0;0.0;175;4773;2722;2051;636;182;23.0
2127;Woensdag 12 juli 2000;654;336;318;328;164;164;232;232;;;4.0;4.0;0.0;0.0;138;4662;2597;2065;506;223;18.0
2128;Donderdag 13 juli 2000;579;305;274;347;168;179;249;249;;;6.0;5.0;0.0;1.0;123;4954;2908;2046;553;219;13.0
2129;Vrijdag 14 juli 2000;613;311;302;368;176;192;995;995;;;13.0;3.0;7.0;3.0;130;5884;3439;2445;404;249;6.0
2130;Zaterdag 15 juli 2000;519;258;261;368;203;165;178;178;;;1.0;0.0;1.0;0.0;0;4000;2638;1362;8;114;0.0
2131;Zondag 16 juli 2000;478;247;231;340;167;173;10;10;;;0.0;0.0;0.0;0.0;0;433;304;129;6;29;0.0
2132;Maandag 17 juli 2000;607;316;291;358;169;189;214;214;;;11.0;7.0;3.0;1.0;125;7149;4370;2779;697;298;20.0
2133;Dinsdag 18 juli 2000;635;319;316;364;195;169;200;200;;;11.0;7.0;1.0;3.0;129;4844;2805;2039;682;256;38.0
2134;Woensdag 19 juli 2000;614;321;293;328;142;186;191;191;;;8.0;4.0;2.0;2.0;144;4145;2410;1735;630;237;18.0
2135;Donderdag 20 juli 2000;641;340;301;396;196;200;314;314;;;9.0;6.0;3.0;0.0;140;5353;3153;2200;496;231;19.0
2136;Vrijdag 21 juli 2000;669;346;323;318;153;165;741;741;;;17.0;5.0;1.0;11.0;132;4933;2912;2021;416;237;4.0
2137;Zaterdag 22 juli 2000;484;233;251;336;176;160;166;166;;;1.0;0.0;1.0;0.0;2;1545;1068;477;3;69;2244.0
2138;Zondag 23 juli 2000;510;257;253;356;183;173;20;20;;;0.0;0.0;0.0;0.0;0;239;155;84;7;47;7.0
2139;Maandag 24 juli 2000;665;343;322;386;190;196;223;223;;;9.0;4.0;2.0;3.0;139;6088;3567;2521;645;268;19.0
2140;Dinsdag 25 juli 2000;623;316;307;372;173;199;211;211;;;11.0;9.0;2.0;0.0;156;4759;2728;2031;539;246;19.0
2141;Woensdag 26 juli 2000;614;300;314;363;190;173;195;195;;;7.0;2.0;1.0;4.0;137;4115;2321;1794;517;252;15.0
2142;Donderdag 27 juli 2000;583;290;293;344;177;167;260;260;;;8.0;4.0;1.0;3.0;127;5049;2828;2221;495;265;11.0
2143;Vrijdag 28 juli 2000;589;288;301;348;169;179;647;647;;;10.0;1.0;6.0;3.0;127;5113;2991;2122;359;270;592.0
2144;Zaterdag 29 juli 2000;504;267;237;336;175;161;134;134;;;0.0;0.0;0.0;0.0;0;1231;820;411;4;74;0.0
2145;Zondag 30 juli 2000;466;223;243;356;173;183;26;26;;;0.0;0.0;0.0;0.0;1;447;299;148;11;55;0.0
2146;Maandag 31 juli 2000;575;310;265;372;190;182;233;233;;;12.0;6.0;3.0;3.0;118;6850;4138;2712;668;435;11.0
2147;Totaal augustus 2000;18315;9371;8944;10960;5308;5652;9834;9834;;;254.0;99.0;70.0;85.0;2896;143916;80784;63132;14833;6662;3836.0
2148;Dinsdag 1 augustus 2000;670;326;344;395;183;212;260;260;;;14.0;7.0;5.0;2.0;102;25490;15240;10250;789;830;33.0
2149;Woensdag 2 augustus 2000;632;313;319;377;185;192;233;233;;;8.0;3.0;2.0;3.0;111;4876;2651;2225;581;190;11.0
2150;Donderdag 3 augustus 2000;626;307;319;370;162;208;221;221;;;6.0;3.0;1.0;2.0;104;5216;2815;2401;634;242;10.0
2151;Vrijdag 4 augustus 2000;619;320;299;354;165;189;633;633;;;6.0;1.0;2.0;3.0;83;4744;2606;2138;489;238;8.0
2152;Zaterdag 5 augustus 2000;502;288;214;345;165;180;162;162;;;1.0;0.0;1.0;0.0;0;1012;617;395;2;52;0.0
2153;Zondag 6 augustus 2000;466;241;225;319;158;161;27;27;;;0.0;0.0;0.0;0.0;0;141;90;51;14;53;0.0
2154;Maandag 7 augustus 2000;617;307;310;359;180;179;215;215;;;17.0;13.0;3.0;1.0;115;6255;3614;2641;882;247;13.0
2155;Dinsdag 8 augustus 2000;653;329;324;338;162;176;280;280;;;12.0;8.0;3.0;1.0;156;4561;2449;2112;685;199;629.0
2156;Woensdag 9 augustus 2000;632;328;304;362;178;184;198;198;;;15.0;4.0;3.0;8.0;137;4108;2354;1754;563;157;14.0
2157;Donderdag 10 augustus 2000;631;302;329;370;185;185;289;289;;;4.0;1.0;0.0;3.0;153;5026;2766;2260;648;219;11.0
2158;Vrijdag 11 augustus 2000;622;326;296;357;173;184;672;672;;;9.0;0.0;5.0;4.0;112;4412;2506;1906;429;161;3.0
2159;Zaterdag 12 augustus 2000;503;261;242;343;156;187;192;192;;;3.0;0.0;1.0;2.0;0;1161;723;438;8;64;0.0
2160;Zondag 13 augustus 2000;493;251;242;359;167;192;16;16;;;1.0;0.0;1.0;0.0;0;148;92;56;0;56;0.0
2161;Maandag 14 augustus 2000;653;337;316;384;186;198;218;218;;;16.0;8.0;6.0;2.0;123;6465;3691;2774;713;274;22.0
2162;Dinsdag 15 augustus 2000;671;341;330;405;196;209;225;225;;;8.0;7.0;1.0;0.0;130;7710;4344;3366;696;331;17.0
2163;Woensdag 16 augustus 2000;609;314;295;358;190;168;217;217;;;8.0;1.0;3.0;4.0;128;4542;2381;2161;518;197;13.0
2164;Donderdag 17 augustus 2000;634;331;303;355;165;190;307;307;;;7.0;4.0;0.0;3.0;137;4954;2593;2361;610;222;19.0
2165;Vrijdag 18 augustus 2000;640;324;316;355;196;159;1167;1167;;;11.0;3.0;2.0;6.0;89;4723;2616;2107;516;229;5.0
2166;Zaterdag 19 augustus 2000;502;257;245;358;173;185;221;221;;;0.0;0.0;0.0;0.0;1;994;611;383;3;45;0.0
2167;Zondag 20 augustus 2000;486;243;243;324;154;170;17;17;;;0.0;0.0;0.0;0.0;1;602;354;248;14;62;2.0
2168;Maandag 21 augustus 2000;583;322;261;355;163;192;191;191;;;18.0;5.0;7.0;6.0;107;6086;3314;2772;785;274;19.0
2169;Dinsdag 22 augustus 2000;661;343;318;348;163;185;216;216;;;5.0;2.0;2.0;1.0;133;4449;2299;2150;599;258;26.0
2170;Woensdag 23 augustus 2000;629;319;310;359;171;188;254;254;;;14.0;5.0;4.0;5.0;146;4022;2186;1836;602;211;1802.0
2171;Donderdag 24 augustus 2000;596;314;282;314;143;171;462;462;;;11.0;2.0;2.0;7.0;115;4553;2440;2113;682;206;126.0
2172;Vrijdag 25 augustus 2000;600;298;302;343;181;162;1428;1428;;;13.0;0.0;3.0;10.0;111;4821;2743;2078;483;273;13.0
2173;Zaterdag 26 augustus 2000;487;253;234;363;187;176;313;313;;;1.0;0.0;1.0;0.0;0;1304;856;448;3;74;0.0
2174;Zondag 27 augustus 2000;481;254;227;334;169;165;14;14;;;1.0;0.0;0.0;1.0;0;263;151;112;3;47;1.0
2175;Maandag 28 augustus 2000;546;265;281;302;158;144;243;243;;;13.0;10.0;3.0;0.0;125;5781;3149;2632;724;324;303.0
2176;Dinsdag 29 augustus 2000;600;310;290;344;160;184;168;168;;;11.0;6.0;3.0;2.0;159;4468;2330;2138;734;223;7.0
2177;Woensdag 30 augustus 2000;593;298;295;349;176;173;261;261;;;6.0;2.0;2.0;2.0;177;4726;2550;2176;660;316;454.0
2178;Donderdag 31 augustus 2000;678;349;329;362;158;204;514;514;;;15.0;4.0;4.0;7.0;141;6303;3653;2650;764;388;275.0
2179;Totaal september 2000;17736;9129;8607;10667;5208;5459;12561;12561;;;276.0;108.0;85.0;83.0;2853;134220;77254;56966;14015;5934;3936.0
2180;Vrijdag 1 september 2000;610;310;300;355;202;153;1736;1736;;;22.0;7.0;7.0;8.0;107;24894;14546;10348;584;928;9.0
2181;Zaterdag 2 september 2000;526;263;263;341;164;177;366;366;;;4.0;1.0;1.0;2.0;0;715;416;299;7;63;0.0
2182;Zondag 3 september 2000;489;246;243;338;171;167;20;20;;;0.0;0.0;0.0;0.0;0;156;88;68;0;70;0.0
2183;Maandag 4 september 2000;590;310;280;327;167;160;218;218;;;18.0;15.0;2.0;1.0;134;6810;3591;3219;781;283;13.0
2184;Dinsdag 5 september 2000;641;317;324;367;172;195;220;220;;;9.0;6.0;2.0;1.0;165;5568;2877;2691;782;204;567.0
2185;Woensdag 6 september 2000;661;322;339;380;168;212;290;290;;;12.0;5.0;2.0;5.0;140;4454;2390;2064;814;198;567.0
2186;Donderdag 7 september 2000;594;317;277;352;167;185;511;511;;;10.0;2.0;6.0;2.0;155;5045;2744;2301;739;173;29.0
2187;Vrijdag 8 september 2000;592;306;286;353;179;174;1560;1560;;;15.0;2.0;9.0;4.0;95;4679;2689;1990;500;208;263.0
2188;Zaterdag 9 september 2000;515;270;245;363;180;183;314;314;;;3.0;0.0;2.0;1.0;0;979;632;347;6;32;0.0
2189;Zondag 10 september 2000;493;261;232;364;186;178;12;12;;;0.0;0.0;0.0;0.0;2;452;295;157;6;59;0.0
2190;Maandag 11 september 2000;592;305;287;377;176;201;184;184;;;11.0;9.0;1.0;1.0;127;5403;3123;2280;839;252;270.0
2191;Dinsdag 12 september 2000;694;332;362;348;162;186;173;173;;;12.0;6.0;4.0;2.0;149;4259;2381;1878;757;295;264.0
2192;Woensdag 13 september 2000;624;341;283;355;187;168;165;165;;;12.0;6.0;2.0;4.0;148;4125;2186;1939;657;133;17.0
2193;Donderdag 14 september 2000;640;349;291;346;156;190;457;457;;;8.0;2.0;1.0;5.0;111;4771;2662;2109;822;196;327.0
2194;Vrijdag 15 september 2000;631;315;316;369;187;182;1387;1387;;;21.0;4.0;7.0;10.0;138;7731;4733;2998;503;260;14.0
2195;Zaterdag 16 september 2000;508;273;235;376;173;203;257;257;;;4.0;0.0;3.0;1.0;1;1265;831;434;13;59;0.0
2196;Zondag 17 september 2000;493;244;249;346;174;172;4;4;;;0.0;0.0;0.0;0.0;0;193;146;47;3;37;2.0
2197;Maandag 18 september 2000;613;311;302;352;156;196;220;220;;;11.0;5.0;3.0;3.0;116;5694;3211;2483;747;274;231.0
2198;Dinsdag 19 september 2000;681;364;317;361;184;177;168;168;;;14.0;8.0;3.0;3.0;156;4190;2306;1884;707;156;431.0
2199;Woensdag 20 september 2000;602;318;284;342;164;178;248;248;;;10.0;5.0;5.0;0.0;136;4657;2741;1916;649;222;19.0
2200;Donderdag 21 september 2000;613;331;282;361;170;191;414;414;;;12.0;4.0;4.0;4.0;140;4643;2645;1998;564;203;37.0
2201;Vrijdag 22 september 2000;647;329;318;364;190;174;1237;1237;;;13.0;0.0;5.0;8.0;134;4349;2595;1754;441;168;9.0
2202;Zaterdag 23 september 2000;518;275;243;379;199;180;232;232;;;3.0;0.0;3.0;0.0;0;1404;932;472;10;63;0.0
2203;Zondag 24 september 2000;492;243;249;342;173;169;5;5;;;0.0;0.0;0.0;0.0;0;193;135;58;6;33;0.0
2204;Maandag 25 september 2000;585;293;292;376;186;190;169;169;;;14.0;7.0;0.0;7.0;127;5979;3433;2546;677;263;18.0
2205;Dinsdag 26 september 2000;608;303;305;337;161;176;180;180;;;11.0;7.0;4.0;0.0;175;4159;2406;1753;679;179;365.0
2206;Woensdag 27 september 2000;638;333;305;345;167;178;189;189;;;4.0;3.0;1.0;0.0;140;4099;2307;1792;564;219;20.0
2207;Donderdag 28 september 2000;684;366;318;322;161;161;337;337;;;8.0;0.0;2.0;6.0;134;4967;2976;1991;667;288;18.0
2208;Vrijdag 29 september 2000;637;311;326;382;164;218;1083;1083;;;14.0;4.0;5.0;5.0;123;6216;3751;2465;482;280;446.0
2209;Zaterdag 30 september 2000;525;271;254;347;162;185;205;205;;;1.0;0.0;1.0;0.0;0;2171;1486;685;9;136;0.0
2210;Totaal oktober 2000;17155;8805;8350;11556;5702;5854;6514;6514;;;225.0;98.0;67.0;60.0;3028;134606;81367;53239;12611;5306;4354.0
2211;Zondag 1 oktober 2000;490;246;244;370;182;188;9;9;;;0.0;0.0;0.0;0.0;0;13529;8867;4662;45;426;0.0
2212;Maandag 2 oktober 2000;600;315;285;379;190;189;154;154;;;14.0;6.0;4.0;4.0;137;9049;5423;3626;688;314;407.0
2213;Dinsdag 3 oktober 2000;617;322;295;359;189;170;133;133;;;11.0;4.0;4.0;3.0;182;5296;3131;2165;619;245;34.0
2214;Woensdag 4 oktober 2000;614;303;311;351;170;181;174;174;;;8.0;4.0;1.0;3.0;150;4634;2611;2023;737;160;21.0
2215;Donderdag 5 oktober 2000;584;301;283;402;197;205;207;207;;;9.0;4.0;2.0;3.0;141;5221;2990;2231;578;202;19.0
2216;Vrijdag 6 oktober 2000;576;299;277;377;176;201;868;868;;;13.0;2.0;6.0;5.0;119;4566;2690;1876;429;239;296.0
2217;Zaterdag 7 oktober 2000;493;255;238;367;176;191;158;158;;;1.0;1.0;0.0;0.0;0;984;697;287;1;38;0.0
2218;Zondag 8 oktober 2000;454;240;214;343;164;179;9;9;;;0.0;0.0;0.0;0.0;0;237;161;76;11;22;2.0
2219;Maandag 9 oktober 2000;547;282;265;371;183;188;136;136;;;11.0;5.0;2.0;4.0;121;5513;3242;2271;735;205;13.0
2220;Dinsdag 10 oktober 2000;607;310;297;344;160;184;263;263;;;14.0;6.0;4.0;4.0;164;4406;2585;1821;593;199;12.0
2221;Woensdag 11 oktober 2000;635;335;300;381;190;191;144;144;;;9.0;3.0;3.0;3.0;133;4027;2339;1688;587;133;13.0
2222;Donderdag 12 oktober 2000;561;284;277;376;177;199;239;239;;;4.0;2.0;0.0;2.0;113;4952;2912;2040;542;184;787.0
2223;Vrijdag 13 oktober 2000;536;259;277;355;177;178;549;549;;;9.0;1.0;3.0;5.0;121;4514;2676;1838;400;174;477.0
2224;Zaterdag 14 oktober 2000;500;257;243;369;176;193;147;147;;;2.0;0.0;1.0;1.0;0;1494;1029;465;1;36;0.0
2225;Zondag 15 oktober 2000;448;218;230;343;166;177;6;6;;;0.0;0.0;0.0;0.0;1;2041;1456;585;9;70;1.0
2226;Maandag 16 oktober 2000;554;289;265;372;190;182;154;154;;;11.0;5.0;4.0;2.0;111;6909;4286;2623;663;188;19.0
2227;Dinsdag 17 oktober 2000;580;306;274;350;181;169;142;142;;;12.0;8.0;2.0;2.0;143;4521;2548;1973;587;196;25.0
2228;Woensdag 18 oktober 2000;518;274;244;375;185;190;188;188;;;15.0;7.0;5.0;3.0;160;4149;2462;1687;548;173;8.0
2229;Donderdag 19 oktober 2000;599;295;304;398;179;219;266;266;;;9.0;2.0;5.0;2.0;143;4523;2708;1815;632;152;26.0
2230;Vrijdag 20 oktober 2000;614;318;296;358;170;188;926;926;;;9.0;3.0;3.0;3.0;118;5182;3142;2040;340;200;769.0
2231;Zaterdag 21 oktober 2000;452;228;224;376;171;205;107;107;;;2.0;1.0;1.0;0.0;2;1380;960;420;0;26;0.0
2232;Zondag 22 oktober 2000;458;237;221;342;171;171;4;4;;;0.0;0.0;0.0;0.0;0;227;149;78;5;21;2.0
2233;Maandag 23 oktober 2000;600;308;292;388;201;187;126;126;;;6.0;3.0;1.0;2.0;130;5843;3558;2285;640;190;238.0
2234;Dinsdag 24 oktober 2000;630;331;299;432;222;210;126;126;;;13.0;11.0;1.0;1.0;151;4263;2399;1864;566;197;162.0
2235;Woensdag 25 oktober 2000;562;293;269;384;207;177;143;143;;;7.0;4.0;1.0;2.0;160;4346;2532;1814;498;249;13.0
2236;Donderdag 26 oktober 2000;587;305;282;387;184;203;175;175;;;2.0;2.0;0.0;0.0;132;4676;2754;1922;615;164;831.0
2237;Vrijdag 27 oktober 2000;596;290;306;385;194;191;602;602;;;10.0;1.0;6.0;3.0;115;4817;2867;1950;405;239;14.0
2238;Zaterdag 28 oktober 2000;457;221;236;397;194;203;91;91;;;0.0;0.0;0.0;0.0;0;1758;1215;543;3;45;0.0
2239;Zondag 29 oktober 2000;511;254;257;361;184;177;2;2;;;0.0;0.0;0.0;0.0;2;251;153;98;3;39;2.0
2240;Maandag 30 oktober 2000;609;337;272;379;203;176;140;140;;;18.0;11.0;5.0;2.0;119;5957;3609;2348;547;281;146.0
2241;Dinsdag 31 oktober 2000;566;293;273;385;193;192;126;126;;;6.0;2.0;3.0;1.0;160;5341;3216;2125;584;299;17.0
2242;Totaal november 2000;16996;8680;8316;11372;5603;5769;4319;4319;;;239.0;127.0;64.0;48.0;3053;132448;81598;50850;11939;4598;4616.0
2243;Woensdag 1 november 2000;594;296;298;400;198;202;138;138;;;12.0;3.0;4.0;5.0;118;22145;14313;7832;532;594;19.0
2244;Donderdag 2 november 2000;597;319;278;357;161;196;155;155;;;6.0;3.0;2.0;1.0;99;5442;3206;2236;614;177;14.0
2245;Vrijdag 3 november 2000;572;305;267;383;189;194;400;400;;;8.0;2.0;3.0;3.0;109;4678;2696;1982;394;179;5.0
2246;Zaterdag 4 november 2000;493;261;232;395;203;192;65;65;;;0.0;0.0;0.0;0.0;0;940;646;294;2;47;0.0
2247;Zondag 5 november 2000;489;250;239;353;163;190;4;4;;;1.0;0.0;0.0;1.0;0;226;173;53;3;22;3.0
2248;Maandag 6 november 2000;562;288;274;370;180;190;140;140;;;15.0;10.0;4.0;1.0;136;5825;3475;2350;698;176;23.0
2249;Dinsdag 7 november 2000;633;320;313;403;202;201;113;113;;;16.0;9.0;4.0;3.0;144;4594;2652;1942;539;157;131.0
2250;Woensdag 8 november 2000;608;304;304;375;196;179;117;117;;;8.0;5.0;1.0;2.0;151;4037;2352;1685;583;123;12.0
2251;Donderdag 9 november 2000;572;289;283;349;170;179;152;152;;;5.0;3.0;1.0;1.0;130;4275;2466;1809;691;170;59.0
2252;Vrijdag 10 november 2000;569;301;268;352;177;175;456;456;;;12.0;2.0;5.0;5.0;150;4746;2870;1876;389;156;1567.0
2253;Zaterdag 11 november 2000;466;245;221;352;180;172;115;115;;;2.0;1.0;1.0;0.0;0;1450;1007;443;13;29;1.0
2254;Zondag 12 november 2000;428;223;205;371;189;182;4;4;;;0.0;0.0;0.0;0.0;10;248;148;100;2;18;2.0
2255;Maandag 13 november 2000;589;302;287;382;199;183;99;99;;;15.0;9.0;3.0;3.0;130;5337;3271;2066;589;179;167.0
2256;Dinsdag 14 november 2000;615;330;285;354;172;182;127;127;;;12.0;8.0;3.0;1.0;149;4299;2555;1744;571;155;463.0
2257;Woensdag 15 november 2000;611;304;307;362;178;184;109;109;;;14.0;9.0;3.0;2.0;153;7311;4679;2632;417;244;12.0
2258;Donderdag 16 november 2000;612;305;307;351;187;164;162;162;;;4.0;2.0;1.0;1.0;116;4873;2943;1930;560;145;15.0
2259;Vrijdag 17 november 2000;623;349;274;406;203;203;396;396;;;10.0;3.0;2.0;5.0;108;4647;2864;1783;404;212;408.0
2260;Zaterdag 18 november 2000;485;245;240;405;207;198;55;55;;;0.0;0.0;0.0;0.0;0;1314;921;393;2;40;1.0
2261;Zondag 19 november 2000;454;212;242;384;197;187;3;3;;;0.0;0.0;0.0;0.0;0;150;93;57;1;33;1.0
2262;Maandag 20 november 2000;587;325;262;382;188;194;156;156;;;18.0;12.0;4.0;2.0;128;5904;3700;2204;681;171;265.0
2263;Dinsdag 21 november 2000;633;311;322;372;170;202;133;133;;;12.0;5.0;3.0;4.0;161;4256;2552;1704;603;166;233.0
2264;Woensdag 22 november 2000;604;286;318;383;189;194;139;139;;;9.0;2.0;4.0;3.0;147;3841;2348;1493;518;158;281.0
2265;Donderdag 23 november 2000;574;270;304;378;183;195;156;156;;;8.0;6.0;2.0;0.0;134;4267;2614;1653;593;152;19.0
2266;Vrijdag 24 november 2000;624;320;304;411;177;234;400;400;;;8.0;4.0;3.0;1.0;142;4485;2640;1845;366;187;13.0
2267;Zaterdag 25 november 2000;479;249;230;404;203;201;51;51;;;2.0;0.0;2.0;0.0;2;2439;1696;743;5;54;0.0
2268;Zondag 26 november 2000;519;247;272;359;174;185;4;4;;;0.0;0.0;0.0;0.0;0;291;198;93;7;23;3.0
2269;Maandag 27 november 2000;587;298;289;362;166;196;117;117;;;14.0;10.0;4.0;0.0;141;5625;3467;2158;549;206;13.0
2270;Dinsdag 28 november 2000;579;298;281;399;202;197;119;119;;;11.0;8.0;2.0;1.0;158;4265;2601;1664;574;176;95.0
2271;Woensdag 29 november 2000;625;309;316;420;203;217;115;115;;;7.0;4.0;1.0;2.0;181;4236;2513;1723;438;183;306.0
2272;Donderdag 30 november 2000;613;319;294;398;197;201;119;119;;;10.0;7.0;2.0;1.0;156;6302;3939;2363;601;266;485.0
2273;Totaal december 2000;16693;8499;8194;12333;6037;6296;4758;4758;;;223.0;117.0;48.0;58.0;2455;127821;79848;47973;8339;4915;1878.0
2274;Vrijdag 1 december 2000;599;289;310;431;218;213;456;456;;;9.0;2.0;4.0;3.0;148;23415;15376;8039;359;528;9.0
2275;Zaterdag 2 december 2000;441;219;222;385;176;209;59;59;;;2.0;0.0;1.0;1.0;0;1010;686;324;6;46;0.0
2276;Zondag 3 december 2000;436;228;208;378;170;208;2;2;;;0.0;0.0;0.0;0.0;0;123;77;46;7;20;0.0
2277;Maandag 4 december 2000;556;272;284;371;180;191;136;136;;;18.0;13.0;3.0;2.0;136;5972;3614;2358;579;193;20.0
2278;Dinsdag 5 december 2000;551;273;278;403;196;207;97;97;;;10.0;6.0;2.0;2.0;114;4392;2569;1823;571;175;127.0
2279;Woensdag 6 december 2000;562;269;293;380;178;202;94;94;;;12.0;6.0;3.0;3.0;135;4269;2574;1695;446;145;154.0
2280;Donderdag 7 december 2000;562;309;253;365;187;178;143;143;;;3.0;2.0;1.0;0.0;144;4843;2943;1900;525;191;10.0
2281;Vrijdag 8 december 2000;570;289;281;392;194;198;348;348;;;8.0;2.0;5.0;1.0;149;4571;2897;1674;373;192;6.0
2282;Zaterdag 9 december 2000;453;239;214;341;171;170;59;59;;;1.0;0.0;0.0;1.0;1;1555;1143;412;3;29;0.0
2283;Zondag 10 december 2000;436;198;238;366;188;178;3;3;;;0.0;0.0;0.0;0.0;0;628;464;164;2;60;1.0
2284;Maandag 11 december 2000;584;303;281;405;205;200;159;159;;;13.0;7.0;3.0;3.0;129;5191;3200;1991;518;229;9.0
2285;Dinsdag 12 december 2000;648;336;312;380;178;202;218;218;;;12.0;8.0;3.0;1.0;155;4725;2757;1968;578;193;5.0
2286;Woensdag 13 december 2000;575;289;286;417;202;215;89;89;;;7.0;3.0;2.0;2.0;130;4121;2451;1670;458;158;308.0
2287;Donderdag 14 december 2000;558;289;269;390;202;188;207;207;;;10.0;6.0;2.0;2.0;184;4930;2960;1970;540;181;983.0
2288;Vrijdag 15 december 2000;617;298;319;378;187;191;494;494;;;14.0;6.0;3.0;5.0;142;9784;6316;3468;361;284;4.0
2289;Zaterdag 16 december 2000;462;233;229;389;184;205;87;87;;;0.0;0.0;0.0;0.0;0;2452;1764;688;6;55;0.0
2290;Zondag 17 december 2000;464;228;236;378;188;190;5;5;;;0.0;0.0;0.0;0.0;0;284;196;88;0;36;0.0
2291;Maandag 18 december 2000;593;303;290;392;190;202;196;196;;;22.0;15.0;2.0;5.0;143;6848;4315;2533;535;260;13.0
2292;Dinsdag 19 december 2000;598;310;288;377;177;200;167;167;;;19.0;8.0;4.0;7.0;131;4427;2646;1781;416;185;98.0
2293;Woensdag 20 december 2000;615;285;330;418;200;218;200;200;;;16.0;11.0;2.0;3.0;114;5414;3364;2050;437;236;72.0
2294;Donderdag 21 december 2000;619;315;304;417;224;193;320;320;;;16.0;7.0;3.0;6.0;140;5026;3016;2010;463;249;16.0
2295;Vrijdag 22 december 2000;598;308;290;438;224;214;552;552;;;7.0;2.0;2.0;3.0;123;5666;3403;2263;328;235;6.0
2296;Zaterdag 23 december 2000;446;234;212;378;193;185;76;76;;;0.0;0.0;0.0;0.0;0;1327;876;451;4;49;0.0
2297;Zondag 24 december 2000;456;252;204;435;204;231;6;6;;;0.0;0.0;0.0;0.0;0;245;172;73;3;23;1.0
2298;Maandag 25 december 2000;494;261;233;405;204;201;3;3;;;0.0;0.0;0.0;0.0;0;142;109;33;1;22;1.0
2299;Dinsdag 26 december 2000;440;237;203;408;203;205;9;9;;;0.0;0.0;0.0;0.0;0;51;32;19;0;34;3.0
2300;Woensdag 27 december 2000;547;272;275;450;217;233;127;127;;;9.0;4.0;2.0;3.0;97;4648;2845;1803;232;190;12.0
2301;Donderdag 28 december 2000;614;340;274;436;215;221;151;151;;;10.0;7.0;1.0;2.0;78;5017;2999;2018;275;227;7.0
2302;Vrijdag 29 december 2000;635;326;309;425;197;228;253;253;;;5.0;2.0;0.0;3.0;62;4756;2781;1975;305;180;12.0
2303;Zaterdag 30 december 2000;519;262;257;400;195;205;38;38;;;0.0;0.0;0.0;0.0;0;957;626;331;2;73;0.0
2304;Zondag 31 december 2000;445;233;212;405;190;215;4;4;;;0.0;0.0;0.0;0.0;0;1032;677;355;6;237;1.0
2305;Totaal op zondag in 2000;24641;12450;12191;19708;9686;10022;476;476;;;4.0;0.0;1.0;3.0;23;30413;20324;10089;310;2432;112.0
2306;Totaal op maandag in 2000;30190;15589;14601;20037;9919;10118;8286;8286;;;705.0;414.0;160.0;131.0;6411;322881;197332;125549;29430;12099;8224.0
2307;Totaal op dinsdag in 2000;32147;16442;15705;20254;9849;10405;8760;8760;;;614.0;336.0;144.0;134.0;7657;279274;167146;112128;29272;10884;10936.0
2308;Totaal op woensdag in 2000;31665;16163;15502;20080;9752;10328;10511;10511;;;567.0;268.0;146.0;153.0;7389;269610;162962;106648;26077;10321;6681.0
2309;Totaal op donderdag in 2000;31201;15955;15246;19902;9660;10242;13249;13249;;;380.0;172.0;90.0;118.0;7092;269393;162725;106668;28006;10548;10847.0
2310;Totaal op vrijdag in 2000;31180;15929;15251;20290;9972;10318;39020;39020;;;576.0;125.0;225.0;226.0;6049;293156;179460;113696;19332;11127;9204.0
2311;Totaal op zaterdag in 2000;25595;13109;12486;20256;9935;10321;7772;7772;;;76.0;7.0;49.0;20.0;29;121626;82307;39319;423;3790;3964.0
2312;Totaal 2001;202603;103806;98797;140377;68319;72058;82091;79677;1339.0;1075.0;3377.0;2847.0;285.0;245.0;37104;1562620;952457;610163;133404;63318;46667.0
2313;Totaal januari 2001;17344;8916;8428;13102;6179;6923;3480;3480;;;171.0;104.0;34.0;33.0;3401;137495;83856;53639;11772;5730;5029.0
2314;Maandag 1 januari 2001;429;225;204;445;200;245;20;20;;;0.0;0.0;0.0;0.0;0;11412;7228;4184;86;425;3.0
2315;Dinsdag 2 januari 2001;564;274;290;483;243;240;125;125;;;12.0;7.0;0.0;5.0;132;8458;5093;3365;605;340;27.0
2316;Woensdag 3 januari 2001;638;335;303;428;203;225;131;131;;;6.0;4.0;1.0;1.0;101;6318;3644;2674;569;353;26.0
2317;Donderdag 4 januari 2001;640;317;323;456;213;243;112;112;;;7.0;5.0;1.0;1.0;147;6707;3880;2827;630;322;1668.0
2318;Vrijdag 5 januari 2001;665;343;322;416;182;234;189;189;;;8.0;4.0;3.0;1.0;130;6452;3773;2679;395;243;15.0
2319;Zaterdag 6 januari 2001;476;249;227;415;200;215;50;50;;;0.0;0.0;0.0;0.0;1;946;654;292;5;39;1.0
2320;Zondag 7 januari 2001;487;252;235;408;195;213;9;9;;;0.0;0.0;0.0;0.0;2;253;167;86;8;40;5.0
2321;Maandag 8 januari 2001;585;290;295;421;189;232;167;167;;;12.0;8.0;0.0;4.0;161;6805;3947;2858;580;241;18.0
2322;Dinsdag 9 januari 2001;589;303;286;405;190;215;122;122;;;14.0;8.0;4.0;2.0;171;5086;2914;2172;535;282;28.0
2323;Woensdag 10 januari 2001;573;301;272;422;206;216;117;117;;;7.0;2.0;2.0;3.0;181;5053;3038;2015;521;181;17.0
2324;Donderdag 11 januari 2001;572;300;272;407;195;212;111;111;;;5.0;3.0;1.0;1.0;152;5061;2978;2083;546;204;13.0
2325;Vrijdag 12 januari 2001;630;321;309;409;212;197;249;249;;;8.0;1.0;4.0;3.0;149;4848;2999;1849;416;212;664.0
2326;Zaterdag 13 januari 2001;445;239;206;385;177;208;30;30;;;0.0;0.0;0.0;0.0;0;959;661;298;7;33;1.0
2327;Zondag 14 januari 2001;447;221;226;403;185;218;9;9;;;0.0;0.0;0.0;0.0;1;236;167;69;2;56;1.0
2328;Maandag 15 januari 2001;572;293;279;371;187;184;118;118;;;6.0;6.0;0.0;0.0;172;9299;6046;3253;567;279;17.0
2329;Dinsdag 16 januari 2001;603;317;286;430;208;222;97;97;;;13.0;10.0;3.0;0.0;206;4657;2768;1889;616;161;136.0
2330;Woensdag 17 januari 2001;582;268;314;449;223;226;102;102;;;2.0;2.0;0.0;0.0;169;4029;2454;1575;544;209;416.0
2331;Donderdag 18 januari 2001;587;301;286;416;189;227;114;114;;;3.0;0.0;1.0;2.0;176;4719;2863;1856;553;157;12.0
2332;Vrijdag 19 januari 2001;615;306;309;420;200;220;249;249;;;8.0;1.0;4.0;3.0;136;4282;2637;1645;374;160;14.0
2333;Zaterdag 20 januari 2001;476;247;229;395;194;201;204;204;;;2.0;0.0;1.0;1.0;2;1661;1187;474;9;45;880.0
2334;Zondag 21 januari 2001;438;233;205;426;218;208;17;17;;;0.0;0.0;0.0;0.0;0;207;138;69;7;23;1.0
2335;Maandag 22 januari 2001;558;291;267;464;225;239;147;147;;;9.0;7.0;1.0;1.0;169;5221;3196;2025;548;204;11.0
2336;Dinsdag 23 januari 2001;646;329;317;471;222;249;96;96;;;8.0;6.0;1.0;1.0;142;4151;2537;1614;552;165;17.0
2337;Woensdag 24 januari 2001;630;321;309;433;208;225;120;120;;;9.0;7.0;1.0;1.0;162;3983;2424;1559;512;205;22.0
2338;Donderdag 25 januari 2001;617;313;304;448;209;239;109;109;;;4.0;2.0;1.0;1.0;176;4945;3113;1832;541;208;287.0
2339;Vrijdag 26 januari 2001;605;318;287;412;189;223;258;258;;;5.0;2.0;2.0;1.0;135;4604;2844;1760;361;219;8.0
2340;Zaterdag 27 januari 2001;487;235;252;393;185;208;52;52;;;0.0;0.0;0.0;0.0;0;1509;1065;444;6;46;0.0
2341;Zondag 28 januari 2001;441;236;205;410;172;238;7;7;;;0.0;0.0;0.0;0.0;1;348;227;121;4;34;3.0
2342;Maandag 29 januari 2001;563;302;261;420;200;220;133;133;;;9.0;7.0;1.0;1.0;165;5235;3178;2057;658;203;541.0
2343;Dinsdag 30 januari 2001;584;328;256;434;176;258;111;111;;;10.0;8.0;2.0;0.0;140;4709;2854;1855;565;179;163.0
2344;Woensdag 31 januari 2001;600;308;292;407;184;223;105;105;;;4.0;4.0;0.0;0.0;122;5342;3182;2160;450;262;14.0
2345;Totaal februari 2001;15334;7896;7438;11115;5430;5685;3385;3385;;;163.0;94.0;34.0;35.0;2969;118126;73177;44949;10209;4342;4092.0
2346;Donderdag 1 februari 2001;568;296;272;393;198;195;158;158;;;5.0;1.0;2.0;2.0;119;20705;13275;7430;613;511;969.0
2347;Vrijdag 2 februari 2001;600;286;314;437;218;219;268;268;;;4.0;2.0;1.0;1.0;118;4849;3000;1849;355;159;9.0
2348;Zaterdag 3 februari 2001;525;275;250;409;210;199;68;68;;;0.0;0.0;0.0;0.0;1;771;531;240;5;56;0.0
2349;Zondag 4 februari 2001;460;230;230;428;208;220;11;11;;;0.0;0.0;0.0;0.0;1;163;94;69;1;29;1.0
2350;Maandag 5 februari 2001;578;321;257;399;199;200;123;123;;;4.0;4.0;0.0;0.0;127;5793;3548;2245;571;165;136.0
2351;Dinsdag 6 februari 2001;630;319;311;444;233;211;105;105;;;17.0;9.0;4.0;4.0;134;4461;2589;1872;594;191;550.0
2352;Woensdag 7 februari 2001;606;310;296;419;203;216;98;98;;;4.0;2.0;2.0;0.0;132;4525;2851;1674;530;134;24.0
2353;Donderdag 8 februari 2001;590;302;288;413;207;206;111;111;;;8.0;4.0;2.0;2.0;144;4556;2751;1805;543;151;20.0
2354;Vrijdag 9 februari 2001;581;295;286;419;198;221;222;222;;;7.0;4.0;1.0;2.0;143;4325;2698;1627;369;170;12.0
2355;Zaterdag 10 februari 2001;431;230;201;377;185;192;73;73;;;2.0;0.0;2.0;0.0;1;1294;919;375;2;31;1.0
2356;Zondag 11 februari 2001;420;213;207;390;189;201;10;10;;;0.0;0.0;0.0;0.0;0;108;75;33;4;34;0.0
2357;Maandag 12 februari 2001;566;309;257;426;199;227;118;118;;;13.0;10.0;0.0;3.0;183;5357;3288;2069;505;157;14.0
2358;Dinsdag 13 februari 2001;591;302;289;375;203;172;92;92;;;6.0;3.0;1.0;2.0;157;4068;2396;1672;564;180;28.0
2359;Woensdag 14 februari 2001;569;287;282;410;206;204;331;331;;;19.0;8.0;7.0;4.0;142;4088;2364;1724;520;269;17.0
2360;Donderdag 15 februari 2001;586;288;298;412;197;215;104;104;;;6.0;5.0;0.0;1.0;172;7037;4509;2528;537;260;14.0
2361;Vrijdag 16 februari 2001;588;313;275;384;189;195;273;273;;;6.0;2.0;2.0;2.0;156;4557;2783;1774;389;172;677.0
2362;Zaterdag 17 februari 2001;435;235;200;367;179;188;60;60;;;0.0;0.0;0.0;0.0;1;1216;835;381;5;34;0.0
2363;Zondag 18 februari 2001;426;228;198;387;186;201;7;7;;;0.0;0.0;0.0;0.0;0;178;123;55;0;32;1.0
2364;Maandag 19 februari 2001;576;292;284;371;165;206;108;108;;;9.0;8.0;1.0;0.0;183;5064;3128;1936;620;202;260.0
2365;Dinsdag 20 februari 2001;581;273;308;378;173;205;138;138;;;10.0;5.0;2.0;3.0;158;4396;2734;1662;554;142;11.0
2366;Woensdag 21 februari 2001;600;313;287;380;174;206;120;120;;;8.0;3.0;2.0;3.0;176;4005;2268;1737;507;139;286.0
2367;Donderdag 22 februari 2001;603;325;278;407;198;209;150;150;;;5.0;4.0;1.0;0.0;155;4891;2928;1963;527;174;12.0
2368;Vrijdag 23 februari 2001;578;304;274;407;204;203;240;240;;;7.0;2.0;2.0;3.0;151;4711;2822;1889;356;204;998.0
2369;Zaterdag 24 februari 2001;479;261;218;368;175;193;34;34;;;0.0;0.0;0.0;0.0;3;1825;1205;620;9;79;0.0
2370;Zondag 25 februari 2001;431;217;214;374;174;200;9;9;;;0.0;0.0;0.0;0.0;0;431;317;114;4;31;9.0
2371;Maandag 26 februari 2001;565;281;284;382;177;205;128;128;;;13.0;10.0;0.0;3.0;147;4947;3093;1854;482;168;20.0
2372;Dinsdag 27 februari 2001;566;283;283;383;196;187;118;118;;;5.0;5.0;0.0;0.0;123;3977;2394;1583;485;152;14.0
2373;Woensdag 28 februari 2001;605;308;297;376;187;189;108;108;;;5.0;3.0;2.0;0.0;142;5828;3659;2169;558;316;9.0
2374;Totaal maart 2001;16834;8702;8132;12572;6185;6387;4474;4474;;;171.0;112.0;32.0;27.0;3243;130072;81668;48404;10588;4777;4672.0
2375;Donderdag 1 maart 2001;561;309;252;380;189;191;153;153;;;6.0;5.0;0.0;1.0;120;21815;14106;7709;624;546;14.0
2376;Vrijdag 2 maart 2001;568;298;270;439;215;224;294;294;;;8.0;2.0;2.0;4.0;119;5245;3271;1974;416;189;8.0
2377;Zaterdag 3 maart 2001;472;249;223;414;209;205;62;62;;;1.0;0.0;1.0;0.0;1;893;651;242;7;29;2.0
2378;Zondag 4 maart 2001;466;225;241;375;189;186;9;9;;;0.0;0.0;0.0;0.0;0;123;84;39;3;23;5.0
2379;Maandag 5 maart 2001;543;269;274;388;174;214;133;133;;;10.0;7.0;2.0;1.0;116;6463;3984;2479;554;237;17.0
2380;Dinsdag 6 maart 2001;573;314;259;418;200;218;130;130;;;8.0;7.0;0.0;1.0;156;4421;2610;1811;541;150;1050.0
2381;Woensdag 7 maart 2001;599;310;289;442;220;222;107;107;;;6.0;5.0;1.0;0.0;154;4427;2678;1749;513;146;8.0
2382;Donderdag 8 maart 2001;614;306;308;392;190;202;124;124;;;15.0;10.0;0.0;5.0;143;4762;2842;1920;506;155;417.0
2383;Vrijdag 9 maart 2001;578;302;276;436;218;218;284;284;;;8.0;4.0;1.0;3.0;137;4411;2733;1678;329;161;17.0
2384;Zaterdag 10 maart 2001;479;245;234;404;201;203;57;57;;;0.0;0.0;0.0;0.0;1;1417;1012;405;0;44;1.0
2385;Zondag 11 maart 2001;447;204;243;416;185;231;9;9;;;0.0;0.0;0.0;0.0;1;136;91;45;7;29;7.0
2386;Maandag 12 maart 2001;586;304;282;404;200;204;174;174;;;16.0;12.0;4.0;0.0;166;5470;3391;2079;425;201;528.0
2387;Dinsdag 13 maart 2001;580;289;291;417;201;216;93;93;;;7.0;5.0;2.0;0.0;189;4054;2346;1708;552;115;66.0
2388;Woensdag 14 maart 2001;581;323;258;389;190;199;112;112;;;3.0;3.0;0.0;0.0;152;3856;2327;1529;503;157;5.0
2389;Donderdag 15 maart 2001;567;287;280;373;186;187;141;141;;;4.0;4.0;0.0;0.0;135;7042;4563;2479;573;224;300.0
2390;Vrijdag 16 maart 2001;569;295;274;419;211;208;327;327;;;2.0;0.0;1.0;1.0;150;4616;2918;1698;342;154;21.0
2391;Zaterdag 17 maart 2001;462;256;206;406;200;206;53;53;;;3.0;1.0;2.0;0.0;0;1014;700;314;1;51;8.0
2392;Zondag 18 maart 2001;461;264;197;404;193;211;10;10;;;0.0;0.0;0.0;0.0;0;158;97;61;4;30;7.0
2393;Maandag 19 maart 2001;577;295;282;418;206;212;128;128;;;14.0;7.0;2.0;5.0;139;5086;3228;1858;564;188;851.0
2394;Dinsdag 20 maart 2001;574;309;265;395;198;197;142;142;;;12.0;5.0;5.0;2.0;161;4252;2658;1594;584;192;21.0
2395;Woensdag 21 maart 2001;598;282;316;420;184;236;213;213;;;10.0;6.0;1.0;3.0;154;3850;2384;1466;418;160;363.0
2396;Donderdag 22 maart 2001;617;293;324;419;210;209;159;159;;;7.0;7.0;0.0;0.0;118;4131;2497;1634;511;160;16.0
2397;Vrijdag 23 maart 2001;578;312;266;402;198;204;413;413;;;2.0;0.0;2.0;0.0;160;4315;2699;1616;331;172;14.0
2398;Zaterdag 24 maart 2001;434;219;215;413;213;200;65;65;;;0.0;0.0;0.0;0.0;0;1554;1087;467;3;51;5.0
2399;Zondag 25 maart 2001;431;226;205;370;186;184;7;7;;;0.0;0.0;0.0;0.0;0;383;258;125;5;51;2.0
2400;Maandag 26 maart 2001;559;300;259;413;212;201;138;138;;;8.0;7.0;1.0;0.0;138;5143;3284;1859;527;253;753.0
2401;Dinsdag 27 maart 2001;566;301;265;372;178;194;115;115;;;9.0;8.0;1.0;0.0;169;4150;2579;1571;556;186;36.0
2402;Woensdag 28 maart 2001;611;303;308;415;216;199;128;128;;;4.0;4.0;0.0;0.0;148;3999;2457;1542;437;188;108.0
2403;Donderdag 29 maart 2001;550;267;283;445;231;214;151;151;;;5.0;2.0;3.0;0.0;179;4693;2931;1762;486;216;14.0
2404;Vrijdag 30 maart 2001;574;301;273;387;195;192;465;465;;;3.0;1.0;1.0;1.0;137;6068;3724;2344;261;222;6.0
2405;Zaterdag 31 maart 2001;459;245;214;387;187;200;78;78;;;0.0;0.0;0.0;0.0;0;2125;1478;647;5;97;2.0
2406;Totaal april 2001;15679;7949;7730;11557;5747;5810;5860;5466;232.0;162.0;147.0;103.0;26.0;18.0;2849;110414;69052;41362;9724;4426;4008.0
2407;Zondag 1 april 2001;427;211;216;355;181;174;18;10;4.0;4.0;1.0;0.0;1.0;0.0;1;12666;8649;4017;29;359;2.0
2408;Maandag 2 april 2001;527;272;255;421;221;200;196;167;21.0;8.0;12.0;9.0;2.0;1.0;151;8613;5378;3235;583;265;785.0
2409;Dinsdag 3 april 2001;614;309;305;401;201;200;123;116;6.0;1.0;4.0;4.0;0.0;0.0;167;4743;2802;1941;561;192;20.0
2410;Woensdag 4 april 2001;581;280;301;394;200;194;155;145;9.0;1.0;10.0;6.0;2.0;2.0;138;4347;2611;1736;534;265;11.0
2411;Donderdag 5 april 2001;566;284;282;420;193;227;182;158;16.0;8.0;6.0;5.0;1.0;0.0;151;4791;2936;1855;640;168;15.0
2412;Vrijdag 6 april 2001;524;262;262;380;198;182;522;502;12.0;8.0;9.0;3.0;2.0;4.0;121;4358;2652;1706;338;171;221.0
2413;Zaterdag 7 april 2001;473;240;233;388;185;203;98;98;0.0;0.0;0.0;0.0;0.0;0.0;2;1093;826;267;11;42;3.0
2414;Zondag 8 april 2001;457;241;216;390;185;205;8;8;0.0;0.0;0.0;0.0;0.0;0.0;0;232;152;80;6;40;13.0
2415;Maandag 9 april 2001;582;313;269;401;197;204;161;147;9.0;5.0;12.0;6.0;3.0;3.0;135;5126;3209;1917;688;250;157.0
2416;Dinsdag 10 april 2001;589;306;283;427;206;221;153;135;12.0;6.0;8.0;4.0;3.0;1.0;149;4229;2678;1551;620;171;477.0
2417;Woensdag 11 april 2001;479;241;238;404;202;202;159;142;7.0;10.0;5.0;3.0;1.0;1.0;155;3535;2230;1305;494;173;18.0
2418;Donderdag 12 april 2001;479;225;254;366;182;184;305;280;13.0;12.0;8.0;6.0;2.0;0.0;176;4605;2883;1722;576;172;318.0
2419;Vrijdag 13 april 2001;424;219;205;385;186;199;75;66;1.0;8.0;0.0;0.0;0.0;0.0;22;1243;794;449;56;58;9.0
2420;Zaterdag 14 april 2001;354;180;174;368;180;188;63;63;0.0;0.0;1.0;0.0;1.0;0.0;1;956;588;368;1;20;3.0
2421;Zondag 15 april 2001;348;177;171;401;202;199;5;5;0.0;0.0;0.0;0.0;0.0;0.0;0;1183;726;457;3;50;4.0
2422;Maandag 16 april 2001;422;205;217;362;184;178;17;17;0.0;0.0;0.0;0.0;0.0;0.0;2;508;341;167;2;29;2.0
2423;Dinsdag 17 april 2001;544;288;256;381;195;186;173;151;9.0;13.0;6.0;6.0;0.0;0.0;170;5431;2901;2530;661;191;11.0
2424;Woensdag 18 april 2001;610;317;293;391;185;206;183;165;12.0;6.0;16.0;13.0;2.0;1.0;183;4326;2607;1719;537;185;25.0
2425;Donderdag 19 april 2001;663;359;304;361;172;189;251;230;10.0;11.0;5.0;4.0;1.0;0.0;162;4671;2772;1899;559;158;174.0
2426;Vrijdag 20 april 2001;575;292;283;360;178;182;835;807;20.0;8.0;3.0;1.0;0.0;2.0;147;5105;3159;1946;376;180;910.0
2427;Zaterdag 21 april 2001;481;249;232;375;189;186;139;137;1.0;1.0;0.0;0.0;0.0;0.0;0;1390;977;413;4;58;10.0
2428;Zondag 22 april 2001;456;229;227;360;181;179;11;11;0.0;0.0;0.0;0.0;0.0;0.0;1;188;132;56;2;33;8.0
2429;Maandag 23 april 2001;571;289;282;410;214;196;185;161;15.0;9.0;17.0;14.0;1.0;2.0;141;5340;3325;2015;521;217;14.0
2430;Dinsdag 24 april 2001;639;311;328;403;210;193;183;164;12.0;7.0;8.0;6.0;2.0;0.0;139;4093;2504;1589;539;182;18.0
2431;Woensdag 25 april 2001;647;318;329;366;186;180;215;190;17.0;8.0;6.0;6.0;0.0;0.0;182;4203;2588;1615;466;160;734.0
2432;Donderdag 26 april 2001;649;338;311;384;176;208;337;314;10.0;13.0;8.0;6.0;2.0;0.0;176;4753;2911;1842;517;202;21.0
2433;Vrijdag 27 april 2001;578;255;323;377;193;184;913;884;14.0;15.0;2.0;1.0;0.0;1.0;174;5630;3546;2084;382;225;21.0
2434;Zaterdag 28 april 2001;471;242;229;367;192;175;154;152;2.0;0.0;0.0;0.0;0.0;0.0;0;1646;1136;510;9;57;2.0
2435;Zondag 29 april 2001;445;241;204;405;203;202;14;14;0.0;0.0;0.0;0.0;0.0;0.0;0;280;183;97;7;24;2.0
2436;Maandag 30 april 2001;504;256;248;354;170;184;27;27;0.0;0.0;0.0;0.0;0.0;0.0;3;1130;856;274;2;129;0.0
2437;Totaal mei 2001;17537;9034;8503;12059;5948;6111;9981;9572;226.0;183.0;192.0;147.0;25.0;20.0;3296;128214;80843;47371;10669;4392;4137.0
2438;Dinsdag 1 mei 2001;629;308;321;378;194;184;195;173;11.0;11.0;7.0;6.0;0.0;1.0;133;20610;13607;7003;536;505;17.0
2439;Woensdag 2 mei 2001;635;323;312;395;179;216;199;179;15.0;5.0;10.0;8.0;1.0;1.0;161;5891;3562;2329;692;176;848.0
2440;Donderdag 3 mei 2001;653;353;300;412;197;215;266;256;5.0;5.0;5.0;4.0;0.0;1.0;165;5658;3383;2275;564;181;503.0
2441;Vrijdag 4 mei 2001;609;315;294;386;196;190;172;157;10.0;5.0;3.0;3.0;0.0;0.0;141;4950;2946;2004;348;159;18.0
2442;Zaterdag 5 mei 2001;471;235;236;365;189;176;89;89;0.0;0.0;0.0;0.0;0.0;0.0;1;980;707;273;5;37;0.0
2443;Zondag 6 mei 2001;422;213;209;395;191;204;10;10;0.0;0.0;0.0;0.0;0.0;0.0;0;215;141;74;4;26;3.0
2444;Maandag 7 mei 2001;604;296;308;389;195;194;210;194;12.0;4.0;15.0;9.0;1.0;5.0;124;5821;3589;2232;548;169;468.0
2445;Dinsdag 8 mei 2001;627;326;301;361;182;179;191;178;5.0;8.0;15.0;13.0;2.0;0.0;134;4558;2811;1747;532;112;24.0
2446;Woensdag 9 mei 2001;669;353;316;388;186;202;186;171;10.0;5.0;9.0;8.0;1.0;0.0;133;4093;2472;1621;552;128;16.0
2447;Donderdag 10 mei 2001;594;309;285;395;207;188;365;351;8.0;6.0;6.0;4.0;0.0;2.0;194;4704;2858;1846;564;144;6.0
2448;Vrijdag 11 mei 2001;614;315;299;415;203;212;1224;1197;14.0;13.0;4.0;2.0;0.0;2.0;146;4065;2462;1603;358;142;9.0
2449;Zaterdag 12 mei 2001;502;245;257;407;205;202;267;261;6.0;0.0;0.0;0.0;0.0;0.0;0;1249;880;369;1;40;1.0
2450;Zondag 13 mei 2001;492;241;251;384;192;192;12;12;0.0;0.0;0.0;0.0;0.0;0.0;0;109;74;35;2;17;0.0
2451;Maandag 14 mei 2001;580;304;276;423;212;211;192;174;13.0;5.0;12.0;10.0;0.0;2.0;169;5037;3102;1935;487;144;174.0
2452;Dinsdag 15 mei 2001;625;321;304;390;193;197;165;152;7.0;6.0;6.0;4.0;1.0;1.0;205;6426;4201;2225;578;220;25.0
2453;Woensdag 16 mei 2001;605;312;293;382;174;208;230;216;7.0;7.0;15.0;12.0;1.0;2.0;186;3892;2312;1580;474;125;233.0
2454;Donderdag 17 mei 2001;590;298;292;398;199;199;407;389;10.0;8.0;6.0;4.0;2.0;0.0;161;4634;2927;1707;495;130;169.0
2455;Vrijdag 18 mei 2001;598;299;299;406;202;204;1420;1391;11.0;18.0;5.0;3.0;2.0;0.0;120;4316;2639;1677;348;137;752.0
2456;Zaterdag 19 mei 2001;433;239;194;371;185;186;260;259;1.0;0.0;0.0;0.0;0.0;0.0;2;1019;729;290;2;32;1.0
2457;Zondag 20 mei 2001;448;220;228;389;193;196;7;6;1.0;0.0;0.0;0.0;0.0;0.0;0;521;398;123;7;31;0.0
2458;Maandag 21 mei 2001;589;310;279;398;204;194;251;228;9.0;14.0;11.0;11.0;0.0;0.0;157;5109;3326;1783;525;254;20.0
2459;Dinsdag 22 mei 2001;655;347;308;395;194;201;254;242;6.0;6.0;9.0;5.0;4.0;0.0;172;4173;2586;1587;459;168;23.0
2460;Woensdag 23 mei 2001;607;326;281;382;195;187;1141;1112;18.0;11.0;10.0;8.0;2.0;0.0;155;4281;2651;1630;438;192;16.0
2461;Donderdag 24 mei 2001;518;265;253;401;199;202;16;16;0.0;0.0;0.0;0.0;0.0;0.0;7;452;309;143;3;34;2.0
2462;Vrijdag 25 mei 2001;503;267;236;401;189;212;889;875;7.0;7.0;6.0;4.0;2.0;0.0;40;2120;1455;665;77;47;7.0
2463;Zaterdag 26 mei 2001;469;238;231;350;170;180;237;234;2.0;1.0;0.0;0.0;0.0;0.0;1;1186;814;372;7;27;0.0
2464;Zondag 27 mei 2001;417;225;192;347;166;181;8;8;0.0;0.0;0.0;0.0;0.0;0.0;0;157;112;45;2;23;0.0
2465;Maandag 28 mei 2001;583;316;267;396;188;208;251;228;15.0;8.0;9.0;7.0;1.0;1.0;161;6405;4032;2373;492;232;518.0
2466;Dinsdag 29 mei 2001;593;305;288;377;179;198;165;154;5.0;6.0;10.0;8.0;2.0;0.0;139;4616;2830;1786;556;231;254.0
2467;Woensdag 30 mei 2001;617;331;286;377;178;199;249;239;5.0;5.0;7.0;4.0;1.0;2.0;151;4698;2921;1777;479;234;16.0
2468;Donderdag 31 mei 2001;586;279;307;406;212;194;453;421;13.0;19.0;12.0;10.0;2.0;0.0;138;6269;4007;2262;534;295;14.0
2469;Totaal juni 2001;17050;8682;8368;11420;5576;5844;11688;11359;174.0;155.0;159.0;127.0;18.0;14.0;3121;127752;79605;48147;10096;5129;2667.0
2470;Vrijdag 1 juni 2001;623;323;300;408;195;213;1555;1523;17.0;15.0;5.0;4.0;0.0;1.0;115;21601;14112;7489;429;524;101.0
2471;Zaterdag 2 juni 2001;430;211;219;396;199;197;234;231;2.0;1.0;0.0;0.0;0.0;0.0;0;741;525;216;5;40;1.0
2472;Zondag 3 juni 2001;481;239;242;362;177;185;10;10;0.0;0.0;0.0;0.0;0.0;0.0;0;92;54;38;3;26;1.0
2473;Maandag 4 juni 2001;456;248;208;337;165;172;17;17;0.0;0.0;0.0;0.0;0.0;0.0;4;300;190;110;2;36;6.0
2474;Dinsdag 5 juni 2001;610;307;303;341;169;172;199;190;5.0;4.0;14.0;9.0;2.0;3.0;123;5919;3697;2222;728;222;19.0
2475;Woensdag 6 juni 2001;665;343;322;411;214;197;257;244;5.0;8.0;8.0;7.0;1.0;0.0;166;5396;3159;2237;584;178;17.0
2476;Donderdag 7 juni 2001;614;292;322;340;168;172;360;351;2.0;7.0;1.0;0.0;1.0;0.0;176;5472;3312;2160;598;233;11.0
2477;Vrijdag 8 juni 2001;582;288;294;390;174;216;1271;1249;9.0;13.0;1.0;1.0;0.0;0.0;153;4754;2991;1763;325;233;15.0
2478;Zaterdag 9 juni 2001;482;249;233;327;161;166;230;224;4.0;2.0;0.0;0.0;0.0;0.0;0;932;626;306;1;36;0.0
2479;Zondag 10 juni 2001;450;235;215;435;208;227;7;7;0.0;0.0;0.0;0.0;0.0;0.0;1;443;296;147;3;42;0.0
2480;Maandag 11 juni 2001;594;294;300;411;194;217;222;210;8.0;4.0;17.0;14.0;3.0;0.0;157;5447;3317;2130;595;239;649.0
2481;Dinsdag 12 juni 2001;604;297;307;399;187;212;189;175;6.0;8.0;10.0;7.0;1.0;2.0;156;4239;2560;1679;486;169;447.0
2482;Woensdag 13 juni 2001;639;310;329;360;173;187;151;141;6.0;4.0;3.0;2.0;0.0;1.0;172;4021;2437;1584;492;135;12.0
2483;Donderdag 14 juni 2001;627;335;292;371;174;197;375;365;7.0;3.0;5.0;4.0;0.0;1.0;168;4772;2894;1878;511;178;15.0
2484;Vrijdag 15 juni 2001;650;348;302;390;181;209;1254;1230;12.0;12.0;3.0;1.0;1.0;1.0;151;7098;4618;2480;294;242;9.0
2485;Zaterdag 16 juni 2001;504;242;262;441;206;235;250;245;2.0;3.0;0.0;0.0;0.0;0.0;1;1325;910;415;4;65;0.0
2486;Zondag 17 juni 2001;482;259;223;349;166;183;9;9;0.0;0.0;0.0;0.0;0.0;0.0;0;190;111;79;7;26;2.0
2487;Maandag 18 juni 2001;578;276;302;357;180;177;190;177;5.0;8.0;13.0;11.0;2.0;0.0;150;5664;3454;2210;529;187;28.0
2488;Dinsdag 19 juni 2001;575;285;290;379;173;206;162;152;7.0;3.0;6.0;6.0;0.0;0.0;168;4045;2399;1646;576;155;26.0
2489;Woensdag 20 juni 2001;613;317;296;382;196;186;221;210;3.0;8.0;5.0;5.0;0.0;0.0;135;4544;2773;1771;423;206;767.0
2490;Donderdag 21 juni 2001;607;315;292;371;191;180;574;552;10.0;12.0;15.0;13.0;1.0;1.0;157;4611;2886;1725;537;167;280.0
2491;Vrijdag 22 juni 2001;565;306;259;360;192;168;1313;1291;13.0;9.0;6.0;5.0;0.0;1.0;143;4628;2885;1743;331;202;16.0
2492;Zaterdag 23 juni 2001;469;241;228;355;172;183;230;230;0.0;0.0;1.0;1.0;0.0;0.0;1;1766;1193;573;1;37;0.0
2493;Zondag 24 juni 2001;485;240;245;381;179;202;12;12;0.0;0.0;0.0;0.0;0.0;0.0;1;195;133;62;5;49;0.0
2494;Maandag 25 juni 2001;644;306;338;397;206;191;214;202;7.0;5.0;12.0;8.0;3.0;1.0;176;5871;3637;2234;536;221;30.0
2495;Dinsdag 26 juni 2001;656;340;316;403;201;202;169;149;14.0;6.0;9.0;7.0;2.0;0.0;167;4331;2602;1729;581;219;153.0
2496;Woensdag 27 juni 2001;683;376;307;376;189;187;177;165;9.0;3.0;9.0;9.0;0.0;0.0;157;4193;2447;1746;474;270;26.0
2497;Donderdag 28 juni 2001;604;294;310;394;199;195;387;377;4.0;6.0;4.0;4.0;0.0;0.0;158;5736;3411;2325;610;294;19.0
2498;Vrijdag 29 juni 2001;628;329;299;424;220;204;1205;1186;9.0;10.0;11.0;8.0;1.0;2.0;164;6785;4226;2559;421;348;17.0
2499;Zaterdag 30 juni 2001;450;237;213;373;167;206;244;235;8.0;1.0;1.0;1.0;0.0;0.0;1;2641;1750;891;5;150;0.0
2500;Totaal juli 2001;17942;9183;8759;11185;5383;5802;7602;7366;136.0;100.0;201.0;174.0;13.0;14.0;3194;141155;83625;57530;12166;7042;4854.0
2501;Zondag 1 juli 2001;465;242;223;316;144;172;16;16;0.0;0.0;0.0;0.0;0.0;0.0;2;14518;9474;5044;42;497;3.0
2502;Maandag 2 juli 2001;567;273;294;365;174;191;194;180;8.0;6.0;15.0;13.0;2.0;0.0;148;9417;5622;3795;592;427;1400.0
2503;Dinsdag 3 juli 2001;642;348;294;361;181;180;170;157;7.0;6.0;17.0;15.0;0.0;2.0;210;5577;3152;2425;711;257;15.0
2504;Woensdag 4 juli 2001;628;328;300;378;191;187;208;198;6.0;4.0;9.0;9.0;0.0;0.0;145;4936;2835;2101;519;332;416.0
2505;Donderdag 5 juli 2001;673;348;325;421;203;218;312;298;9.0;5.0;7.0;6.0;1.0;0.0;156;5534;3141;2393;610;281;896.0
2506;Vrijdag 6 juli 2001;628;315;313;446;214;232;1105;1093;3.0;9.0;4.0;4.0;0.0;0.0;162;4975;2883;2092;403;256;10.0
2507;Zaterdag 7 juli 2001;533;274;259;435;198;237;245;244;1.0;0.0;1.0;0.0;0.0;1.0;0;1330;925;405;4;74;0.0
2508;Zondag 8 juli 2001;470;241;229;345;174;171;8;8;0.0;0.0;0.0;0.0;0.0;0.0;0;199;134;65;8;73;1.0
2509;Maandag 9 juli 2001;570;314;256;362;177;185;186;177;5.0;4.0;13.0;12.0;1.0;0.0;145;6167;3509;2658;616;303;24.0
2510;Dinsdag 10 juli 2001;615;317;298;352;158;194;198;188;6.0;4.0;13.0;11.0;0.0;2.0;150;5346;3006;2340;732;265;29.0
2511;Woensdag 11 juli 2001;595;303;292;377;190;187;169;162;5.0;2.0;11.0;9.0;0.0;2.0;157;4554;2649;1905;564;282;13.0
2512;Donderdag 12 juli 2001;607;312;295;340;170;170;311;298;10.0;3.0;9.0;9.0;0.0;0.0;134;5234;3035;2199;566;214;15.0
2513;Vrijdag 13 juli 2001;541;273;268;341;169;172;605;593;9.0;3.0;2.0;2.0;0.0;0.0;135;5083;2983;2100;364;273;11.0
2514;Zaterdag 14 juli 2001;456;214;242;362;159;203;199;194;5.0;0.0;0.0;0.0;0.0;0.0;4;1534;1053;481;7;88;0.0
2515;Zondag 15 juli 2001;438;233;205;341;147;194;17;17;0.0;0.0;0.0;0.0;0.0;0.0;0;2084;1474;610;6;156;1.0
2516;Maandag 16 juli 2001;583;288;295;346;159;187;225;211;6.0;8.0;11.0;9.0;1.0;1.0;159;7846;4709;3137;725;348;300.0
2517;Dinsdag 17 juli 2001;676;350;326;353;169;184;207;193;7.0;7.0;11.0;9.0;1.0;1.0;148;4749;2817;1932;604;217;21.0
2518;Woensdag 18 juli 2001;619;302;317;392;177;215;232;221;5.0;6.0;10.0;9.0;1.0;0.0;137;4244;2373;1871;523;245;12.0
2519;Donderdag 19 juli 2001;622;338;284;334;164;170;299;293;3.0;3.0;3.0;3.0;0.0;0.0;138;4604;2698;1906;529;180;6.0
2520;Vrijdag 20 juli 2001;625;324;301;346;163;183;692;681;5.0;6.0;5.0;3.0;1.0;1.0;96;5141;2987;2154;390;162;9.0
2521;Zaterdag 21 juli 2001;511;254;257;297;157;140;120;120;0.0;0.0;0.0;0.0;0.0;0.0;1;1160;745;415;6;46;0.0
2522;Zondag 22 juli 2001;470;220;250;337;140;197;15;15;0.0;0.0;0.0;0.0;0.0;0.0;0;228;149;79;6;35;4.0
2523;Maandag 23 juli 2001;645;357;288;352;189;163;229;223;6.0;0.0;11.0;8.0;2.0;1.0;149;5913;3478;2435;611;253;1594.0
2524;Dinsdag 24 juli 2001;589;292;297;391;197;194;193;182;9.0;2.0;8.0;6.0;2.0;0.0;123;4424;2604;1820;556;199;10.0
2525;Woensdag 25 juli 2001;625;305;320;356;174;182;212;208;1.0;3.0;12.0;11.0;1.0;0.0;128;4545;2596;1949;414;257;13.0
2526;Donderdag 26 juli 2001;654;333;321;349;164;185;227;216;7.0;4.0;7.0;5.0;0.0;2.0;173;4555;2549;2006;540;218;13.0
2527;Vrijdag 27 juli 2001;646;323;323;336;165;171;478;470;3.0;5.0;5.0;4.0;0.0;1.0;135;4591;2674;1917;312;237;8.0
2528;Zaterdag 28 juli 2001;523;257;266;382;175;207;114;114;0.0;0.0;1.0;1.0;0.0;0.0;0;1317;773;544;3;82;0.0
2529;Zondag 29 juli 2001;478;246;232;353;167;186;25;25;0.0;0.0;0.0;0.0;0.0;0.0;0;256;155;101;3;54;2.0
2530;Maandag 30 juli 2001;604;315;289;369;203;166;191;182;4.0;5.0;9.0;9.0;0.0;0.0;138;5616;3245;2371;594;358;12.0
2531;Dinsdag 31 juli 2001;644;344;300;350;171;179;200;189;6.0;5.0;7.0;7.0;0.0;0.0;121;5478;3198;2280;606;373;16.0
2532;Totaal augustus 2001;17726;9055;8671;11113;5336;5777;10402;10119;151.0;132.0;270.0;240.0;12.0;18.0;3023;143876;80626;63250;14633;6923;3774.0
2533;Woensdag 1 augustus 2001;615;304;311;332;171;161;310;289;13.0;8.0;9.0;7.0;1.0;1.0;115;23458;13874;9584;622;839;2.0
2534;Donderdag 2 augustus 2001;602;306;296;362;190;172;214;209;2.0;3.0;8.0;6.0;2.0;0.0;110;5505;2973;2532;624;241;6.0
2535;Vrijdag 3 augustus 2001;631;326;305;353;188;165;572;560;7.0;5.0;2.0;2.0;0.0;0.0;111;5180;2833;2347;392;195;9.0
2536;Zaterdag 4 augustus 2001;472;237;235;332;174;158;135;134;1.0;0.0;0.0;0.0;0.0;0.0;1;802;489;313;7;61;1429.0
2537;Zondag 5 augustus 2001;453;238;215;340;158;182;19;19;0.0;0.0;0.0;0.0;0.0;0.0;0;249;174;75;0;42;0.0
2538;Maandag 6 augustus 2001;538;268;270;374;185;189;240;231;5.0;4.0;15.0;13.0;1.0;1.0;120;6165;3495;2670;808;266;249.0
2539;Dinsdag 7 augustus 2001;617;319;298;375;176;199;223;214;4.0;5.0;11.0;10.0;0.0;1.0;112;5015;2804;2211;669;191;15.0
2540;Woensdag 8 augustus 2001;640;317;323;344;162;182;274;262;8.0;4.0;8.0;7.0;1.0;0.0;143;4449;2414;2035;600;213;12.0
2541;Donderdag 9 augustus 2001;596;323;273;355;153;202;229;220;3.0;6.0;8.0;6.0;0.0;2.0;151;4397;2466;1931;653;215;11.0
2542;Vrijdag 10 augustus 2001;571;273;298;335;168;167;680;669;7.0;4.0;6.0;3.0;1.0;2.0;109;5280;3017;2263;452;241;9.0
2543;Zaterdag 11 augustus 2001;521;272;249;358;175;183;131;130;1.0;0.0;0.0;0.0;0.0;0.0;3;980;642;338;2;44;0.0
2544;Zondag 12 augustus 2001;435;231;204;309;141;168;21;21;0.0;0.0;0.0;0.0;0.0;0.0;1;194;102;92;0;54;1.0
2545;Maandag 13 augustus 2001;578;306;272;336;161;175;188;182;3.0;3.0;13.0;12.0;1.0;0.0;133;5936;3196;2740;723;295;11.0
2546;Dinsdag 14 augustus 2001;619;312;307;349;179;170;222;220;0.0;2.0;10.0;10.0;0.0;0.0;147;4549;2500;2049;727;217;782.0
2547;Woensdag 15 augustus 2001;610;293;317;382;190;192;247;232;6.0;9.0;11.0;10.0;0.0;1.0;130;7490;4234;3256;574;335;11.0
2548;Donderdag 16 augustus 2001;688;355;333;363;175;188;307;305;2.0;0.0;6.0;4.0;0.0;2.0;138;5222;2762;2460;638;261;9.0
2549;Vrijdag 17 augustus 2001;584;302;282;375;177;198;918;895;10.0;13.0;6.0;6.0;0.0;0.0;145;4799;2608;2191;542;224;9.0
2550;Zaterdag 18 augustus 2001;486;253;233;369;174;195;225;223;2.0;0.0;0.0;0.0;0.0;0.0;1;1061;702;359;4;61;2.0
2551;Zondag 19 augustus 2001;492;233;259;337;151;186;17;17;0.0;0.0;0.0;0.0;0.0;0.0;2;163;80;83;3;33;2.0
2552;Maandag 20 augustus 2001;546;276;270;371;146;225;207;196;8.0;3.0;13.0;11.0;1.0;1.0;116;6545;3610;2935;733;290;74.0
2553;Dinsdag 21 augustus 2001;563;303;260;327;156;171;182;173;4.0;5.0;15.0;15.0;0.0;0.0;148;4549;2428;2121;716;192;20.0
2554;Woensdag 22 augustus 2001;665;334;331;388;198;190;252;245;6.0;1.0;18.0;18.0;0.0;0.0;123;4131;2255;1876;682;225;656.0
2555;Donderdag 23 augustus 2001;645;326;319;368;193;175;365;353;6.0;6.0;17.0;17.0;0.0;0.0;123;4314;2235;2079;679;187;18.0
2556;Vrijdag 24 augustus 2001;659;351;308;393;171;222;1310;1282;12.0;16.0;8.0;7.0;0.0;1.0;101;4429;2424;2005;480;245;9.0
2557;Zaterdag 25 augustus 2001;485;227;258;392;179;213;297;289;6.0;2.0;0.0;0.0;0.0;0.0;1;1628;1125;503;8;96;0.0
2558;Zondag 26 augustus 2001;457;236;221;409;184;225;13;13;0.0;0.0;0.0;0.0;0.0;0.0;0;236;135;101;3;56;2.0
2559;Maandag 27 augustus 2001;571;288;283;342;151;191;235;223;4.0;8.0;23.0;20.0;3.0;0.0;122;5480;2958;2522;768;324;289.0
2560;Dinsdag 28 augustus 2001;591;295;296;367;179;188;190;184;4.0;2.0;18.0;16.0;0.0;2.0;142;4621;2478;2143;686;257;24.0
2561;Woensdag 29 augustus 2001;624;333;291;367;177;190;229;219;4.0;6.0;14.0;11.0;1.0;2.0;156;4413;2357;2056;649;243;17.0
2562;Donderdag 30 augustus 2001;587;304;283;352;180;172;478;462;7.0;9.0;23.0;21.0;0.0;2.0;162;5799;3290;2509;661;337;19.0
2563;Vrijdag 31 augustus 2001;585;314;271;357;174;183;1472;1448;16.0;8.0;8.0;8.0;0.0;0.0;157;6837;3966;2871;528;443;77.0
2564;Totaal september 2001;17147;8719;8428;10706;5128;5578;10594;10316;148.0;130.0;375.0;346.0;17.0;12.0;2984;126014;73310;52704;13109;5566;2365.0
2565;Zaterdag 1 september 2001;451;235;216;332;156;176;398;394;4.0;0.0;0.0;0.0;0.0;0.0;0;16243;9829;6414;77;612;0.0
2566;Zondag 2 september 2001;467;240;227;324;129;195;7;7;0.0;0.0;0.0;0.0;0.0;0.0;0;118;62;56;7;62;0.0
2567;Maandag 3 september 2001;591;315;276;385;166;219;211;198;7.0;6.0;20.0;19.0;1.0;0.0;148;7640;4360;3280;747;267;9.0
2568;Dinsdag 4 september 2001;596;311;285;362;165;197;202;194;5.0;3.0;18.0;17.0;0.0;1.0;157;5451;2851;2600;900;331;13.0
2569;Woensdag 5 september 2001;624;321;303;360;198;162;269;264;3.0;2.0;17.0;15.0;2.0;0.0;156;5115;2794;2321;813;211;20.0
2570;Donderdag 6 september 2001;638;309;329;373;176;197;510;492;12.0;6.0;19.0;16.0;0.0;3.0;178;5060;2725;2335;751;184;17.0
2571;Vrijdag 7 september 2001;586;311;275;345;170;175;1548;1518;15.0;15.0;14.0;11.0;1.0;2.0;159;4875;2754;2121;517;197;552.0
2572;Zaterdag 8 september 2001;470;222;248;308;151;157;297;292;4.0;1.0;1.0;0.0;0.0;1.0;0;834;572;262;2;49;0.0
2573;Zondag 9 september 2001;455;225;230;349;168;181;12;12;0.0;0.0;0.0;0.0;0.0;0.0;0;168;122;46;7;52;0.0
2574;Maandag 10 september 2001;605;297;308;332;159;173;194;181;6.0;7.0;24.0;22.0;2.0;0.0;159;5936;3365;2571;789;242;18.0
2575;Dinsdag 11 september 2001;626;334;292;361;177;184;161;149;5.0;7.0;20.0;19.0;0.0;1.0;173;4596;2475;2121;761;199;22.0
2576;Woensdag 12 september 2001;609;303;306;348;165;183;272;261;7.0;4.0;19.0;18.0;1.0;0.0;155;4101;2269;1832;591;191;143.0
2577;Donderdag 13 september 2001;619;313;306;333;159;174;279;266;4.0;9.0;17.0;16.0;1.0;0.0;125;4370;2455;1915;573;190;15.0
2578;Vrijdag 14 september 2001;633;326;307;372;179;193;1397;1375;14.0;8.0;8.0;8.0;0.0;0.0;121;5004;3066;1938;457;176;11.0
2579;Zaterdag 15 september 2001;480;265;215;318;145;173;266;264;2.0;0.0;0.0;0.0;0.0;0.0;1;2967;2036;931;5;106;0.0
2580;Zondag 16 september 2001;482;243;239;339;165;174;9;9;0.0;0.0;0.0;0.0;0.0;0.0;0;280;177;103;8;50;0.0
2581;Maandag 17 september 2001;594;308;286;334;164;170;169;160;5.0;4.0;25.0;25.0;0.0;0.0;128;6214;3595;2619;679;198;13.0
2582;Dinsdag 18 september 2001;633;307;326;374;190;184;161;147;8.0;6.0;17.0;16.0;0.0;1.0;139;4342;2394;1948;628;170;12.0
2583;Woensdag 19 september 2001;627;347;280;393;200;193;179;175;2.0;2.0;20.0;20.0;0.0;0.0;159;4086;2293;1793;716;173;8.0
2584;Donderdag 20 september 2001;629;305;324;375;174;201;412;401;5.0;6.0;16.0;14.0;1.0;1.0;126;5201;2999;2202;574;204;882.0
2585;Vrijdag 21 september 2001;637;342;295;382;186;196;1262;1244;8.0;10.0;17.0;17.0;0.0;0.0;147;4706;2742;1964;615;173;14.0
2586;Zaterdag 22 september 2001;480;248;232;375;174;201;255;251;3.0;1.0;0.0;0.0;0.0;0.0;1;1339;940;399;1;48;0.0
2587;Zondag 23 september 2001;479;229;250;344;151;193;3;2;1.0;0.0;0.0;0.0;0.0;0.0;1;214;161;53;9;43;0.0
2588;Maandag 24 september 2001;625;308;317;396;188;208;161;151;4.0;6.0;26.0;26.0;0.0;0.0;137;5452;3231;2221;641;262;496.0
2589;Dinsdag 25 september 2001;658;335;323;364;167;197;141;135;2.0;4.0;26.0;22.0;4.0;0.0;148;4805;2886;1919;530;212;12.0
2590;Woensdag 26 september 2001;611;291;320;364;183;181;174;172;2.0;0.0;18.0;16.0;1.0;1.0;150;4509;2605;1904;602;218;27.0
2591;Donderdag 27 september 2001;629;318;311;362;183;179;356;347;6.0;3.0;20.0;19.0;1.0;0.0;158;4936;2847;2089;637;251;76.0
2592;Vrijdag 28 september 2001;609;297;312;359;172;187;1080;1050;10.0;20.0;12.0;9.0;2.0;1.0;157;5406;3252;2154;456;302;5.0
2593;Zaterdag 29 september 2001;515;252;263;359;173;186;206;202;4.0;0.0;1.0;1.0;0.0;0.0;1;1191;832;359;6;67;0.0
2594;Zondag 30 september 2001;489;262;227;384;195;189;3;3;0.0;0.0;0.0;0.0;0.0;0.0;0;855;621;234;10;126;0.0
2595;Totaal oktober 2001;17556;9009;8547;11523;5661;5862;6155;5964;112.0;79.0;493.0;462.0;18.0;13.0;3525;141799;85892;55907;12332;5550;4480.0
2596;Maandag 1 oktober 2001;599;301;298;338;171;167;202;196;5.0;1.0;25.0;24.0;1.0;0.0;168;23658;15263;8395;652;733;55.0
2597;Dinsdag 2 oktober 2001;623;302;321;376;187;189;151;145;3.0;3.0;24.0;23.0;1.0;0.0;171;5073;2873;2200;676;250;16.0
2598;Woensdag 3 oktober 2001;659;339;320;389;201;188;136;132;3.0;1.0;15.0;12.0;2.0;1.0;166;5075;2894;2181;618;244;530.0
2599;Donderdag 4 oktober 2001;620;306;314;404;189;215;207;200;5.0;2.0;19.0;17.0;2.0;0.0;150;5262;3085;2177;615;178;15.0
2600;Vrijdag 5 oktober 2001;552;289;263;385;191;194;768;752;10.0;6.0;10.0;8.0;1.0;1.0;140;4872;2758;2114;479;214;12.0
2601;Zaterdag 6 oktober 2001;459;239;220;354;168;186;147;145;0.0;2.0;0.0;0.0;0.0;0.0;0;852;623;229;1;30;0.0
2602;Zondag 7 oktober 2001;481;256;225;361;174;187;5;5;0.0;0.0;0.0;0.0;0.0;0.0;0;188;140;48;5;35;0.0
2603;Maandag 8 oktober 2001;607;319;288;354;178;176;140;137;2.0;1.0;31.0;30.0;0.0;1.0;158;5642;3328;2314;587;228;11.0
2604;Dinsdag 9 oktober 2001;631;317;314;360;187;173;121;114;5.0;2.0;17.0;17.0;0.0;0.0;142;4424;2533;1891;617;181;627.0
2605;Woensdag 10 oktober 2001;654;322;332;358;180;178;227;220;5.0;2.0;24.0;24.0;0.0;0.0;157;4789;2898;1891;556;161;13.0
2606;Donderdag 11 oktober 2001;583;276;307;374;179;195;207;201;5.0;1.0;20.0;20.0;0.0;0.0;145;4460;2568;1892;553;163;25.0
2607;Vrijdag 12 oktober 2001;594;313;281;395;195;200;707;690;5.0;12.0;18.0;16.0;2.0;0.0;160;4662;2775;1887;385;248;746.0
2608;Zaterdag 13 oktober 2001;458;232;226;364;197;167;93;93;0.0;0.0;0.0;0.0;0.0;0.0;1;1050;721;329;7;31;0.0
2609;Zondag 14 oktober 2001;482;259;223;362;160;202;3;3;0.0;0.0;0.0;0.0;0.0;0.0;0;238;152;86;5;28;2.0
2610;Maandag 15 oktober 2001;594;315;279;393;194;199;161;154;5.0;2.0;17.0;17.0;0.0;0.0;153;9029;5769;3260;562;296;18.0
2611;Dinsdag 16 oktober 2001;621;302;319;381;178;203;146;139;4.0;3.0;22.0;20.0;0.0;2.0;176;4530;2616;1914;625;142;20.0
2612;Woensdag 17 oktober 2001;590;315;275;363;192;171;136;128;5.0;3.0;20.0;17.0;2.0;1.0;155;4136;2320;1816;471;147;16.0
2613;Donderdag 18 oktober 2001;587;302;285;392;184;208;232;222;4.0;6.0;23.0;22.0;1.0;0.0;154;4666;2785;1881;556;193;1099.0
2614;Vrijdag 19 oktober 2001;568;293;275;404;198;206;625;612;10.0;3.0;11.0;10.0;0.0;1.0;179;4551;2787;1764;352;191;15.0
2615;Zaterdag 20 oktober 2001;451;224;227;371;157;214;150;146;3.0;1.0;0.0;0.0;0.0;0.0;1;1900;1323;577;2;40;2.0
2616;Zondag 21 oktober 2001;437;226;211;397;197;200;7;7;0.0;0.0;0.0;0.0;0.0;0.0;1;221;155;66;2;21;0.0
2617;Maandag 22 oktober 2001;557;287;270;371;186;185;166;154;7.0;5.0;29.0;28.0;0.0;1.0;155;5956;3500;2456;518;231;283.0
2618;Dinsdag 23 oktober 2001;634;334;300;394;210;184;118;114;3.0;1.0;30.0;27.0;1.0;2.0;160;4360;2538;1822;490;180;18.0
2619;Woensdag 24 oktober 2001;593;302;291;352;180;172;144;139;2.0;3.0;30.0;28.0;2.0;0.0;147;4237;2415;1822;439;140;12.0
2620;Donderdag 25 oktober 2001;590;306;284;372;182;190;172;168;1.0;3.0;14.0;12.0;2.0;0.0;162;5074;3106;1968;500;229;507.0
2621;Vrijdag 26 oktober 2001;593;313;280;352;165;187;493;478;6.0;9.0;12.0;11.0;0.0;1.0;125;4867;2944;1923;340;185;6.0
2622;Zaterdag 27 oktober 2001;464;240;224;380;209;171;87;83;3.0;1.0;0.0;0.0;0.0;0.0;0;1665;1210;455;3;64;0.0
2623;Zondag 28 oktober 2001;474;255;219;347;167;180;3;3;0.0;0.0;0.0;0.0;0.0;0.0;0;362;237;125;4;48;0.0
2624;Maandag 29 oktober 2001;595;302;293;369;176;193;134;128;5.0;1.0;26.0;25.0;0.0;1.0;144;5808;3496;2312;597;242;20.0
2625;Dinsdag 30 oktober 2001;557;297;260;366;166;200;122;117;4.0;1.0;29.0;28.0;1.0;0.0;127;4783;2792;1991;553;224;395.0
2626;Woensdag 31 oktober 2001;649;326;323;345;163;182;145;139;2.0;4.0;27.0;26.0;0.0;1.0;128;5409;3288;2121;562;253;17.0
2627;Totaal november 2001;16345;8340;8005;11391;5610;5781;4226;4085;72.0;69.0;546.0;508.0;22.0;16.0;3116;133916;83161;50755;10536;4630;3633.0
2628;Donderdag 1 november 2001;597;294;303;379;193;186;236;223;9.0;4.0;20.0;17.0;2.0;1.0;125;23269;15114;8155;536;609;20.0
2629;Vrijdag 2 november 2001;535;257;278;376;176;200;368;362;3.0;3.0;13.0;12.0;1.0;0.0;118;5198;3096;2102;406;199;10.0
2630;Zaterdag 3 november 2001;445;235;210;336;170;166;72;71;1.0;0.0;0.0;0.0;0.0;0.0;0;894;622;272;1;41;0.0
2631;Zondag 4 november 2001;444;240;204;348;177;171;8;7;1.0;0.0;0.0;0.0;0.0;0.0;0;156;105;51;2;33;0.0
2632;Maandag 5 november 2001;591;299;292;355;186;169;113;106;1.0;6.0;26.0;24.0;0.0;2.0;136;6183;3722;2461;573;212;394.0
2633;Dinsdag 6 november 2001;599;311;288;376;196;180;105;98;3.0;4.0;30.0;26.0;2.0;2.0;156;4692;2745;1947;550;180;22.0
2634;Woensdag 7 november 2001;596;295;301;366;182;184;103;101;1.0;1.0;26.0;24.0;2.0;0.0;144;4370;2645;1725;543;111;12.0
2635;Donderdag 8 november 2001;579;292;287;399;194;205;110;107;1.0;2.0;18.0;18.0;0.0;0.0;157;4552;2684;1868;541;153;596.0
2636;Vrijdag 9 november 2001;604;312;292;368;172;196;361;356;2.0;3.0;14.0;12.0;2.0;0.0;147;4320;2649;1671;344;138;17.0
2637;Zaterdag 10 november 2001;427;219;208;341;163;178;77;76;0.0;1.0;0.0;0.0;0.0;0.0;2;1560;1158;402;8;38;0.0
2638;Zondag 11 november 2001;426;209;217;330;158;172;11;10;1.0;0.0;0.0;0.0;0.0;0.0;0;264;192;72;5;29;0.0
2639;Maandag 12 november 2001;566;287;279;369;169;200;137;133;2.0;2.0;31.0;30.0;0.0;1.0;163;5274;3203;2071;569;186;625.0
2640;Dinsdag 13 november 2001;571;309;262;381;201;180;94;89;5.0;0.0;26.0;25.0;0.0;1.0;165;4060;2358;1702;549;134;287.0
2641;Woensdag 14 november 2001;595;303;292;414;208;206;130;125;2.0;3.0;25.0;23.0;0.0;2.0;145;4281;2524;1757;452;137;15.0
2642;Donderdag 15 november 2001;517;282;235;407;199;208;150;142;4.0;4.0;17.0;17.0;0.0;0.0;149;7657;4884;2773;512;233;12.0
2643;Vrijdag 16 november 2001;558;270;288;409;209;200;346;337;7.0;2.0;21.0;18.0;1.0;2.0;110;4981;3140;1841;327;132;8.0
2644;Zaterdag 17 november 2001;469;250;219;356;175;181;57;57;0.0;0.0;2.0;1.0;1.0;0.0;0;1299;965;334;2;29;0.0
2645;Zondag 18 november 2001;422;215;207;338;168;170;4;4;0.0;0.0;0.0;0.0;0.0;0.0;0;255;141;114;6;24;4.0
2646;Maandag 19 november 2001;610;296;314;358;181;177;106;102;2.0;2.0;33.0;31.0;2.0;0.0;138;5261;3268;1993;531;220;16.0
2647;Dinsdag 20 november 2001;614;308;306;394;210;184;129;125;0.0;4.0;24.0;22.0;2.0;0.0;165;4685;2813;1872;527;136;11.0
2648;Woensdag 21 november 2001;626;337;289;383;180;203;116;113;1.0;2.0;29.0;27.0;1.0;1.0;135;3866;2289;1577;466;150;281.0
2649;Donderdag 22 november 2001;573;308;265;381;186;195;159;153;4.0;2.0;21.0;20.0;1.0;0.0;124;4333;2752;1581;423;160;16.0
2650;Vrijdag 23 november 2001;593;298;295;421;218;203;350;336;6.0;8.0;22.0;20.0;1.0;1.0;137;4176;2601;1575;286;126;506.0
2651;Zaterdag 24 november 2001;438;239;199;414;186;228;45;43;2.0;0.0;0.0;0.0;0.0;0.0;2;1728;1190;538;5;36;0.0
2652;Zondag 25 november 2001;446;226;220;398;192;206;0;0;;;0.0;0.0;0.0;0.0;0;428;308;120;5;41;3.0
2653;Maandag 26 november 2001;557;266;291;399;187;212;131;127;4.0;0.0;48.0;45.0;3.0;0.0;121;5079;3133;1946;457;217;487.0
2654;Dinsdag 27 november 2001;601;290;311;386;189;197;96;93;2.0;1.0;30.0;28.0;1.0;1.0;167;3910;2151;1759;548;135;16.0
2655;Woensdag 28 november 2001;584;311;273;400;191;209;107;102;0.0;5.0;24.0;23.0;0.0;1.0;146;4671;2794;1877;492;240;15.0
2656;Donderdag 29 november 2001;606;306;300;390;192;198;154;150;2.0;2.0;26.0;25.0;0.0;1.0;129;4972;3038;1934;505;195;253.0
2657;Vrijdag 30 november 2001;556;276;280;419;202;217;351;337;6.0;8.0;20.0;20.0;0.0;0.0;135;7542;4877;2665;365;356;7.0
2658;Totaal december 2001;16109;8321;7788;12634;6136;6498;4244;4091;88.0;65.0;489.0;430.0;34.0;25.0;2383;123787;77642;46145;7570;4811;2956.0
2659;Zaterdag 1 december 2001;431;212;219;409;183;226;65;63;2.0;0.0;0.0;0.0;0.0;0.0;3;15271;10564;4707;32;298;0.0
2660;Zondag 2 december 2001;436;230;206;354;195;159;4;4;0.0;0.0;0.0;0.0;0.0;0.0;0;141;103;38;1;31;5.0
2661;Maandag 3 december 2001;574;296;278;388;194;194;130;126;1.0;3.0;35.0;28.0;3.0;4.0;138;7687;4691;2996;544;258;11.0
2662;Dinsdag 4 december 2001;608;331;277;373;190;183;113;108;3.0;2.0;22.0;18.0;2.0;2.0;174;4959;2880;2079;460;183;1016.0
2663;Woensdag 5 december 2001;513;262;251;405;195;210;105;95;5.0;5.0;34.0;32.0;1.0;1.0;149;5006;2889;2117;444;204;51.0
2664;Donderdag 6 december 2001;542;298;244;381;175;206;135;129;3.0;3.0;25.0;22.0;2.0;1.0;149;5142;3069;2073;529;184;225.0
2665;Vrijdag 7 december 2001;563;279;284;392;205;187;294;284;8.0;2.0;16.0;14.0;1.0;1.0;124;5307;3292;2015;373;181;282.0
2666;Zaterdag 8 december 2001;435;229;206;412;211;201;51;50;1.0;0.0;0.0;0.0;0.0;0.0;0;1452;1036;416;3;49;0.0
2667;Zondag 9 december 2001;424;206;218;417;213;204;3;3;0.0;0.0;0.0;0.0;0.0;0.0;0;164;87;77;1;19;6.0
2668;Maandag 10 december 2001;571;292;279;398;213;185;139;129;7.0;3.0;41.0;36.0;4.0;1.0;140;6296;3865;2431;537;241;22.0
2669;Dinsdag 11 december 2001;555;270;285;379;191;188;102;95;4.0;3.0;31.0;26.0;3.0;2.0;153;4244;2455;1789;461;185;135.0
2670;Woensdag 12 december 2001;568;291;277;409;190;219;205;193;5.0;7.0;33.0;29.0;3.0;1.0;150;4783;2998;1785;419;186;2.0
2671;Donderdag 13 december 2001;597;323;274;397;183;214;129;124;5.0;0.0;17.0;16.0;1.0;0.0;151;4885;2963;1922;464;185;135.0
2672;Vrijdag 14 december 2001;574;317;257;407;210;197;478;469;4.0;5.0;29.0;23.0;2.0;4.0;132;6378;3976;2402;312;256;2.0
2673;Zaterdag 15 december 2001;447;232;215;414;220;194;87;83;4.0;0.0;0.0;0.0;0.0;0.0;0;4927;3605;1322;8;145;1.0
2674;Zondag 16 december 2001;476;258;218;393;158;235;4;4;0.0;0.0;0.0;0.0;0.0;0.0;0;397;282;115;6;45;2.0
2675;Maandag 17 december 2001;570;304;266;388;169;219;212;204;4.0;4.0;41.0;39.0;2.0;0.0;149;7437;4670;2767;461;249;17.0
2676;Dinsdag 18 december 2001;591;293;298;424;199;225;185;181;3.0;1.0;31.0;29.0;0.0;2.0;149;4950;2968;1982;485;208;927.0
2677;Woensdag 19 december 2001;599;334;265;432;194;238;173;165;1.0;7.0;35.0;33.0;0.0;2.0;104;4527;2671;1856;460;204;13.0
2678;Donderdag 20 december 2001;604;313;291;435;202;233;233;228;2.0;3.0;32.0;29.0;3.0;0.0;137;6259;3967;2292;526;224;14.0
2679;Vrijdag 21 december 2001;567;281;286;425;197;228;661;642;11.0;8.0;25.0;25.0;0.0;0.0;136;6033;3723;2310;311;289;37.0
2680;Zaterdag 22 december 2001;518;274;244;484;231;253;110;109;1.0;0.0;0.0;0.0;0.0;0.0;0;1997;1388;609;3;52;0.0
2681;Zondag 23 december 2001;422;218;204;394;193;201;6;6;0.0;0.0;0.0;0.0;0.0;0.0;0;261;179;82;1;25;0.0
2682;Maandag 24 december 2001;530;293;237;397;192;205;84;82;2.0;0.0;9.0;5.0;3.0;1.0;32;2085;1319;766;99;64;9.0
2683;Dinsdag 25 december 2001;400;197;203;421;204;217;17;17;0.0;0.0;0.0;0.0;0.0;0.0;1;142;104;38;5;12;8.0
2684;Woensdag 26 december 2001;428;203;225;379;184;195;15;15;0.0;0.0;0.0;0.0;0.0;0.0;0;60;39;21;2;26;7.0
2685;Donderdag 27 december 2001;532;279;253;437;238;199;126;119;4.0;3.0;14.0;13.0;0.0;1.0;101;5034;3078;1956;286;233;8.0
2686;Vrijdag 28 december 2001;605;286;319;430;210;220;242;233;5.0;4.0;14.0;9.0;3.0;2.0;85;4644;2730;1914;268;251;16.0
2687;Zaterdag 29 december 2001;470;249;221;431;212;219;44;43;1.0;0.0;0.0;0.0;0.0;0.0;1;750;491;259;6;38;1.0
2688;Zondag 30 december 2001;462;233;229;405;191;214;5;4;1.0;0.0;0.0;0.0;0.0;0.0;0;338;247;91;1;50;0.0
2689;Maandag 31 december 2001;497;238;259;424;194;230;87;84;1.0;2.0;5.0;4.0;1.0;0.0;25;2231;1313;918;62;236;4.0
2690;Totaal op zondag in 2001;23527;12070;11457;19415;9261;10154;493;480;9.0;4.0;1.0;0.0;1.0;0.0;17;42370;28347;14023;285;2920;115.0
2691;Totaal op maandag in 2001;30126;15465;14661;20343;9875;10468;8340;7941;233.0;166.0;868.0;757.0;62.0;49.0;7018;323619;197208;126411;27972;12741;12481.0
2692;Totaal op dinsdag in 2001;31281;16019;15262;20137;9878;10259;7754;7375;211.0;168.0;750.0;633.0;64.0;53.0;7884;256567;152069;104498;30088;10402;8150.0
2693;Totaal op woensdag in 2001;31588;16137;15451;20174;9877;10297;10084;9686;223.0;175.0;698.0;602.0;53.0;43.0;7589;251964;148712;103252;27014;11113;6388.0
2694;Totaal op donderdag in 2001;31138;15925;15213;20215;9861;10354;12524;12083;233.0;208.0;587.0;506.0;44.0;37.0;7630;312488;189993;122495;28479;11546;10211.0
2695;Totaal op vrijdag in 2001;30599;15673;14926;20392;9980;10412;35542;34855;351.0;336.0;456.0;343.0;53.0;60.0;6921;273773;166923;106850;19233;10995;6965.0
2696;Totaal op zaterdag in 2001;24344;12517;11827;19701;9587;10114;7354;7257;79.0;18.0;17.0;6.0;8.0;3.0;45;101839;69205;32634;333;3601;2357.0
2697;Totaal 2002;202083;103734;98349;142355;68998;73357;85808;83970;935.0;903.0;8321.0;7774.0;269.0;278.0;33179;1595926;966979;628947;121250;66728;45321.0
2698;Totaal januari 2002;17019;8767;8252;13469;6445;7024;3169;3070;51.0;48.0;599.0;563.0;20.0;16.0;3294;139441;84260;55181;11366;5456;3356.0
2699;Dinsdag 1 januari 2002;411;215;196;405;209;196;14;14;0.0;0.0;0.0;0.0;0.0;0.0;3;9820;6077;3743;61;329;0.0
2700;Woensdag 2 januari 2002;548;277;271;409;188;221;95;90;2.0;3.0;17.0;15.0;1.0;1.0;122;7355;4323;3032;465;318;673.0
2701;Donderdag 3 januari 2002;651;359;292;441;196;245;128;120;4.0;4.0;21.0;20.0;1.0;0.0;120;7640;4252;3388;650;304;12.0
2702;Vrijdag 4 januari 2002;617;330;287;429;231;198;149;146;1.0;2.0;24.0;23.0;0.0;1.0;157;6812;3928;2884;479;266;269.0
2703;Zaterdag 5 januari 2002;479;272;207;439;207;232;38;38;0.0;0.0;0.0;0.0;0.0;0.0;2;918;613;305;8;54;1.0
2704;Zondag 6 januari 2002;447;227;220;399;195;204;11;10;0.0;1.0;0.0;0.0;0.0;0.0;0;184;118;66;6;31;4.0
2705;Maandag 7 januari 2002;578;303;275;455;224;231;146;144;0.0;2.0;40.0;37.0;1.0;2.0;260;7530;4445;3085;572;250;466.0
2706;Dinsdag 8 januari 2002;595;314;281;457;203;254;124;121;1.0;2.0;36.0;34.0;1.0;1.0;156;5867;3438;2429;514;200;17.0
2707;Woensdag 9 januari 2002;561;279;282;466;219;247;101;98;2.0;1.0;22.0;20.0;2.0;0.0;140;5066;3015;2051;539;206;14.0
2708;Donderdag 10 januari 2002;624;313;311;491;223;268;141;141;0.0;0.0;23.0;20.0;2.0;1.0;121;6043;3555;2488;518;238;12.0
2709;Vrijdag 11 januari 2002;544;284;260;435;196;239;239;231;3.0;5.0;22.0;21.0;0.0;1.0;141;4761;2836;1925;362;207;11.0
2710;Zaterdag 12 januari 2002;441;237;204;406;186;220;54;52;1.0;1.0;0.0;0.0;0.0;0.0;2;1062;754;308;1;45;0.0
2711;Zondag 13 januari 2002;396;217;179;435;214;221;10;10;0.0;0.0;0.0;0.0;0.0;0.0;1;134;89;45;3;37;1.0
2712;Maandag 14 januari 2002;625;318;307;441;191;250;113;108;3.0;2.0;41.0;40.0;0.0;1.0;158;6316;3755;2561;581;206;436.0
2713;Dinsdag 15 januari 2002;611;299;312;424;198;226;92;89;3.0;0.0;34.0;32.0;1.0;1.0;133;7374;4608;2766;526;295;20.0
2714;Woensdag 16 januari 2002;578;294;284;457;222;235;99;98;0.0;1.0;35.0;34.0;1.0;0.0;134;4736;2866;1870;480;173;14.0
2715;Donderdag 17 januari 2002;586;288;298;434;210;224;109;103;2.0;4.0;23.0;22.0;0.0;1.0;139;5079;3098;1981;467;178;427.0
2716;Vrijdag 18 januari 2002;575;291;284;435;226;209;246;239;3.0;4.0;21.0;20.0;0.0;1.0;146;4680;2921;1759;382;159;16.0
2717;Zaterdag 19 januari 2002;468;241;227;428;196;232;50;49;1.0;0.0;0.0;0.0;0.0;0.0;4;1056;757;299;6;38;0.0
2718;Zondag 20 januari 2002;428;226;202;413;193;220;9;9;0.0;0.0;0.0;0.0;0.0;0.0;1;539;398;141;6;37;0.0
2719;Maandag 21 januari 2002;585;291;294;436;217;219;126;121;3.0;2.0;38.0;32.0;5.0;1.0;156;5730;3592;2138;542;191;297.0
2720;Dinsdag 22 januari 2002;594;309;285;440;216;224;106;103;2.0;1.0;20.0;18.0;2.0;0.0;156;4532;2732;1800;550;142;329.0
2721;Woensdag 23 januari 2002;595;296;299;437;212;225;106;103;3.0;0.0;24.0;23.0;0.0;1.0;110;4264;2433;1831;432;187;12.0
2722;Donderdag 24 januari 2002;599;290;309;446;216;230;108;105;2.0;1.0;17.0;17.0;0.0;0.0;161;4516;2660;1856;524;169;154.0
2723;Vrijdag 25 januari 2002;569;290;279;447;224;223;259;246;8.0;5.0;22.0;21.0;0.0;1.0;134;4974;3125;1849;419;196;10.0
2724;Zaterdag 26 januari 2002;493;251;242;472;222;250;52;52;0.0;0.0;0.0;0.0;0.0;0.0;0;1660;1102;558;11;47;3.0
2725;Zondag 27 januari 2002;422;221;201;401;184;217;6;6;0.0;0.0;0.0;0.0;0.0;0.0;1;208;143;65;5;43;2.0
2726;Maandag 28 januari 2002;552;303;249;410;199;211;124;119;2.0;3.0;35.0;34.0;0.0;1.0;161;5516;3315;2201;599;220;24.0
2727;Dinsdag 29 januari 2002;626;316;310;434;220;214;100;98;0.0;2.0;31.0;31.0;0.0;0.0;140;4305;2646;1659;563;196;14.0
2728;Woensdag 30 januari 2002;623;317;306;415;197;218;100;96;3.0;1.0;29.0;27.0;1.0;1.0;157;4567;2773;1794;523;206;94.0
2729;Donderdag 31 januari 2002;598;299;299;432;211;221;114;111;2.0;1.0;24.0;22.0;2.0;0.0;178;6197;3893;2304;572;288;24.0
2730;Totaal februari 2002;15448;7918;7530;11735;5643;6092;5098;4940;94.0;64.0;605.0;566.0;19.0;20.0;2882;123408;76359;47049;8950;4541;3571.0
2731;Vrijdag 1 februari 2002;559;285;274;428;216;212;321;309;8.0;4.0;17.0;15.0;1.0;1.0;123;19685;12841;6844;379;537;14.0
2732;Zaterdag 2 februari 2002;418;212;206;426;210;216;327;317;9.0;1.0;0.0;0.0;0.0;0.0;3;1067;767;300;6;61;2.0
2733;Zondag 3 februari 2002;431;208;223;393;178;215;5;5;0.0;0.0;0.0;0.0;0.0;0.0;1;175;110;65;10;33;0.0
2734;Maandag 4 februari 2002;566;308;258;403;223;180;128;124;3.0;1.0;36.0;32.0;1.0;3.0;139;6301;3710;2591;593;250;1015.0
2735;Dinsdag 5 februari 2002;588;302;286;407;174;233;119;118;1.0;0.0;37.0;35.0;1.0;1.0;155;5105;3074;2031;562;165;149.0
2736;Woensdag 6 februari 2002;584;301;283;417;217;200;121;110;5.0;6.0;39.0;36.0;1.0;2.0;129;4378;2570;1808;551;151;17.0
2737;Donderdag 7 februari 2002;618;335;283;443;200;243;106;100;4.0;2.0;22.0;20.0;1.0;1.0;129;4983;2998;1985;491;171;21.0
2738;Vrijdag 8 februari 2002;611;306;305;414;201;213;215;214;0.0;1.0;11.0;11.0;0.0;0.0;146;4843;2915;1928;341;180;11.0
2739;Zaterdag 9 februari 2002;442;239;203;380;175;205;41;41;0.0;0.0;0.0;0.0;0.0;0.0;0;947;664;283;2;19;0.0
2740;Zondag 10 februari 2002;458;242;216;395;179;216;6;6;0.0;0.0;0.0;0.0;0.0;0.0;0;427;303;124;2;47;1.0
2741;Maandag 11 februari 2002;594;311;283;409;195;214;120;112;5.0;3.0;25.0;25.0;0.0;0.0;145;4484;2834;1650;454;181;16.0
2742;Dinsdag 12 februari 2002;625;327;298;416;189;227;127;123;2.0;2.0;27.0;26.0;1.0;0.0;140;3883;2257;1626;365;122;15.0
2743;Woensdag 13 februari 2002;582;272;310;379;185;194;76;72;2.0;2.0;26.0;25.0;0.0;1.0;141;4325;2512;1813;391;179;16.0
2744;Donderdag 14 februari 2002;589;281;308;411;202;209;402;390;4.0;8.0;23.0;21.0;2.0;0.0;134;5013;3019;1994;471;180;21.0
2745;Vrijdag 15 februari 2002;596;312;284;416;201;215;275;273;2.0;0.0;31.0;28.0;3.0;0.0;125;7427;4793;2634;384;249;18.0
2746;Zaterdag 16 februari 2002;463;240;223;385;184;201;49;49;0.0;0.0;0.0;0.0;0.0;0.0;0;1342;931;411;2;36;0.0
2747;Zondag 17 februari 2002;411;222;189;362;184;178;13;13;0.0;0.0;0.0;0.0;0.0;0.0;0;198;122;76;5;26;1.0
2748;Maandag 18 februari 2002;556;274;282;467;228;239;148;143;2.0;3.0;46.0;45.0;0.0;1.0;181;6038;3674;2364;528;217;779.0
2749;Dinsdag 19 februari 2002;648;333;315;382;197;185;117;111;3.0;3.0;38.0;35.0;1.0;2.0;174;4294;2483;1811;477;153;1214.0
2750;Woensdag 20 februari 2002;662;344;318;400;202;198;881;837;25.0;19.0;33.0;30.0;1.0;2.0;140;4686;2799;1887;425;164;12.0
2751;Donderdag 21 februari 2002;570;280;290;411;202;209;138;136;2.0;0.0;29.0;28.0;1.0;0.0;135;4867;2909;1958;428;181;188.0
2752;Vrijdag 22 februari 2002;593;297;296;416;185;231;750;732;12.0;6.0;20.0;18.0;0.0;2.0;152;4665;2830;1835;297;178;11.0
2753;Zaterdag 23 februari 2002;462;232;230;461;228;233;52;52;0.0;0.0;0.0;0.0;0.0;0.0;1;1623;1110;513;1;32;1.0
2754;Zondag 24 februari 2002;416;204;212;420;192;228;13;13;0.0;0.0;0.0;0.0;0.0;0.0;0;318;220;98;5;31;2.0
2755;Maandag 25 februari 2002;568;293;275;462;224;238;128;126;1.0;1.0;44.0;42.0;1.0;1.0;172;6197;3816;2381;476;268;15.0
2756;Dinsdag 26 februari 2002;641;329;312;488;232;256;127;126;1.0;0.0;36.0;31.0;3.0;2.0;145;4633;2839;1794;432;235;7.0
2757;Woensdag 27 februari 2002;618;322;296;478;209;269;120;119;1.0;0.0;33.0;32.0;1.0;0.0;144;4465;2709;1756;403;197;10.0
2758;Donderdag 28 februari 2002;579;307;272;466;231;235;173;169;2.0;2.0;32.0;31.0;0.0;1.0;128;7039;4550;2489;469;298;15.0
2759;Totaal maart 2002;16792;8597;8195;13281;6367;6914;4313;4206;60.0;47.0;673.0;632.0;21.0;20.0;2820;130942;81652;49290;9508;5037;5353.0
2760;Vrijdag 1 maart 2002;564;267;297;425;216;209;405;395;6.0;4.0;28.0;26.0;1.0;1.0;122;21225;13922;7303;400;516;9.0
2761;Zaterdag 2 maart 2002;475;212;263;477;214;263;85;84;1.0;0.0;0.0;0.0;0.0;0.0;1;845;592;253;4;45;0.0
2762;Zondag 3 maart 2002;439;242;197;435;206;229;13;13;0.0;0.0;0.0;0.0;0.0;0.0;0;171;107;64;7;29;1.0
2763;Maandag 4 maart 2002;592;321;271;439;217;222;156;151;2.0;3.0;43.0;40.0;3.0;0.0;133;6741;4057;2684;567;235;11.0
2764;Dinsdag 5 maart 2002;576;281;295;447;200;247;107;104;2.0;1.0;37.0;34.0;1.0;2.0;131;5438;3337;2101;474;218;1764.0
2765;Woensdag 6 maart 2002;589;297;292;412;192;220;87;87;0.0;0.0;17.0;16.0;1.0;0.0;148;4659;2733;1926;353;160;9.0
2766;Donderdag 7 maart 2002;580;284;296;405;182;223;128;121;5.0;2.0;26.0;25.0;1.0;0.0;117;5291;3143;2148;482;144;9.0
2767;Vrijdag 8 maart 2002;620;314;306;417;189;228;305;299;2.0;4.0;25.0;23.0;0.0;2.0;142;4985;3026;1959;304;164;880.0
2768;Zaterdag 9 maart 2002;474;249;225;470;203;267;52;52;0.0;0.0;0.0;0.0;0.0;0.0;0;998;684;314;4;17;2.0
2769;Zondag 10 maart 2002;453;230;223;425;206;219;11;11;0.0;0.0;0.0;0.0;0.0;0.0;3;434;293;141;4;44;3.0
2770;Maandag 11 maart 2002;592;328;264;448;223;225;120;118;2.0;0.0;34.0;30.0;3.0;1.0;121;5454;3338;2116;584;203;14.0
2771;Dinsdag 12 maart 2002;595;338;257;452;206;246;133;131;2.0;0.0;40.0;39.0;1.0;0.0;148;4532;2849;1683;535;214;17.0
2772;Woensdag 13 maart 2002;555;295;260;410;198;212;114;110;1.0;3.0;29.0;28.0;0.0;1.0;136;4191;2472;1719;475;145;18.0
2773;Donderdag 14 maart 2002;558;285;273;447;219;228;142;137;4.0;1.0;35.0;34.0;1.0;0.0;147;4850;2951;1899;549;170;732.0
2774;Vrijdag 15 maart 2002;587;298;289;439;216;223;353;346;5.0;2.0;23.0;23.0;0.0;0.0;134;7256;4559;2697;376;235;11.0
2775;Zaterdag 16 maart 2002;430;215;215;456;229;227;57;56;1.0;0.0;0.0;0.0;0.0;0.0;1;1330;950;380;7;36;1.0
2776;Zondag 17 maart 2002;439;231;208;436;205;231;8;8;0.0;0.0;0.0;0.0;0.0;0.0;0;153;90;63;9;13;1.0
2777;Maandag 18 maart 2002;588;302;286;429;226;203;159;156;1.0;2.0;33.0;31.0;2.0;0.0;141;5915;3646;2269;572;196;18.0
2778;Dinsdag 19 maart 2002;587;297;290;414;199;215;106;105;1.0;0.0;47.0;46.0;0.0;1.0;161;4090;2449;1641;501;197;150.0
2779;Woensdag 20 maart 2002;591;293;298;401;193;208;148;143;2.0;3.0;24.0;21.0;1.0;2.0;147;4756;2873;1883;431;199;10.0
2780;Donderdag 21 maart 2002;579;289;290;431;188;243;273;262;5.0;6.0;30.0;25.0;1.0;4.0;128;4792;2878;1914;472;230;8.0
2781;Vrijdag 22 maart 2002;548;283;265;443;209;234;456;444;7.0;5.0;30.0;29.0;0.0;1.0;116;4836;2981;1855;346;160;9.0
2782;Zaterdag 23 maart 2002;488;237;251;386;184;202;92;92;0.0;0.0;0.0;0.0;0.0;0.0;0;1754;1248;506;4;75;1.0
2783;Zondag 24 maart 2002;457;227;230;434;220;214;9;9;0.0;0.0;0.0;0.0;0.0;0.0;0;180;128;52;4;50;1.0
2784;Maandag 25 maart 2002;586;294;292;400;198;202;152;147;3.0;2.0;50.0;47.0;1.0;2.0;140;5956;3702;2254;519;263;914.0
2785;Dinsdag 26 maart 2002;613;332;281;414;194;220;103;102;1.0;0.0;38.0;36.0;2.0;0.0;177;4459;2710;1749;519;236;10.0
2786;Woensdag 27 maart 2002;548;286;262;419;190;229;154;149;4.0;1.0;43.0;41.0;1.0;1.0;149;4476;2743;1733;479;264;252.0
2787;Donderdag 28 maart 2002;635;318;317;428;209;219;241;232;3.0;6.0;40.0;37.0;1.0;2.0;160;6717;4188;2529;476;287;496.0
2788;Vrijdag 29 maart 2002;540;283;257;439;214;225;66;65;0.0;1.0;1.0;1.0;0.0;0.0;17;2294;1480;814;48;147;2.0
2789;Zaterdag 30 maart 2002;477;247;230;408;210;198;67;66;0.0;1.0;0.0;0.0;0.0;0.0;0;1506;1027;479;3;55;0.0
2790;Zondag 31 maart 2002;437;222;215;395;212;183;11;11;0.0;0.0;0.0;0.0;0.0;0.0;0;658;496;162;0;90;0.0
2791;Totaal april 2002;15995;8217;7778;11968;5898;6070;6014;5863;76.0;75.0;667.0;616.0;24.0;27.0;2583;122987;76523;46464;9266;4723;2682.0
2792;Maandag 1 april 2002;455;226;229;421;215;206;23;22;1.0;0.0;0.0;0.0;0.0;0.0;3;11170;7566;3604;26;309;0.0
2793;Dinsdag 2 april 2002;571;298;273;366;187;179;185;177;5.0;3.0;32.0;32.0;0.0;0.0;136;9108;5461;3647;617;355;268.0
2794;Woensdag 3 april 2002;600;302;298;412;201;211;125;122;2.0;1.0;25.0;24.0;1.0;0.0;149;5608;3287;2321;560;223;16.0
2795;Donderdag 4 april 2002;643;329;314;409;190;219;214;206;5.0;3.0;36.0;33.0;1.0;2.0;141;5653;3315;2338;546;182;14.0
2796;Vrijdag 5 april 2002;581;302;279;417;217;200;520;511;5.0;4.0;27.0;24.0;3.0;0.0;111;5530;3249;2281;420;190;11.0
2797;Zaterdag 6 april 2002;467;239;228;390;179;211;105;103;2.0;0.0;0.0;0.0;0.0;0.0;0;984;691;293;7;47;3.0
2798;Zondag 7 april 2002;411;205;206;380;178;202;13;13;0.0;0.0;0.0;0.0;0.0;0.0;0;225;162;63;3;30;1.0
2799;Maandag 8 april 2002;543;266;277;407;199;208;197;190;3.0;4.0;40.0;36.0;2.0;2.0;133;5836;3545;2291;538;246;451.0
2800;Dinsdag 9 april 2002;615;322;293;426;208;218;114;112;0.0;2.0;35.0;31.0;1.0;3.0;139;4553;2707;1846;555;174;205.0
2801;Woensdag 10 april 2002;569;279;290;403;198;205;128;126;0.0;2.0;30.0;28.0;0.0;2.0;125;4507;2711;1796;431;190;18.0
2802;Donderdag 11 april 2002;589;342;247;400;194;206;160;157;2.0;1.0;37.0;35.0;1.0;1.0;168;4634;2825;1809;477;167;16.0
2803;Vrijdag 12 april 2002;547;274;273;429;203;226;502;494;4.0;4.0;27.0;26.0;0.0;1.0;132;4932;3038;1894;313;188;20.0
2804;Zaterdag 13 april 2002;435;209;226;439;220;219;68;65;2.0;1.0;0.0;0.0;0.0;0.0;0;923;664;259;3;30;1.0
2805;Zondag 14 april 2002;431;223;208;370;181;189;13;13;0.0;0.0;0.0;0.0;0.0;0.0;0;298;215;83;5;21;4.0
2806;Maandag 15 april 2002;515;276;239;419;187;232;163;160;2.0;1.0;38.0;37.0;0.0;1.0;121;8253;5361;2892;461;258;809.0
2807;Dinsdag 16 april 2002;574;306;268;392;185;207;125;121;2.0;2.0;40.0;36.0;1.0;3.0;160;4382;2631;1751;471;185;14.0
2808;Woensdag 17 april 2002;578;304;274;400;210;190;164;158;2.0;4.0;29.0;26.0;2.0;1.0;124;4366;2648;1718;461;178;104.0
2809;Donderdag 18 april 2002;551;259;292;401;199;202;187;185;1.0;1.0;26.0;25.0;1.0;0.0;119;4678;2821;1857;452;171;15.0
2810;Vrijdag 19 april 2002;513;273;240;392;175;217;609;599;4.0;6.0;19.0;16.0;3.0;0.0;111;4408;2773;1635;340;143;9.0
2811;Zaterdag 20 april 2002;459;239;220;410;209;201;148;144;3.0;1.0;1.0;1.0;0.0;0.0;1;1817;1279;538;10;31;0.0
2812;Zondag 21 april 2002;451;233;218;364;183;181;4;4;0.0;0.0;0.0;0.0;0.0;0.0;0;210;165;45;5;25;0.0
2813;Maandag 22 april 2002;568;287;281;390;202;188;205;197;3.0;5.0;47.0;44.0;1.0;2.0;124;5079;3117;1962;492;199;229.0
2814;Dinsdag 23 april 2002;584;316;268;401;190;211;139;133;3.0;3.0;49.0;45.0;3.0;1.0;135;4407;2784;1623;517;278;135.0
2815;Woensdag 24 april 2002;633;339;294;374;187;187;211;201;7.0;3.0;44.0;40.0;0.0;4.0;142;4199;2554;1645;499;164;299.0
2816;Donderdag 25 april 2002;570;267;303;426;218;208;318;310;3.0;5.0;39.0;37.0;2.0;0.0;146;5250;3268;1982;481;208;19.0
2817;Vrijdag 26 april 2002;541;268;273;409;217;192;924;905;8.0;11.0;27.0;25.0;0.0;2.0;122;5184;3121;2063;329;200;15.0
2818;Zaterdag 27 april 2002;431;241;190;393;201;192;181;176;3.0;2.0;0.0;0.0;0.0;0.0;1;1751;1196;555;2;66;0.0
2819;Zondag 28 april 2002;474;245;229;387;177;210;5;5;0.0;0.0;0.0;0.0;0.0;0.0;0;386;312;74;2;29;0.0
2820;Maandag 29 april 2002;573;288;285;362;193;169;232;222;4.0;6.0;19.0;15.0;2.0;2.0;40;3635;2327;1308;240;132;6.0
2821;Dinsdag 30 april 2002;523;260;263;379;195;184;32;32;0.0;0.0;0.0;0.0;0.0;0.0;0;1021;730;291;3;104;0.0
2822;Totaal mei 2002;16800;8529;8271;11623;5655;5968;11414;11166;119.0;129.0;684.0;632.0;25.0;27.0;2803;134162;84380;49782;8897;4839;2229.0
2823;Woensdag 1 mei 2002;545;279;266;373;185;188;192;186;2.0;4.0;30.0;27.0;2.0;1.0;140;20435;13225;7210;452;532;15.0
2824;Donderdag 2 mei 2002;591;290;301;404;202;202;353;338;7.0;8.0;40.0;39.0;1.0;0.0;141;7093;4373;2720;559;340;33.0
2825;Vrijdag 3 mei 2002;620;322;298;378;175;203;926;914;5.0;7.0;19.0;18.0;0.0;1.0;115;5772;3455;2317;392;213;703.0
2826;Zaterdag 4 mei 2002;486;231;255;385;199;186;47;47;0.0;0.0;0.0;0.0;0.0;0.0;1;778;551;227;6;42;1.0
2827;Zondag 5 mei 2002;452;205;247;357;175;182;13;13;0.0;0.0;0.0;0.0;0.0;0.0;0;260;188;72;3;31;0.0
2828;Maandag 6 mei 2002;574;293;281;344;164;180;240;230;6.0;4.0;52.0;47.0;2.0;3.0;124;6672;4097;2575;504;244;35.0
2829;Dinsdag 7 mei 2002;609;336;273;365;183;182;227;217;2.0;8.0;41.0;39.0;1.0;1.0;174;5012;2970;2042;451;178;24.0
2830;Woensdag 8 mei 2002;632;333;299;398;195;203;950;931;14.0;5.0;25.0;23.0;1.0;1.0;131;5315;3233;2082;403;190;11.0
2831;Donderdag 9 mei 2002;457;233;224;365;183;182;21;21;0.0;0.0;0.0;0.0;0.0;0.0;4;268;191;77;1;25;0.0
2832;Vrijdag 10 mei 2002;536;289;247;414;204;210;754;742;9.0;3.0;4.0;2.0;0.0;2.0;24;2147;1440;707;79;63;2.0
2833;Zaterdag 11 mei 2002;467;217;250;351;165;186;194;191;3.0;0.0;1.0;1.0;0.0;0.0;0;807;608;199;3;22;0.0
2834;Zondag 12 mei 2002;445;228;217;353;177;176;15;15;0.0;0.0;0.0;0.0;0.0;0.0;1;239;158;81;1;20;0.0
2835;Maandag 13 mei 2002;552;281;271;353;185;168;167;158;8.0;1.0;42.0;39.0;2.0;1.0;148;6648;4124;2524;539;220;10.0
2836;Dinsdag 14 mei 2002;630;313;317;356;183;173;193;186;1.0;6.0;38.0;37.0;0.0;1.0;148;4760;2880;1880;496;169;13.0
2837;Woensdag 15 mei 2002;619;298;321;394;190;204;169;163;1.0;5.0;12.0;9.0;2.0;1.0;136;7198;4707;2491;338;222;230.0
2838;Donderdag 16 mei 2002;580;285;295;380;174;206;383;375;3.0;5.0;39.0;37.0;0.0;2.0;118;5450;3376;2074;450;159;14.0
2839;Vrijdag 17 mei 2002;584;287;297;401;205;196;1267;1247;8.0;12.0;26.0;24.0;1.0;1.0;106;4924;3018;1906;365;143;490.0
2840;Zaterdag 18 mei 2002;508;236;272;397;207;190;228;222;3.0;3.0;0.0;0.0;0.0;0.0;1;1158;820;338;1;34;0.0
2841;Zondag 19 mei 2002;480;248;232;339;159;180;5;5;0.0;0.0;0.0;0.0;0.0;0.0;0;95;56;39;1;14;1.0
2842;Maandag 20 mei 2002;460;253;207;381;176;205;26;26;0.0;0.0;1.0;0.0;0.0;1.0;3;749;493;256;6;35;0.0
2843;Dinsdag 21 mei 2002;568;288;280;392;198;194;246;239;3.0;4.0;34.0;33.0;0.0;1.0;146;4949;3033;1916;580;216;180.0
2844;Woensdag 22 mei 2002;614;319;295;347;182;165;278;274;3.0;1.0;39.0;36.0;1.0;2.0;147;4644;2813;1831;447;146;17.0
2845;Donderdag 23 mei 2002;551;290;261;363;158;205;380;365;6.0;9.0;56.0;54.0;2.0;0.0;161;4994;3012;1982;450;164;17.0
2846;Vrijdag 24 mei 2002;547;284;263;364;177;187;1369;1344;13.0;12.0;23.0;19.0;1.0;3.0;147;4673;3010;1663;287;154;17.0
2847;Zaterdag 25 mei 2002;448;205;243;362;183;179;343;338;3.0;2.0;0.0;0.0;0.0;0.0;1;1906;1366;540;7;42;4.0
2848;Zondag 26 mei 2002;419;234;185;346;160;186;10;9;0.0;1.0;0.0;0.0;0.0;0.0;0;227;169;58;2;21;1.0
2849;Maandag 27 mei 2002;565;299;266;381;179;202;215;209;3.0;3.0;40.0;39.0;0.0;1.0;130;5622;3409;2213;448;258;26.0
2850;Dinsdag 28 mei 2002;593;288;305;390;187;203;211;202;5.0;4.0;25.0;21.0;2.0;2.0;151;4466;2828;1638;412;222;28.0
2851;Woensdag 29 mei 2002;567;297;270;360;168;192;217;212;1.0;4.0;37.0;35.0;1.0;1.0;135;4235;2539;1696;412;183;21.0
2852;Donderdag 30 mei 2002;539;286;253;415;184;231;400;394;3.0;3.0;31.0;29.0;2.0;0.0;152;5520;3520;2000;477;214;324.0
2853;Vrijdag 31 mei 2002;562;282;280;415;193;222;1375;1353;7.0;15.0;29.0;24.0;4.0;1.0;118;7146;4718;2428;325;323;12.0
2854;Totaal juni 2002;16116;8342;7774;11084;5476;5608;11252;11039;94.0;119.0;681.0;645.0;15.0;21.0;2767;123737;76774;46963;8832;5442;4931.0
2855;Zaterdag 1 juni 2002;447;217;230;349;178;171;366;352;8.0;6.0;0.0;0.0;0.0;0.0;1;13347;8901;4446;26;342;1.0
2856;Zondag 2 juni 2002;441;240;201;331;151;180;7;7;0.0;0.0;0.0;0.0;0.0;0.0;1;212;151;61;8;33;1.0
2857;Maandag 3 juni 2002;595;319;276;384;178;206;211;201;4.0;6.0;32.0;28.0;2.0;2.0;129;7438;4570;2868;507;255;62.0
2858;Dinsdag 4 juni 2002;612;327;285;414;207;207;191;185;2.0;4.0;36.0;34.0;1.0;1.0;150;4896;2865;2031;493;165;19.0
2859;Woensdag 5 juni 2002;595;325;270;365;169;196;223;216;1.0;6.0;36.0;35.0;0.0;1.0;139;4503;2667;1836;357;229;23.0
2860;Donderdag 6 juni 2002;562;288;274;379;197;182;495;491;3.0;1.0;26.0;23.0;1.0;2.0;134;4871;2963;1908;494;185;1203.0
2861;Vrijdag 7 juni 2002;556;296;260;413;196;217;1316;1299;5.0;12.0;21.0;20.0;0.0;1.0;143;4245;2586;1659;318;211;12.0
2862;Zaterdag 8 juni 2002;418;231;187;380;200;180;289;281;6.0;2.0;0.0;0.0;0.0;0.0;3;1107;767;340;2;45;0.0
2863;Zondag 9 juni 2002;430;212;218;323;180;143;11;11;0.0;0.0;0.0;0.0;0.0;0.0;1;132;78;54;2;28;0.0
2864;Maandag 10 juni 2002;521;280;241;342;159;183;193;187;3.0;3.0;46.0;42.0;2.0;2.0;147;6211;3817;2394;573;245;856.0
2865;Dinsdag 11 juni 2002;533;268;265;347;159;188;150;147;2.0;1.0;41.0;38.0;1.0;2.0;147;4223;2494;1729;483;172;19.0
2866;Woensdag 12 juni 2002;576;303;273;405;207;198;238;231;2.0;5.0;33.0;32.0;0.0;1.0;126;4276;2564;1712;390;179;20.0
2867;Donderdag 13 juni 2002;560;302;258;373;198;175;255;252;1.0;2.0;30.0;30.0;0.0;0.0;149;4621;2808;1813;434;200;292.0
2868;Vrijdag 14 juni 2002;586;290;296;380;199;181;1327;1308;8.0;11.0;24.0;22.0;0.0;2.0;114;5495;3478;2017;301;212;14.0
2869;Zaterdag 15 juni 2002;476;251;225;350;159;191;275;270;5.0;0.0;0.0;0.0;0.0;0.0;0;3237;2346;891;10;105;2.0
2870;Zondag 16 juni 2002;447;239;208;328;154;174;14;14;0.0;0.0;0.0;0.0;0.0;0.0;0;336;204;132;5;49;0.0
2871;Maandag 17 juni 2002;562;297;265;415;210;205;185;179;2.0;4.0;48.0;48.0;0.0;0.0;118;6050;3829;2221;581;277;15.0
2872;Dinsdag 18 juni 2002;595;284;311;387;204;183;168;164;1.0;3.0;36.0;34.0;1.0;1.0;129;4154;2424;1730;421;151;16.0
2873;Woensdag 19 juni 2002;593;309;284;391;199;192;205;199;5.0;1.0;37.0;36.0;0.0;1.0;161;4164;2475;1689;416;188;653.0
2874;Donderdag 20 juni 2002;604;294;310;394;185;209;436;428;1.0;7.0;35.0;34.0;1.0;0.0;148;4902;2966;1936;400;200;453.0
2875;Vrijdag 21 juni 2002;536;260;276;360;190;170;1646;1611;15.0;20.0;22.0;22.0;0.0;0.0;118;4624;2843;1781;325;168;21.0
2876;Zaterdag 22 juni 2002;464;255;209;389;199;190;326;323;3.0;0.0;0.0;0.0;0.0;0.0;1;1488;1094;394;9;66;0.0
2877;Zondag 23 juni 2002;464;243;221;329;171;158;11;11;0.0;0.0;0.0;0.0;0.0;0.0;0;236;147;89;5;40;0.0
2878;Maandag 24 juni 2002;609;301;308;351;171;180;240;236;1.0;3.0;47.0;43.0;1.0;3.0;136;5886;3616;2270;456;262;137.0
2879;Dinsdag 25 juni 2002;595;304;291;372;182;190;196;190;3.0;3.0;40.0;38.0;1.0;1.0;153;4619;2813;1806;456;250;261.0
2880;Woensdag 26 juni 2002;603;305;298;395;192;203;264;259;4.0;1.0;30.0;28.0;1.0;1.0;142;4534;2647;1887;462;283;18.0
2881;Donderdag 27 juni 2002;614;302;312;340;158;182;412;405;3.0;4.0;34.0;34.0;0.0;0.0;143;5073;3052;2021;523;292;815.0
2882;Vrijdag 28 juni 2002;601;331;270;392;196;196;1307;1292;5.0;10.0;26.0;24.0;2.0;0.0;134;6353;3901;2452;368;314;17.0
2883;Zaterdag 29 juni 2002;460;239;221;362;171;191;281;277;1.0;3.0;1.0;0.0;1.0;0.0;0;1365;933;432;4;105;1.0
2884;Zondag 30 juni 2002;461;230;231;344;157;187;14;13;0.0;1.0;0.0;0.0;0.0;0.0;0;1139;775;364;3;191;0.0
2885;Totaal juli 2002;18011;9213;8798;11509;5610;5899;7897;7762;64.0;71.0;690.0;639.0;29.0;22.0;2945;149158;88448;60710;11365;7481;2927.0
2886;Maandag 1 juli 2002;582;298;284;377;200;177;256;247;4.0;5.0;46.0;40.0;4.0;2.0;151;25825;16135;9690;665;920;146.0
2887;Dinsdag 2 juli 2002;638;322;316;358;184;174;174;170;1.0;3.0;40.0;35.0;2.0;3.0;153;5851;3404;2447;538;238;13.0
2888;Woensdag 3 juli 2002;609;305;304;355;189;166;190;187;2.0;1.0;35.0;31.0;2.0;2.0;127;5359;3098;2261;459;280;23.0
2889;Donderdag 4 juli 2002;642;343;299;369;178;191;344;336;2.0;6.0;23.0;23.0;0.0;0.0;144;5738;3252;2486;565;274;481.0
2890;Vrijdag 5 juli 2002;640;317;323;371;181;190;1054;1040;4.0;10.0;23.0;20.0;2.0;1.0;128;5411;3162;2249;447;359;155.0
2891;Zaterdag 6 juli 2002;456;233;223;377;193;184;211;203;5.0;3.0;0.0;0.0;0.0;0.0;1;1105;758;347;8;82;2.0
2892;Zondag 7 juli 2002;495;257;238;361;152;209;19;19;0.0;0.0;0.0;0.0;0.0;0.0;0;294;183;111;3;58;0.0
2893;Maandag 8 juli 2002;589;295;294;349;177;172;199;196;1.0;2.0;29.0;28.0;1.0;0.0;124;6565;3897;2668;544;332;540.0
2894;Dinsdag 9 juli 2002;667;340;327;398;195;203;186;186;0.0;0.0;39.0;36.0;2.0;1.0;137;4915;2809;2106;551;253;15.0
2895;Woensdag 10 juli 2002;641;319;322;330;158;172;222;220;0.0;2.0;34.0;33.0;0.0;1.0;147;5204;3072;2132;478;231;17.0
2896;Donderdag 11 juli 2002;593;299;294;370;197;173;266;261;3.0;2.0;36.0;34.0;2.0;0.0;141;4808;2744;2064;543;259;17.0
2897;Vrijdag 12 juli 2002;615;323;292;391;185;206;874;863;7.0;4.0;19.0;16.0;3.0;0.0;121;5091;3093;1998;461;330;10.0
2898;Zaterdag 13 juli 2002;503;271;232;358;173;185;132;129;2.0;1.0;1.0;1.0;0.0;0.0;1;1153;789;364;13;50;509.0
2899;Zondag 14 juli 2002;464;229;235;352;163;189;18;18;0.0;0.0;0.0;0.0;0.0;0.0;0;273;178;95;8;32;0.0
2900;Maandag 15 juli 2002;609;310;299;357;163;194;218;212;3.0;3.0;28.0;26.0;1.0;1.0;121;10143;6166;3977;559;381;13.0
2901;Dinsdag 16 juli 2002;642;338;304;347;180;167;210;201;6.0;3.0;44.0;44.0;0.0;0.0;155;4904;2830;2074;472;251;17.0
2902;Woensdag 17 juli 2002;651;333;318;378;197;181;213;206;3.0;4.0;27.0;26.0;1.0;0.0;113;4585;2673;1912;442;200;14.0
2903;Donderdag 18 juli 2002;566;294;272;353;168;185;225;222;1.0;2.0;31.0;30.0;0.0;1.0;113;4796;2873;1923;481;264;14.0
2904;Vrijdag 19 juli 2002;574;298;276;347;158;189;614;609;4.0;1.0;11.0;9.0;1.0;1.0;123;4711;2688;2023;440;221;12.0
2905;Zaterdag 20 juli 2002;453;228;225;349;184;165;161;160;1.0;0.0;0.0;0.0;0.0;0.0;1;1933;1290;643;9;87;0.0
2906;Zondag 21 juli 2002;443;241;202;369;181;188;23;23;0.0;0.0;0.0;0.0;0.0;0.0;0;241;152;89;1;33;0.0
2907;Maandag 22 juli 2002;623;320;303;381;182;199;253;249;0.0;4.0;40.0;37.0;0.0;3.0;127;6019;3507;2512;521;251;858.0
2908;Dinsdag 23 juli 2002;598;293;305;407;187;220;189;186;3.0;0.0;26.0;24.0;2.0;0.0;126;4519;2565;1954;453;222;13.0
2909;Woensdag 24 juli 2002;632;311;321;363;169;194;197;193;2.0;2.0;31.0;27.0;2.0;2.0;141;4482;2592;1890;480;225;14.0
2910;Donderdag 25 juli 2002;575;262;313;359;164;195;236;233;1.0;2.0;26.0;25.0;1.0;0.0;117;4774;2756;2018;386;255;11.0
2911;Vrijdag 26 juli 2002;593;319;274;383;187;196;430;420;5.0;5.0;8.0;8.0;0.0;0.0;121;4611;2654;1957;409;295;4.0
2912;Zaterdag 27 juli 2002;546;307;239;340;165;175;155;154;1.0;0.0;0.0;0.0;0.0;0.0;0;1274;770;504;3;85;0.0
2913;Zondag 28 juli 2002;481;254;227;379;202;177;23;23;0.0;0.0;0.0;0.0;0.0;0.0;1;292;190;102;1;48;0.0
2914;Maandag 29 juli 2002;633;316;317;419;185;234;211;209;0.0;2.0;31.0;29.0;2.0;0.0;101;5000;2874;2126;484;306;11.0
2915;Dinsdag 30 juli 2002;611;299;312;434;207;227;195;192;2.0;1.0;33.0;32.0;0.0;1.0;102;4118;2344;1774;475;231;9.0
2916;Woensdag 31 juli 2002;647;339;308;428;206;222;199;195;1.0;3.0;29.0;25.0;1.0;3.0;108;5164;2950;2214;466;428;9.0
2917;Totaal augustus 2002;17959;9232;8727;11134;5351;5783;10742;10563;88.0;91.0;719.0;678.0;22.0;19.0;2716;143116;80006;63110;13462;6991;4137.0
2918;Donderdag 1 augustus 2002;597;301;296;368;175;193;308;302;5.0;1.0;32.0;32.0;0.0;0.0;139;24205;14698;9507;496;933;4.0
2919;Vrijdag 2 augustus 2002;587;332;255;410;205;205;591;581;3.0;7.0;23.0;21.0;1.0;1.0;99;5267;2868;2399;501;258;8.0
2920;Zaterdag 3 augustus 2002;477;237;240;358;178;180;141;140;1.0;0.0;1.0;0.0;0.0;1.0;1;731;435;296;9;70;0.0
2921;Zondag 4 augustus 2002;440;224;216;375;182;193;25;25;0.0;0.0;0.0;0.0;0.0;0.0;1;154;91;63;8;30;0.0
2922;Maandag 5 augustus 2002;610;321;289;347;162;185;263;262;0.0;1.0;44.0;43.0;1.0;0.0;103;6774;3768;3006;943;278;6.0
2923;Dinsdag 6 augustus 2002;605;293;312;343;176;167;201;200;1.0;0.0;40.0;38.0;2.0;0.0;122;4718;2709;2009;727;208;9.0
2924;Woensdag 7 augustus 2002;617;322;295;361;161;200;207;205;1.0;1.0;30.0;27.0;2.0;1.0;105;4707;2506;2201;585;179;11.0
2925;Donderdag 8 augustus 2002;583;295;288;363;186;177;358;346;5.0;7.0;28.0;27.0;0.0;1.0;114;4983;2777;2206;552;231;14.0
2926;Vrijdag 9 augustus 2002;603;278;325;353;188;165;586;576;3.0;7.0;19.0;17.0;1.0;1.0;113;4421;2446;1975;435;252;11.0
2927;Zaterdag 10 augustus 2002;512;264;248;349;171;178;172;171;1.0;0.0;0.0;0.0;0.0;0.0;1;1383;876;507;3;58;0.0
2928;Zondag 11 augustus 2002;498;256;242;345;168;177;24;24;0.0;0.0;0.0;0.0;0.0;0.0;0;160;84;76;3;37;0.0
2929;Maandag 12 augustus 2002;628;327;301;346;176;170;243;235;6.0;2.0;35.0;34.0;1.0;0.0;127;6261;3481;2780;666;281;9.0
2930;Dinsdag 13 augustus 2002;636;331;305;335;159;176;171;169;1.0;1.0;39.0;36.0;1.0;2.0;134;4857;2599;2258;629;197;13.0
2931;Woensdag 14 augustus 2002;549;283;266;328;161;167;223;214;3.0;6.0;30.0;26.0;3.0;1.0;110;4484;2425;2059;540;204;16.0
2932;Donderdag 15 augustus 2002;631;320;311;372;172;200;284;282;0.0;2.0;41.0;37.0;2.0;2.0;126;8246;4694;3552;547;387;8.0
2933;Vrijdag 16 augustus 2002;658;350;308;357;163;194;960;952;2.0;6.0;19.0;19.0;0.0;0.0;113;5071;2688;2383;456;280;10.0
2934;Zaterdag 17 augustus 2002;497;270;227;395;181;214;223;223;0.0;0.0;0.0;0.0;0.0;0.0;1;956;594;362;4;32;1.0
2935;Zondag 18 augustus 2002;529;276;253;364;162;202;11;10;1.0;0.0;0.0;0.0;0.0;0.0;0;233;129;104;6;67;3.0
2936;Maandag 19 augustus 2002;627;317;310;412;178;234;252;244;2.0;6.0;49.0;46.0;2.0;1.0;111;5892;3144;2748;694;248;12.0
2937;Dinsdag 20 augustus 2002;659;339;320;383;181;202;221;214;5.0;2.0;41.0;39.0;1.0;1.0;123;4878;2570;2308;653;254;16.0
2938;Woensdag 21 augustus 2002;593;280;313;415;192;223;219;215;2.0;2.0;33.0;30.0;0.0;3.0;153;4248;2268;1980;681;191;14.0
2939;Donderdag 22 augustus 2002;583;326;257;372;191;181;428;422;4.0;2.0;29.0;28.0;0.0;1.0;126;4861;2618;2243;599;260;24.0
2940;Vrijdag 23 augustus 2002;614;319;295;371;156;215;1234;1210;11.0;13.0;22.0;21.0;1.0;0.0;126;4692;2571;2121;494;300;17.0
2941;Zaterdag 24 augustus 2002;489;238;251;355;165;190;309;305;1.0;3.0;0.0;0.0;0.0;0.0;0;1263;814;449;0;41;1.0
2942;Zondag 25 augustus 2002;469;222;247;316;161;155;16;14;2.0;0.0;0.0;0.0;0.0;0.0;1;417;235;182;7;64;0.0
2943;Maandag 26 augustus 2002;630;317;313;336;159;177;221;217;1.0;3.0;43.0;41.0;1.0;1.0;97;5774;3164;2610;681;319;15.0
2944;Dinsdag 27 augustus 2002;600;306;294;354;178;176;196;192;3.0;1.0;35.0;35.0;0.0;0.0;149;4848;2373;2475;706;289;1772.0
2945;Woensdag 28 augustus 2002;664;361;303;355;169;186;272;267;1.0;4.0;33.0;31.0;1.0;1.0;158;4897;2604;2293;649;265;1765.0
2946;Donderdag 29 augustus 2002;637;325;312;336;176;160;455;450;2.0;3.0;30.0;28.0;1.0;1.0;143;5136;2726;2410;672;270;367.0
2947;Vrijdag 30 augustus 2002;624;320;304;334;156;178;1568;1543;15.0;10.0;23.0;22.0;1.0;0.0;120;6843;3957;2886;511;365;11.0
2948;Zaterdag 31 augustus 2002;513;282;231;326;163;163;360;353;6.0;1.0;0.0;0.0;0.0;0.0;0;1756;1094;662;5;143;0.0
2949;Totaal september 2002;17586;9093;8493;10438;5036;5402;10478;10301;88.0;89.0;713.0;649.0;29.0;35.0;2644;134619;77339;57280;13042;6134;2913.0
2950;Zondag 1 september 2002;433;229;204;321;151;170;15;15;0.0;0.0;0.0;0.0;0.0;0.0;0;13896;8024;5872;69;562;0.0
2951;Maandag 2 september 2002;599;324;275;340;165;175;231;225;1.0;5.0;44.0;40.0;1.0;3.0;94;9326;5245;4081;764;385;304.0
2952;Dinsdag 3 september 2002;627;310;317;360;172;188;192;189;0.0;3.0;26.0;23.0;2.0;1.0;129;5887;3067;2820;817;294;17.0
2953;Woensdag 4 september 2002;610;315;295;380;165;215;280;275;3.0;2.0;39.0;35.0;1.0;3.0;128;5408;2888;2520;764;211;290.0
2954;Donderdag 5 september 2002;597;313;284;354;166;188;490;483;1.0;6.0;29.0;28.0;1.0;0.0;126;5856;3147;2709;577;264;149.0
2955;Vrijdag 6 september 2002;607;302;305;374;184;190;1586;1570;10.0;6.0;21.0;18.0;1.0;2.0;125;4847;2642;2205;493;224;315.0
2956;Zaterdag 7 september 2002;474;256;218;324;154;170;358;352;6.0;0.0;0.0;0.0;0.0;0.0;0;910;631;279;4;56;0.0
2957;Zondag 8 september 2002;506;270;236;337;162;175;11;11;0.0;0.0;0.0;0.0;0.0;0.0;0;197;119;78;13;27;1.0
2958;Maandag 9 september 2002;615;303;312;365;175;190;251;238;6.0;7.0;34.0;30.0;1.0;3.0;140;5964;3363;2601;631;210;14.0
2959;Dinsdag 10 september 2002;623;318;305;355;170;185;190;187;2.0;1.0;31.0;29.0;0.0;2.0;123;4950;2784;2166;685;255;351.0
2960;Woensdag 11 september 2002;591;313;278;330;159;171;149;148;1.0;0.0;31.0;29.0;1.0;1.0;104;4414;2315;2099;564;181;38.0
2961;Donderdag 12 september 2002;610;323;287;355;155;200;413;403;4.0;6.0;26.0;24.0;1.0;1.0;157;5245;2888;2357;617;209;19.0
2962;Vrijdag 13 september 2002;623;319;304;334;170;164;963;945;7.0;11.0;21.0;20.0;1.0;0.0;151;4602;2656;1946;483;190;15.0
2963;Zaterdag 14 september 2002;499;249;250;370;187;183;283;279;2.0;2.0;0.0;0.0;0.0;0.0;2;1096;776;320;8;31;0.0
2964;Zondag 15 september 2002;458;238;220;347;166;181;14;14;0.0;0.0;0.0;0.0;0.0;0.0;2;1812;1244;568;6;98;1.0
2965;Maandag 16 september 2002;623;299;324;342;164;178;197;189;4.0;4.0;37.0;33.0;0.0;4.0;120;7053;4146;2907;587;299;317.0
2966;Dinsdag 17 september 2002;669;362;307;362;178;184;145;143;2.0;0.0;36.0;31.0;3.0;2.0;123;4358;2447;1911;564;196;24.0
2967;Woensdag 18 september 2002;634;329;305;344;154;190;227;225;1.0;1.0;38.0;34.0;3.0;1.0;134;4436;2454;1982;556;166;21.0
2968;Donderdag 19 september 2002;626;320;306;314;160;154;363;362;1.0;0.0;31.0;30.0;0.0;1.0;112;4793;2708;2085;646;211;185.0
2969;Vrijdag 20 september 2002;583;285;298;299;149;150;1417;1404;4.0;9.0;26.0;21.0;3.0;2.0;125;5307;3118;2189;421;182;15.0
2970;Zaterdag 21 september 2002;524;281;243;350;172;178;279;275;4.0;0.0;1.0;0.0;1.0;0.0;0;1085;783;302;3;49;1.0
2971;Zondag 22 september 2002;518;277;241;361;160;201;9;8;1.0;0.0;0.0;0.0;0.0;0.0;0;218;160;58;3;29;1.0
2972;Maandag 23 september 2002;638;351;287;348;174;174;172;164;5.0;3.0;48.0;45.0;1.0;2.0;116;5708;3300;2408;912;265;312.0
2973;Dinsdag 24 september 2002;699;350;349;359;189;170;154;146;3.0;5.0;34.0;31.0;2.0;1.0;131;4179;2318;1861;483;195;17.0
2974;Woensdag 25 september 2002;660;356;304;340;166;174;207;202;2.0;3.0;38.0;36.0;2.0;0.0;113;4478;2706;1772;655;286;21.0
2975;Donderdag 26 september 2002;692;373;319;319;144;175;326;321;2.0;3.0;34.0;32.0;1.0;1.0;137;4894;2918;1976;691;247;185.0
2976;Vrijdag 27 september 2002;594;307;287;380;193;187;1132;1112;10.0;10.0;25.0;24.0;1.0;0.0;113;4878;2951;1927;409;297;283.0
2977;Zaterdag 28 september 2002;527;267;260;344;163;181;220;218;1.0;1.0;0.0;0.0;0.0;0.0;0;1369;987;382;9;67;1.0
2978;Zondag 29 september 2002;461;233;228;344;175;169;7;7;0.0;0.0;0.0;0.0;0.0;0.0;0;281;189;92;4;37;2.0
2979;Maandag 30 september 2002;666;321;345;386;194;192;197;191;5.0;1.0;63.0;56.0;2.0;5.0;139;7172;4365;2807;604;411;14.0
2980;Totaal oktober 2002;17831;9242;8589;11530;5644;5886;6643;6506;78.0;59.0;804.0;763.0;20.0;21.0;2956;138345;83610;54735;11594;5779;3548.0
2981;Dinsdag 1 oktober 2002;677;349;328;359;167;192;175;169;3.0;3.0;30.0;28.0;2.0;0.0;137;21156;13437;7719;611;698;12.0
2982;Woensdag 2 oktober 2002;615;322;293;360;190;170;177;168;7.0;2.0;29.0;27.0;1.0;1.0;144;5240;2982;2258;571;200;648.0
2983;Donderdag 3 oktober 2002;658;347;311;378;207;171;201;200;1.0;0.0;36.0;31.0;3.0;2.0;130;5071;2831;2240;588;277;9.0
2984;Vrijdag 4 oktober 2002;647;320;327;368;193;175;771;763;4.0;4.0;20.0;18.0;0.0;2.0;122;4827;2836;1991;471;279;8.0
2985;Zaterdag 5 oktober 2002;500;256;244;367;178;189;173;172;1.0;0.0;1.0;1.0;0.0;0.0;1;935;646;289;3;46;1.0
2986;Zondag 6 oktober 2002;463;239;224;339;162;177;10;10;0.0;0.0;0.0;0.0;0.0;0.0;0;166;106;60;0;40;1.0
2987;Maandag 7 oktober 2002;628;305;323;337;170;167;150;144;2.0;4.0;49.0;48.0;0.0;1.0;107;5572;3226;2346;499;278;14.0
2988;Dinsdag 8 oktober 2002;636;310;326;358;180;178;145;137;2.0;6.0;34.0;31.0;1.0;2.0;113;4614;2604;2010;630;181;13.0
2989;Woensdag 9 oktober 2002;632;332;300;407;207;200;135;133;1.0;1.0;33.0;32.0;1.0;0.0;154;4357;2540;1817;538;161;385.0
2990;Donderdag 10 oktober 2002;663;346;317;342;170;172;395;390;3.0;2.0;33.0;31.0;0.0;2.0;154;5433;3188;2245;576;166;246.0
2991;Vrijdag 11 oktober 2002;612;323;289;370;196;174;739;727;6.0;6.0;26.0;25.0;0.0;1.0;105;4512;2790;1722;375;183;17.0
2992;Zaterdag 12 oktober 2002;470;256;214;372;204;168;139;136;3.0;0.0;1.0;1.0;0.0;0.0;0;1219;848;371;4;46;0.0
2993;Zondag 13 oktober 2002;511;271;240;332;149;183;7;7;0.0;0.0;0.0;0.0;0.0;0.0;0;185;149;36;2;39;0.0
2994;Maandag 14 oktober 2002;562;305;257;372;173;199;143;141;1.0;1.0;55.0;52.0;2.0;1.0;137;5681;3394;2287;550;262;483.0
2995;Dinsdag 15 oktober 2002;588;301;287;381;168;213;147;143;1.0;3.0;31.0;30.0;1.0;0.0;121;6755;4239;2516;573;230;17.0
2996;Woensdag 16 oktober 2002;610;319;291;371;175;196;170;164;3.0;3.0;32.0;32.0;0.0;0.0;129;4962;2925;2037;650;185;414.0
2997;Donderdag 17 oktober 2002;594;310;284;373;183;190;229;224;4.0;1.0;36.0;33.0;2.0;1.0;138;4819;2862;1957;538;233;13.0
2998;Vrijdag 18 oktober 2002;619;301;318;376;175;201;701;685;7.0;9.0;30.0;29.0;0.0;1.0;123;4744;2862;1882;327;169;22.0
2999;Zaterdag 19 oktober 2002;493;251;242;378;184;194;128;126;2.0;0.0;1.0;0.0;1.0;0.0;1;1102;765;337;8;32;0.0
3000;Zondag 20 oktober 2002;406;229;177;355;170;185;8;7;0.0;1.0;0.0;0.0;0.0;0.0;0;591;414;177;4;33;0.0
3001;Maandag 21 oktober 2002;563;281;282;404;208;196;156;153;3.0;0.0;37.0;34.0;1.0;2.0;98;5521;3304;2217;517;195;285.0
3002;Dinsdag 22 oktober 2002;615;312;303;387;198;189;170;166;3.0;1.0;46.0;45.0;0.0;1.0;110;4515;2643;1872;484;203;10.0
3003;Woensdag 23 oktober 2002;627;315;312;372;175;197;153;151;1.0;1.0;35.0;35.0;0.0;0.0;137;4437;2494;1943;443;203;12.0
3004;Donderdag 24 oktober 2002;618;297;321;374;164;210;190;185;2.0;3.0;22.0;21.0;1.0;0.0;130;4686;2821;1865;478;203;198.0
3005;Vrijdag 25 oktober 2002;586;333;253;416;212;204;563;555;5.0;3.0;22.0;22.0;0.0;0.0;127;5036;3087;1949;286;181;17.0
3006;Zaterdag 26 oktober 2002;459;254;205;375;172;203;99;98;1.0;0.0;0.0;0.0;0.0;0.0;0;1585;1114;471;4;68;0.0
3007;Zondag 27 oktober 2002;493;259;234;384;194;190;7;7;0.0;0.0;0.0;0.0;0.0;0.0;0;239;157;82;2;21;1.0
3008;Maandag 28 oktober 2002;571;292;279;368;162;206;146;139;4.0;3.0;40.0;35.0;2.0;3.0;133;5583;3275;2308;496;236;479.0
3009;Dinsdag 29 oktober 2002;596;316;280;400;209;191;110;109;1.0;0.0;52.0;51.0;1.0;0.0;123;4103;2411;1692;509;205;13.0
3010;Woensdag 30 oktober 2002;562;289;273;386;189;197;133;127;4.0;2.0;38.0;38.0;0.0;0.0;142;4761;2987;1774;429;238;216.0
3011;Donderdag 31 oktober 2002;557;302;255;369;160;209;173;170;3.0;0.0;35.0;33.0;1.0;1.0;140;5938;3673;2265;428;288;14.0
3012;Totaal november 2002;16011;8131;7880;11491;5531;5960;4371;4242;67.0;62.0;762.0;717.0;22.0;23.0;2598;130395;79928;50467;8188;4974;3845.0
3013;Vrijdag 1 november 2002;574;288;286;418;192;226;462;447;9.0;6.0;32.0;32.0;0.0;0.0;105;20976;13317;7659;372;631;12.0
3014;Zaterdag 2 november 2002;460;226;234;383;176;207;94;93;1.0;0.0;0.0;0.0;0.0;0.0;1;809;542;267;3;40;0.0
3015;Zondag 3 november 2002;424;221;203;357;166;191;6;6;0.0;0.0;0.0;0.0;0.0;0.0;0;146;83;63;3;39;2.0
3016;Maandag 4 november 2002;580;288;292;371;173;198;138;135;2.0;1.0;25.0;21.0;2.0;2.0;107;6376;3751;2625;428;287;425.0
3017;Dinsdag 5 november 2002;608;319;289;381;172;209;110;104;4.0;2.0;33.0;33.0;0.0;0.0;139;5152;3024;2128;533;211;34.0
3018;Woensdag 6 november 2002;578;294;284;357;181;176;110;105;4.0;1.0;34.0;32.0;1.0;1.0;153;4667;2718;1949;448;157;264.0
3019;Donderdag 7 november 2002;580;284;296;406;204;202;128;126;0.0;2.0;29.0;28.0;0.0;1.0;134;4851;2793;2058;446;172;301.0
3020;Vrijdag 8 november 2002;554;281;273;395;196;199;332;330;1.0;1.0;29.0;28.0;0.0;1.0;113;4618;2740;1878;301;191;13.0
3021;Zaterdag 9 november 2002;480;254;226;385;180;205;59;59;0.0;0.0;1.0;1.0;0.0;0.0;0;920;668;252;2;26;0.0
3022;Zondag 10 november 2002;472;233;239;371;177;194;8;8;0.0;0.0;0.0;0.0;0.0;0.0;0;396;286;110;2;47;0.0
3023;Maandag 11 november 2002;567;281;286;387;207;180;205;198;4.0;3.0;70.0;66.0;0.0;4.0;110;5576;3370;2206;477;210;287.0
3024;Dinsdag 12 november 2002;585;293;292;376;186;190;115;106;5.0;4.0;34.0;33.0;0.0;1.0;136;4230;2564;1666;415;169;124.0
3025;Woensdag 13 november 2002;558;273;285;400;203;197;83;81;0.0;2.0;32.0;32.0;0.0;0.0;131;4237;2410;1827;433;138;618.0
3026;Donderdag 14 november 2002;588;301;287;362;178;184;146;142;1.0;3.0;31.0;31.0;0.0;0.0;126;5066;3037;2029;386;170;236.0
3027;Vrijdag 15 november 2002;547;289;258;391;186;205;362;356;3.0;3.0;18.0;17.0;1.0;0.0;108;7387;4789;2598;282;222;20.0
3028;Zaterdag 16 november 2002;480;249;231;373;175;198;53;51;2.0;0.0;1.0;1.0;0.0;0.0;0;1268;906;362;2;23;1.0
3029;Zondag 17 november 2002;434;213;221;348;168;180;0;0;0.0;0.0;0.0;0.0;0.0;0.0;0;162;105;57;5;34;2.0
3030;Maandag 18 november 2002;543;301;242;375;180;195;133;130;3.0;0.0;46.0;42.0;3.0;1.0;116;5901;3583;2318;410;187;451.0
3031;Dinsdag 19 november 2002;553;287;266;374;182;192;109;106;1.0;2.0;45.0;43.0;1.0;1.0;144;4411;2585;1826;372;173;15.0
3032;Woensdag 20 november 2002;580;275;305;434;220;214;140;132;4.0;4.0;39.0;38.0;1.0;0.0;133;4629;2708;1921;393;161;20.0
3033;Donderdag 21 november 2002;573;299;274;408;193;215;138;135;1.0;2.0;34.0;32.0;0.0;2.0;118;4710;2733;1977;371;198;241.0
3034;Vrijdag 22 november 2002;559;296;263;400;191;209;439;430;5.0;4.0;27.0;21.0;3.0;3.0;87;4642;2856;1786;283;166;16.0
3035;Zaterdag 23 november 2002;419;190;229;378;173;205;53;52;1.0;0.0;2.0;2.0;0.0;0.0;2;1537;1072;465;2;41;1.0
3036;Zondag 24 november 2002;408;191;217;351;173;178;3;3;0.0;0.0;0.0;0.0;0.0;0.0;0;222;155;67;4;22;4.0
3037;Maandag 25 november 2002;543;266;277;369;171;198;150;140;7.0;3.0;45.0;41.0;2.0;2.0;128;5648;3482;2166;380;240;571.0
3038;Dinsdag 26 november 2002;590;314;276;348;166;182;123;117;1.0;5.0;37.0;31.0;4.0;2.0;148;4211;2548;1663;449;159;10.0
3039;Woensdag 27 november 2002;585;297;288;406;201;205;107;103;2.0;2.0;43.0;41.0;1.0;1.0;131;4314;2536;1778;339;216;12.0
3040;Donderdag 28 november 2002;568;303;265;411;194;217;145;138;1.0;6.0;47.0;45.0;1.0;1.0;124;5229;3244;1985;369;243;16.0
3041;Vrijdag 29 november 2002;573;278;295;401;197;204;364;354;5.0;5.0;28.0;26.0;2.0;0.0;104;5966;3770;2196;274;283;149.0
3042;Zaterdag 30 november 2002;448;247;201;375;170;205;56;55;0.0;1.0;0.0;0.0;0.0;0.0;0;2138;1553;585;4;118;0.0
3043;Totaal december 2002;16515;8453;8062;13093;6342;6751;4417;4312;56.0;49.0;724.0;674.0;23.0;27.0;2171;125616;77700;47916;6780;5331;5829.0
3044;Zondag 1 december 2002;449;202;247;386;201;185;3;2;1.0;0.0;0.0;0.0;0.0;0.0;0;11612;7948;3664;17;241;0.0
3045;Maandag 2 december 2002;523;244;279;353;180;173;152;148;2.0;2.0;54.0;47.0;3.0;4.0;107;8545;5235;3310;365;262;16.0
3046;Dinsdag 3 december 2002;581;284;297;382;201;181;104;98;3.0;3.0;42.0;40.0;1.0;1.0;141;5257;3111;2146;358;229;1312.0
3047;Woensdag 4 december 2002;564;280;284;384;188;196;102;96;3.0;3.0;41.0;40.0;0.0;1.0;125;4718;2689;2029;398;176;20.0
3048;Donderdag 5 december 2002;493;250;243;386;180;206;64;61;2.0;1.0;24.0;23.0;0.0;1.0;117;4329;2587;1742;331;196;175.0
3049;Vrijdag 6 december 2002;563;291;272;374;173;201;267;262;4.0;1.0;27.0;27.0;0.0;0.0;108;4933;3041;1892;290;223;600.0
3050;Zaterdag 7 december 2002;411;209;202;417;220;197;65;63;0.0;2.0;0.0;0.0;0.0;0.0;0;1108;793;315;5;24;0.0
3051;Zondag 8 december 2002;426;234;192;380;204;176;5;5;0.0;0.0;0.0;0.0;0.0;0.0;0;175;134;41;4;34;0.0
3052;Maandag 9 december 2002;589;306;283;435;235;200;148;144;2.0;2.0;43.0;41.0;1.0;1.0;112;5486;3400;2086;362;228;13.0
3053;Dinsdag 10 december 2002;561;301;260;432;214;218;147;145;2.0;0.0;43.0;41.0;1.0;1.0;119;4789;2968;1821;369;179;266.0
3054;Woensdag 11 december 2002;614;291;323;398;189;209;133;132;1.0;0.0;33.0;31.0;2.0;0.0;125;4250;2382;1868;374;138;15.0
3055;Donderdag 12 december 2002;636;322;314;452;211;241;314;307;3.0;4.0;41.0;39.0;2.0;0.0;128;5307;3181;2126;428;242;344.0
3056;Vrijdag 13 december 2002;529;260;269;425;201;224;275;269;3.0;3.0;19.0;18.0;1.0;0.0;119;4686;2893;1793;274;197;11.0
3057;Zaterdag 14 december 2002;464;231;233;432;204;228;104;104;0.0;0.0;1.0;0.0;0.0;1.0;0;1871;1326;545;2;47;0.0
3058;Zondag 15 december 2002;456;241;215;437;213;224;4;4;0.0;0.0;0.0;0.0;0.0;0.0;0;2207;1549;658;2;59;1.0
3059;Maandag 16 december 2002;562;311;251;433;206;227;162;155;3.0;4.0;39.0;38.0;0.0;1.0;113;7534;4745;2789;381;325;3.0
3060;Dinsdag 17 december 2002;598;293;305;419;170;249;151;144;3.0;4.0;42.0;39.0;2.0;1.0;104;4692;2758;1934;388;204;3.0
3061;Woensdag 18 december 2002;653;340;313;438;215;223;186;183;3.0;0.0;37.0;32.0;2.0;3.0;110;4846;2966;1880;362;229;8.0
3062;Donderdag 19 december 2002;664;356;308;420;196;224;215;211;1.0;3.0;36.0;32.0;1.0;3.0;113;5010;3005;2005;455;258;448.0
3063;Vrijdag 20 december 2002;608;302;306;443;208;235;685;672;7.0;6.0;45.0;39.0;3.0;3.0;109;6842;4246;2596;283;272;1030.0
3064;Zaterdag 21 december 2002;436;232;204;435;202;233;154;152;1.0;1.0;1.0;1.0;0.0;0.0;0;1733;1140;593;2;68;1.0
3065;Zondag 22 december 2002;441;227;214;435;219;216;7;7;0.0;0.0;0.0;0.0;0.0;0.0;0;271;183;88;1;63;0.0
3066;Maandag 23 december 2002;591;312;279;456;216;240;273;270;1.0;2.0;54.0;51.0;2.0;1.0;131;6975;4119;2856;445;315;70.0
3067;Dinsdag 24 december 2002;585;291;294;446;222;224;213;205;6.0;2.0;37.0;35.0;0.0;2.0;98;4079;2521;1558;252;148;1427.0
3068;Woensdag 25 december 2002;463;255;208;418;185;233;8;8;0.0;0.0;0.0;0.0;0.0;0.0;1;164;96;68;4;28;8.0
3069;Donderdag 26 december 2002;439;221;218;474;239;235;12;12;0.0;0.0;0.0;0.0;0.0;0.0;1;62;40;22;2;33;8.0
3070;Vrijdag 27 december 2002;547;279;268;486;253;233;112;111;0.0;1.0;6.0;6.0;0.0;0.0;16;1680;1077;603;49;97;10.0
3071;Zaterdag 28 december 2002;485;255;230;414;194;220;66;64;0.0;2.0;0.0;0.0;0.0;0.0;0;849;553;296;1;74;5.0
3072;Zondag 29 december 2002;496;257;239;433;188;245;2;2;0.0;0.0;0.0;0.0;0.0;0.0;0;170;95;75;3;23;1.0
3073;Maandag 30 december 2002;598;309;289;439;213;226;148;146;2.0;0.0;39.0;37.0;1.0;1.0;83;6969;4267;2702;387;314;18.0
3074;Dinsdag 31 december 2002;490;267;223;431;202;229;136;130;3.0;3.0;20.0;17.0;1.0;2.0;91;4467;2652;1815;186;405;16.0
3075;Totaal op zondag in 2002;23514;12127;11387;19373;9340;10033;545;536;5.0;4.0;0.0;0.0;0.0;0.0;15;42784;27739;15045;292;2860;45.0
3076;Totaal op maandag in 2002;30166;15532;14634;20353;9931;10422;9185;8907;141.0;137.0;2084.0;1934.0;68.0;82.0;6416;346270;209461;136809;26910;13845;12327.0
3077;Totaal op dinsdag in 2002;31849;16340;15509;20836;10098;10738;7931;7704;115.0;112.0;1858.0;1745.0;58.0;55.0;7018;274295;163003;111292;25916;11798;10446.0
3078;Totaal op woensdag in 2002;31097;15913;15184;20355;9871;10484;10008;9725;149.0;134.0;1632.0;1527.0;50.0;55.0;6850;257356;151875;105481;24276;10733;7489.0
3079;Totaal op donderdag in 2002;30740;15727;15013;20494;9840;10654;13063;12778;130.0;155.0;1574.0;1489.0;45.0;40.0;6769;284880;169378;115502;25081;12088;9061.0
3080;Totaal op vrijdag in 2002;30266;15508;14758;20714;10119;10595;36962;36344;297.0;321.0;1158.0;1069.0;45.0;44.0;6074;310477;190585;119892;18506;12363;5405.0
3081;Totaal op Zaterdag in 2002;24451;12587;11864;20230;9799;10431;8114;7976;98.0;40.0;15.0;10.0;3.0;2.0;37;79864;54938;24926;269;3041;548.0
3082;Totaal 2003;200297;102870;97427;141936;69012;72924;80427;78928;735.0;764.0;10119.0;9577.0;262.0;280.0;31479;1566511;950321;616190;104514;68885;28799.0
3083;Totaal januari 2003;17153;8874;8279;13106;6315;6791;3111;3039;45.0;27.0;756.0;725.0;12.0;19.0;2994;142812;86784;56028;9483;5608;996.0
3084;Woensdag 1 januari 2003;422;222;200;422;203;219;8;8;0.0;0.0;0.0;0.0;0.0;0.0;0;9681;6147;3534;59;389;0.0
3085;Donderdag 2 januari 2003;581;283;298;447;210;237;90;87;3.0;0.0;14.0;14.0;0.0;0.0;88;7825;4698;3127;461;357;23.0
3086;Vrijdag 3 januari 2003;633;351;282;482;258;224;173;170;3.0;0.0;25.0;22.0;1.0;2.0;101;6598;3803;2795;377;278;16.0
3087;Zaterdag 4 januari 2003;484;251;233;403;198;205;38;38;0.0;0.0;0.0;0.0;0.0;0.0;0;554;346;208;2;62;0.0
3088;Zondag 5 januari 2003;474;238;236;387;185;202;11;11;0.0;0.0;1.0;1.0;0.0;0.0;0;356;252;104;5;65;1.0
3089;Maandag 6 januari 2003;591;299;292;413;206;207;158;156;1.0;1.0;33.0;33.0;0.0;0.0;102;7765;4559;3206;548;279;11.0
3090;Dinsdag 7 januari 2003;618;327;291;434;223;211;120;114;4.0;2.0;39.0;39.0;0.0;0.0;153;6123;3577;2546;514;220;13.0
3091;Woensdag 8 januari 2003;586;313;273;428;214;214;111;109;0.0;2.0;42.0;40.0;1.0;1.0;144;5605;3134;2471;479;181;15.0
3092;Donderdag 9 januari 2003;581;295;286;409;173;236;106;105;0.0;1.0;41.0;39.0;1.0;1.0;130;6165;3684;2481;471;199;326.0
3093;Vrijdag 10 januari 2003;587;311;276;439;203;236;178;173;3.0;2.0;31.0;29.0;1.0;1.0;127;5766;3514;2252;373;210;12.0
3094;Zaterdag 11 januari 2003;456;235;221;458;228;230;50;50;0.0;0.0;0.0;0.0;0.0;0.0;2;895;647;248;3;34;2.0
3095;Zondag 12 januari 2003;431;219;212;406;194;212;8;8;0.0;0.0;0.0;0.0;0.0;0.0;0;236;163;73;5;36;2.0
3096;Maandag 13 januari 2003;583;297;286;437;213;224;98;96;2.0;0.0;43.0;41.0;0.0;2.0;151;6325;3906;2419;416;241;18.0
3097;Dinsdag 14 januari 2003;557;308;249;438;208;230;109;107;1.0;1.0;37.0;37.0;0.0;0.0;150;5210;3124;2086;422;190;283.0
3098;Woensdag 15 januari 2003;606;317;289;400;188;212;100;93;2.0;5.0;30.0;28.0;1.0;1.0;163;7797;4874;2923;421;233;14.0
3099;Donderdag 16 januari 2003;625;318;307;445;222;223;118;117;0.0;1.0;38.0;35.0;0.0;3.0;121;6085;3691;2394;445;192;20.0
3100;Vrijdag 17 januari 2003;597;329;268;412;185;227;226;225;0.0;1.0;29.0;28.0;1.0;0.0;135;4805;2871;1934;344;187;15.0
3101;Zaterdag 18 januari 2003;443;230;213;434;216;218;54;54;0.0;0.0;0.0;0.0;0.0;0.0;4;1041;747;294;5;29;3.0
3102;Zondag 19 januari 2003;436;218;218;415;207;208;12;11;1.0;0.0;0.0;0.0;0.0;0.0;0;125;78;47;3;32;0.0
3103;Maandag 20 januari 2003;606;297;309;453;212;241;114;111;3.0;0.0;42.0;38.0;1.0;3.0;172;6470;4064;2406;441;193;17.0
3104;Dinsdag 21 januari 2003;620;312;308;436;215;221;84;83;1.0;0.0;42.0;41.0;1.0;0.0;140;4646;2796;1850;414;168;16.0
3105;Woensdag 22 januari 2003;562;281;281;459;213;246;70;67;2.0;1.0;21.0;21.0;0.0;0.0;115;4404;2610;1794;313;153;13.0
3106;Donderdag 23 januari 2003;553;287;266;396;178;218;88;84;1.0;3.0;31.0;29.0;1.0;1.0;118;5185;3093;2092;479;212;21.0
3107;Vrijdag 24 januari 2003;554;293;261;395;171;224;237;228;6.0;3.0;25.0;24.0;1.0;0.0;129;4721;2946;1775;294;220;51.0
3108;Zaterdag 25 januari 2003;480;263;217;434;212;222;62;61;1.0;0.0;1.0;0.0;1.0;0.0;0;1702;1200;502;1;42;2.0
3109;Zondag 26 januari 2003;497;253;244;390;197;193;7;7;0.0;0.0;0.0;0.0;0.0;0.0;0;206;142;64;2;37;2.0
3110;Maandag 27 januari 2003;571;297;274;374;173;201;130;127;2.0;1.0;61.0;58.0;0.0;3.0;154;5612;3380;2232;479;240;13.0
3111;Dinsdag 28 januari 2003;635;323;312;421;200;221;114;110;4.0;0.0;42.0;41.0;1.0;0.0;176;4490;2569;1921;422;164;24.0
3112;Woensdag 29 januari 2003;603;309;294;412;201;211;96;95;1.0;0.0;30.0;30.0;0.0;0.0;125;4451;2597;1854;465;166;16.0
3113;Donderdag 30 januari 2003;614;316;298;431;217;214;113;110;1.0;2.0;29.0;29.0;0.0;0.0;152;5263;3220;2043;480;268;24.0
3114;Vrijdag 31 januari 2003;567;282;285;396;192;204;228;224;3.0;1.0;29.0;28.0;0.0;1.0;142;6705;4352;2353;340;331;23.0
3115;Totaal februari 2003;15579;7891;7688;11305;5510;5795;3995;3894;52.0;49.0;750.0;723.0;12.0;15.0;2645;119970;74105;45865;8169;4665;6103.0
3116;Zaterdag 1 februari 2003;468;218;250;380;177;203;223;220;2.0;1.0;2.0;2.0;0.0;0.0;0;12051;7950;4101;17;317;2.0
3117;Zondag 2 februari 2003;435;237;198;407;196;211;7;6;1.0;0.0;0.0;0.0;0.0;0.0;0;158;110;48;5;45;0.0
3118;Maandag 3 februari 2003;622;327;295;403;208;195;127;123;1.0;3.0;49.0;48.0;1.0;0.0;94;7328;4453;2875;485;269;227.0
3119;Dinsdag 4 februari 2003;634;330;304;382;210;172;108;106;1.0;1.0;46.0;44.0;1.0;1.0;111;4911;2881;2030;440;186;716.0
3120;Woensdag 5 februari 2003;611;305;306;395;199;196;100;98;2.0;0.0;34.0;33.0;0.0;1.0;136;4657;2756;1901;473;171;614.0
3121;Donderdag 6 februari 2003;566;285;281;378;184;194;120;119;0.0;1.0;32.0;31.0;1.0;0.0;150;4908;2831;2077;442;236;989.0
3122;Vrijdag 7 februari 2003;585;294;291;428;203;225;221;215;3.0;3.0;18.0;16.0;2.0;0.0;104;4672;2865;1807;337;169;622.0
3123;Zaterdag 8 februari 2003;480;243;237;414;201;213;54;54;0.0;0.0;0.0;0.0;0.0;0.0;3;891;605;286;4;35;1.0
3124;Zondag 9 februari 2003;472;219;253;345;168;177;8;7;1.0;0.0;0.0;0.0;0.0;0.0;0;125;79;46;7;33;0.0
3125;Maandag 10 februari 2003;573;278;295;362;173;189;125;122;1.0;2.0;52.0;52.0;0.0;0.0;127;5634;3460;2174;389;213;12.0
3126;Dinsdag 11 februari 2003;648;324;324;394;202;192;123;116;4.0;3.0;50.0;50.0;0.0;0.0;149;4315;2596;1719;419;203;11.0
3127;Woensdag 12 februari 2003;589;308;281;387;183;204;108;103;2.0;3.0;37.0;36.0;0.0;1.0;134;4224;2564;1660;407;162;12.0
3128;Donderdag 13 februari 2003;565;296;269;408;187;221;75;72;1.0;2.0;26.0;26.0;0.0;0.0;143;4261;2571;1690;440;137;11.0
3129;Vrijdag 14 februari 2003;597;299;298;449;216;233;763;747;6.0;10.0;27.0;24.0;2.0;1.0;130;5494;3397;2097;305;190;10.0
3130;Zaterdag 15 februari 2003;456;236;220;388;195;193;66;65;1.0;0.0;1.0;1.0;0.0;0.0;0;2566;1800;766;3;50;2.0
3131;Zondag 16 februari 2003;428;210;218;348;163;185;11;11;0.0;0.0;0.0;0.0;0.0;0.0;1;254;161;93;1;24;0.0
3132;Maandag 17 februari 2003;596;304;292;399;198;201;149;146;1.0;2.0;47.0;44.0;2.0;1.0;147;5865;3585;2280;444;235;14.0
3133;Dinsdag 18 februari 2003;600;305;295;395;200;195;141;136;3.0;2.0;38.0;36.0;0.0;2.0;136;4167;2572;1595;360;175;12.0
3134;Woensdag 19 februari 2003;640;316;324;417;208;209;135;135;0.0;0.0;33.0;32.0;1.0;0.0;115;4129;2390;1739;391;138;11.0
3135;Donderdag 20 februari 2003;592;304;288;410;198;212;161;151;5.0;5.0;35.0;34.0;0.0;1.0;161;5322;3208;2114;393;197;17.0
3136;Vrijdag 21 februari 2003;567;270;297;447;241;206;305;300;3.0;2.0;24.0;22.0;1.0;1.0;137;4671;2875;1796;428;189;12.0
3137;Zaterdag 22 februari 2003;462;237;225;433;192;241;65;64;1.0;0.0;0.0;0.0;0.0;0.0;1;1599;1159;440;9;50;0.0
3138;Zondag 23 februari 2003;446;237;209;422;217;205;7;7;0.0;0.0;0.0;0.0;0.0;0.0;1;239;175;64;0;30;1.0
3139;Maandag 24 februari 2003;591;315;276;423;182;241;139;135;2.0;2.0;57.0;55.0;0.0;2.0;131;5695;3511;2184;488;237;2108.0
3140;Dinsdag 25 februari 2003;611;309;302;423;196;227;137;134;2.0;1.0;50.0;49.0;0.0;1.0;120;4784;2954;1830;408;208;248.0
3141;Woensdag 26 februari 2003;616;315;301;428;197;231;109;104;4.0;1.0;32.0;31.0;0.0;1.0;148;4338;2567;1771;374;213;26.0
3142;Donderdag 27 februari 2003;580;307;273;417;210;207;122;119;2.0;1.0;33.0;32.0;1.0;0.0;132;5089;3059;2030;419;222;415.0
3143;Vrijdag 28 februari 2003;549;263;286;423;206;217;286;279;3.0;4.0;27.0;25.0;0.0;2.0;134;7623;4971;2652;281;331;10.0
3144;Totaal maart 2003;16755;8656;8099;13113;6435;6678;5245;5111;74.0;60.0;830.0;783.0;16.0;31.0;2724;123802;76989;46813;7939;5059;2315.0
3145;Zaterdag 1 maart 2003;466;245;221;439;228;211;57;57;0.0;0.0;0.0;0.0;0.0;0.0;2;12914;8746;4168;14;313;4.0
3146;Zondag 2 maart 2003;465;229;236;468;249;219;6;6;0.0;0.0;0.0;0.0;0.0;0.0;1;114;81;33;0;50;2.0
3147;Maandag 3 maart 2003;568;280;288;405;203;202;777;744;20.0;13.0;47.0;40.0;4.0;3.0;96;6777;4197;2580;378;233;12.0
3148;Dinsdag 4 maart 2003;580;271;309;423;186;237;100;99;0.0;1.0;56.0;54.0;1.0;1.0;108;4556;2717;1839;350;189;16.0
3149;Woensdag 5 maart 2003;584;314;270;447;215;232;102;98;3.0;1.0;39.0;37.0;0.0;2.0;117;5290;3138;2152;416;221;798.0
3150;Donderdag 6 maart 2003;569;289;280;429;215;214;131;130;1.0;0.0;34.0;33.0;0.0;1.0;133;5258;3111;2147;409;214;703.0
3151;Vrijdag 7 maart 2003;527;271;256;452;216;236;312;306;4.0;2.0;20.0;18.0;1.0;1.0;118;4804;2876;1928;275;172;17.0
3152;Zaterdag 8 maart 2003;477;228;249;443;227;216;61;60;1.0;0.0;0.0;0.0;0.0;0.0;0;986;739;247;2;22;0.0
3153;Zondag 9 maart 2003;461;236;225;392;203;189;7;7;0.0;0.0;0.0;0.0;0.0;0.0;0;139;99;40;4;28;0.0
3154;Maandag 10 maart 2003;578;302;276;441;198;243;148;147;0.0;1.0;61.0;60.0;0.0;1.0;130;6216;3758;2458;433;204;275.0
3155;Dinsdag 11 maart 2003;637;356;281;415;227;188;105;102;3.0;0.0;34.0;30.0;1.0;3.0;135;3975;2393;1582;344;143;9.0
3156;Woensdag 12 maart 2003;585;299;286;422;201;221;99;97;0.0;2.0;30.0;28.0;0.0;2.0;142;4440;2634;1806;385;168;23.0
3157;Donderdag 13 maart 2003;597;312;285;472;232;240;116;115;0.0;1.0;42.0;40.0;1.0;1.0;146;4508;2712;1796;413;189;126.0
3158;Vrijdag 14 maart 2003;578;297;281;430;198;232;324;318;2.0;4.0;28.0;26.0;0.0;2.0;144;4970;3099;1871;293;157;20.0
3159;Zaterdag 15 maart 2003;477;253;224;409;204;205;71;71;0.0;0.0;1.0;1.0;0.0;0.0;0;2831;2090;741;3;89;6.0
3160;Zondag 16 maart 2003;472;246;226;394;194;200;4;4;0.0;0.0;0.0;0.0;0.0;0.0;0;238;162;76;4;37;0.0
3161;Maandag 17 maart 2003;572;309;263;420;209;211;158;154;2.0;2.0;59.0;52.0;3.0;4.0;130;5681;3575;2106;446;223;17.0
3162;Dinsdag 18 maart 2003;556;273;283;392;207;185;134;129;3.0;2.0;39.0;37.0;0.0;2.0;104;4267;2612;1655;443;193;27.0
3163;Woensdag 19 maart 2003;582;292;290;447;239;208;120;118;1.0;1.0;32.0;29.0;0.0;3.0;127;3855;2264;1591;367;181;28.0
3164;Donderdag 20 maart 2003;597;302;295;421;199;222;566;548;13.0;5.0;39.0;38.0;1.0;0.0;131;4653;2832;1821;331;209;16.0
3165;Vrijdag 21 maart 2003;557;301;256;461;226;235;588;578;6.0;4.0;22.0;21.0;0.0;1.0;135;4434;2794;1640;282;199;19.0
3166;Zaterdag 22 maart 2003;453;237;216;388;174;214;68;67;0.0;1.0;0.0;0.0;0.0;0.0;2;1250;890;360;3;44;1.0
3167;Zondag 23 maart 2003;432;227;205;369;163;206;4;4;0.0;0.0;0.0;0.0;0.0;0.0;0;182;141;41;3;19;0.0
3168;Maandag 24 maart 2003;555;286;269;428;193;235;162;157;2.0;3.0;59.0;57.0;2.0;0.0;169;5141;3129;2012;388;223;28.0
3169;Dinsdag 25 maart 2003;590;310;280;415;212;203;121;115;3.0;3.0;43.0;41.0;2.0;0.0;148;4366;2681;1685;437;216;27.0
3170;Woensdag 26 maart 2003;551;295;256;431;220;211;107;103;2.0;2.0;37.0;36.0;0.0;1.0;155;3971;2283;1688;411;197;26.0
3171;Donderdag 27 maart 2003;563;303;260;399;191;208;150;148;0.0;2.0;33.0;33.0;0.0;0.0;150;4701;2803;1898;427;214;39.0
3172;Vrijdag 28 maart 2003;554;289;265;437;211;226;396;383;7.0;6.0;29.0;29.0;0.0;0.0;86;5088;3147;1941;277;246;23.0
3173;Zaterdag 29 maart 2003;531;282;249;430;219;211;70;68;1.0;1.0;0.0;0.0;0.0;0.0;1;1184;877;307;6;49;1.0
3174;Zondag 30 maart 2003;459;229;230;374;176;198;9;9;0.0;0.0;0.0;0.0;0.0;0.0;0;415;300;115;1;63;0.0
3175;Maandag 31 maart 2003;582;293;289;420;200;220;172;169;0.0;3.0;46.0;43.0;0.0;3.0;114;6598;4109;2489;394;354;52.0
3176;Totaal april 2003;16585;8541;8044;12203;6010;6193;5588;5469;57.0;62.0;787.0;733.0;28.0;26.0;2550;117632;72230;45402;7363;4781;1187.0
3177;Dinsdag 1 april 2003;553;289;264;433;220;213;214;207;5.0;2.0;43.0;40.0;2.0;1.0;137;19519;12437;7082;487;605;0.0
3178;Woensdag 2 april 2003;548;271;277;439;233;206;127;124;1.0;2.0;36.0;34.0;1.0;1.0;156;5087;2914;2173;422;174;657.0
3179;Donderdag 3 april 2003;572;273;299;427;204;223;158;156;2.0;0.0;42.0;40.0;2.0;0.0;109;5086;2840;2246;423;164;102.0
3180;Vrijdag 4 april 2003;582;294;288;447;211;236;497;484;9.0;4.0;27.0;25.0;1.0;1.0;150;4739;2918;1821;314;196;1.0
3181;Zaterdag 5 april 2003;448;225;223;398;189;209;114;113;0.0;1.0;0.0;0.0;0.0;0.0;0;902;653;249;1;46;0.0
3182;Zondag 6 april 2003;472;243;229;384;178;206;6;6;0.0;0.0;0.0;0.0;0.0;0.0;0;160;110;50;2;19;0.0
3183;Maandag 7 april 2003;553;289;264;408;205;203;147;145;0.0;2.0;55.0;53.0;1.0;1.0;137;5505;3312;2193;407;196;0.0
3184;Dinsdag 8 april 2003;590;323;267;395;205;190;122;118;2.0;2.0;39.0;37.0;1.0;1.0;134;4395;2562;1833;444;186;3.0
3185;Woensdag 9 april 2003;562;308;254;382;176;206;117;114;1.0;2.0;42.0;36.0;4.0;2.0;135;4216;2468;1748;354;183;5.0
3186;Donderdag 10 april 2003;616;338;278;389;205;184;184;178;5.0;1.0;27.0;26.0;0.0;1.0;101;4760;2819;1941;359;202;30.0
3187;Vrijdag 11 april 2003;580;299;281;399;183;216;489;480;3.0;6.0;30.0;29.0;0.0;1.0;110;4031;2478;1553;288;178;281.0
3188;Zaterdag 12 april 2003;480;237;243;383;191;192;109;106;2.0;1.0;2.0;1.0;0.0;1.0;0;1112;822;290;2;26;0.0
3189;Zondag 13 april 2003;462;235;227;374;183;191;10;10;0.0;0.0;0.0;0.0;0.0;0.0;0;136;65;71;1;28;0.0
3190;Maandag 14 april 2003;576;298;278;448;236;212;169;162;2.0;5.0;60.0;57.0;1.0;2.0;121;5429;3227;2202;418;220;3.0
3191;Dinsdag 15 april 2003;622;325;297;399;195;204;147;142;1.0;4.0;38.0;36.0;2.0;0.0;107;6094;3911;2183;418;202;5.0
3192;Woensdag 16 april 2003;628;325;303;406;213;193;156;153;3.0;0.0;35.0;29.0;2.0;4.0;146;4167;2513;1654;301;153;4.0
3193;Donderdag 17 april 2003;625;316;309;418;202;216;305;297;5.0;3.0;39.0;38.0;1.0;0.0;169;4606;2772;1834;380;198;3.0
3194;Vrijdag 18 april 2003;593;284;309;456;219;237;105;103;0.0;2.0;3.0;2.0;0.0;1.0;11;1536;1046;490;38;86;5.0
3195;Zaterdag 19 april 2003;473;234;239;422;207;215;77;76;1.0;0.0;0.0;0.0;0.0;0.0;1;957;678;279;6;25;1.0
3196;Zondag 20 april 2003;472;253;219;375;178;197;6;6;0.0;0.0;0.0;0.0;0.0;0.0;0;425;301;124;5;40;0.0
3197;Maandag 21 april 2003;479;243;236;400;193;207;20;20;0.0;0.0;0.0;0.0;0.0;0.0;2;361;255;106;7;18;0.0
3198;Dinsdag 22 april 2003;589;310;279;376;184;192;195;187;2.0;6.0;56.0;53.0;1.0;2.0;151;5807;3595;2212;449;268;3.0
3199;Woensdag 23 april 2003;612;321;291;405;199;206;191;188;1.0;2.0;35.0;33.0;1.0;1.0;134;4660;2788;1872;388;234;28.0
3200;Donderdag 24 april 2003;602;310;292;397;179;218;309;302;1.0;6.0;47.0;45.0;1.0;1.0;153;4990;2949;2041;386;191;11.0
3201;Vrijdag 25 april 2003;646;327;319;415;221;194;898;889;4.0;5.0;21.0;17.0;3.0;1.0;129;5020;3140;1880;320;267;23.0
3202;Zaterdag 26 april 2003;471;265;206;439;239;200;142;140;2.0;0.0;1.0;1.0;0.0;0.0;1;1417;966;451;1;55;0.0
3203;Zondag 27 april 2003;458;224;234;412;204;208;9;9;0.0;0.0;0.0;0.0;0.0;0.0;1;195;129;66;3;29;0.0
3204;Maandag 28 april 2003;609;330;279;405;190;215;252;245;3.0;4.0;65.0;59.0;4.0;2.0;107;5904;3590;2314;371;262;8.0
3205;Dinsdag 29 april 2003;609;300;309;403;197;206;282;278;2.0;2.0;44.0;42.0;0.0;2.0;147;5432;3254;2178;366;219;9.0
3206;Woensdag 30 april 2003;503;252;251;369;171;198;31;31;0.0;0.0;0.0;0.0;0.0;0.0;1;984;718;266;2;111;5.0
3207;Totaal mei 2003;16572;8465;8107;11309;5449;5860;10681;10494;84.0;103.0;781.0;730.0;31.0;20.0;2707;120416;75490;44926;7160;4628;1872.0
3208;Donderdag 1 mei 2003;598;304;294;366;173;193;255;249;3.0;3.0;38.0;37.0;1.0;0.0;132;18508;11984;6524;406;531;5.0
3209;Vrijdag 2 mei 2003;587;287;300;355;171;184;819;813;3.0;3.0;21.0;21.0;0.0;0.0;134;5144;3081;2063;322;227;3.0
3210;Zaterdag 3 mei 2003;512;278;234;340;158;182;152;150;1.0;1.0;1.0;0.0;1.0;0.0;0;677;491;186;2;25;1.0
3211;Zondag 4 mei 2003;462;245;217;339;186;153;6;6;0.0;0.0;0.0;0.0;0.0;0.0;0;102;76;26;0;25;1.0
3212;Maandag 5 mei 2003;555;278;277;390;189;201;42;40;1.0;1.0;3.0;2.0;1.0;0.0;6;841;593;248;6;48;4.0
3213;Dinsdag 6 mei 2003;576;277;299;357;174;183;203;194;4.0;5.0;45.0;42.0;2.0;1.0;159;7669;4719;2950;525;229;7.0
3214;Woensdag 7 mei 2003;598;304;294;369;178;191;237;232;2.0;3.0;40.0;38.0;2.0;0.0;160;5484;3222;2262;418;126;9.0
3215;Donderdag 8 mei 2003;594;316;278;348;153;195;289;280;5.0;4.0;27.0;25.0;2.0;0.0;147;5588;3321;2267;379;189;10.0
3216;Vrijdag 9 mei 2003;586;312;274;381;170;211;847;836;5.0;6.0;25.0;25.0;0.0;0.0;172;4539;2790;1749;250;177;131.0
3217;Zaterdag 10 mei 2003;426;213;213;354;168;186;189;185;3.0;1.0;1.0;1.0;0.0;0.0;0;1359;964;395;2;38;0.0
3218;Zondag 11 mei 2003;429;223;206;355;179;176;7;7;0.0;0.0;0.0;0.0;0.0;0.0;0;122;76;46;3;12;0.0
3219;Maandag 12 mei 2003;570;300;270;362;187;175;230;224;5.0;1.0;57.0;53.0;1.0;3.0;144;5587;3390;2197;340;197;19.0
3220;Dinsdag 13 mei 2003;583;293;290;380;186;194;123;122;1.0;0.0;46.0;45.0;1.0;0.0;118;4111;2474;1637;402;137;13.0
3221;Woensdag 14 mei 2003;602;323;279;391;193;198;207;201;3.0;3.0;41.0;41.0;0.0;0.0;164;4015;2384;1631;383;147;34.0
3222;Donderdag 15 mei 2003;558;283;275;362;168;194;385;377;2.0;6.0;24.0;22.0;1.0;1.0;148;7400;4770;2630;330;224;16.0
3223;Vrijdag 16 mei 2003;573;286;287;337;161;176;1184;1171;5.0;8.0;26.0;23.0;1.0;2.0;122;4651;2984;1667;263;191;2.0
3224;Zaterdag 17 mei 2003;468;230;238;371;189;182;214;214;0.0;0.0;0.0;0.0;0.0;0.0;0;992;745;247;4;24;0.0
3225;Zondag 18 mei 2003;436;224;212;357;160;197;14;14;0.0;0.0;0.0;0.0;0.0;0.0;0;191;135;56;3;25;4.0
3226;Maandag 19 mei 2003;580;290;290;375;171;204;208;197;5.0;6.0;54.0;47.0;2.0;5.0;99;5379;3232;2147;366;239;20.0
3227;Dinsdag 20 mei 2003;578;296;282;354;162;192;181;175;4.0;2.0;48.0;45.0;2.0;1.0;158;4415;2801;1614;424;162;18.0
3228;Woensdag 21 mei 2003;542;296;246;376;179;197;203;200;1.0;2.0;38.0;35.0;3.0;0.0;109;4086;2433;1653;411;136;123.0
3229;Donderdag 22 mei 2003;533;269;264;379;184;195;409;398;4.0;7.0;44.0;42.0;0.0;2.0;172;4413;2652;1761;395;169;17.0
3230;Vrijdag 23 mei 2003;572;297;275;352;160;192;1371;1355;4.0;12.0;23.0;20.0;2.0;1.0;124;4083;2615;1468;287;205;6.0
3231;Zaterdag 24 mei 2003;424;214;210;395;205;190;261;257;2.0;2.0;1.0;1.0;0.0;0.0;2;1363;1020;343;1;31;1.0
3232;Zondag 25 mei 2003;399;217;182;359;183;176;8;8;0.0;0.0;0.0;0.0;0.0;0.0;0;371;297;74;3;35;2.0
3233;Maandag 26 mei 2003;557;281;276;355;171;184;227;220;4.0;3.0;65.0;64.0;1.0;0.0;134;5333;3315;2018;397;261;1033.0
3234;Dinsdag 27 mei 2003;598;300;298;364;167;197;240;234;0.0;6.0;54.0;47.0;4.0;3.0;118;4400;2670;1730;401;276;378.0
3235;Woensdag 28 mei 2003;564;264;300;370;183;187;1038;1019;10.0;9.0;56.0;51.0;4.0;1.0;159;5624;3540;2084;385;255;12.0
3236;Donderdag 29 mei 2003;511;262;249;353;171;182;21;21;0.0;0.0;0.0;0.0;0.0;0.0;3;490;348;142;0;61;2.0
3237;Vrijdag 30 mei 2003;516;260;256;362;179;183;869;857;3.0;9.0;3.0;3.0;0.0;0.0;22;2246;1502;744;47;117;1.0
3238;Zaterdag 31 mei 2003;485;243;242;401;191;210;242;238;4.0;0.0;0.0;0.0;0.0;0.0;1;1233;866;367;5;109;0.0
3239;Totaal juni 2003;16325;8333;7992;11088;5396;5692;10516;10318;99.0;99.0;784.0;742.0;24.0;18.0;2679;124555;76930;47625;7595;5649;1723.0
3240;Zondag 1 juni 2003;439;235;204;405;190;215;10;10;0.0;0.0;0.0;0.0;0.0;0.0;0;9883;6769;3114;21;275;0.0
3241;Maandag 2 juni 2003;589;305;284;453;239;214;211;208;1.0;2.0;55.0;51.0;3.0;1.0;129;9506;6007;3499;507;297;130.0
3242;Dinsdag 3 juni 2003;603;291;312;486;227;259;218;214;0.0;4.0;50.0;48.0;0.0;2.0;134;5806;3459;2347;440;220;15.0
3243;Woensdag 4 juni 2003;608;299;309;390;188;202;198;194;2.0;2.0;37.0;37.0;0.0;0.0;170;4754;2795;1959;450;162;359.0
3244;Donderdag 5 juni 2003;569;292;277;360;171;189;447;436;9.0;2.0;44.0;41.0;3.0;0.0;129;5183;3117;2066;413;196;25.0
3245;Vrijdag 6 juni 2003;607;318;289;345;160;185;1578;1557;11.0;10.0;22.0;21.0;0.0;1.0;117;4891;2959;1932;299;180;21.0
3246;Zaterdag 7 juni 2003;492;235;257;418;202;216;287;282;2.0;3.0;1.0;1.0;0.0;0.0;0;856;632;224;4;34;2.0
3247;Zondag 8 juni 2003;431;210;221;401;212;189;10;10;0.0;0.0;0.0;0.0;0.0;0.0;0;157;107;50;6;16;0.0
3248;Maandag 9 juni 2003;457;225;232;342;176;166;15;15;0.0;0.0;0.0;0.0;0.0;0.0;1;268;190;78;2;60;0.0
3249;Dinsdag 10 juni 2003;558;301;257;347;176;171;228;220;6.0;2.0;42.0;41.0;0.0;1.0;124;5527;3318;2209;458;198;11.0
3250;Woensdag 11 juni 2003;631;333;298;354;161;193;188;183;3.0;2.0;29.0;28.0;1.0;0.0;139;4909;2923;1986;439;223;9.0
3251;Donderdag 12 juni 2003;579;306;273;362;181;181;389;380;5.0;4.0;35.0;34.0;1.0;0.0;112;5047;3025;2022;376;189;26.0
3252;Vrijdag 13 juni 2003;546;285;261;353;172;181;838;817;9.0;12.0;23.0;23.0;0.0;0.0;109;4353;2671;1682;176;169;14.0
3253;Zaterdag 14 juni 2003;458;237;221;375;180;195;300;299;1.0;0.0;1.0;1.0;0.0;0.0;1;1048;737;311;3;55;1.0
3254;Zondag 15 juni 2003;445;224;221;354;165;189;12;12;0.0;0.0;0.0;0.0;0.0;0.0;0;1508;1068;440;6;81;0.0
3255;Maandag 16 juni 2003;582;288;294;347;164;183;217;209;3.0;5.0;56.0;50.0;5.0;1.0;108;6626;4174;2452;318;249;27.0
3256;Dinsdag 17 juni 2003;619;319;300;402;203;199;168;165;2.0;1.0;44.0;40.0;1.0;3.0;136;4358;2644;1714;400;221;10.0
3257;Woensdag 18 juni 2003;610;318;292;347;174;173;213;210;2.0;1.0;30.0;28.0;0.0;2.0;151;4222;2547;1675;404;195;16.0
3258;Donderdag 19 juni 2003;584;317;267;332;155;177;346;337;2.0;7.0;39.0;39.0;0.0;0.0;126;4668;2878;1790;347;200;567.0
3259;Vrijdag 20 juni 2003;599;307;292;350;161;189;1464;1437;7.0;20.0;26.0;23.0;3.0;0.0;131;5125;3168;1957;232;222;18.0
3260;Zaterdag 21 juni 2003;443;214;229;349;171;178;399;392;5.0;2.0;2.0;0.0;2.0;0.0;1;1124;808;316;2;54;2.0
3261;Zondag 22 juni 2003;430;229;201;337;165;172;8;8;0.0;0.0;0.0;0.0;0.0;0.0;0;195;130;65;0;49;0.0
3262;Maandag 23 juni 2003;551;271;280;362;186;176;191;183;5.0;3.0;56.0;55.0;1.0;0.0;107;5546;3344;2202;408;303;194.0
3263;Dinsdag 24 juni 2003;602;300;302;369;163;206;175;170;2.0;3.0;50.0;45.0;2.0;3.0;182;4735;2792;1943;394;214;15.0
3264;Woensdag 25 juni 2003;577;296;281;377;192;185;231;229;1.0;1.0;38.0;35.0;1.0;2.0;129;4565;2724;1841;350;254;21.0
3265;Donderdag 26 juni 2003;576;301;275;367;178;189;374;369;3.0;2.0;25.0;25.0;0.0;0.0;140;4952;2980;1972;394;290;196.0
3266;Vrijdag 27 juni 2003;577;285;292;365;173;192;1295;1275;11.0;9.0;22.0;21.0;0.0;1.0;155;5212;3115;2097;251;318;19.0
3267;Zaterdag 28 juni 2003;450;219;231;348;188;160;293;288;5.0;0.0;0.0;0.0;0.0;0.0;0;1664;1174;490;2;93;0.0
3268;Zondag 29 juni 2003;513;247;266;353;158;195;6;6;0.0;0.0;1.0;1.0;0.0;0.0;0;228;145;83;1;60;2.0
3269;Maandag 30 juni 2003;600;326;274;338;165;173;207;203;2.0;2.0;56.0;54.0;1.0;1.0;148;7639;4530;3109;492;572;23.0
3270;Totaal juli 2003;17913;9220;8693;11234;5447;5787;7496;7403;48.0;45.0;899.0;853.0;21.0;25.0;2878;141372;83508;57864;9396;7452;957.0
3271;Dinsdag 1 juli 2003;568;289;279;342;153;189;217;214;1.0;2.0;49.0;46.0;1.0;2.0;114;23313;14557;8756;577;837;132.0
3272;Woensdag 2 juli 2003;598;305;293;365;188;177;193;189;2.0;2.0;35.0;33.0;1.0;1.0;138;5771;3330;2441;405;309;125.0
3273;Donderdag 3 juli 2003;594;286;308;321;157;164;281;281;0.0;0.0;39.0;36.0;1.0;2.0;149;5748;3195;2553;485;347;18.0
3274;Vrijdag 4 juli 2003;587;321;266;321;165;156;1015;1001;4.0;10.0;33.0;32.0;0.0;1.0;86;5223;2996;2227;331;290;17.0
3275;Zaterdag 5 juli 2003;508;257;251;350;180;170;237;235;2.0;0.0;0.0;0.0;0.0;0.0;0;1128;736;392;2;67;1.0
3276;Zondag 6 juli 2003;453;246;207;355;172;183;6;6;0.0;0.0;0.0;0.0;0.0;0.0;0;142;89;53;6;44;1.0
3277;Maandag 7 juli 2003;621;300;321;336;193;143;234;229;4.0;1.0;54.0;52.0;0.0;2.0;118;6706;3785;2921;480;319;14.0
3278;Dinsdag 8 juli 2003;633;324;309;347;178;169;159;157;1.0;1.0;49.0;46.0;2.0;1.0;150;4887;2742;2145;373;255;21.0
3279;Woensdag 9 juli 2003;637;337;300;356;173;183;194;193;0.0;1.0;44.0;42.0;1.0;1.0;138;4525;2583;1942;397;190;28.0
3280;Donderdag 10 juli 2003;634;323;311;359;171;188;268;262;4.0;2.0;39.0;37.0;1.0;1.0;130;5367;3113;2254;390;280;21.0
3281;Vrijdag 11 juli 2003;599;306;293;363;178;185;725;719;4.0;2.0;24.0;20.0;2.0;2.0;119;4722;2768;1954;297;230;22.0
3282;Zaterdag 12 juli 2003;493;248;245;364;169;195;196;193;2.0;1.0;0.0;0.0;0.0;0.0;1;1135;820;315;2;52;1.0
3283;Zondag 13 juli 2003;485;264;221;311;138;173;20;20;0.0;0.0;0.0;0.0;0.0;0.0;0;164;98;66;2;30;1.0
3284;Maandag 14 juli 2003;591;284;307;374;180;194;239;234;3.0;2.0;47.0;44.0;1.0;2.0;91;6126;3631;2495;493;295;7.0
3285;Dinsdag 15 juli 2003;654;336;318;359;170;189;198;197;1.0;0.0;56.0;53.0;2.0;1.0;149;7196;4337;2859;432;386;18.0
3286;Woensdag 16 juli 2003;677;346;331;409;208;201;163;161;2.0;0.0;32.0;32.0;0.0;0.0;131;4458;2597;1861;380;203;377.0
3287;Donderdag 17 juli 2003;627;324;303;406;193;213;236;235;0.0;1.0;29.0;28.0;1.0;0.0;122;4625;2716;1909;410;263;13.0
3288;Vrijdag 18 juli 2003;599;314;285;416;215;201;525;519;4.0;2.0;27.0;25.0;2.0;0.0;123;4525;2770;1755;312;235;8.0
3289;Zaterdag 19 juli 2003;493;266;227;381;188;193;154;152;1.0;1.0;0.0;0.0;0.0;0.0;0;965;611;354;4;89;0.0
3290;Zondag 20 juli 2003;482;249;233;376;176;200;17;17;0.0;0.0;0.0;0.0;0.0;0.0;0;477;313;164;8;68;0.0
3291;Maandag 21 juli 2003;602;306;296;372;183;189;249;248;0.0;1.0;51.0;50.0;1.0;0.0;127;5667;3283;2384;440;315;5.0
3292;Dinsdag 22 juli 2003;619;331;288;351;150;201;196;193;0.0;3.0;44.0;43.0;0.0;1.0;122;4284;2461;1823;446;239;18.0
3293;Woensdag 23 juli 2003;574;284;290;373;152;221;182;179;3.0;0.0;38.0;37.0;0.0;1.0;128;3997;2307;1690;362;208;19.0
3294;Donderdag 24 juli 2003;688;370;318;419;202;217;178;173;3.0;2.0;26.0;26.0;0.0;0.0;148;4375;2599;1776;377;244;27.0
3295;Vrijdag 25 juli 2003;582;292;290;356;164;192;461;460;0.0;1.0;21.0;19.0;1.0;1.0;144;5038;2865;2173;297;241;7.0
3296;Zaterdag 26 juli 2003;457;251;206;351;167;184;145;145;0.0;0.0;0.0;0.0;0.0;0.0;0;1051;689;362;0;47;1.0
3297;Zondag 27 juli 2003;502;255;247;331;169;162;23;22;1.0;0.0;0.0;0.0;0.0;0.0;0;243;169;74;6;50;1.0
3298;Maandag 28 juli 2003;585;278;307;359;177;182;232;226;2.0;4.0;64.0;59.0;3.0;2.0;99;5402;3117;2285;480;318;19.0
3299;Dinsdag 29 juli 2003;588;306;282;353;176;177;180;175;1.0;4.0;39.0;36.0;1.0;2.0;138;4324;2476;1848;384;256;6.0
3300;Woensdag 30 juli 2003;602;322;280;394;188;206;184;181;2.0;1.0;33.0;32.0;0.0;1.0;110;4439;2566;1873;399;284;12.0
3301;Donderdag 31 juli 2003;581;300;281;364;174;190;189;187;1.0;1.0;26.0;25.0;0.0;1.0;103;5349;3189;2160;419;461;17.0
3302;Totaal augustus 2003;17572;9038;8534;11619;5548;6071;9935;9771;80.0;84.0;847.0;805.0;21.0;21.0;2307;133376;74633;58743;11276;7128;2794.0
3303;Vrijdag 1 augustus 2003;584;306;278;366;181;185;562;552;3.0;7.0;28.0;27.0;0.0;1.0;88;23487;14057;9430;472;865;8.0
3304;Zaterdag 2 augustus 2003;494;239;255;369;171;198;127;127;0.0;0.0;2.0;2.0;0.0;0.0;1;614;400;214;3;72;1.0
3305;Zondag 3 augustus 2003;460;242;218;351;181;170;25;25;0.0;0.0;0.0;0.0;0.0;0.0;0;130;70;60;8;48;1.0
3306;Maandag 4 augustus 2003;589;294;295;362;172;190;263;257;1.0;5.0;51.0;49.0;0.0;2.0;93;6269;3435;2834;676;314;16.0
3307;Dinsdag 5 augustus 2003;630;309;321;320;148;172;241;236;1.0;4.0;57.0;55.0;2.0;0.0;108;4979;2673;2306;738;225;7.0
3308;Woensdag 6 augustus 2003;595;284;311;412;195;217;223;220;1.0;2.0;27.0;25.0;2.0;0.0;101;4190;2232;1958;536;205;10.0
3309;Donderdag 7 augustus 2003;666;351;315;451;215;236;216;212;1.0;3.0;37.0;36.0;1.0;0.0;92;4336;2417;1919;531;201;5.0
3310;Vrijdag 8 augustus 2003;643;346;297;452;217;235;729;718;7.0;4.0;9.0;9.0;0.0;0.0;109;4658;2621;2037;365;195;21.0
3311;Zaterdag 9 augustus 2003;478;262;216;391;181;210;135;134;1.0;0.0;0.0;0.0;0.0;0.0;1;716;492;224;3;52;0.0
3312;Zondag 10 augustus 2003;429;222;207;385;187;198;15;15;0.0;0.0;0.0;0.0;0.0;0.0;1;504;317;187;6;40;0.0
3313;Maandag 11 augustus 2003;626;330;296;411;176;235;261;258;1.0;2.0;55.0;52.0;1.0;2.0;104;5568;3088;2480;573;247;6.0
3314;Dinsdag 12 augustus 2003;631;312;319;420;208;212;199;192;3.0;4.0;51.0;49.0;1.0;1.0;112;4200;2293;1907;540;235;14.0
3315;Woensdag 13 augustus 2003;646;327;319;451;197;254;184;179;0.0;5.0;38.0;37.0;0.0;1.0;130;4263;2204;2059;506;218;12.0
3316;Donderdag 14 augustus 2003;612;311;301;437;220;217;297;294;2.0;1.0;44.0;42.0;1.0;1.0;93;4994;2653;2341;562;238;11.0
3317;Vrijdag 15 augustus 2003;572;305;267;387;184;203;807;791;11.0;5.0;26.0;24.0;0.0;2.0;91;8135;4669;3466;400;343;303.0
3318;Zaterdag 16 augustus 2003;494;261;233;384;167;217;216;208;5.0;3.0;3.0;3.0;0.0;0.0;0;1032;643;389;4;94;7.0
3319;Zondag 17 augustus 2003;471;210;261;376;187;189;14;14;0.0;0.0;0.0;0.0;0.0;0.0;0;211;97;114;5;51;1.0
3320;Maandag 18 augustus 2003;610;293;317;365;180;185;223;221;1.0;1.0;61.0;58.0;0.0;3.0;128;6560;3569;2991;584;333;10.0
3321;Dinsdag 19 augustus 2003;583;304;279;376;187;189;190;187;1.0;2.0;51.0;47.0;2.0;2.0;133;4751;2500;2251;604;262;17.0
3322;Woensdag 20 augustus 2003;593;309;284;336;169;167;217;212;2.0;3.0;45.0;41.0;4.0;0.0;112;4950;2655;2295;595;224;16.0
3323;Donderdag 21 augustus 2003;557;292;265;353;151;202;351;346;3.0;2.0;36.0;35.0;1.0;0.0;116;5093;2788;2305;517;274;8.0
3324;Vrijdag 22 augustus 2003;604;333;271;363;174;189;1178;1157;11.0;10.0;21.0;20.0;0.0;1.0;113;4641;2530;2111;401;304;7.0
3325;Zaterdag 23 augustus 2003;499;258;241;379;157;222;291;288;1.0;2.0;1.0;0.0;0.0;1.0;1;1250;809;441;1;57;0.0
3326;Zondag 24 augustus 2003;500;260;240;324;149;175;20;20;0.0;0.0;0.0;0.0;0.0;0.0;0;210;111;99;4;33;0.0
3327;Maandag 25 augustus 2003;593;304;289;362;191;171;220;216;0.0;4.0;57.0;55.0;1.0;1.0;108;6099;3415;2684;525;347;1912.0
3328;Dinsdag 26 augustus 2003;586;306;280;339;167;172;212;210;2.0;0.0;45.0;41.0;2.0;2.0;125;4713;2477;2236;629;313;344.0
3329;Woensdag 27 augustus 2003;661;354;307;347;161;186;246;240;5.0;1.0;40.0;37.0;2.0;1.0;126;4562;2436;2126;518;282;19.0
3330;Donderdag 28 augustus 2003;581;287;294;346;181;165;496;491;2.0;3.0;34.0;34.0;0.0;0.0;111;5307;2942;2365;540;365;21.0
3331;Vrijdag 29 augustus 2003;617;322;295;369;178;191;1401;1378;13.0;10.0;28.0;27.0;1.0;0.0;110;5082;2867;2215;421;398;17.0
3332;Zaterdag 30 augustus 2003;482;258;224;334;165;169;366;363;2.0;1.0;0.0;0.0;0.0;0.0;0;1120;697;423;5;105;0.0
3333;Zondag 31 augustus 2003;486;247;239;301;151;150;10;10;0.0;0.0;0.0;0.0;0.0;0.0;0;752;476;276;4;188;0.0
3334;Totaal september 2003;17338;8885;8453;10942;5397;5545;10249;10098;59.0;92.0;891.0;839.0;25.0;27.0;2496;138326;79824;58502;12441;6706;3441.0
3335;Maandag 1 september 2003;591;312;279;347;181;166;274;266;2.0;6.0;55.0;53.0;1.0;1.0;132;24265;13823;10442;640;978;15.0
3336;Dinsdag 2 september 2003;585;322;263;325;155;170;192;190;2.0;0.0;57.0;55.0;0.0;2.0;116;6232;3255;2977;710;283;21.0
3337;Woensdag 3 september 2003;606;313;293;368;178;190;313;303;3.0;7.0;30.0;27.0;2.0;1.0;116;5508;2957;2551;616;247;20.0
3338;Donderdag 4 september 2003;580;310;270;359;170;189;433;425;0.0;8.0;31.0;29.0;1.0;1.0;125;5718;3064;2654;487;231;27.0
3339;Vrijdag 5 september 2003;593;284;309;361;173;188;1462;1451;3.0;8.0;18.0;18.0;0.0;0.0;103;4976;2772;2204;453;211;14.0
3340;Zaterdag 6 september 2003;496;250;246;366;180;186;398;394;2.0;2.0;0.0;0.0;0.0;0.0;0;725;560;165;5;54;1.0
3341;Zondag 7 september 2003;462;234;228;361;172;189;8;8;0.0;0.0;0.0;0.0;0.0;0.0;0;243;153;90;5;33;0.0
3342;Maandag 8 september 2003;613;305;308;344;166;178;188;182;2.0;4.0;42.0;42.0;0.0;0.0;98;5857;3255;2602;542;282;13.0
3343;Dinsdag 9 september 2003;613;306;307;369;182;187;257;255;1.0;1.0;37.0;34.0;2.0;1.0;115;4729;2578;2151;656;241;23.0
3344;Woensdag 10 september 2003;617;299;318;326;168;158;239;234;2.0;3.0;47.0;44.0;1.0;2.0;107;4611;2556;2055;462;220;37.0
3345;Donderdag 11 september 2003;614;314;300;369;177;192;245;245;0.0;0.0;33.0;32.0;0.0;1.0;120;4858;2704;2154;541;188;21.0
3346;Vrijdag 12 september 2003;586;309;277;362;171;191;1283;1267;6.0;10.0;31.0;30.0;0.0;1.0;129;4406;2539;1867;372;218;4.0
3347;Zaterdag 13 september 2003;499;262;237;345;185;160;185;185;0.0;0.0;0.0;0.0;0.0;0.0;0;776;568;208;3;58;1.0
3348;Zondag 14 september 2003;471;227;244;342;151;191;12;12;0.0;0.0;0.0;0.0;0.0;0.0;0;193;129;64;4;31;1.0
3349;Maandag 15 september 2003;595;304;291;353;170;183;204;195;4.0;5.0;51.0;49.0;1.0;1.0;100;8812;5500;3312;549;330;12.0
3350;Dinsdag 16 september 2003;599;319;280;379;188;191;156;153;1.0;2.0;41.0;38.0;1.0;2.0;164;5097;3020;2077;644;198;21.0
3351;Woensdag 17 september 2003;640;332;308;410;208;202;189;185;2.0;2.0;46.0;40.0;5.0;1.0;110;4340;2351;1989;569;158;766.0
3352;Donderdag 18 september 2003;632;313;319;372;180;192;401;397;3.0;1.0;32.0;31.0;1.0;0.0;121;4807;2758;2049;847;216;178.0
3353;Vrijdag 19 september 2003;647;324;323;404;196;208;1134;1115;7.0;12.0;19.0;17.0;1.0;1.0;120;4263;2478;1785;346;179;29.0
3354;Zaterdag 20 september 2003;496;270;226;366;171;195;286;283;0.0;3.0;0.0;0.0;0.0;0.0;0;1457;1058;399;5;49;10.0
3355;Zondag 21 september 2003;481;253;228;377;199;178;4;4;0.0;0.0;0.0;0.0;0.0;0.0;0;199;113;86;6;32;1.0
3356;Maandag 22 september 2003;628;307;321;443;238;205;195;190;4.0;1.0;59.0;53.0;2.0;4.0;107;5417;3193;2224;512;266;1093.0
3357;Dinsdag 23 september 2003;628;321;307;359;183;176;137;134;2.0;1.0;48.0;47.0;0.0;1.0;85;4144;2371;1773;620;250;21.0
3358;Woensdag 24 september 2003;637;322;315;340;157;183;179;174;2.0;3.0;38.0;36.0;1.0;1.0;116;4224;2365;1859;527;391;299.0
3359;Donderdag 25 september 2003;572;299;273;371;188;183;309;303;2.0;4.0;37.0;35.0;1.0;1.0;124;4806;2799;2007;764;274;21.0
3360;Vrijdag 26 september 2003;601;287;314;436;221;215;1015;1004;4.0;7.0;31.0;28.0;1.0;2.0;105;4596;2749;1847;436;295;39.0
3361;Zaterdag 27 september 2003;481;274;207;358;183;175;209;207;1.0;1.0;0.0;0.0;0.0;0.0;0;1440;1020;420;3;48;1.0
3362;Zondag 28 september 2003;490;240;250;324;154;170;8;7;1.0;0.0;0.0;0.0;0.0;0.0;0;247;165;82;6;52;0.0
3363;Maandag 29 september 2003;634;333;301;354;187;167;183;179;3.0;1.0;52.0;49.0;2.0;1.0;96;5574;3336;2238;490;287;130.0
3364;Dinsdag 30 september 2003;651;340;311;352;165;187;151;151;0.0;0.0;56.0;52.0;2.0;2.0;87;5806;3635;2171;621;406;622.0
3365;Totaal oktober 2003;17087;8760;8327;11445;5606;5839;6271;6150;64.0;57.0;949.0;895.0;27.0;27.0;2637;140094;85295;54799;10097;6024;1766.0
3366;Woensdag 1 oktober 2003;596;286;310;312;162;150;204;196;5.0;3.0;44.0;41.0;2.0;1.0;84;21453;13924;7529;562;729;25.0
3367;Donderdag 2 oktober 2003;630;337;293;415;216;199;190;187;1.0;2.0;41.0;40.0;0.0;1.0;149;5736;3271;2465;539;265;13.0
3368;Vrijdag 3 oktober 2003;587;303;284;395;175;220;720;705;9.0;6.0;27.0;25.0;0.0;2.0;88;5074;2983;2091;344;248;19.0
3369;Zaterdag 4 oktober 2003;496;268;228;344;174;170;131;128;2.0;1.0;0.0;0.0;0.0;0.0;0;855;629;226;3;19;4.0
3370;Zondag 5 oktober 2003;448;229;219;359;204;155;13;13;0.0;0.0;0.0;0.0;0.0;0.0;0;234;157;77;1;46;0.0
3371;Maandag 6 oktober 2003;587;288;299;347;183;164;181;176;1.0;4.0;52.0;45.0;3.0;4.0;113;5439;3201;2238;722;269;32.0
3372;Dinsdag 7 oktober 2003;657;332;325;328;159;169;135;132;2.0;1.0;45.0;45.0;0.0;0.0;146;4334;2479;1855;570;198;37.0
3373;Woensdag 8 oktober 2003;592;311;281;370;176;194;132;129;1.0;2.0;37.0;35.0;2.0;0.0;120;4520;2639;1881;450;205;44.0
3374;Donderdag 9 oktober 2003;630;332;298;372;174;198;220;217;1.0;2.0;28.0;25.0;1.0;2.0;104;4597;2668;1929;490;201;612.0
3375;Vrijdag 10 oktober 2003;576;275;301;385;175;210;851;836;10.0;5.0;28.0;27.0;1.0;0.0;76;4889;3050;1839;327;283;31.0
3376;Zaterdag 11 oktober 2003;493;248;245;332;169;163;115;114;1.0;0.0;0.0;0.0;0.0;0.0;1;972;711;261;3;30;1.0
3377;Zondag 12 oktober 2003;442;222;220;350;172;178;11;11;0.0;0.0;0.0;0.0;0.0;0.0;2;237;149;88;4;42;1.0
3378;Maandag 13 oktober 2003;581;271;310;378;187;191;165;160;4.0;1.0;39.0;39.0;0.0;0.0;98;5474;3257;2217;423;216;5.0
3379;Dinsdag 14 oktober 2003;592;314;278;369;179;190;162;158;1.0;3.0;47.0;44.0;0.0;3.0;103;4868;2827;2041;502;193;22.0
3380;Woensdag 15 oktober 2003;572;287;285;370;190;180;146;143;3.0;0.0;48.0;46.0;0.0;2.0;132;7006;4336;2670;439;303;18.0
3381;Donderdag 16 oktober 2003;562;312;250;365;186;179;189;186;0.0;3.0;35.0;31.0;2.0;2.0;126;4857;2926;1931;432;212;13.0
3382;Vrijdag 17 oktober 2003;573;283;290;377;176;201;524;516;4.0;4.0;35.0;33.0;2.0;0.0;90;4743;2842;1901;275;216;47.0
3383;Zaterdag 18 oktober 2003;468;256;212;366;184;182;97;95;1.0;1.0;0.0;0.0;0.0;0.0;0;1170;806;364;1;38;1.0
3384;Zondag 19 oktober 2003;418;213;205;361;171;190;9;9;0.0;0.0;0.0;0.0;0.0;0.0;0;150;87;63;0;29;1.0
3385;Maandag 20 oktober 2003;591;323;268;389;189;200;186;184;2.0;0.0;63.0;60.0;0.0;3.0;114;6161;3850;2311;430;261;522.0
3386;Dinsdag 21 oktober 2003;587;301;286;395;201;194;149;147;0.0;2.0;50.0;49.0;1.0;0.0;149;4259;2541;1718;374;191;19.0
3387;Woensdag 22 oktober 2003;559;295;264;350;172;178;124;123;0.0;1.0;43.0;40.0;1.0;2.0;102;4365;2598;1767;398;146;24.0
3388;Donderdag 23 oktober 2003;516;251;265;358;179;179;170;166;0.0;4.0;42.0;39.0;2.0;1.0;125;4435;2617;1818;405;181;133.0
3389;Vrijdag 24 oktober 2003;546;280;266;366;173;193;447;437;7.0;3.0;25.0;24.0;1.0;0.0;119;4498;2718;1780;281;166;22.0
3390;Zaterdag 25 oktober 2003;487;256;231;376;171;205;69;68;1.0;0.0;1.0;1.0;0.0;0.0;0;1844;1317;527;4;47;8.0
3391;Zondag 26 oktober 2003;460;232;228;365;185;180;6;6;0.0;0.0;0.0;0.0;0.0;0.0;0;223;151;72;2;25;0.0
3392;Maandag 27 oktober 2003;578;274;304;368;183;185;138;134;3.0;1.0;63.0;61.0;2.0;0.0;126;5671;3309;2362;503;232;31.0
3393;Dinsdag 28 oktober 2003;557;274;283;400;193;207;141;140;0.0;1.0;53.0;48.0;3.0;2.0;117;4651;2805;1846;480;193;14.0
3394;Woensdag 29 oktober 2003;573;317;256;385;179;206;94;94;0.0;0.0;32.0;30.0;1.0;1.0;113;4500;2565;1935;452;211;24.0
3395;Donderdag 30 oktober 2003;556;286;270;397;186;211;156;153;3.0;0.0;40.0;37.0;2.0;1.0;125;5704;3331;2373;377;261;21.0
3396;Vrijdag 31 oktober 2003;577;304;273;401;183;218;396;387;2.0;7.0;31.0;30.0;1.0;0.0;115;7175;4551;2624;304;368;22.0
3397;Totaal november 2003;15864;8191;7673;11291;5513;5778;3616;3530;37.0;49.0;907.0;857.0;20.0;30.0;2436;125242;77547;47695;7197;5074;3474.0
3398;Zaterdag 1 november 2003;476;239;237;391;188;203;74;73;1.0;0.0;2.0;1.0;0.0;1.0;0;14427;9696;4731;29;372;3.0
3399;Zondag 2 november 2003;420;217;203;401;210;191;2;2;0.0;0.0;0.0;0.0;0.0;0.0;0;159;91;68;6;28;2.0
3400;Maandag 3 november 2003;579;302;277;349;156;193;140;138;0.0;2.0;50.0;48.0;1.0;1.0;113;7415;4485;2930;453;345;709.0
3401;Dinsdag 4 november 2003;536;278;258;412;201;211;117;111;2.0;4.0;56.0;55.0;0.0;1.0;122;5398;3081;2317;434;169;27.0
3402;Woensdag 5 november 2003;606;317;289;395;191;204;108;104;1.0;3.0;38.0;36.0;0.0;2.0;158;4982;2801;2181;370;176;25.0
3403;Donderdag 6 november 2003;550;290;260;404;187;217;116;114;1.0;1.0;33.0;31.0;1.0;1.0;96;5097;2990;2107;418;189;133.0
3404;Vrijdag 7 november 2003;558;297;261;389;189;200;324;318;1.0;5.0;28.0;25.0;0.0;3.0;102;4932;2991;1941;310;200;209.0
3405;Zaterdag 8 november 2003;479;263;216;375;175;200;53;53;0.0;0.0;0.0;0.0;0.0;0.0;0;1087;795;292;9;26;3.0
3406;Zondag 9 november 2003;416;200;216;312;157;155;2;1;1.0;0.0;0.0;0.0;0.0;0.0;1;168;113;55;0;24;0.0
3407;Maandag 10 november 2003;560;298;262;352;170;182;139;133;1.0;5.0;57.0;55.0;0.0;2.0;139;5977;3666;2311;416;224;146.0
3408;Dinsdag 11 november 2003;570;288;282;399;197;202;182;179;1.0;2.0;45.0;43.0;0.0;2.0;114;4779;2854;1925;415;208;364.0
3409;Woensdag 12 november 2003;584;282;302;347;161;186;84;82;2.0;0.0;52.0;52.0;0.0;0.0;116;4591;2766;1825;370;216;24.0
3410;Donderdag 13 november 2003;609;306;303;390;195;195;95;92;1.0;2.0;39.0;39.0;0.0;0.0;132;4703;2751;1952;330;195;38.0
3411;Vrijdag 14 november 2003;569;270;299;393;195;198;330;324;4.0;2.0;33.0;32.0;1.0;0.0;121;5354;3319;2035;239;204;110.0
3412;Zaterdag 15 november 2003;441;228;213;345;173;172;47;46;0.0;1.0;0.0;0.0;0.0;0.0;0;3174;2270;904;4;82;1.0
3413;Zondag 16 november 2003;429;230;199;355;193;162;3;2;1.0;0.0;0.0;0.0;0.0;0.0;0;274;202;72;0;21;0.0
3414;Maandag 17 november 2003;587;289;298;385;182;203;140;138;0.0;2.0;46.0;42.0;1.0;3.0;138;6054;3698;2356;404;251;12.0
3415;Dinsdag 18 november 2003;605;295;310;369;176;193;120;118;1.0;1.0;65.0;56.0;7.0;2.0;135;4353;2621;1732;416;203;11.0
3416;Woensdag 19 november 2003;541;276;265;351;186;165;105;103;2.0;0.0;42.0;40.0;2.0;0.0;133;4120;2480;1640;358;169;599.0
3417;Donderdag 20 november 2003;566;292;274;364;169;195;153;147;3.0;3.0;40.0;39.0;0.0;1.0;140;4999;3087;1912;358;184;13.0
3418;Vrijdag 21 november 2003;569;280;289;423;206;217;348;343;3.0;2.0;42.0;39.0;1.0;2.0;121;4649;2846;1803;241;207;27.0
3419;Zaterdag 22 november 2003;469;257;212;394;183;211;72;71;0.0;1.0;0.0;0.0;0.0;0.0;0;1442;1040;402;4;33;7.0
3420;Zondag 23 november 2003;432;220;212;353;184;169;4;4;0.0;0.0;0.0;0.0;0.0;0.0;0;217;140;77;1;31;2.0
3421;Maandag 24 november 2003;569;301;268;372;187;185;133;127;1.0;5.0;61.0;57.0;1.0;3.0;114;5770;3520;2250;339;260;314.0
3422;Dinsdag 25 november 2003;599;321;278;387;186;201;103;98;4.0;1.0;58.0;55.0;0.0;3.0;96;4534;2855;1679;368;194;511.0
3423;Woensdag 26 november 2003;537;287;250;385;186;199;96;93;1.0;2.0;40.0;38.0;2.0;0.0;107;4192;2421;1771;331;206;18.0
3424;Donderdag 27 november 2003;564;309;255;353;176;177;137;131;1.0;5.0;40.0;40.0;0.0;0.0;131;4694;2899;1795;327;247;26.0
3425;Vrijdag 28 november 2003;565;302;263;393;190;203;343;339;4.0;0.0;39.0;34.0;2.0;3.0;106;5561;3583;1978;241;289;137.0
3426;Zaterdag 29 november 2003;436;232;204;376;160;216;43;43;0.0;0.0;1.0;0.0;1.0;0.0;1;1175;787;388;2;48;0.0
3427;Zondag 30 november 2003;443;225;218;377;204;173;3;3;0.0;0.0;0.0;0.0;0.0;0.0;0;965;699;266;4;73;3.0
3428;Totaal december 2003;15554;8016;7538;13281;6386;6895;3724;3651;36.0;37.0;938.0;892.0;25.0;21.0;2426;138914;86986;51928;6398;6111;2171.0
3429;Maandag 1 december 2003;555;290;265;385;184;201;151;146;2.0;3.0;70.0;67.0;2.0;1.0;106;22783;14816;7967;411;601;9.0
3430;Dinsdag 2 december 2003;561;299;262;371;181;190;105;102;1.0;2.0;48.0;45.0;2.0;1.0;114;5499;3369;2130;353;218;26.0
3431;Woensdag 3 december 2003;503;247;256;363;166;197;102;102;0.0;0.0;40.0;39.0;1.0;0.0;135;4990;2986;2004;347;207;168.0
3432;Donderdag 4 december 2003;505;264;241;383;200;183;82;82;0.0;0.0;43.0;43.0;0.0;0.0;129;5147;3155;1992;307;227;124.0
3433;Vrijdag 5 december 2003;442;241;201;364;181;183;101;99;0.0;2.0;20.0;18.0;0.0;2.0;127;4658;2866;1792;240;216;29.0
3434;Zaterdag 6 december 2003;449;223;226;397;196;201;40;38;1.0;1.0;0.0;0.0;0.0;0.0;0;1005;752;253;8;33;1.0
3435;Zondag 7 december 2003;433;235;198;373;177;196;0;0;;;0.0;0.0;0.0;0.0;0;158;108;50;7;29;1.0
3436;Maandag 8 december 2003;524;260;264;416;214;202;144;141;1.0;2.0;73.0;71.0;0.0;2.0;99;5497;3314;2183;393;236;24.0
3437;Dinsdag 9 december 2003;571;291;280;406;207;199;94;92;2.0;0.0;44.0;42.0;2.0;0.0;115;4162;2440;1722;335;193;171.0
3438;Woensdag 10 december 2003;593;304;289;411;188;223;111;110;0.0;1.0;38.0;37.0;1.0;0.0;92;4536;2863;1673;309;179;22.0
3439;Donderdag 11 december 2003;589;301;288;426;211;215;134;133;1.0;0.0;38.0;37.0;0.0;1.0;130;4262;2493;1769;313;183;17.0
3440;Vrijdag 12 december 2003;570;289;281;401;196;205;491;486;1.0;4.0;31.0;29.0;1.0;1.0;102;5220;3221;1999;230;261;538.0
3441;Zaterdag 13 december 2003;407;229;178;422;221;201;56;56;0.0;0.0;0.0;0.0;0.0;0.0;0;1477;1029;448;3;63;2.0
3442;Zondag 14 december 2003;415;222;193;416;200;216;0;0;;;0.0;0.0;0.0;0.0;0;252;177;75;3;32;0.0
3443;Maandag 15 december 2003;563;285;278;432;214;218;145;142;1.0;2.0;52.0;48.0;2.0;2.0;124;10921;7328;3593;348;359;17.0
3444;Dinsdag 16 december 2003;539;250;289;422;206;216;112;110;2.0;0.0;50.0;48.0;1.0;1.0;118;4944;3030;1914;344;208;21.0
3445;Woensdag 17 december 2003;527;266;261;442;212;230;122;121;0.0;1.0;46.0;43.0;2.0;1.0;88;4366;2604;1762;315;201;17.0
3446;Donderdag 18 december 2003;539;278;261;452;239;213;164;163;0.0;1.0;35.0;32.0;2.0;1.0;153;4938;3016;1922;328;227;24.0
3447;Vrijdag 19 december 2003;531;266;265;443;187;256;506;495;2.0;9.0;38.0;37.0;1.0;0.0;110;5367;3335;2032;197;245;21.0
3448;Zaterdag 20 december 2003;411;212;199;524;250;274;126;120;5.0;1.0;0.0;0.0;0.0;0.0;0;2882;1960;922;1;73;0.0
3449;Zondag 21 december 2003;423;231;192;397;175;222;2;2;0.0;0.0;0.0;0.0;0.0;0.0;1;273;180;93;1;52;0.0
3450;Maandag 22 december 2003;566;303;263;436;206;230;198;195;1.0;2.0;67.0;62.0;3.0;2.0;113;7547;4668;2879;362;348;21.0
3451;Dinsdag 23 december 2003;552;281;271;448;210;238;194;191;2.0;1.0;68.0;63.0;3.0;2.0;150;5292;3199;2093;318;288;863.0
3452;Woensdag 24 december 2003;529;288;241;428;213;215;141;137;3.0;1.0;29.0;27.0;1.0;1.0;118;4227;2510;1717;199;194;14.0
3453;Donderdag 25 december 2003;357;179;178;466;204;262;1;1;0.0;0.0;0.0;0.0;0.0;0.0;1;174;121;53;0;9;1.0
3454;Vrijdag 26 december 2003;406;214;192;467;225;242;0;0;;;0.0;0.0;0.0;0.0;0;60;43;17;0;38;1.0
3455;Zaterdag 27 december 2003;447;233;214;459;226;233;40;39;1.0;0.0;1.0;1.0;0.0;0.0;0;822;544;278;5;47;0.0
3456;Zondag 28 december 2003;432;216;216;497;212;285;2;2;0.0;0.0;0.0;0.0;0.0;0.0;0;388;280;108;4;36;1.0
3457;Maandag 29 december 2003;566;306;260;464;249;215;120;117;3.0;0.0;46.0;44.0;1.0;1.0;99;6386;3849;2537;307;361;10.0
3458;Dinsdag 30 december 2003;545;266;279;470;214;256;136;128;6.0;2.0;39.0;37.0;0.0;2.0;120;6161;3911;2250;248;314;18.0
3459;Woensdag 31 december 2003;504;247;257;500;222;278;104;101;1.0;2.0;22.0;22.0;0.0;0.0;82;4520;2819;1701;162;433;10.0
3460;Totaal op zondag in 2003;23539;12048;11491;19352;9483;9869;452;445;7.0;0.0;2.0;2.0;0.0;0.0;9;23873;16185;7688;197;2361;35.0
3461;Totaal op maandag in 2003;30130;15348;14782;20218;9938;10280;9538;9290;115.0;133.0;2676.0;2530.0;63.0;83.0;5857;344448;208236;136212;22263;14660;9369.0
3462;Totaal op dinsdag in 2003;31005;15887;15118;20200;9865;10335;8327;8127;101.0;99.0;2463.0;2332.0;62.0;69.0;6752;289967;173495;116472;23712;12548;5278.0
3463;Totaal op woensdag in 2003;31021;15940;15081;20766;10067;10699;8781;8594;94.0;93.0;1898.0;1795.0;56.0;47.0;6517;265821;157378;108443;21002;11640;5650.0
3464;Totaal op donderdag in 2003;30211;15601;14610;20394;9841;10553;11534;11308;106.0;120.0;1755.0;1686.0;37.0;32.0;6491;269640;160230;109410;21692;11813;5296.0
3465;Totaal op vrijdag in 2003;29899;15344;14555;20721;9935;10786;34169;33637;247.0;285.0;1299.0;1214.0;39.0;46.0;5825;271853;165006;106847;15425;12357;3084.0
3466;Totaal op zaterdag in 2003;24492;12702;11790;20285;9883;10402;7626;7527;65.0;34.0;26.0;18.0;5.0;3.0;28;100909;69791;31118;223;3506;87.0
3467;Totaal 2004;194007;99230;94777;136553;66359;70194;73441;72231;579.0;631.0;11156.0;10573.0;261.0;322.0;31098;1588247;970322;617925;94019;75049;26173.0
3468;Totaal januari 2004;16229;8157;8072;13726;6533;7193;2886;2839;28.0;19.0;798.0;757.0;15.0;26.0;2607;131226;80303;50923;7690;5561;2875.0
3469;Donderdag 1 januari 2004;343;180;163;462;220;242;13;13;0.0;0.0;0.0;0.0;0.0;0.0;0;10618;6526;4092;58;434;3.0
3470;Vrijdag 2 januari 2004;428;219;209;491;230;261;66;66;0.0;0.0;3.0;3.0;0.0;0.0;7;1986;1250;736;55;131;20.0
3471;Zaterdag 3 januari 2004;417;216;201;494;234;260;36;36;0.0;0.0;0.0;0.0;0.0;0.0;2;575;415;160;4;58;3.0
3472;Zondag 4 januari 2004;380;190;190;452;228;224;10;10;0.0;0.0;0.0;0.0;0.0;0.0;1;198;129;69;4;31;0.0
3473;Maandag 5 januari 2004;516;284;232;470;210;260;107;105;0.0;2.0;42.0;40.0;1.0;1.0;92;9626;5773;3853;523;355;13.0
3474;Dinsdag 6 januari 2004;608;310;298;507;250;257;146;144;1.0;1.0;45.0;44.0;0.0;1.0;134;6644;3977;2667;496;257;20.0
3475;Woensdag 7 januari 2004;553;280;273;464;238;226;109;107;1.0;1.0;43.0;42.0;0.0;1.0;152;5749;3350;2399;384;271;21.0
3476;Donderdag 8 januari 2004;600;273;327;480;230;250;97;95;1.0;1.0;50.0;49.0;1.0;0.0;121;5997;3616;2381;416;248;24.0
3477;Vrijdag 9 januari 2004;591;298;293;471;218;253;169;167;0.0;2.0;22.0;21.0;0.0;1.0;96;5113;2955;2158;305;178;23.0
3478;Zaterdag 10 januari 2004;456;238;218;452;219;233;56;56;0.0;0.0;0.0;0.0;0.0;0.0;0;1365;1001;364;17;77;7.0
3479;Zondag 11 januari 2004;412;203;209;489;240;249;3;3;0.0;0.0;0.0;0.0;0.0;0.0;0;154;99;55;2;36;2.0
3480;Maandag 12 januari 2004;603;311;292;445;215;230;129;128;0.0;1.0;61.0;59.0;1.0;1.0;119;6275;3783;2492;448;239;28.0
3481;Dinsdag 13 januari 2004;585;293;292;440;218;222;72;69;2.0;1.0;46.0;45.0;0.0;1.0;144;4673;2763;1910;404;197;823.0
3482;Woensdag 14 januari 2004;597;277;320;409;197;212;127;124;2.0;1.0;35.0;32.0;0.0;3.0;116;4827;2886;1941;368;209;24.0
3483;Donderdag 15 januari 2004;589;300;289;456;202;254;106;104;2.0;0.0;31.0;29.0;1.0;1.0;165;7865;5041;2824;408;216;30.0
3484;Vrijdag 16 januari 2004;551;299;252;450;221;229;210;209;1.0;0.0;23.0;19.0;3.0;1.0;110;4932;3019;1913;275;212;364.0
3485;Zaterdag 17 januari 2004;474;235;239;445;215;230;44;44;0.0;0.0;2.0;1.0;0.0;1.0;1;1045;803;242;2;55;0.0
3486;Zondag 18 januari 2004;427;212;215;410;207;203;6;6;0.0;0.0;1.0;1.0;0.0;0.0;0;191;130;61;8;20;0.0
3487;Maandag 19 januari 2004;491;248;243;424;208;216;107;106;1.0;0.0;50.0;46.0;2.0;2.0;125;5718;3564;2154;366;237;28.0
3488;Dinsdag 20 januari 2004;590;285;305;412;165;247;92;90;1.0;1.0;40.0;37.0;1.0;2.0;141;5012;2979;2033;380;195;26.0
3489;Woensdag 21 januari 2004;586;301;285;408;187;221;93;92;0.0;1.0;37.0;36.0;0.0;1.0;107;4468;2655;1813;382;148;13.0
3490;Donderdag 22 januari 2004;603;307;296;433;194;239;108;107;1.0;0.0;35.0;33.0;1.0;1.0;170;4900;2969;1931;357;167;21.0
3491;Vrijdag 23 januari 2004;574;271;303;418;189;229;225;220;2.0;3.0;22.0;21.0;1.0;0.0;153;4699;2855;1844;264;172;35.0
3492;Zaterdag 24 januari 2004;446;207;239;404;191;213;36;35;1.0;0.0;0.0;0.0;0.0;0.0;0;1306;929;377;9;26;3.0
3493;Zondag 25 januari 2004;469;242;227;422;202;220;5;4;1.0;0.0;0.0;0.0;0.0;0.0;0;407;264;143;2;27;3.0
3494;Maandag 26 januari 2004;563;291;272;406;203;203;114;111;3.0;0.0;54.0;51.0;1.0;2.0;125;5615;3421;2194;379;252;779.0
3495;Dinsdag 27 januari 2004;565;290;275;413;205;208;125;123;2.0;0.0;52.0;49.0;1.0;2.0;155;4510;2692;1818;389;237;41.0
3496;Woensdag 28 januari 2004;590;285;305;385;178;207;83;81;0.0;2.0;40.0;37.0;1.0;2.0;123;4290;2557;1733;349;219;456.0
3497;Donderdag 29 januari 2004;549;285;264;474;212;262;97;95;2.0;0.0;46.0;44.0;0.0;2.0;156;4611;2760;1851;383;255;26.0
3498;Vrijdag 30 januari 2004;587;306;281;415;202;213;245;239;4.0;2.0;18.0;18.0;0.0;0.0;92;6074;3852;2222;250;293;39.0
3499;Zaterdag 31 januari 2004;486;221;265;425;205;220;50;50;0.0;0.0;0.0;0.0;0.0;0.0;0;1783;1290;493;3;109;0.0
3500;Totaal februari 2004;15180;7851;7329;11300;5561;5739;3318;3261;24.0;33.0;839.0;800.0;18.0;21.0;2533;120876;75007;45869;6656;4934;2611.0
3501;Zondag 1 februari 2004;396;200;196;389;179;210;2;2;0.0;0.0;0.0;0.0;0.0;0.0;1;10709;7045;3664;24;291;0.0
3502;Maandag 2 februari 2004;508;276;232;395;163;232;143;138;2.0;3.0;62.0;61.0;1.0;0.0;109;8625;5231;3394;373;336;20.0
3503;Dinsdag 3 februari 2004;613;323;290;416;205;211;92;90;2.0;0.0;48.0;47.0;1.0;0.0;142;5470;3235;2235;409;194;92.0
3504;Woensdag 4 februari 2004;578;325;253;389;190;199;141;139;1.0;1.0;52.0;52.0;0.0;0.0;119;5163;3090;2073;341;190;39.0
3505;Donderdag 5 februari 2004;545;270;275;389;181;208;104;102;0.0;2.0;34.0;34.0;0.0;0.0;134;5599;3382;2217;356;200;22.0
3506;Vrijdag 6 februari 2004;542;275;267;433;236;197;256;251;4.0;1.0;24.0;23.0;1.0;0.0;149;4817;2886;1931;264;185;26.0
3507;Zaterdag 7 februari 2004;480;224;256;384;196;188;38;38;0.0;0.0;0.0;0.0;0.0;0.0;0;931;675;256;5;36;3.0
3508;Zondag 8 februari 2004;418;226;192;345;139;206;12;12;0.0;0.0;0.0;0.0;0.0;0.0;1;245;152;93;4;35;1.0
3509;Maandag 9 februari 2004;552;289;263;391;196;195;124;121;0.0;3.0;64.0;58.0;3.0;3.0;115;5558;3421;2137;356;224;23.0
3510;Dinsdag 10 februari 2004;564;292;272;413;216;197;116;113;1.0;2.0;43.0;40.0;2.0;1.0;139;4732;2887;1845;349;189;6.0
3511;Woensdag 11 februari 2004;548;276;272;416;197;219;91;90;1.0;0.0;55.0;54.0;1.0;0.0;82;4390;2633;1757;318;210;20.0
3512;Donderdag 12 februari 2004;582;315;267;387;191;196;125;124;0.0;1.0;39.0;34.0;2.0;3.0;151;4810;2987;1823;375;175;27.0
3513;Vrijdag 13 februari 2004;527;268;259;362;197;165;188;182;1.0;5.0;26.0;26.0;0.0;0.0;132;4505;2730;1775;240;202;33.0
3514;Zaterdag 14 februari 2004;442;231;211;377;204;173;180;177;0.0;3.0;1.0;0.0;1.0;0.0;0;1428;1030;398;4;35;1.0
3515;Zondag 15 februari 2004;461;241;220;346;174;172;7;7;0.0;0.0;0.0;0.0;0.0;0.0;0;1635;1206;429;1;61;0.0
3516;Maandag 16 februari 2004;558;268;290;389;188;201;143;142;0.0;1.0;55.0;51.0;0.0;4.0;120;6564;4129;2435;356;241;8.0
3517;Dinsdag 17 februari 2004;572;274;298;378;204;174;119;116;2.0;1.0;36.0;35.0;1.0;0.0;161;4546;2796;1750;411;195;18.0
3518;Woensdag 18 februari 2004;533;278;255;370;187;183;120;120;0.0;0.0;38.0;36.0;0.0;2.0;117;4393;2640;1753;308;189;10.0
3519;Donderdag 19 februari 2004;573;302;271;398;197;201;113;113;0.0;0.0;33.0;31.0;1.0;1.0;137;4481;2677;1804;382;161;25.0
3520;Vrijdag 20 februari 2004;551;281;270;427;229;198;325;322;1.0;2.0;22.0;19.0;2.0;1.0;118;5116;3180;1936;252;210;34.0
3521;Zaterdag 21 februari 2004;467;251;216;399;176;223;48;48;0.0;0.0;0.0;0.0;0.0;0.0;0;1401;979;422;1;31;812.0
3522;Zondag 22 februari 2004;414;222;192;385;199;186;6;6;0.0;0.0;1.0;1.0;0.0;0.0;0;217;147;70;2;27;5.0
3523;Maandag 23 februari 2004;577;310;267;412;192;220;152;145;5.0;2.0;53.0;51.0;1.0;1.0;104;4812;2955;1857;313;176;26.0
3524;Dinsdag 24 februari 2004;561;292;269;408;199;209;113;112;0.0;1.0;51.0;51.0;0.0;0.0;118;3908;2348;1560;321;250;164.0
3525;Woensdag 25 februari 2004;587;311;276;403;206;197;115;111;1.0;3.0;47.0;44.0;0.0;3.0;134;4709;2890;1819;313;274;866.0
3526;Donderdag 26 februari 2004;605;301;304;393;198;195;129;128;1.0;0.0;30.0;30.0;0.0;0.0;159;4803;2961;1842;332;223;296.0
3527;Vrijdag 27 februari 2004;557;289;268;388;198;190;253;250;2.0;1.0;25.0;22.0;1.0;2.0;90;5295;3320;1975;234;251;30.0
3528;Zaterdag 28 februari 2004;460;223;237;355;166;189;48;48;0.0;0.0;0.0;0.0;0.0;0.0;1;1468;1023;445;10;70;4.0
3529;Zondag 29 februari 2004;409;218;191;363;158;205;15;14;0.0;1.0;0.0;0.0;0.0;0.0;0;546;372;174;2;73;0.0
3530;Totaal maart 2004;16215;8291;7924;11983;5968;6015;4166;4020;68.0;78.0;1018.0;955.0;30.0;33.0;2888;136273;85492;50781;7224;5771;2253.0
3531;Maandag 1 maart 2004;538;269;269;423;239;184;172;164;8.0;0.0;63.0;58.0;2.0;3.0;115;22117;14444;7673;405;591;25.0
3532;Dinsdag 2 maart 2004;580;304;276;401;214;187;216;209;5.0;2.0;50.0;45.0;2.0;3.0;116;5843;3542;2301;403;238;13.0
3533;Woensdag 3 maart 2004;590;311;279;364;159;205;106;102;2.0;2.0;39.0;38.0;1.0;0.0;111;5163;3092;2071;340;207;21.0
3534;Donderdag 4 maart 2004;597;319;278;399;189;210;133;131;0.0;2.0;53.0;53.0;0.0;0.0;115;5468;3210;2258;393;206;29.0
3535;Vrijdag 5 maart 2004;563;292;271;412;211;201;298;290;2.0;6.0;14.0;14.0;0.0;0.0;116;4876;3005;1871;257;166;16.0
3536;Zaterdag 6 maart 2004;485;225;260;366;185;181;43;41;2.0;0.0;0.0;0.0;0.0;0.0;0;900;629;271;4;22;2.0
3537;Zondag 7 maart 2004;457;233;224;355;158;197;4;4;0.0;0.0;0.0;0.0;0.0;0.0;1;202;137;65;2;14;1.0
3538;Maandag 8 maart 2004;577;287;290;360;169;191;139;135;2.0;2.0;42.0;32.0;4.0;6.0;124;5779;3554;2225;337;261;21.0
3539;Dinsdag 9 maart 2004;555;290;265;399;208;191;116;116;0.0;0.0;58.0;57.0;1.0;0.0;139;4393;2627;1766;322;230;738.0
3540;Woensdag 10 maart 2004;519;266;253;384;197;187;109;99;0.0;10.0;37.0;33.0;0.0;4.0;121;4541;2781;1760;303;154;14.0
3541;Donderdag 11 maart 2004;538;277;261;377;168;209;116;110;2.0;4.0;34.0;33.0;0.0;1.0;152;4425;2759;1666;327;175;108.0
3542;Vrijdag 12 maart 2004;572;272;300;371;179;192;348;332;8.0;8.0;39.0;38.0;0.0;1.0;94;4452;2792;1660;238;193;20.0
3543;Zaterdag 13 maart 2004;468;255;213;379;192;187;39;35;2.0;2.0;0.0;0.0;0.0;0.0;1;840;589;251;3;31;1.0
3544;Zondag 14 maart 2004;386;195;191;379;178;201;8;8;0.0;0.0;0.0;0.0;0.0;0.0;0;223;146;77;4;24;1.0
3545;Maandag 15 maart 2004;524;264;260;428;200;228;140;132;6.0;2.0;49.0;45.0;4.0;0.0;106;8199;5280;2919;326;268;93.0
3546;Dinsdag 16 maart 2004;527;281;246;376;199;177;129;125;0.0;4.0;33.0;31.0;0.0;2.0;130;4632;2817;1815;381;203;21.0
3547;Woensdag 17 maart 2004;552;262;290;417;215;202;119;117;2.0;0.0;40.0;38.0;2.0;0.0;135;4153;2567;1586;302;207;190.0
3548;Donderdag 18 maart 2004;564;293;271;399;202;197;133;131;0.0;2.0;53.0;48.0;4.0;1.0;138;4379;2688;1691;281;192;204.0
3549;Vrijdag 19 maart 2004;503;245;258;386;199;187;336;326;2.0;8.0;31.0;28.0;1.0;2.0;103;4024;2506;1518;222;221;35.0
3550;Zaterdag 20 maart 2004;401;211;190;381;174;207;78;78;0.0;0.0;1.0;1.0;0.0;0.0;0;1526;1140;386;1;47;4.0
3551;Zondag 21 maart 2004;431;224;207;353;183;170;9;9;0.0;0.0;0.0;0.0;0.0;0.0;0;205;136;69;2;25;0.0
3552;Maandag 22 maart 2004;552;267;285;380;204;176;148;144;2.0;2.0;69.0;66.0;2.0;1.0;118;5078;3169;1909;299;250;22.0
3553;Dinsdag 23 maart 2004;554;287;267;389;199;190;105;101;0.0;4.0;43.0;39.0;1.0;3.0;132;4228;2632;1596;343;253;82.0
3554;Woensdag 24 maart 2004;534;270;264;353;172;181;137;131;2.0;4.0;42.0;41.0;0.0;1.0;149;3894;2386;1508;305;175;20.0
3555;Donderdag 25 maart 2004;579;298;281;405;195;210;138;134;2.0;2.0;36.0;35.0;1.0;0.0;136;4957;3121;1836;313;258;31.0
3556;Vrijdag 26 maart 2004;515;275;240;362;179;183;396;382;10.0;4.0;36.0;33.0;2.0;1.0;139;4662;2883;1779;211;205;26.0
3557;Zaterdag 27 maart 2004;427;212;215;402;206;196;64;63;1.0;0.0;1.0;1.0;0.0;0.0;0;1670;1189;481;4;68;1.0
3558;Zondag 28 maart 2004;398;202;196;348;181;167;3;3;0.0;0.0;0.0;0.0;0.0;0.0;2;315;224;91;1;40;1.0
3559;Maandag 29 maart 2004;535;283;252;386;193;193;136;130;2.0;4.0;58.0;56.0;0.0;2.0;115;5235;3267;1968;314;263;476.0
3560;Dinsdag 30 maart 2004;596;310;286;425;208;217;126;122;2.0;2.0;55.0;53.0;1.0;1.0;145;4441;2780;1661;310;248;20.0
3561;Woensdag 31 maart 2004;598;312;286;424;213;211;122;116;4.0;2.0;42.0;39.0;2.0;1.0;135;5453;3400;2053;271;336;17.0
3562;Totaal april 2004;15801;8165;7636;11092;5347;5745;6401;6280;58.0;63.0;895.0;846.0;22.0;27.0;2520;123807;78325;45482;5678;5556;1968.0
3563;Donderdag 1 april 2004;523;267;256;376;178;198;292;286;3.0;3.0;42.0;41.0;0.0;1.0;122;21693;14190;7503;364;670;192.0
3564;Vrijdag 2 april 2004;556;287;269;393;185;208;644;633;5.0;6.0;27.0;24.0;0.0;3.0;89;5385;3302;2083;246;314;17.0
3565;Zaterdag 3 april 2004;442;237;205;376;191;185;81;80;1.0;0.0;0.0;0.0;0.0;0.0;2;843;596;247;5;50;126.0
3566;Zondag 4 april 2004;459;242;217;363;169;194;62;60;1.0;1.0;1.0;0.0;0.0;1.0;1;232;163;69;4;37;0.0
3567;Maandag 5 april 2004;519;258;261;374;188;186;185;181;2.0;2.0;58.0;58.0;0.0;0.0;146;6205;3808;2397;337;260;36.0
3568;Dinsdag 6 april 2004;566;289;277;377;199;178;128;126;2.0;0.0;42.0;38.0;1.0;3.0;170;4482;2740;1742;282;206;24.0
3569;Woensdag 7 april 2004;539;259;280;341;173;168;145;141;3.0;1.0;51.0;49.0;0.0;2.0;125;4188;2590;1598;262;218;19.0
3570;Donderdag 8 april 2004;599;308;291;367;166;201;247;238;2.0;7.0;53.0;49.0;4.0;0.0;135;5327;3236;2091;324;184;18.0
3571;Vrijdag 9 april 2004;570;307;263;409;187;222;71;71;0.0;0.0;7.0;7.0;0.0;0.0;23;1545;1079;466;43;90;8.0
3572;Zaterdag 10 april 2004;466;248;218;342;169;173;66;64;1.0;1.0;1.0;1.0;0.0;0.0;0;1411;1071;340;3;42;0.0
3573;Zondag 11 april 2004;415;226;189;350;160;190;5;5;0.0;0.0;0.0;0.0;0.0;0.0;0;91;61;30;1;18;3.0
3574;Maandag 12 april 2004;472;235;237;347;161;186;15;15;0.0;0.0;0.0;0.0;0.0;0.0;1;319;216;103;3;32;0.0
3575;Dinsdag 13 april 2004;541;278;263;402;194;208;128;126;1.0;1.0;48.0;44.0;1.0;3.0;149;5756;3568;2188;330;251;347.0
3576;Woensdag 14 april 2004;588;306;282;390;195;195;185;179;3.0;3.0;44.0;43.0;1.0;0.0;148;4678;2821;1857;310;315;27.0
3577;Donderdag 15 april 2004;548;287;261;340;159;181;161;161;0.0;0.0;52.0;49.0;1.0;2.0;150;7428;4845;2583;275;268;31.0
3578;Vrijdag 16 april 2004;589;301;288;361;173;188;610;606;1.0;3.0;31.0;29.0;2.0;0.0;125;4901;3048;1853;194;189;15.0
3579;Zaterdag 17 april 2004;455;226;229;388;176;212;104;101;1.0;2.0;2.0;2.0;0.0;0.0;1;999;715;284;4;38;2.0
3580;Zondag 18 april 2004;465;255;210;420;212;208;7;7;0.0;0.0;0.0;0.0;0.0;0.0;0;217;158;59;0;29;3.0
3581;Maandag 19 april 2004;584;296;288;366;183;183;191;187;3.0;1.0;67.0;64.0;2.0;1.0;134;5331;3329;2002;282;226;16.0
3582;Dinsdag 20 april 2004;578;298;280;374;195;179;568;557;5.0;6.0;61.0;55.0;2.0;4.0;157;4499;2837;1662;326;185;913.0
3583;Woensdag 21 april 2004;548;282;266;363;173;190;159;156;1.0;2.0;36.0;32.0;0.0;4.0;124;4048;2473;1575;266;159;25.0
3584;Donderdag 22 april 2004;569;304;265;378;186;192;228;224;3.0;1.0;44.0;44.0;0.0;0.0;117;4609;2845;1764;291;201;40.0
3585;Vrijdag 23 april 2004;562;286;276;375;176;199;734;724;7.0;3.0;30.0;28.0;1.0;1.0;140;4547;2903;1644;223;220;9.0
3586;Zaterdag 24 april 2004;450;253;197;352;169;183;230;226;1.0;3.0;1.0;1.0;0.0;0.0;0;1548;1107;441;6;36;1.0
3587;Zondag 25 april 2004;428;201;227;333;164;169;7;6;1.0;0.0;0.0;0.0;0.0;0.0;1;466;353;113;1;24;2.0
3588;Maandag 26 april 2004;609;315;294;376;176;200;178;172;3.0;3.0;70.0;65.0;4.0;1.0;107;5490;3410;2080;333;307;24.0
3589;Dinsdag 27 april 2004;544;268;276;359;166;193;177;173;1.0;3.0;48.0;48.0;0.0;0.0;139;4378;2657;1721;324;247;18.0
3590;Woensdag 28 april 2004;571;280;291;382;175;207;228;223;0.0;5.0;41.0;39.0;1.0;1.0;113;4896;2964;1932;325;244;25.0
3591;Donderdag 29 april 2004;548;282;266;363;179;184;527;514;7.0;6.0;38.0;36.0;2.0;0.0;98;6926;4235;2691;307;362;25.0
3592;Vrijdag 30 april 2004;498;284;214;355;170;185;38;38;0.0;0.0;0.0;0.0;0.0;0.0;3;1369;1005;364;7;134;2.0
3593;Totaal mei 2004;15751;8096;7655;11093;5382;5711;9209;9075;70.0;64.0;840.0;798.0;21.0;21.0;2229;115677;72930;42747;6318;4785;3309.0
3594;Zaterdag 1 mei 2004;452;232;220;366;162;204;141;137;3.0;1.0;1.0;1.0;0.0;0.0;2;11774;7972;3802;21;307;1.0
3595;Zondag 2 mei 2004;431;233;198;347;165;182;7;7;0.0;0.0;0.0;0.0;0.0;0.0;1;221;162;59;5;34;0.0
3596;Maandag 3 mei 2004;546;276;270;350;176;174;223;220;2.0;1.0;58.0;56.0;0.0;2.0;105;8240;5135;3105;401;286;13.0
3597;Dinsdag 4 mei 2004;579;328;251;384;167;217;111;108;2.0;1.0;55.0;55.0;0.0;0.0;132;5130;3076;2054;409;250;17.0
3598;Woensdag 5 mei 2004;502;259;243;339;171;168;38;37;0.0;1.0;0.0;0.0;0.0;0.0;11;646;435;211;12;40;4.0
3599;Donderdag 6 mei 2004;643;312;331;323;176;147;382;375;5.0;2.0;57.0;55.0;1.0;1.0;183;7006;4233;2773;438;259;430.0
3600;Vrijdag 7 mei 2004;577;298;279;369;167;202;921;912;4.0;5.0;36.0;34.0;1.0;1.0;105;5163;3110;2053;289;181;18.0
3601;Zaterdag 8 mei 2004;473;244;229;361;181;180;173;168;2.0;3.0;1.0;1.0;0.0;0.0;0;929;627;302;3;29;0.0
3602;Zondag 9 mei 2004;460;216;244;329;169;160;5;5;0.0;0.0;0.0;0.0;0.0;0.0;1;128;74;54;7;11;0.0
3603;Maandag 10 mei 2004;523;263;260;348;178;170;215;207;3.0;5.0;64.0;62.0;0.0;2.0;111;6390;4149;2241;402;237;21.0
3604;Dinsdag 11 mei 2004;528;271;257;393;191;202;164;161;2.0;1.0;54.0;51.0;2.0;1.0;124;4638;2723;1915;401;173;21.0
3605;Woensdag 12 mei 2004;507;264;243;369;176;193;222;220;0.0;2.0;39.0;37.0;0.0;2.0;121;4393;2690;1703;360;166;41.0
3606;Donderdag 13 mei 2004;510;250;260;378;175;203;225;225;0.0;0.0;44.0;43.0;0.0;1.0;98;4587;2820;1767;348;166;29.0
3607;Vrijdag 14 mei 2004;551;267;284;368;184;184;1193;1173;11.0;9.0;26.0;24.0;1.0;1.0;92;4779;2977;1802;279;202;413.0
3608;Zaterdag 15 mei 2004;450;237;213;325;165;160;236;232;1.0;3.0;1.0;0.0;1.0;0.0;0;2806;2003;803;5;70;0.0
3609;Zondag 16 mei 2004;376;183;193;382;189;193;12;11;1.0;0.0;0.0;0.0;0.0;0.0;1;253;176;77;2;21;0.0
3610;Maandag 17 mei 2004;529;279;250;382;178;204;210;207;0.0;3.0;81.0;75.0;2.0;4.0;166;5975;3696;2279;351;210;1038.0
3611;Dinsdag 18 mei 2004;590;338;252;349;165;184;195;191;3.0;1.0;49.0;44.0;3.0;2.0;94;4510;2806;1704;395;216;22.0
3612;Woensdag 19 mei 2004;565;319;246;365;186;179;936;925;7.0;4.0;35.0;34.0;1.0;0.0;137;4678;2856;1822;347;211;25.0
3613;Donderdag 20 mei 2004;520;273;247;367;180;187;18;18;0.0;0.0;0.0;0.0;0.0;0.0;1;746;516;230;1;35;2.0
3614;Vrijdag 21 mei 2004;508;260;248;358;180;178;758;749;5.0;4.0;8.0;7.0;1.0;0.0;24;1438;959;479;40;58;0.0
3615;Zaterdag 22 mei 2004;452;214;238;352;188;164;188;188;0.0;0.0;1.0;1.0;0.0;0.0;1;875;626;249;2;24;0.0
3616;Zondag 23 mei 2004;411;213;198;327;160;167;6;6;0.0;0.0;0.0;0.0;0.0;0.0;1;193;148;45;3;17;0.0
3617;Maandag 24 mei 2004;538;262;276;343;161;182;222;220;1.0;1.0;57.0;56.0;1.0;0.0;145;6872;4304;2568;383;312;19.0
3618;Dinsdag 25 mei 2004;540;285;255;357;184;173;212;209;1.0;2.0;49.0;46.0;1.0;2.0;163;5117;3243;1874;399;280;36.0
3619;Woensdag 26 mei 2004;548;277;271;373;179;194;222;221;1.0;0.0;44.0;41.0;2.0;1.0;112;4645;2827;1818;333;209;21.0
3620;Donderdag 27 mei 2004;528;260;268;359;161;198;388;381;5.0;2.0;38.0;36.0;2.0;0.0;139;5257;3284;1973;405;306;18.0
3621;Vrijdag 28 mei 2004;528;270;258;362;164;198;1337;1316;9.0;12.0;41.0;39.0;1.0;1.0;155;5938;3746;2192;271;271;1120.0
3622;Zaterdag 29 mei 2004;467;227;240;378;175;203;216;213;2.0;1.0;1.0;0.0;1.0;0.0;0;1091;679;412;3;60;0.0
3623;Zondag 30 mei 2004;457;250;207;337;165;172;15;15;0.0;0.0;0.0;0.0;0.0;0.0;0;436;330;106;2;48;0.0
3624;Maandag 31 mei 2004;462;236;226;353;164;189;18;18;0.0;0.0;0.0;0.0;0.0;0.0;4;823;548;275;1;96;0.0
3625;Totaal juni 2004;16477;8465;8012;10692;5169;5523;9820;9670;69.0;81.0;1004.0;945.0;25.0;34.0;2804;134370;84134;50236;7756;6366;1541.0
3626;Dinsdag 1 juni 2004;515;253;262;379;198;181;226;219;5.0;2.0;54.0;48.0;2.0;4.0;122;20217;13023;7194;444;558;14.0
3627;Woensdag 2 juni 2004;636;349;287;338;174;164;191;190;1.0;0.0;42.0;38.0;2.0;2.0;106;5755;3496;2259;394;236;19.0
3628;Donderdag 3 juni 2004;545;294;251;337;151;186;317;310;3.0;4.0;47.0;45.0;2.0;0.0;140;5936;3570;2366;406;229;21.0
3629;Vrijdag 4 juni 2004;576;304;272;367;171;196;1341;1329;4.0;8.0;19.0;18.0;0.0;1.0;128;5007;3063;1944;254;200;24.0
3630;Zaterdag 5 juni 2004;459;229;230;344;171;173;285;282;2.0;1.0;1.0;1.0;0.0;0.0;0;890;629;261;2;49;4.0
3631;Zondag 6 juni 2004;439;211;228;367;167;200;11;11;0.0;0.0;0.0;0.0;0.0;0.0;0;202;151;51;4;53;4.0
3632;Maandag 7 juni 2004;580;293;287;368;148;220;231;227;2.0;2.0;75.0;69.0;2.0;4.0;122;6045;3711;2334;365;249;29.0
3633;Dinsdag 8 juni 2004;618;302;316;417;221;196;196;188;4.0;4.0;63.0;57.0;3.0;3.0;155;4564;2851;1713;367;231;24.0
3634;Woensdag 9 juni 2004;626;312;314;420;204;216;184;180;2.0;2.0;60.0;58.0;2.0;0.0;116;4195;2490;1705;307;184;14.0
3635;Donderdag 10 juni 2004;575;308;267;400;189;211;261;260;0.0;1.0;20.0;17.0;2.0;1.0;133;4639;2910;1729;334;197;20.0
3636;Vrijdag 11 juni 2004;547;296;251;377;205;172;1039;1033;3.0;3.0;24.0;24.0;0.0;0.0;105;4345;2751;1594;228;217;11.0
3637;Zaterdag 12 juni 2004;494;267;227;346;181;165;271;267;4.0;0.0;1.0;1.0;0.0;0.0;1;970;710;260;1;52;4.0
3638;Zondag 13 juni 2004;465;223;242;352;173;179;4;4;0.0;0.0;0.0;0.0;0.0;0.0;0;146;104;42;2;28;2.0
3639;Maandag 14 juni 2004;553;302;251;348;170;178;184;179;1.0;4.0;77.0;74.0;2.0;1.0;126;5890;3652;2238;346;197;366.0
3640;Dinsdag 15 juni 2004;572;301;271;365;176;189;168;158;3.0;7.0;45.0;44.0;0.0;1.0;115;6915;4503;2412;359;281;17.0
3641;Woensdag 16 juni 2004;588;307;281;337;163;174;170;165;2.0;3.0;54.0;52.0;1.0;1.0;106;4524;2799;1725;321;222;28.0
3642;Donderdag 17 juni 2004;557;282;275;367;182;185;289;285;1.0;3.0;34.0;33.0;0.0;1.0;129;4695;2868;1827;332;213;12.0
3643;Vrijdag 18 juni 2004;578;271;307;339;156;183;1178;1164;6.0;8.0;28.0;26.0;1.0;1.0;119;4630;2869;1761;266;197;14.0
3644;Zaterdag 19 juni 2004;483;248;235;311;142;169;205;202;2.0;1.0;0.0;0.0;0.0;0.0;1;1076;775;301;3;37;0.0
3645;Zondag 20 juni 2004;429;221;208;336;166;170;4;4;0.0;0.0;0.0;0.0;0.0;0.0;0;514;372;142;1;37;3.0
3646;Maandag 21 juni 2004;558;289;269;339;153;186;314;306;5.0;3.0;58.0;54.0;1.0;3.0;148;5557;3395;2162;456;290;6.0
3647;Dinsdag 22 juni 2004;571;288;283;304;138;166;161;157;3.0;1.0;46.0;45.0;0.0;1.0;134;4437;2668;1769;348;248;191.0
3648;Woensdag 23 juni 2004;592;314;278;377;185;192;168;167;1.0;0.0;44.0;42.0;1.0;1.0;140;4081;2504;1577;310;260;602.0
3649;Donderdag 24 juni 2004;574;266;308;380;184;196;391;386;0.0;5.0;36.0;33.0;1.0;2.0;143;4523;2831;1692;342;296;22.0
3650;Vrijdag 25 juni 2004;583;296;287;364;156;208;1198;1185;6.0;7.0;23.0;21.0;1.0;1.0;114;5190;3276;1914;283;325;38.0
3651;Zaterdag 26 juni 2004;484;258;226;322;157;165;253;249;3.0;1.0;0.0;0.0;0.0;0.0;1;1666;1199;467;3;64;6.0
3652;Zondag 27 juni 2004;468;251;217;356;175;181;4;4;0.0;0.0;0.0;0.0;0.0;0.0;1;269;163;106;1;58;1.0
3653;Maandag 28 juni 2004;600;324;276;351;185;166;211;210;0.0;1.0;65.0;62.0;2.0;1.0;129;6183;3876;2307;407;331;16.0
3654;Dinsdag 29 juni 2004;608;311;297;356;169;187;150;143;2.0;5.0;54.0;51.0;0.0;3.0;160;4748;2803;1945;434;320;9.0
3655;Woensdag 30 juni 2004;604;295;309;328;159;169;215;206;4.0;5.0;34.0;32.0;0.0;2.0;110;6561;4122;2439;436;507;20.0
3656;Totaal juli 2004;17324;8800;8524;10786;5253;5533;7470;7391;38.0;41.0;902.0;857.0;22.0;23.0;2661;145155;86847;58308;8250;8703;1996.0
3657;Donderdag 1 juli 2004;578;295;283;360;183;177;325;322;0.0;3.0;42.0;40.0;0.0;2.0;115;24336;15237;9099;423;1035;162.0
3658;Vrijdag 2 juli 2004;536;267;269;351;181;170;1005;999;3.0;3.0;24.0;23.0;0.0;1.0;137;5842;3402;2440;352;409;10.0
3659;Zaterdag 3 juli 2004;459;238;221;373;173;200;230;228;1.0;1.0;1.0;1.0;0.0;0.0;1;959;608;351;1;87;0.0
3660;Zondag 4 juli 2004;515;266;249;335;160;175;5;5;0.0;0.0;0.0;0.0;0.0;0.0;0;184;122;62;1;68;0.0
3661;Maandag 5 juli 2004;566;259;307;358;180;178;203;200;2.0;1.0;66.0;63.0;0.0;3.0;103;6916;3914;3002;458;368;543.0
3662;Dinsdag 6 juli 2004;596;319;277;338;162;176;154;151;3.0;0.0;44.0;41.0;3.0;0.0;173;5461;3093;2368;456;296;28.0
3663;Woensdag 7 juli 2004;627;332;295;367;181;186;242;238;1.0;3.0;38.0;36.0;1.0;1.0;127;5193;2978;2215;373;260;19.0
3664;Donderdag 8 juli 2004;593;307;286;367;163;204;203;200;2.0;1.0;40.0;39.0;1.0;0.0;103;5446;3215;2231;387;265;44.0
3665;Vrijdag 9 juli 2004;631;330;301;387;174;213;745;739;3.0;3.0;24.0;21.0;2.0;1.0;110;4774;2859;1915;261;335;385.0
3666;Zaterdag 10 juli 2004;449;216;233;337;159;178;179;179;0.0;0.0;2.0;1.0;0.0;1.0;1;1674;1103;571;8;135;2.0
3667;Zondag 11 juli 2004;463;244;219;339;168;171;9;9;0.0;0.0;0.0;0.0;0.0;0.0;0;203;132;71;1;56;1.0
3668;Maandag 12 juli 2004;613;329;284;336;158;178;206;203;1.0;2.0;68.0;65.0;2.0;1.0;129;6122;3510;2612;433;429;14.0
3669;Dinsdag 13 juli 2004;605;317;288;327;158;169;145;143;2.0;0.0;33.0;33.0;0.0;0.0;127;4759;2710;2049;406;276;18.0
3670;Woensdag 14 juli 2004;600;291;309;337;163;174;206;201;1.0;4.0;41.0;39.0;1.0;1.0;144;4812;2816;1996;352;328;20.0
3671;Donderdag 15 juli 2004;575;298;277;313;148;165;195;194;1.0;0.0;47.0;45.0;2.0;0.0;114;8062;4941;3121;441;434;36.0
3672;Vrijdag 16 juli 2004;621;318;303;356;182;174;654;646;3.0;5.0;21.0;19.0;0.0;2.0;124;5449;3281;2168;268;360;37.0
3673;Zaterdag 17 juli 2004;446;214;232;363;188;175;154;154;0.0;0.0;1.0;0.0;0.0;1.0;0;1168;783;385;1;77;0.0
3674;Zondag 18 juli 2004;465;227;238;367;170;197;15;15;0.0;0.0;0.0;0.0;0.0;0.0;1;241;142;99;7;34;0.0
3675;Maandag 19 juli 2004;583;286;297;349;149;200;192;191;0.0;1.0;61.0;57.0;1.0;3.0;118;6044;3640;2404;421;348;11.0
3676;Dinsdag 20 juli 2004;577;293;284;348;170;178;157;156;1.0;0.0;59.0;56.0;2.0;1.0;124;5088;3007;2081;381;308;29.0
3677;Woensdag 21 juli 2004;584;297;287;354;164;190;159;155;2.0;2.0;35.0;34.0;1.0;0.0;113;4504;2715;1789;339;246;150.0
3678;Donderdag 22 juli 2004;617;307;310;362;181;181;177;175;1.0;1.0;34.0;34.0;0.0;0.0;121;4687;2769;1918;390;261;390.0
3679;Vrijdag 23 juli 2004;621;332;289;370;191;179;434;432;0.0;2.0;36.0;34.0;2.0;0.0;122;4560;2728;1832;282;261;27.0
3680;Zaterdag 24 juli 2004;464;236;228;272;138;134;137;136;0.0;1.0;0.0;0.0;0.0;0.0;0;1382;924;458;1;44;0.0
3681;Zondag 25 juli 2004;472;241;231;317;150;167;17;17;0.0;0.0;0.0;0.0;0.0;0.0;1;439;294;145;2;53;0.0
3682;Maandag 26 juli 2004;561;269;292;331;167;164;231;229;1.0;1.0;45.0;43.0;0.0;2.0;105;5670;3386;2284;399;369;16.0
3683;Dinsdag 27 juli 2004;590;280;310;330;152;178;165;163;1.0;1.0;47.0;43.0;2.0;2.0;98;4350;2524;1826;400;296;14.0
3684;Woensdag 28 juli 2004;608;297;311;327;163;164;177;172;4.0;1.0;36.0;36.0;0.0;0.0;114;4593;2650;1943;330;354;15.0
3685;Donderdag 29 juli 2004;585;320;265;352;193;159;187;185;2.0;0.0;34.0;33.0;1.0;0.0;114;4600;2630;1970;364;318;17.0
3686;Vrijdag 30 juli 2004;635;330;305;397;199;198;431;427;0.0;4.0;23.0;21.0;1.0;1.0;120;6110;3713;2397;306;394;8.0
3687;Zaterdag 31 juli 2004;489;245;244;366;185;181;131;127;3.0;1.0;0.0;0.0;0.0;0.0;2;1527;1021;506;6;199;0.0
3688;Totaal augustus 2004;16919;8667;8252;11166;5372;5794;8207;8089;57.0;61.0;937.0;881.0;26.0;30.0;2547;140094;78520;61574;10778;7866;1818.0
3689;Zondag 1 augustus 2004;466;239;227;346;164;182;16;16;0.0;0.0;0.0;0.0;0.0;0.0;0;13818;8223;5595;57;526;1.0
3690;Maandag 2 augustus 2004;586;299;287;376;191;185;223;221;1.0;1.0;60.0;55.0;1.0;4.0;96;8990;5300;3690;640;413;32.0
3691;Dinsdag 3 augustus 2004;575;292;283;365;172;193;172;170;2.0;0.0;44.0;41.0;1.0;2.0;130;5530;3061;2469;593;238;566.0
3692;Woensdag 4 augustus 2004;603;323;280;367;170;197;228;224;2.0;2.0;33.0;31.0;1.0;1.0;103;4944;2708;2236;523;263;19.0
3693;Donderdag 5 augustus 2004;577;299;278;389;176;213;191;190;0.0;1.0;30.0;25.0;3.0;2.0;111;4976;2789;2187;498;333;25.0
3694;Vrijdag 6 augustus 2004;591;306;285;390;189;201;536;526;4.0;6.0;24.0;24.0;0.0;0.0;117;4685;2578;2107;383;285;6.0
3695;Zaterdag 7 augustus 2004;533;268;265;360;180;180;151;150;1.0;0.0;1.0;1.0;0.0;0.0;0;895;610;285;4;44;3.0
3696;Zondag 8 augustus 2004;469;242;227;395;177;218;17;17;0.0;0.0;0.0;0.0;0.0;0.0;0;280;178;102;3;32;0.0
3697;Maandag 9 augustus 2004;587;306;281;404;197;207;216;213;1.0;2.0;72.0;65.0;4.0;3.0;95;5388;3029;2359;464;243;128.0
3698;Dinsdag 10 augustus 2004;613;325;288;418;199;219;180;174;1.0;5.0;50.0;47.0;2.0;1.0;104;4837;2715;2122;412;288;20.0
3699;Woensdag 11 augustus 2004;566;301;265;394;191;203;173;172;0.0;1.0;46.0;42.0;3.0;1.0;104;4047;2270;1777;429;262;8.0
3700;Donderdag 12 augustus 2004;592;314;278;383;182;201;239;238;0.0;1.0;42.0;39.0;1.0;2.0;123;4854;2739;2115;394;316;32.0
3701;Vrijdag 13 augustus 2004;558;294;264;377;179;198;396;385;7.0;4.0;18.0;18.0;0.0;0.0;110;4397;2497;1900;311;264;171.0
3702;Zaterdag 14 augustus 2004;473;247;226;327;157;170;190;190;0.0;0.0;0.0;0.0;0.0;0.0;1;1060;672;388;0;58;4.0
3703;Zondag 15 augustus 2004;448;231;217;376;197;179;14;14;0.0;0.0;0.0;0.0;0.0;0.0;0;1920;1146;774;4;106;1.0
3704;Maandag 16 augustus 2004;586;305;281;355;171;184;285;282;1.0;2.0;55.0;52.0;2.0;1.0;68;7511;4225;3286;451;381;27.0
3705;Dinsdag 17 augustus 2004;566;290;276;370;178;192;184;182;0.0;2.0;42.0;40.0;0.0;2.0;121;4859;2564;2295;535;273;18.0
3706;Woensdag 18 augustus 2004;606;298;308;351;157;194;226;220;5.0;1.0;44.0;41.0;3.0;0.0;146;5041;2722;2319;426;304;9.0
3707;Donderdag 19 augustus 2004;563;270;293;327;154;173;308;300;4.0;4.0;38.0;36.0;0.0;2.0;142;5112;2756;2356;461;285;16.0
3708;Vrijdag 20 augustus 2004;617;304;313;343;153;190;1063;1047;3.0;13.0;24.0;23.0;1.0;0.0;102;5200;2949;2251;400;324;26.0
3709;Zaterdag 21 augustus 2004;452;227;225;345;177;168;230;230;0.0;0.0;0.0;0.0;0.0;0.0;0;988;626;362;6;39;1.0
3710;Zondag 22 augustus 2004;458;236;222;323;142;181;9;9;0.0;0.0;1.0;0.0;0.0;1.0;0;210;106;104;0;36;0.0
3711;Maandag 23 augustus 2004;553;270;283;341;176;165;228;224;3.0;1.0;62.0;59.0;1.0;2.0;133;6393;3360;3033;478;343;21.0
3712;Dinsdag 24 augustus 2004;545;265;280;359;182;177;188;187;1.0;0.0;50.0;50.0;0.0;0.0;143;4778;2539;2239;513;219;20.0
3713;Woensdag 25 augustus 2004;562;296;266;324;153;171;229;226;2.0;1.0;39.0;38.0;1.0;0.0;130;4826;2588;2238;501;324;24.0
3714;Donderdag 26 augustus 2004;566;293;273;343;178;165;376;371;2.0;3.0;33.0;31.0;0.0;2.0;118;5087;2714;2373;637;298;17.0
3715;Vrijdag 27 augustus 2004;551;297;254;353;183;170;1218;1203;12.0;3.0;20.0;19.0;1.0;0.0;116;4885;2695;2190;416;340;26.0
3716;Zaterdag 28 augustus 2004;416;219;197;343;171;172;314;308;1.0;5.0;2.0;1.0;0.0;1.0;0;1428;965;463;4;80;7.0
3717;Zondag 29 augustus 2004;460;227;233;366;180;186;7;6;1.0;0.0;0.0;0.0;0.0;0.0;0;295;157;138;1;59;4.0
3718;Maandag 30 augustus 2004;576;286;290;313;144;169;221;219;1.0;1.0;51.0;49.0;0.0;2.0;111;6594;3636;2958;550;439;20.0
3719;Dinsdag 31 augustus 2004;605;298;307;343;152;191;179;175;2.0;2.0;56.0;54.0;1.0;1.0;123;6266;3403;2863;684;451;566.0
3720;Totaal september 2004;16438;8371;8067;10553;5169;5384;9564;9420;64.0;80.0;926.0;889.0;18.0;19.0;2509;139937;80268;59669;11967;6872;1681.0
3721;Woensdag 1 september 2004;578;285;293;359;169;190;241;235;3.0;3.0;43.0;41.0;1.0;1.0;132;24370;13826;10544;668;943;13.0
3722;Donderdag 2 september 2004;548;288;260;362;182;180;392;387;3.0;2.0;36.0;35.0;1.0;0.0;122;6280;3381;2899;663;302;18.0
3723;Vrijdag 3 september 2004;519;259;260;338;168;170;1309;1295;5.0;9.0;25.0;24.0;0.0;1.0;91;5503;2969;2534;469;278;17.0
3724;Zaterdag 4 september 2004;468;239;229;339;156;183;400;396;1.0;3.0;1.0;1.0;0.0;0.0;0;793;483;310;2;88;8.0
3725;Zondag 5 september 2004;473;241;232;360;186;174;12;11;1.0;0.0;0.0;0.0;0.0;0.0;0;225;137;88;2;48;1.0
3726;Maandag 6 september 2004;556;278;278;361;184;177;219;215;2.0;2.0;53.0;49.0;3.0;1.0;137;6583;3520;3063;552;354;25.0
3727;Dinsdag 7 september 2004;556;276;280;356;180;176;174;172;1.0;1.0;35.0;34.0;1.0;0.0;151;4938;2565;2373;619;172;26.0
3728;Woensdag 8 september 2004;561;312;249;346;183;163;205;203;2.0;0.0;42.0;41.0;1.0;0.0;105;5050;2715;2335;563;244;29.0
3729;Donderdag 9 september 2004;572;263;309;353;165;188;428;417;2.0;9.0;40.0;38.0;1.0;1.0;115;5098;2737;2361;680;239;418.0
3730;Vrijdag 10 september 2004;564;303;261;357;175;182;1265;1245;5.0;15.0;20.0;18.0;0.0;2.0;101;5033;2972;2061;430;249;15.0
3731;Zaterdag 11 september 2004;464;230;234;367;186;181;163;160;2.0;1.0;1.0;1.0;0.0;0.0;0;753;525;228;3;64;3.0
3732;Zondag 12 september 2004;483;246;237;319;162;157;8;8;0.0;0.0;0.0;0.0;0.0;0.0;1;228;137;91;0;34;0.0
3733;Maandag 13 september 2004;548;273;275;335;154;181;145;142;1.0;2.0;46.0;42.0;2.0;2.0;92;5647;3284;2363;484;268;40.0
3734;Dinsdag 14 september 2004;616;332;284;329;149;180;164;163;1.0;0.0;51.0;51.0;0.0;0.0;145;4689;2593;2096;707;231;168.0
3735;Woensdag 15 september 2004;582;307;275;359;163;196;198;193;2.0;3.0;51.0;50.0;1.0;0.0;128;7147;4132;3015;627;391;25.0
3736;Donderdag 16 september 2004;560;288;272;359;178;181;279;276;1.0;2.0;42.0;42.0;0.0;0.0;112;5291;3058;2233;568;186;153.0
3737;Vrijdag 17 september 2004;575;279;296;363;187;176;1043;1033;5.0;5.0;27.0;26.0;1.0;0.0;102;4543;2575;1968;350;258;157.0
3738;Zaterdag 18 september 2004;491;246;245;340;158;182;251;247;2.0;2.0;1.0;1.0;0.0;0.0;2;1006;726;280;1;52;4.0
3739;Zondag 19 september 2004;483;241;242;320;165;155;6;6;0.0;0.0;0.0;0.0;0.0;0.0;0;171;105;66;3;30;1.0
3740;Maandag 20 september 2004;600;302;298;361;190;171;201;197;4.0;0.0;59.0;56.0;2.0;1.0;105;5941;3596;2345;520;272;147.0
3741;Dinsdag 21 september 2004;593;306;287;332;157;175;180;172;4.0;4.0;45.0;41.0;2.0;2.0;127;4415;2477;1938;696;175;24.0
3742;Woensdag 22 september 2004;587;324;263;358;181;177;148;144;3.0;1.0;42.0;41.0;0.0;1.0;99;4315;2543;1772;562;201;46.0
3743;Donderdag 23 september 2004;582;296;286;356;162;194;237;233;1.0;3.0;39.0;37.0;0.0;2.0;90;4696;2790;1906;475;213;13.0
3744;Vrijdag 24 september 2004;593;296;297;350;181;169;996;985;5.0;6.0;23.0;23.0;0.0;0.0;99;4513;2677;1836;359;233;12.0
3745;Zaterdag 25 september 2004;463;224;239;344;166;178;219;219;0.0;0.0;2.0;2.0;0.0;0.0;0;1723;1168;555;5;52;1.0
3746;Zondag 26 september 2004;435;211;224;333;135;198;5;5;0.0;0.0;0.0;0.0;0.0;0.0;1;256;168;88;2;35;2.0
3747;Maandag 27 september 2004;593;315;278;406;200;206;184;180;2.0;2.0;68.0;64.0;0.0;4.0;136;5318;3215;2103;477;307;237.0
3748;Dinsdag 28 september 2004;565;273;292;377;179;198;150;145;4.0;1.0;43.0;42.0;1.0;0.0;92;4650;2763;1887;533;242;36.0
3749;Woensdag 29 september 2004;636;336;300;375;189;186;131;128;1.0;2.0;38.0;37.0;1.0;0.0;124;4451;2590;1861;468;277;12.0
3750;Donderdag 30 september 2004;594;302;292;339;179;160;211;208;1.0;2.0;53.0;52.0;0.0;1.0;100;6311;3841;2470;479;434;30.0
3751;Totaal oktober 2004;16239;8281;7958;11103;5454;5649;5309;5228;44.0;37.0;963.0;916.0;22.0;25.0;2465;130605;79936;50669;8556;6199;991.0
3752;Vrijdag 1 oktober 2004;612;316;296;376;186;190;751;745;4.0;2.0;29.0;25.0;3.0;1.0;163;21822;13842;7980;376;737;100.0
3753;Zaterdag 2 oktober 2004;453;237;216;354;181;173;117;117;0.0;0.0;0.0;0.0;0.0;0.0;0;631;437;194;7;64;2.0
3754;Zondag 3 oktober 2004;434;207;227;331;168;163;6;6;0.0;0.0;0.0;0.0;0.0;0.0;0;154;96;58;3;58;0.0
3755;Maandag 4 oktober 2004;565;285;280;366;183;183;185;182;0.0;3.0;55.0;50.0;2.0;3.0;85;6646;3910;2736;495;357;15.0
3756;Dinsdag 5 oktober 2004;586;322;264;372;189;183;123;122;1.0;0.0;41.0;40.0;0.0;1.0;120;5271;3017;2254;559;257;23.0
3757;Woensdag 6 oktober 2004;559;273;286;350;170;180;115;109;2.0;4.0;48.0;44.0;1.0;3.0;133;4763;2754;2009;455;223;343.0
3758;Donderdag 7 oktober 2004;575;282;293;349;166;183;170;168;1.0;1.0;42.0;40.0;1.0;1.0;110;5227;3156;2071;411;252;15.0
3759;Vrijdag 8 oktober 2004;560;302;258;358;186;172;538;533;3.0;2.0;34.0;34.0;0.0;0.0;102;4547;2779;1768;349;214;20.0
3760;Zaterdag 9 oktober 2004;441;229;212;330;153;177;72;70;1.0;1.0;0.0;0.0;0.0;0.0;1;826;612;214;1;45;3.0
3761;Zondag 10 oktober 2004;476;228;248;313;149;164;3;3;0.0;0.0;0.0;0.0;0.0;0.0;1;477;330;147;4;36;0.0
3762;Maandag 11 oktober 2004;514;261;253;370;189;181;135;131;3.0;1.0;64.0;58.0;1.0;5.0;111;5384;3276;2108;514;298;137.0
3763;Dinsdag 12 oktober 2004;583;294;289;357;170;187;144;138;3.0;3.0;42.0;42.0;0.0;0.0;120;4322;2522;1800;487;186;25.0
3764;Woensdag 13 oktober 2004;556;278;278;329;165;164;113;109;3.0;1.0;47.0;44.0;2.0;1.0;136;4312;2611;1701;433;174;27.0
3765;Donderdag 14 oktober 2004;537;261;276;365;168;197;232;229;0.0;3.0;37.0;37.0;0.0;0.0;128;4832;2835;1997;385;230;30.0
3766;Vrijdag 15 oktober 2004;591;298;293;358;188;170;519;513;5.0;1.0;31.0;29.0;0.0;2.0;115;7779;5116;2663;270;296;10.0
3767;Zaterdag 16 oktober 2004;435;215;220;371;182;189;95;93;0.0;2.0;2.0;2.0;0.0;0.0;0;1225;865;360;2;41;2.0
3768;Zondag 17 oktober 2004;434;213;221;347;156;191;3;3;0.0;0.0;0.0;0.0;0.0;0.0;0;192;129;63;3;14;1.0
3769;Maandag 18 oktober 2004;569;312;257;371;174;197;166;164;2.0;0.0;67.0;64.0;1.0;2.0;127;5770;3506;2264;425;252;31.0
3770;Dinsdag 19 oktober 2004;540;280;260;347;168;179;125;121;2.0;2.0;52.0;50.0;1.0;1.0;136;4269;2443;1826;622;169;13.0
3771;Woensdag 20 oktober 2004;589;282;307;370;200;170;129;127;1.0;1.0;42.0;42.0;0.0;0.0;113;4929;2973;1956;369;212;18.0
3772;Donderdag 21 oktober 2004;543;284;259;364;172;192;156;154;0.0;2.0;51.0;49.0;1.0;1.0;111;4647;2773;1874;343;267;21.0
3773;Vrijdag 22 oktober 2004;581;306;275;372;183;189;444;436;3.0;5.0;30.0;30.0;0.0;0.0;94;4479;2676;1803;236;189;19.0
3774;Zaterdag 23 oktober 2004;448;212;236;353;190;163;54;53;1.0;0.0;1.0;1.0;0.0;0.0;0;1238;891;347;8;34;0.0
3775;Zondag 24 oktober 2004;423;223;200;352;167;185;1;1;0.0;0.0;0.0;0.0;0.0;0.0;0;220;160;60;4;14;0.0
3776;Maandag 25 oktober 2004;539;276;263;353;171;182;150;147;2.0;1.0;72.0;70.0;2.0;0.0;103;5547;3372;2175;443;287;27.0
3777;Dinsdag 26 oktober 2004;562;280;282;359;171;188;112;108;3.0;1.0;56.0;52.0;4.0;0.0;141;4469;2663;1806;336;305;42.0
3778;Woensdag 27 oktober 2004;538;281;257;362;165;197;109;108;0.0;1.0;52.0;52.0;0.0;0.0;126;4181;2435;1746;339;296;12.0
3779;Donderdag 28 oktober 2004;537;293;244;402;208;194;135;134;1.0;0.0;36.0;33.0;1.0;2.0;93;5010;2972;2038;396;274;24.0
3780;Vrijdag 29 oktober 2004;564;284;280;378;176;202;323;321;2.0;0.0;31.0;27.0;2.0;2.0;96;5331;3277;2054;280;244;31.0
3781;Zaterdag 30 oktober 2004;469;246;223;372;197;175;82;81;1.0;0.0;1.0;1.0;0.0;0.0;0;1383;987;396;0;93;0.0
3782;Zondag 31 oktober 2004;426;221;205;352;163;189;2;2;0.0;0.0;0.0;0.0;0.0;0.0;0;722;521;201;1;81;0.0
3783;Totaal november 2004;15613;8030;7583;10969;5356;5613;3385;3321;23.0;41.0;1017.0;966.0;21.0;30.0;2629;132533;82177;50356;7095;5835;2385.0
3784;Maandag 1 november 2004;490;253;237;371;170;201;152;150;1.0;1.0;65.0;60.0;2.0;3.0;117;22495;14682;7813;441;776;25.0
3785;Dinsdag 2 november 2004;590;318;272;380;201;179;74;73;1.0;0.0;56.0;51.0;4.0;1.0;134;5357;3089;2268;415;284;39.0
3786;Woensdag 3 november 2004;545;291;254;321;147;174;76;72;1.0;3.0;50.0;50.0;0.0;0.0;128;4855;2788;2067;369;225;19.0
3787;Donderdag 4 november 2004;521;278;243;370;171;199;111;107;1.0;3.0;36.0;33.0;1.0;2.0;119;5200;3023;2177;343;191;32.0
3788;Vrijdag 5 november 2004;550;292;258;390;190;200;271;269;1.0;1.0;30.0;30.0;0.0;0.0;118;4887;2973;1914;220;229;25.0
3789;Zaterdag 6 november 2004;454;252;202;329;163;166;48;48;0.0;0.0;2.0;2.0;0.0;0.0;1;837;639;198;3;22;3.0
3790;Zondag 7 november 2004;473;246;227;356;175;181;1;1;0.0;0.0;0.0;0.0;0.0;0.0;0;184;134;50;1;22;0.0
3791;Maandag 8 november 2004;605;293;312;351;165;186;115;114;1.0;0.0;64.0;61.0;1.0;2.0;111;5561;3333;2228;421;195;1035.0
3792;Dinsdag 9 november 2004;576;303;273;394;182;212;83;82;0.0;1.0;46.0;44.0;0.0;2.0;132;4264;2408;1856;328;171;27.0
3793;Woensdag 10 november 2004;553;270;283;341;166;175;100;97;1.0;2.0;49.0;45.0;4.0;0.0;134;4424;2605;1819;342;221;22.0
3794;Donderdag 11 november 2004;556;271;285;351;175;176;158;157;0.0;1.0;43.0;39.0;1.0;3.0;138;4429;2643;1786;317;198;259.0
3795;Vrijdag 12 november 2004;536;262;274;388;199;189;317;313;1.0;3.0;26.0;24.0;0.0;2.0;117;4437;2765;1672;285;197;25.0
3796;Zaterdag 13 november 2004;444;243;201;388;189;199;38;37;1.0;0.0;0.0;0.0;0.0;0.0;0;856;628;228;14;23;2.0
3797;Zondag 14 november 2004;433;205;228;324;161;163;1;1;0.0;0.0;0.0;0.0;0.0;0.0;1;271;176;95;6;26;0.0
3798;Maandag 15 november 2004;535;274;261;340;167;173;129;128;0.0;1.0;60.0;59.0;0.0;1.0;123;8537;5539;2998;302;319;361.0
3799;Dinsdag 16 november 2004;561;293;268;395;195;200;87;85;1.0;1.0;47.0;47.0;0.0;0.0;104;4527;2738;1789;288;181;24.0
3800;Woensdag 17 november 2004;518;264;254;338;175;163;97;95;0.0;2.0;41.0;40.0;0.0;1.0;122;4324;2686;1638;291;168;17.0
3801;Donderdag 18 november 2004;547;283;264;413;204;209;122;118;1.0;3.0;44.0;43.0;0.0;1.0;103;4402;2734;1668;297;221;31.0
3802;Vrijdag 19 november 2004;604;304;300;379;187;192;279;274;0.0;5.0;33.0;29.0;0.0;4.0;112;4161;2578;1583;256;186;35.0
3803;Zaterdag 20 november 2004;435;222;213;350;174;176;48;46;1.0;1.0;1.0;0.0;1.0;0.0;0;1783;1304;479;2;69;6.0
3804;Zondag 21 november 2004;407;198;209;360;191;169;2;2;0.0;0.0;0.0;0.0;0.0;0.0;0;247;177;70;2;23;0.0
3805;Maandag 22 november 2004;560;299;261;361;194;167;141;138;2.0;1.0;63.0;60.0;1.0;2.0;108;5339;3237;2102;282;234;13.0
3806;Dinsdag 23 november 2004;587;325;262;365;186;179;93;90;1.0;2.0;51.0;50.0;0.0;1.0;94;4223;2575;1648;336;178;16.0
3807;Woensdag 24 november 2004;545;276;269;372;179;193;110;108;0.0;2.0;37.0;35.0;1.0;1.0;160;4072;2388;1684;315;158;20.0
3808;Donderdag 25 november 2004;511;249;262;351;166;185;129;123;4.0;2.0;35.0;34.0;1.0;0.0;133;4793;3004;1789;329;192;25.0
3809;Vrijdag 26 november 2004;555;286;269;368;176;192;310;303;3.0;4.0;27.0;25.0;2.0;0.0;93;4741;2875;1866;219;289;284.0
3810;Zaterdag 27 november 2004;436;208;228;381;186;195;64;64;0.0;0.0;0.0;0.0;0.0;0.0;0;1613;1177;436;1;40;0.0
3811;Zondag 28 november 2004;417;217;200;369;166;203;0;0;0.0;0.0;0.0;0.0;0.0;0.0;0;420;286;134;2;46;5.0
3812;Maandag 29 november 2004;551;300;251;387;171;216;135;132;1.0;2.0;55.0;53.0;0.0;2.0;114;5482;3370;2112;334;435;20.0
3813;Dinsdag 30 november 2004;518;255;263;386;185;201;94;94;0.0;0.0;56.0;52.0;2.0;2.0;113;5812;3623;2189;334;316;15.0
3814;Totaal december 2004;15821;8056;7765;12090;5795;6295;3706;3637;36.0;33.0;1017.0;963.0;21.0;33.0;2706;137694;86383;51311;6051;6601;2745.0
3815;Woensdag 1 december 2004;572;282;290;359;176;183;120;112;4.0;4.0;47.0;42.0;2.0;3.0;118;21050;13727;7323;320;598;939.0
3816;Donderdag 2 december 2004;549;281;268;391;181;210;86;81;4.0;1.0;40.0;38.0;1.0;1.0;184;5621;3310;2311;344;218;30.0
3817;Vrijdag 3 december 2004;574;316;258;370;177;193;193;188;2.0;3.0;29.0;29.0;0.0;0.0;111;4878;2972;1906;233;200;16.0
3818;Zaterdag 4 december 2004;403;224;179;377;186;191;34;34;0.0;0.0;0.0;0.0;0.0;0.0;0;760;561;199;5;49;1.0
3819;Zondag 5 december 2004;369;176;193;349;180;169;1;1;0.0;0.0;0.0;0.0;0.0;0.0;0;248;174;74;4;20;0.0
3820;Maandag 6 december 2004;490;245;245;328;172;156;135;132;3.0;0.0;68.0;66.0;1.0;1.0;121;6051;3714;2337;320;275;361.0
3821;Dinsdag 7 december 2004;546;299;247;363;168;195;104;100;1.0;3.0;52.0;49.0;2.0;1.0;135;4711;2900;1811;348;163;21.0
3822;Woensdag 8 december 2004;517;252;265;375;183;192;101;100;1.0;0.0;43.0;42.0;0.0;1.0;110;4444;2650;1794;328;175;37.0
3823;Donderdag 9 december 2004;584;313;271;391;194;197;101;98;1.0;2.0;32.0;29.0;3.0;0.0;91;4424;2718;1706;310;193;122.0
3824;Vrijdag 10 december 2004;549;287;262;415;197;218;327;324;2.0;1.0;30.0;28.0;1.0;1.0;89;4884;3102;1782;222;264;16.0
3825;Zaterdag 11 december 2004;465;227;238;357;163;194;54;54;0.0;0.0;0.0;0.0;0.0;0.0;1;1415;1013;402;1;41;0.0
3826;Zondag 12 december 2004;409;221;188;378;179;199;3;3;0.0;0.0;0.0;0.0;0.0;0.0;0;354;239;115;0;38;1.0
3827;Maandag 13 december 2004;529;254;275;350;170;180;132;129;2.0;1.0;76.0;71.0;2.0;3.0;116;5322;3264;2058;316;239;140.0
3828;Dinsdag 14 december 2004;589;297;292;411;189;222;120;117;1.0;2.0;51.0;48.0;0.0;3.0;102;4265;2669;1596;317;199;9.0
3829;Woensdag 15 december 2004;542;268;274;392;188;204;105;104;0.0;1.0;46.0;44.0;1.0;1.0;99;8061;5303;2758;274;343;8.0
3830;Donderdag 16 december 2004;586;300;286;378;176;202;139;135;3.0;1.0;35.0;35.0;0.0;0.0;117;4821;3085;1736;286;222;17.0
3831;Vrijdag 17 december 2004;561;279;282;407;193;214;418;416;1.0;1.0;19.0;19.0;0.0;0.0;110;5202;3283;1919;236;255;28.0
3832;Zaterdag 18 december 2004;475;231;244;422;211;211;98;94;1.0;3.0;1.0;1.0;0.0;0.0;1;2112;1499;613;3;62;4.0
3833;Zondag 19 december 2004;413;225;188;374;181;193;2;2;0.0;0.0;0.0;0.0;0.0;0.0;0;276;217;59;1;44;0.0
3834;Maandag 20 december 2004;553;279;274;350;146;204;189;187;1.0;1.0;89.0;84.0;0.0;5.0;122;7496;4783;2713;356;305;68.0
3835;Dinsdag 21 december 2004;558;303;255;377;175;202;166;163;2.0;1.0;53.0;49.0;1.0;3.0;136;4532;2733;1799;316;226;44.0
3836;Woensdag 22 december 2004;593;317;276;426;217;209;154;153;1.0;0.0;44.0;41.0;2.0;1.0;148;4546;2783;1763;285;264;19.0
3837;Donderdag 23 december 2004;523;267;256;409;196;213;210;207;3.0;0.0;41.0;39.0;0.0;2.0;159;4911;3070;1841;249;227;22.0
3838;Vrijdag 24 december 2004;522;258;264;437;204;233;127;126;0.0;1.0;14.0;13.0;1.0;0.0;75;3321;2029;1292;97;160;12.0
3839;Zaterdag 25 december 2004;404;191;213;439;207;232;0;0;0.0;0.0;0.0;0.0;0.0;0.0;0;182;134;48;1;28;1.0
3840;Zondag 26 december 2004;395;203;192;398;198;200;1;1;0.0;0.0;0.0;0.0;0.0;0.0;0;76;55;21;2;17;0.0
3841;Maandag 27 december 2004;476;224;252;415;196;219;142;141;0.0;1.0;60.0;57.0;2.0;1.0;109;4509;2790;1719;164;290;513.0
3842;Dinsdag 28 december 2004;488;241;247;404;190;214;139;137;0.0;2.0;65.0;61.0;1.0;3.0;110;4425;2627;1798;207;324;22.0
3843;Woensdag 29 december 2004;565;275;290;424;215;209;107;105;2.0;0.0;41.0;38.0;1.0;2.0;125;4861;2875;1986;218;338;17.0
3844;Donderdag 30 december 2004;542;282;260;411;200;211;109;107;1.0;1.0;32.0;31.0;0.0;1.0;156;5787;3516;2271;205;400;31.0
3845;Vrijdag 31 december 2004;480;239;241;413;187;226;89;86;0.0;3.0;9.0;9.0;0.0;0.0;61;4149;2588;1561;83;424;246.0
3846;Totaal op zondag in 2004;22760;11608;11152;18734;9050;9684;405;397;6.0;2.0;4.0;2.0;0.0;2.0;19;40926;26343;14583;207;2675;50.0
3847;Totaal op maandag in 2004;28651;14607;14044;19293;9330;9963;8811;8641;91.0;79.0;3076.0;2901.0;71.0;104.0;5826;345777;211611;134166;20002;15522;7153.0
3848;Totaal op dinsdag in 2004;29706;15317;14389;19695;9612;10083;7807;7629;91.0;87.0;2535.0;2407.0;56.0;72.0;6845;267490;159594;107896;21564;12756;5570.0
3849;Totaal op woensdag in 2004;29671;15185;14486;19285;9422;9863;8534;8349;85.0;100.0;2186.0;2085.0;47.0;54.0;6291;280596;167825;112771;18766;13552;4468.0
3850;Totaal op donderdag in 2004;29719;15197;14522;20097;9646;10451;10744;10564;80.0;100.0;2033.0;1940.0;46.0;47.0;6564;315225;191516;123709;19623;14300;3736.0
3851;Totaal op vrijdag in 2004;29735;15261;14474;20324;9933;10391;30378;29978;180.0;220.0;1286.0;1210.0;37.0;39.0;5528;264900;162071;102829;13639;13091;4154.0
3852;Totaal op zaterdag in 2004;23765;12055;11710;19125;9366;9759;6762;6673;46.0;43.0;36.0;28.0;4.0;4.0;25;73333;51362;21971;218;3153;1042.0
3853;Totaal 2005;187910;96338;91572;136402;66362;70040;72263;71113;570.0;580.0;11307.0;10699.0;279.0;329.0;31905;1651575;1009486;642089;92297;83399;28488.0
3854;Totaal januari 2005;15678;7997;7681;12544;6133;6411;2733;2692;17.0;24.0;841.0;801.0;21.0;19.0;2666;131742;80711;51031;6935;6090;1754.0
3855;Zaterdag 1 januari 2005;394;199;195;396;199;197;12;12;0.0;0.0;0.0;0.0;0.0;0.0;0;11874;7382;4492;47;502;0.0
3856;Zondag 2 januari 2005;417;209;208;400;199;201;4;4;0.0;0.0;0.0;0.0;0.0;0.0;2;519;335;184;3;82;0.0
3857;Maandag 3 januari 2005;524;250;274;394;186;208;86;86;0.0;0.0;33.0;32.0;0.0;1.0;88;7109;4266;2843;338;345;281.0
3858;Dinsdag 4 januari 2005;531;258;273;414;190;224;94;91;1.0;2.0;44.0;41.0;2.0;1.0;117;5558;3247;2311;331;294;10.0
3859;Woensdag 5 januari 2005;563;289;274;430;231;199;109;108;0.0;1.0;34.0;33.0;0.0;1.0;154;5717;3355;2362;313;275;26.0
3860;Donderdag 6 januari 2005;540;279;261;420;207;213;80;79;0.0;1.0;36.0;35.0;0.0;1.0;118;6005;3567;2438;316;202;31.0
3861;Vrijdag 7 januari 2005;537;271;266;405;174;231;143;140;1.0;2.0;17.0;14.0;1.0;2.0;130;5423;3247;2176;276;231;18.0
3862;Zaterdag 8 januari 2005;474;243;231;427;228;199;43;42;0.0;1.0;0.0;0.0;0.0;0.0;0;1072;740;332;1;57;2.0
3863;Zondag 9 januari 2005;397;190;207;381;185;196;5;5;0.0;0.0;0.0;0.0;0.0;0.0;2;227;154;73;5;42;1.0
3864;Maandag 10 januari 2005;531;283;248;442;205;237;154;153;1.0;0.0;70.0;70.0;0.0;0.0;130;6627;4164;2463;351;285;17.0
3865;Dinsdag 11 januari 2005;548;294;254;375;180;195;90;90;0.0;0.0;46.0;44.0;1.0;1.0;127;4657;2731;1926;397;218;35.0
3866;Woensdag 12 januari 2005;557;279;278;427;199;228;101;99;2.0;0.0;43.0;40.0;1.0;2.0;120;4856;2875;1981;376;184;28.0
3867;Donderdag 13 januari 2005;537;266;271;381;196;185;79;76;1.0;2.0;30.0;29.0;1.0;0.0;132;4765;2881;1884;355;210;33.0
3868;Vrijdag 14 januari 2005;544;298;246;405;210;195;209;204;2.0;3.0;24.0;21.0;1.0;2.0;140;5484;3343;2141;229;233;60.0
3869;Zaterdag 15 januari 2005;439;226;213;391;194;197;58;58;0.0;0.0;1.0;1.0;0.0;0.0;0;3082;2157;925;11;62;2.0
3870;Zondag 16 januari 2005;425;202;223;387;172;215;2;2;0.0;0.0;0.0;0.0;0.0;0.0;1;295;187;108;6;41;0.0
3871;Maandag 17 januari 2005;521;257;264;421;202;219;116;113;2.0;1.0;46.0;44.0;2.0;0.0;111;6129;3693;2436;345;242;11.0
3872;Dinsdag 18 januari 2005;544;287;257;423;208;215;101;99;1.0;1.0;51.0;47.0;2.0;2.0;154;4579;2731;1848;297;201;30.0
3873;Woensdag 19 januari 2005;611;307;304;406;200;206;92;92;0.0;0.0;38.0;38.0;0.0;0.0;120;4178;2459;1719;343;192;50.0
3874;Donderdag 20 januari 2005;530;283;247;360;177;183;111;110;1.0;0.0;37.0;34.0;3.0;0.0;129;4934;3046;1888;345;233;29.0
3875;Vrijdag 21 januari 2005;521;292;229;416;192;224;215;213;1.0;1.0;29.0;28.0;1.0;0.0;98;4644;2863;1781;227;186;427.0
3876;Zaterdag 22 januari 2005;463;233;230;394;204;190;47;47;0.0;0.0;0.0;0.0;0.0;0.0;0;1271;942;329;6;26;6.0
3877;Zondag 23 januari 2005;442;213;229;425;206;219;5;5;0.0;0.0;0.0;0.0;0.0;0.0;0;219;162;57;3;19;0.0
3878;Maandag 24 januari 2005;550;283;267;387;198;189;116;115;1.0;0.0;72.0;68.0;2.0;2.0;146;5270;3190;2080;341;261;33.0
3879;Dinsdag 25 januari 2005;563;281;282;400;194;206;99;96;0.0;3.0;35.0;32.0;1.0;2.0;129;4703;2865;1838;352;225;401.0
3880;Woensdag 26 januari 2005;589;306;283;369;190;179;89;87;0.0;2.0;34.0;33.0;0.0;1.0;138;4302;2588;1714;333;211;27.0
3881;Donderdag 27 januari 2005;515;263;252;424;207;217;100;99;0.0;1.0;38.0;36.0;1.0;1.0;139;4721;2893;1828;381;254;14.0
3882;Vrijdag 28 januari 2005;523;267;256;411;194;217;194;191;2.0;1.0;25.0;24.0;1.0;0.0;122;5255;3385;1870;253;264;30.0
3883;Zaterdag 29 januari 2005;421;217;204;416;227;189;49;48;0.0;1.0;2.0;2.0;0.0;0.0;0;1015;725;290;1;66;3.0
3884;Zondag 30 januari 2005;421;210;211;406;182;224;6;6;0.0;0.0;0.0;0.0;0.0;0.0;0;474;349;125;3;51;0.0
3885;Maandag 31 januari 2005;506;262;244;411;197;214;124;122;1.0;1.0;56.0;55.0;1.0;0.0;119;6778;4189;2589;350;396;149.0
3886;Totaal februari 2005;14671;7542;7129;12264;6037;6227;3045;3000;22.0;23.0;889.0;850.0;17.0;22.0;2432;123006;76478;46528;6844;5235;1465.0
3887;Dinsdag 1 februari 2005;574;316;258;408;202;206;104;101;1.0;2.0;49.0;47.0;1.0;1.0;139;20605;13187;7418;402;541;21.0
3888;Woensdag 2 februari 2005;536;269;267;444;220;224;99;97;1.0;1.0;36.0;34.0;0.0;2.0;147;5343;3136;2207;392;192;31.0
3889;Donderdag 3 februari 2005;562;291;271;416;211;205;91;90;0.0;1.0;37.0;37.0;0.0;0.0;149;5246;3159;2087;392;226;32.0
3890;Vrijdag 4 februari 2005;548;278;270;424;202;222;184;182;1.0;1.0;17.0;16.0;0.0;1.0;110;4926;2922;2004;237;215;37.0
3891;Zaterdag 5 februari 2005;447;249;198;400;183;217;54;54;0.0;0.0;1.0;1.0;0.0;0.0;0;780;528;252;1;37;5.0
3892;Zondag 6 februari 2005;410;194;216;403;207;196;9;9;0.0;0.0;0.0;0.0;0.0;0.0;0;144;107;37;2;23;5.0
3893;Maandag 7 februari 2005;515;267;248;412;218;194;113;111;0.0;2.0;59.0;55.0;1.0;3.0;90;4958;2998;1960;337;186;17.0
3894;Dinsdag 8 februari 2005;577;308;269;409;212;197;82;81;1.0;0.0;54.0;51.0;1.0;2.0;104;3937;2401;1536;403;185;17.0
3895;Woensdag 9 februari 2005;545;283;262;425;203;222;89;89;0.0;0.0;43.0;41.0;1.0;1.0;139;4392;2603;1789;347;229;250.0
3896;Donderdag 10 februari 2005;573;303;270;400;193;207;91;91;0.0;0.0;35.0;33.0;0.0;2.0;134;4964;3075;1889;376;232;39.0
3897;Vrijdag 11 februari 2005;596;283;313;436;211;225;159;158;1.0;0.0;34.0;33.0;0.0;1.0;110;4575;2743;1832;238;200;32.0
3898;Zaterdag 12 februari 2005;461;230;231;481;257;224;38;38;0.0;0.0;0.0;0.0;0.0;0.0;1;1090;798;292;2;28;9.0
3899;Zondag 13 februari 2005;443;234;209;438;196;242;6;6;0.0;0.0;0.0;0.0;0.0;0.0;0;193;136;57;4;33;4.0
3900;Maandag 14 februari 2005;575;275;300;416;222;194;383;376;2.0;5.0;81.0;80.0;1.0;0.0;105;6105;3884;2221;352;257;21.0
3901;Dinsdag 15 februari 2005;593;307;286;427;217;210;98;96;0.0;2.0;58.0;53.0;4.0;1.0;120;6660;4195;2465;352;275;24.0
3902;Woensdag 16 februari 2005;532;292;240;450;220;230;85;83;2.0;0.0;35.0;32.0;2.0;1.0;125;4549;2689;1860;311;209;32.0
3903;Donderdag 17 februari 2005;555;276;279;467;240;227;97;96;1.0;0.0;33.0;32.0;1.0;0.0;135;4796;2939;1857;329;166;38.0
3904;Vrijdag 18 februari 2005;533;279;254;466;224;242;210;207;2.0;1.0;24.0;23.0;0.0;1.0;112;4409;2763;1646;231;198;36.0
3905;Zaterdag 19 februari 2005;440;222;218;453;225;228;40;39;0.0;1.0;0.0;0.0;0.0;0.0;0;1091;776;315;7;38;303.0
3906;Zondag 20 februari 2005;427;221;206;415;200;215;5;5;0.0;0.0;0.0;0.0;0.0;0.0;1;558;413;145;4;37;2.0
3907;Maandag 21 februari 2005;525;266;259;459;207;252;145;144;0.0;1.0;65.0;62.0;2.0;1.0;90;5671;3609;2062;499;251;33.0
3908;Dinsdag 22 februari 2005;591;285;306;461;231;230;117;113;2.0;2.0;42.0;40.0;1.0;1.0;134;4344;2632;1712;350;180;303.0
3909;Woensdag 23 februari 2005;562;307;255;476;223;253;98;97;1.0;0.0;42.0;41.0;1.0;0.0;136;4297;2525;1772;309;191;21.0
3910;Donderdag 24 februari 2005;551;289;262;462;213;249;129;127;0.0;2.0;39.0;38.0;0.0;1.0;128;4756;2955;1801;333;220;16.0
3911;Vrijdag 25 februari 2005;584;280;304;465;223;242;320;315;4.0;1.0;26.0;26.0;0.0;0.0;113;5389;3257;2132;239;304;104.0
3912;Zaterdag 26 februari 2005;458;249;209;429;236;193;55;55;0.0;0.0;1.0;1.0;0.0;0.0;0;1471;971;500;4;72;10.0
3913;Zondag 27 februari 2005;412;215;197;445;206;239;7;7;0.0;0.0;0.0;0.0;0.0;0.0;1;247;187;60;6;43;3.0
3914;Maandag 28 februari 2005;546;274;272;477;235;242;137;133;3.0;1.0;78.0;74.0;1.0;3.0;109;7510;4890;2620;385;467;20.0
3915;Totaal maart 2005;15876;8152;7724;13783;6520;7263;3449;3397;28.0;24.0;963.0;905.0;29.0;29.0;2836;133654;84472;49182;6847;6065;2229.0
3916;Dinsdag 1 maart 2005;567;288;279;471;207;264;146;140;1.0;5.0;50.0;47.0;0.0;3.0;154;21458;14121;7337;406;644;31.0
3917;Woensdag 2 maart 2005;527;282;245;507;240;267;82;81;1.0;0.0;40.0;40.0;0.0;0.0;121;4995;3007;1988;316;221;47.0
3918;Donderdag 3 maart 2005;572;290;282;475;252;223;122;122;0.0;0.0;38.0;37.0;1.0;0.0;110;5147;3084;2063;287;189;32.0
3919;Vrijdag 4 maart 2005;565;279;286;473;221;252;233;230;3.0;0.0;21.0;21.0;0.0;0.0;125;4830;2946;1884;239;183;328.0
3920;Zaterdag 5 maart 2005;481;267;214;505;242;263;67;67;0.0;0.0;0.0;0.0;0.0;0.0;0;858;614;244;2;41;2.0
3921;Zondag 6 maart 2005;455;229;226;443;218;225;2;2;0.0;0.0;0.0;0.0;0.0;0.0;0;149;105;44;1;18;0.0
3922;Maandag 7 maart 2005;527;274;253;447;185;262;141;137;2.0;2.0;71.0;68.0;0.0;3.0;119;5998;3629;2369;341;273;25.0
3923;Dinsdag 8 maart 2005;534;261;273;502;245;257;115;113;1.0;1.0;58.0;53.0;3.0;2.0;152;4900;2914;1986;389;307;39.0
3924;Woensdag 9 maart 2005;510;270;240;500;240;260;86;84;1.0;1.0;51.0;50.0;0.0;1.0;163;4616;2744;1872;315;182;36.0
3925;Donderdag 10 maart 2005;535;263;272;479;211;268;103;101;0.0;2.0;30.0;30.0;0.0;0.0;133;5357;3391;1966;289;203;33.0
3926;Vrijdag 11 maart 2005;544;269;275;453;223;230;226;225;0.0;1.0;25.0;24.0;1.0;0.0;107;4344;2780;1564;255;188;30.0
3927;Zaterdag 12 maart 2005;435;208;227;468;231;237;46;46;0.0;0.0;1.0;1.0;0.0;0.0;0;1044;779;265;5;15;0.0
3928;Zondag 13 maart 2005;420;208;212;428;220;208;5;5;0.0;0.0;0.0;0.0;0.0;0.0;0;158;110;48;0;27;0.0
3929;Maandag 14 maart 2005;544;296;248;463;211;252;154;152;2.0;0.0;67.0;64.0;2.0;1.0;110;5822;3633;2189;391;219;23.0
3930;Dinsdag 15 maart 2005;544;288;256;450;184;266;108;105;3.0;0.0;59.0;55.0;1.0;3.0;135;7390;4720;2670;336;259;34.0
3931;Woensdag 16 maart 2005;544;271;273;456;215;241;93;91;0.0;2.0;37.0;33.0;3.0;1.0;135;4456;2826;1630;299;203;57.0
3932;Donderdag 17 maart 2005;525;278;247;457;210;247;112;109;0.0;3.0;37.0;30.0;3.0;4.0;167;4524;2800;1724;270;210;37.0
3933;Vrijdag 18 maart 2005;517;283;234;437;217;220;360;355;2.0;3.0;26.0;25.0;0.0;1.0;98;4303;2817;1486;231;224;23.0
3934;Zaterdag 19 maart 2005;453;234;219;421;195;226;63;63;0.0;0.0;2.0;2.0;0.0;0.0;1;1119;822;297;4;42;0.0
3935;Zondag 20 maart 2005;428;241;187;405;184;221;7;7;0.0;0.0;0.0;0.0;0.0;0.0;0;516;350;166;0;50;1.0
3936;Maandag 21 maart 2005;519;273;246;406;200;206;228;225;2.0;1.0;77.0;73.0;2.0;2.0;130;5604;3544;2060;343;259;601.0
3937;Dinsdag 22 maart 2005;550;299;251;446;199;247;123;119;3.0;1.0;59.0;56.0;2.0;1.0;123;4189;2578;1611;335;215;19.0
3938;Woensdag 23 maart 2005;543;278;265;402;200;202;106;105;1.0;0.0;34.0;32.0;1.0;1.0;155;4353;2688;1665;350;230;52.0
3939;Donderdag 24 maart 2005;532;271;261;476;240;236;195;193;1.0;1.0;32.0;31.0;0.0;1.0;167;4989;3058;1931;273;347;158.0
3940;Vrijdag 25 maart 2005;519;264;255;397;204;193;93;92;0.0;1.0;5.0;5.0;0.0;0.0;21;2370;1598;772;30;89;7.0
3941;Zaterdag 26 maart 2005;441;228;213;432;202;230;49;48;1.0;0.0;3.0;1.0;1.0;1.0;1;1433;1053;380;5;42;0.0
3942;Zondag 27 maart 2005;433;216;217;402;180;222;4;4;0.0;0.0;0.0;0.0;0.0;0.0;0;174;124;50;5;39;0.0
3943;Maandag 28 maart 2005;464;234;230;393;191;202;16;16;0.0;0.0;0.0;0.0;0.0;0.0;3;518;369;149;3;50;1.0
3944;Dinsdag 29 maart 2005;539;272;267;403;185;218;135;134;1.0;0.0;60.0;50.0;7.0;3.0;151;5798;3674;2124;355;366;19.0
3945;Woensdag 30 maart 2005;591;272;319;415;191;224;113;112;1.0;0.0;48.0;46.0;1.0;1.0;138;5543;3390;2153;384;326;33.0
3946;Donderdag 31 maart 2005;518;266;252;371;177;194;116;114;2.0;0.0;32.0;31.0;1.0;0.0;117;6699;4204;2495;388;404;561.0
3947;Totaal april 2005;15563;7954;7609;11214;5558;5656;5542;5463;40.0;39.0;895.0;850.0;21.0;24.0;2888;131053;82998;48055;6339;5814;2245.0
3948;Vrijdag 1 april 2005;532;281;251;441;224;217;545;537;3.0;5.0;33.0;28.0;3.0;2.0;147;22081;14417;7664;315;750;16.0
3949;Zaterdag 2 april 2005;461;216;245;378;177;201;70;69;0.0;1.0;2.0;1.0;1.0;0.0;2;791;561;230;0;53;2.0
3950;Zondag 3 april 2005;408;214;194;364;176;188;8;8;0.0;0.0;0.0;0.0;0.0;0.0;1;182;110;72;0;21;0.0
3951;Maandag 4 april 2005;567;283;284;388;194;194;200;195;2.0;3.0;65.0;61.0;0.0;4.0;133;6900;4222;2678;346;278;40.0
3952;Dinsdag 5 april 2005;564;303;261;354;174;180;134;131;3.0;0.0;47.0;43.0;2.0;2.0;164;5178;3223;1955;318;263;421.0
3953;Woensdag 6 april 2005;569;296;273;423;194;229;121;118;1.0;2.0;54.0;49.0;3.0;2.0;154;4770;2824;1946;345;225;31.0
3954;Donderdag 7 april 2005;546;270;276;399;197;202;128;128;0.0;0.0;38.0;36.0;1.0;1.0;132;4996;2952;2044;284;292;64.0
3955;Vrijdag 8 april 2005;558;278;280;404;192;212;370;366;2.0;2.0;20.0;19.0;0.0;1.0;133;4707;2944;1763;251;199;13.0
3956;Zaterdag 9 april 2005;426;229;197;369;181;188;71;71;0.0;0.0;1.0;1.0;0.0;0.0;0;958;698;260;1;37;0.0
3957;Zondag 10 april 2005;440;216;224;333;172;161;5;5;0.0;0.0;0.0;0.0;0.0;0.0;1;493;382;111;5;36;1.0
3958;Maandag 11 april 2005;516;252;264;358;195;163;140;136;3.0;1.0;58.0;55.0;1.0;2.0;120;5368;3340;2028;388;242;23.0
3959;Dinsdag 12 april 2005;552;266;286;388;209;179;117;114;3.0;0.0;49.0;49.0;0.0;0.0;114;4284;2588;1696;291;204;41.0
3960;Woensdag 13 april 2005;545;266;279;341;173;168;84;81;1.0;2.0;45.0;44.0;0.0;1.0;176;4069;2509;1560;308;199;28.0
3961;Donderdag 14 april 2005;574;303;271;383;192;191;138;137;0.0;1.0;34.0;33.0;1.0;0.0;118;4692;2942;1750;349;176;324.0
3962;Vrijdag 15 april 2005;580;290;290;378;189;189;472;466;3.0;3.0;29.0;23.0;4.0;2.0;131;7561;4875;2686;227;260;27.0
3963;Zaterdag 16 april 2005;446;233;213;376;188;188;101;101;0.0;0.0;0.0;0.0;0.0;0.0;0;1197;828;369;2;44;0.0
3964;Zondag 17 april 2005;497;263;234;391;180;211;5;5;0.0;0.0;0.0;0.0;0.0;0.0;1;205;148;57;3;29;0.0
3965;Maandag 18 april 2005;534;274;260;380;195;185;165;162;2.0;1.0;81.0;77.0;2.0;2.0;108;5652;3578;2074;322;260;31.0
3966;Dinsdag 19 april 2005;563;289;274;360;179;181;113;113;0.0;0.0;49.0;47.0;0.0;2.0;138;4238;2614;1624;300;189;28.0
3967;Woensdag 20 april 2005;545;259;286;357;178;179;139;138;1.0;0.0;40.0;39.0;1.0;0.0;170;4574;2743;1831;311;262;393.0
3968;Donderdag 21 april 2005;523;287;236;358;173;185;168;165;3.0;0.0;34.0;34.0;0.0;0.0;139;4485;2828;1657;296;198;26.0
3969;Vrijdag 22 april 2005;587;294;293;360;180;180;624;618;1.0;5.0;17.0;17.0;0.0;0.0;146;4469;2847;1622;204;188;33.0
3970;Zaterdag 23 april 2005;430;231;199;375;186;189;159;157;2.0;0.0;0.0;0.0;0.0;0.0;1;1943;1413;530;1;24;0.0
3971;Zondag 24 april 2005;444;234;210;376;184;192;5;5;0.0;0.0;0.0;0.0;0.0;0.0;0;256;168;88;0;18;0.0
3972;Maandag 25 april 2005;545;291;254;385;191;194;176;173;0.0;3.0;64.0;62.0;1.0;1.0;110;5512;3409;2103;328;282;19.0
3973;Dinsdag 26 april 2005;543;283;260;359;172;187;148;145;1.0;2.0;50.0;49.0;0.0;1.0;153;4301;2687;1614;310;212;592.0
3974;Woensdag 27 april 2005;566;279;287;370;186;184;147;144;2.0;1.0;41.0;40.0;0.0;1.0;135;4162;2663;1499;292;234;53.0
3975;Donderdag 28 april 2005;561;289;272;368;194;174;275;271;2.0;2.0;36.0;35.0;1.0;0.0;136;5159;3405;1754;284;220;15.0
3976;Vrijdag 29 april 2005;503;260;243;336;163;173;683;674;5.0;4.0;8.0;8.0;0.0;0.0;125;6352;4076;2276;257;286;24.0
3977;Zaterdag 30 april 2005;438;225;213;362;170;192;31;30;0.0;1.0;0.0;0.0;0.0;0.0;0;1518;1004;514;1;133;0.0
3978;Totaal mei 2005;15711;8134;7577;11453;5547;5906;10072;9889;89.0;94.0;901.0;857.0;20.0;24.0;2566;119995;75508;44487;5699;5259;1640.0
3979;Zondag 1 mei 2005;452;250;202;350;180;170;8;7;1.0;0.0;0.0;0.0;0.0;0.0;0;10887;7326;3561;31;299;3.0
3980;Maandag 2 mei 2005;559;276;283;368;171;197;299;286;8.0;5.0;62.0;60.0;0.0;2.0;151;8279;5291;2988;300;367;34.0
3981;Dinsdag 3 mei 2005;585;300;285;397;185;212;249;246;1.0;2.0;49.0;45.0;1.0;3.0;101;4919;3126;1793;271;230;27.0
3982;Woensdag 4 mei 2005;560;277;283;362;176;186;190;187;1.0;2.0;43.0;43.0;0.0;0.0;135;4865;3083;1782;248;186;96.0
3983;Donderdag 5 mei 2005;507;281;226;357;169;188;174;170;3.0;1.0;0.0;0.0;0.0;0.0;0;394;299;95;2;49;2.0
3984;Vrijdag 6 mei 2005;551;258;293;375;192;183;620;609;5.0;6.0;5.0;5.0;0.0;0.0;22;1153;825;328;44;50;4.0
3985;Zaterdag 7 mei 2005;512;262;250;369;192;177;174;171;1.0;2.0;2.0;2.0;0.0;0.0;0;701;506;195;7;17;0.0
3986;Zondag 8 mei 2005;431;232;199;336;167;169;14;14;0.0;0.0;0.0;0.0;0.0;0.0;0;181;130;51;1;33;0.0
3987;Maandag 9 mei 2005;550;289;261;372;189;183;222;215;3.0;4.0;60.0;59.0;1.0;0.0;117;6007;3830;2177;323;289;46.0
3988;Dinsdag 10 mei 2005;570;301;269;347;158;189;190;187;2.0;1.0;49.0;44.0;3.0;2.0;132;4065;2202;1863;280;144;40.0
3989;Woensdag 11 mei 2005;556;277;279;376;190;186;163;160;1.0;2.0;40.0;40.0;0.0;0.0;128;4079;1993;2086;320;122;26.0
3990;Donderdag 12 mei 2005;524;297;227;342;173;169;330;327;2.0;1.0;43.0;42.0;1.0;0.0;120;5481;3298;2183;298;202;25.0
3991;Vrijdag 13 mei 2005;505;266;239;396;193;203;718;711;2.0;5.0;32.0;31.0;0.0;1.0;107;5034;3168;1866;267;209;35.0
3992;Zaterdag 14 mei 2005;416;191;225;362;163;199;186;185;1.0;0.0;1.0;1.0;0.0;0.0;3;1244;900;344;3;41;2.0
3993;Zondag 15 mei 2005;445;228;217;377;170;207;9;9;0.0;0.0;0.0;0.0;0.0;0.0;0;1464;983;481;3;67;3.0
3994;Maandag 16 mei 2005;413;215;198;351;177;174;16;16;0.0;0.0;0.0;0.0;0.0;0.0;2;710;497;213;0;49;6.0
3995;Dinsdag 17 mei 2005;549;290;259;365;185;180;200;193;5.0;2.0;50.0;45.0;3.0;2.0;127;5981;3809;2172;367;267;39.0
3996;Woensdag 18 mei 2005;593;300;293;363;168;195;188;182;1.0;5.0;35.0;34.0;0.0;1.0;117;5347;3268;2079;318;207;52.0
3997;Donderdag 19 mei 2005;506;235;271;368;186;182;336;327;4.0;5.0;45.0;44.0;1.0;0.0;177;5159;3193;1966;304;224;32.0
3998;Vrijdag 20 mei 2005;496;269;227;391;193;198;2444;2394;19.0;31.0;28.0;25.0;0.0;3.0;102;5137;3250;1887;228;226;21.0
3999;Zaterdag 21 mei 2005;469;250;219;379;193;186;281;276;3.0;2.0;0.0;0.0;0.0;0.0;0;1041;731;310;1;32;1.0
4000;Zondag 22 mei 2005;381;201;180;357;165;192;6;6;0.0;0.0;0.0;0.0;0.0;0.0;1;227;160;67;2;17;3.0
4001;Maandag 23 mei 2005;520;273;247;369;179;190;208;203;3.0;2.0;78.0;74.0;1.0;3.0;146;5664;3540;2124;363;225;22.0
4002;Dinsdag 24 mei 2005;511;277;234;358;162;196;145;143;1.0;1.0;56.0;54.0;2.0;0.0;190;4447;2690;1757;294;169;49.0
4003;Woensdag 25 mei 2005;531;250;281;364;164;200;359;353;4.0;2.0;48.0;46.0;2.0;0.0;176;4708;2895;1813;284;213;31.0
4004;Donderdag 26 mei 2005;568;308;260;400;190;210;350;346;3.0;1.0;34.0;31.0;1.0;2.0;164;4740;2882;1858;314;253;957.0
4005;Vrijdag 27 mei 2005;514;288;226;406;188;218;1333;1319;8.0;6.0;26.0;22.0;1.0;3.0;109;4615;2907;1708;201;266;21.0
4006;Zaterdag 28 mei 2005;442;225;217;393;179;214;272;264;6.0;2.0;0.0;0.0;0.0;0.0;0;1587;1173;414;1;67;0.0
4007;Zondag 29 mei 2005;449;226;223;372;197;175;8;8;0.0;0.0;0.0;0.0;0.0;0.0;0;243;163;80;1;34;0.0
4008;Maandag 30 mei 2005;495;257;238;368;177;191;235;231;1.0;3.0;58.0;54.0;3.0;1.0;116;5756;3606;2150;292;348;31.0
4009;Dinsdag 31 mei 2005;551;285;266;363;176;187;145;144;0.0;1.0;57.0;56.0;0.0;1.0;123;5880;3784;2096;331;357;32.0
4010;Totaal juni 2005;15583;8021;7562;10883;5388;5495;9418;9277;68.0;73.0;1002.0;945.0;25.0;32.0;2802;134044;84281;49763;6589;7109;4195.0
4011;Woensdag 1 juni 2005;567;277;290;338;160;178;180;178;1.0;1.0;27.0;25.0;2.0;0.0;125;20814;13667;7147;290;621;28.0
4012;Donderdag 2 juni 2005;533;265;268;362;180;182;243;234;5.0;4.0;37.0;33.0;0.0;4.0;123;6054;3600;2454;294;245;36.0
4013;Vrijdag 3 juni 2005;488;255;233;361;167;194;1088;1075;6.0;7.0;21.0;20.0;0.0;1.0;141;5016;3094;1922;241;252;38.0
4014;Zaterdag 4 juni 2005;414;205;209;338;165;173;242;239;2.0;1.0;0.0;0.0;0.0;0.0;0;790;556;234;2;50;1.0
4015;Zondag 5 juni 2005;433;226;207;330;148;182;4;4;0.0;0.0;0.0;0.0;0.0;0.0;0;242;161;81;2;48;2.0
4016;Maandag 6 juni 2005;549;280;269;330;162;168;257;251;3.0;3.0;81.0;74.0;4.0;3.0;128;6120;3736;2384;361;301;32.0
4017;Dinsdag 7 juni 2005;537;284;253;329;155;174;249;244;1.0;4.0;48.0;47.0;0.0;1.0;130;4664;2792;1872;362;237;139.0
4018;Woensdag 8 juni 2005;568;310;258;342;189;153;154;148;2.0;4.0;50.0;47.0;2.0;1.0;113;4629;2814;1815;281;175;30.0
4019;Donderdag 9 juni 2005;527;267;260;338;162;176;255;252;2.0;1.0;30.0;29.0;0.0;1.0;129;4233;2624;1609;284;216;29.0
4020;Vrijdag 10 juni 2005;496;286;210;316;168;148;1147;1135;5.0;7.0;32.0;30.0;2.0;0.0;126;5015;3124;1891;232;242;1313.0
4021;Zaterdag 11 juni 2005;434;248;186;348;181;167;229;226;2.0;1.0;0.0;0.0;0.0;0.0;1;1006;750;256;9;39;5.0
4022;Zondag 12 juni 2005;413;210;203;374;192;182;6;6;0.0;0.0;0.0;0.0;0.0;0.0;1;238;173;65;3;21;0.0
4023;Maandag 13 juni 2005;570;267;303;377;192;185;164;163;1.0;0.0;68.0;65.0;2.0;1.0;103;5532;3467;2065;341;291;23.0
4024;Dinsdag 14 juni 2005;585;305;280;337;174;163;172;168;2.0;2.0;59.0;56.0;1.0;2.0;133;4501;2770;1731;338;201;24.0
4025;Woensdag 15 juni 2005;532;273;259;380;183;197;193;192;0.0;1.0;47.0;44.0;2.0;1.0;118;7214;4707;2507;273;282;39.0
4026;Donderdag 16 juni 2005;550;288;262;374;199;175;293;288;4.0;1.0;26.0;25.0;0.0;1.0;109;4835;3029;1806;280;238;599.0
4027;Vrijdag 17 juni 2005;496;232;264;346;169;177;1063;1049;4.0;10.0;37.0;33.0;2.0;2.0;136;4594;2895;1699;244;270;41.0
4028;Zaterdag 18 juni 2005;437;232;205;378;183;195;256;251;3.0;2.0;1.0;1.0;0.0;0.0;2;1176;858;318;4;26;2.0
4029;Zondag 19 juni 2005;493;257;236;347;170;177;6;5;1.0;0.0;0.0;0.0;0.0;0.0;0;150;109;41;0;19;1.0
4030;Maandag 20 juni 2005;576;318;258;389;188;201;232;226;3.0;3.0;67.0;64.0;1.0;2.0;97;5717;3640;2077;347;342;38.0
4031;Dinsdag 21 juni 2005;541;286;255;442;211;231;255;249;4.0;2.0;59.0;52.0;2.0;5.0;162;4186;2571;1615;349;282;33.0
4032;Woensdag 22 juni 2005;606;307;299;373;196;177;180;180;0.0;0.0;40.0;38.0;1.0;1.0;108;3888;2379;1509;263;270;822.0
4033;Donderdag 23 juni 2005;587;301;286;362;180;182;283;277;4.0;2.0;37.0;35.0;2.0;0.0;153;4333;2680;1653;275;257;18.0
4034;Vrijdag 24 juni 2005;549;283;266;421;195;226;1154;1139;4.0;11.0;22.0;22.0;0.0;0.0;124;4404;2747;1657;189;306;29.0
4035;Zaterdag 25 juni 2005;503;268;235;437;210;227;262;259;3.0;0.0;1.0;0.0;0.0;1.0;0;1923;1325;598;3;72;1.0
4036;Zondag 26 juni 2005;372;190;182;358;188;170;12;12;0.0;0.0;0.0;0.0;0.0;0.0;2;260;162;98;5;83;1.0
4037;Maandag 27 juni 2005;505;262;243;342;170;172;201;200;1.0;0.0;74.0;71.0;1.0;2.0;122;5541;3382;2159;333;374;34.0
4038;Dinsdag 28 juni 2005;567;263;304;344;173;171;173;168;3.0;2.0;52.0;51.0;0.0;1.0;152;4962;3165;1797;342;318;38.0
4039;Woensdag 29 juni 2005;592;290;302;411;201;210;144;142;0.0;2.0;45.0;42.0;1.0;2.0;124;4586;2664;1922;282;364;594.0
4040;Donderdag 30 juni 2005;563;286;277;359;177;182;321;317;2.0;2.0;41.0;41.0;0.0;0.0;140;7421;4640;2781;360;667;205.0
4041;Totaal juli 2005;16405;8468;7937;10381;4928;5453;7516;7413;50.0;53.0;879.0;823.0;24.0;32.0;2611;144633;86281;58352;7576;8654;1890.0
4042;Vrijdag 1 juli 2005;518;281;237;349;144;205;1191;1175;6.0;10.0;35.0;31.0;4.0;0.0;119;25123;15544;9579;354;977;24.0
4043;Zaterdag 2 juli 2005;490;241;249;355;179;176;228;228;0.0;0.0;0.0;0.0;0.0;0.0;1;1029;670;359;8;103;1.0
4044;Zondag 3 juli 2005;449;226;223;349;164;185;4;4;0.0;0.0;0.0;0.0;0.0;0.0;0;176;118;58;4;51;0.0
4045;Maandag 4 juli 2005;559;279;280;343;166;177;231;230;0.0;1.0;65.0;60.0;1.0;4.0;114;6842;3880;2962;460;499;19.0
4046;Dinsdag 5 juli 2005;561;291;270;302;143;159;182;178;2.0;2.0;53.0;51.0;1.0;1.0;126;5978;3404;2574;426;336;52.0
4047;Woensdag 6 juli 2005;543;285;258;325;159;166;140;138;1.0;1.0;38.0;37.0;0.0;1.0;125;5510;3167;2343;395;321;23.0
4048;Donderdag 7 juli 2005;570;283;287;328;153;175;333;330;2.0;1.0;43.0;37.0;2.0;4.0;106;5728;3204;2524;388;306;38.0
4049;Vrijdag 8 juli 2005;528;269;259;360;169;191;867;858;2.0;7.0;24.0;22.0;1.0;1.0;141;5415;3306;2109;325;308;13.0
4050;Zaterdag 9 juli 2005;452;228;224;308;166;142;170;169;1.0;0.0;1.0;0.0;0.0;1.0;1;1082;672;410;2;58;1.0
4051;Zondag 10 juli 2005;421;213;208;336;169;167;7;6;1.0;0.0;0.0;0.0;0.0;0.0;0;465;329;136;1;50;0.0
4052;Maandag 11 juli 2005;583;279;304;328;150;178;204;199;3.0;2.0;51.0;49.0;1.0;1.0;124;5845;3404;2441;367;344;26.0
4053;Dinsdag 12 juli 2005;625;315;310;349;165;184;168;167;0.0;1.0;57.0;56.0;1.0;0.0;161;5016;2957;2059;394;308;67.0
4054;Woensdag 13 juli 2005;578;296;282;354;172;182;126;122;4.0;0.0;43.0;41.0;0.0;2.0;129;4494;2637;1857;276;277;20.0
4055;Donderdag 14 juli 2005;626;341;285;331;170;161;248;247;0.0;1.0;37.0;35.0;2.0;0.0;140;5208;3159;2049;343;352;21.0
4056;Vrijdag 15 juli 2005;597;294;303;373;178;195;601;594;1.0;6.0;30.0;29.0;1.0;0.0;109;8552;5276;3276;310;485;26.0
4057;Zaterdag 16 juli 2005;442;219;223;320;155;165;125;124;1.0;0.0;0.0;0.0;0.0;0.0;0;1215;844;371;0;86;800.0
4058;Zondag 17 juli 2005;450;258;192;327;145;182;13;13;0.0;0.0;0.0;0.0;0.0;0.0;1;241;166;75;2;59;0.0
4059;Maandag 18 juli 2005;570;297;273;329;171;158;215;208;3.0;4.0;53.0;50.0;2.0;1.0;136;6584;3856;2728;383;366;33.0
4060;Dinsdag 19 juli 2005;578;303;275;356;158;198;161;153;3.0;5.0;50.0;42.0;3.0;5.0;133;5048;2993;2055;362;260;19.0
4061;Woensdag 20 juli 2005;579;309;270;333;164;169;173;173;0.0;0.0;39.0;34.0;1.0;4.0;126;5288;3076;2212;348;256;26.0
4062;Donderdag 21 juli 2005;569;285;284;339;143;196;205;202;2.0;1.0;43.0;41.0;1.0;1.0;124;4861;2895;1966;352;270;36.0
4063;Vrijdag 22 juli 2005;572;287;285;323;151;172;521;516;3.0;2.0;20.0;20.0;0.0;0.0;96;5118;3054;2064;287;290;23.0
4064;Zaterdag 23 juli 2005;432;237;195;306;129;177;125;123;0.0;2.0;0.0;0.0;0.0;0.0;1;1192;796;396;1;71;473.0
4065;Zondag 24 juli 2005;434;227;207;340;152;188;15;15;0.0;0.0;0.0;0.0;0.0;0.0;0;261;178;83;9;48;0.0
4066;Maandag 25 juli 2005;546;289;257;312;140;172;213;208;1.0;4.0;52.0;48.0;1.0;3.0;141;6433;3866;2567;422;403;14.0
4067;Dinsdag 26 juli 2005;582;301;281;316;148;168;171;170;1.0;0.0;53.0;50.0;1.0;2.0;109;4813;2720;2093;332;277;47.0
4068;Woensdag 27 juli 2005;519;271;248;337;171;166;166;162;2.0;2.0;40.0;39.0;0.0;1.0;116;4502;2548;1954;414;383;21.0
4069;Donderdag 28 juli 2005;565;297;268;364;168;196;181;178;3.0;0.0;37.0;36.0;1.0;0.0;124;5186;3080;2106;326;377;51.0
4070;Vrijdag 29 juli 2005;559;299;260;325;160;165;390;381;8.0;1.0;15.0;15.0;0.0;0.0;106;5465;3243;2222;277;456;15.0
4071;Zaterdag 30 juli 2005;468;238;230;354;163;191;132;132;0.0;0.0;0.0;0.0;0.0;0.0;1;1154;756;398;8;111;1.0
4072;Zondag 31 juli 2005;440;230;210;310;163;147;10;10;0.0;0.0;0.0;0.0;0.0;0.0;1;809;483;326;0;166;0.0
4073;Totaal augustus 2005;16701;8507;8194;10348;5089;5259;7840;7706;64.0;70.0;951.0;896.0;25.0;30.0;2683;154769;87299;67470;10263;8984;2282.0
4074;Maandag 1 augustus 2005;555;269;286;317;157;160;264;260;2.0;2.0;53.0;51.0;2.0;0.0;106;26609;15809;10800;640;1143;19.0
4075;Dinsdag 2 augustus 2005;541;266;275;349;185;164;169;165;2.0;2.0;53.0;52.0;1.0;0.0;118;6069;3269;2800;533;359;35.0
4076;Woensdag 3 augustus 2005;579;302;277;380;174;206;164;161;1.0;2.0;39.0;37.0;1.0;1.0;110;5500;2966;2534;506;254;20.0
4077;Donderdag 4 augustus 2005;547;286;261;325;180;145;165;156;6.0;3.0;30.0;28.0;1.0;1.0;94;5497;2995;2502;354;247;536.0
4078;Vrijdag 5 augustus 2005;569;299;270;344;186;158;548;539;3.0;6.0;13.0;13.0;0.0;0.0;106;4843;2795;2048;406;288;21.0
4079;Zaterdag 6 augustus 2005;509;261;248;307;156;151;120;117;0.0;3.0;2.0;1.0;1.0;0.0;1;788;487;301;12;50;0.0
4080;Zondag 7 augustus 2005;437;220;217;292;135;157;11;11;0.0;0.0;0.0;0.0;0.0;0.0;0;230;146;84;2;36;0.0
4081;Maandag 8 augustus 2005;565;275;290;341;161;180;282;273;3.0;6.0;63.0;60.0;2.0;1.0;84;6258;3559;2699;457;309;9.0
4082;Dinsdag 9 augustus 2005;607;304;303;285;139;146;160;154;4.0;2.0;44.0;39.0;1.0;4.0;117;4698;2632;2066;433;437;14.0
4083;Woensdag 10 augustus 2005;575;289;286;343;158;185;173;171;0.0;2.0;36.0;35.0;0.0;1.0;152;4912;2812;2100;368;273;13.0
4084;Donderdag 11 augustus 2005;558;265;293;322;172;150;179;176;0.0;3.0;27.0;27.0;0.0;0.0;104;4881;2657;2224;329;250;19.0
4085;Vrijdag 12 augustus 2005;567;304;263;341;155;186;540;530;5.0;5.0;24.0;21.0;3.0;0.0;97;4876;2835;2041;315;282;22.0
4086;Zaterdag 13 augustus 2005;474;244;230;322;149;173;119;117;1.0;1.0;1.0;1.0;0.0;0.0;0;829;552;277;0;40;1.0
4087;Zondag 14 augustus 2005;447;240;207;290;140;150;11;11;0.0;0.0;0.0;0.0;0.0;0.0;0;329;220;109;2;38;0.0
4088;Maandag 15 augustus 2005;548;300;248;340;173;167;210;209;1.0;0.0;50.0;47.0;2.0;1.0;98;10021;5929;4092;435;531;31.0
4089;Dinsdag 16 augustus 2005;569;283;286;337;181;156;187;184;1.0;2.0;45.0;44.0;1.0;0.0;135;5565;3139;2426;417;276;365.0
4090;Woensdag 17 augustus 2005;565;281;284;358;182;176;167;167;0.0;0.0;28.0;27.0;0.0;1.0;150;4699;2576;2123;343;283;630.0
4091;Donderdag 18 augustus 2005;582;284;298;354;179;175;217;212;2.0;3.0;40.0;38.0;2.0;0.0;125;5021;2709;2312;406;265;19.0
4092;Vrijdag 19 augustus 2005;566;274;292;389;174;215;797;785;8.0;4.0;21.0;16.0;2.0;3.0;108;4704;2592;2112;348;279;17.0
4093;Zaterdag 20 augustus 2005;472;238;234;320;157;163;228;227;1.0;0.0;0.0;0.0;0.0;0.0;0;1556;993;563;5;44;1.0
4094;Zondag 21 augustus 2005;430;211;219;296;139;157;11;11;0.0;0.0;0.0;0.0;0.0;0.0;0;219;85;134;3;48;0.0
4095;Maandag 22 augustus 2005;557;275;282;326;162;164;232;230;0.0;2.0;66.0;63.0;1.0;2.0;97;6411;3450;2961;468;334;13.0
4096;Dinsdag 23 augustus 2005;542;299;243;320;144;176;183;179;2.0;2.0;49.0;47.0;1.0;1.0;115;4966;2584;2382;531;332;10.0
4097;Woensdag 24 augustus 2005;609;329;280;360;186;174;219;213;4.0;2.0;50.0;45.0;1.0;4.0;146;4857;2587;2270;499;296;10.0
4098;Donderdag 25 augustus 2005;555;292;263;337;152;185;380;374;3.0;3.0;38.0;37.0;1.0;0.0;133;5538;2957;2581;494;348;424.0
4099;Vrijdag 26 augustus 2005;542;270;272;341;176;165;1225;1208;8.0;9.0;21.0;20.0;1.0;0.0;105;5254;3001;2253;382;366;16.0
4100;Zaterdag 27 augustus 2005;459;229;230;336;146;190;280;278;2.0;0.0;1.0;0.0;0.0;1.0;0;1229;805;424;6;77;3.0
4101;Zondag 28 augustus 2005;439;227;212;341;171;170;13;13;0.0;0.0;0.0;0.0;0.0;0.0;0;420;229;191;1;67;3.0
4102;Maandag 29 augustus 2005;566;286;280;354;167;187;225;222;1.0;2.0;72.0;68.0;0.0;4.0;110;6258;3388;2870;516;533;7.0
4103;Dinsdag 30 augustus 2005;573;308;265;331;162;169;158;155;1.0;2.0;45.0;41.0;1.0;3.0;138;5327;2830;2497;548;412;13.0
4104;Woensdag 31 augustus 2005;597;297;300;350;191;159;203;198;3.0;2.0;40.0;38.0;0.0;2.0;134;6405;3711;2694;504;487;11.0
4105;Totaal september 2005;16194;8351;7843;10024;4957;5067;10081;9937;66.0;78.0;888.0;838.0;21.0;29.0;2675;154074;89108;64966;12965;8111;3461.0
4106;Donderdag 1 september 2005;558;267;291;336;167;169;449;446;2.0;1.0;30.0;29.0;1.0;0.0;119;26622;15376;11246;622;1167;8.0
4107;Vrijdag 2 september 2005;580;308;272;359;186;173;1278;1257;11.0;10.0;22.0;19.0;1.0;2.0;97;6251;3215;3036;443;417;7.0
4108;Zaterdag 3 september 2005;457;227;230;344;169;175;336;328;4.0;4.0;1.0;1.0;0.0;0.0;0;684;395;289;11;56;0.0
4109;Zondag 4 september 2005;446;241;205;349;174;175;17;17;0.0;0.0;0.0;0.0;0.0;0.0;0;308;124;184;4;68;0.0
4110;Maandag 5 september 2005;547;308;239;315;142;173;253;252;1.0;0.0;65.0;61.0;2.0;2.0;113;7264;3954;3310;715;373;760.0
4111;Dinsdag 6 september 2005;595;315;280;360;174;186;174;172;1.0;1.0;54.0;52.0;1.0;1.0;144;5712;3066;2646;736;316;15.0
4112;Woensdag 7 september 2005;582;289;293;369;186;183;224;219;1.0;4.0;36.0;34.0;1.0;1.0;151;5472;2873;2599;581;241;10.0
4113;Donderdag 8 september 2005;565;308;257;344;171;173;325;320;2.0;3.0;29.0;28.0;0.0;1.0;123;5611;3061;2550;657;276;369.0
4114;Vrijdag 9 september 2005;563;297;266;370;176;194;1381;1366;8.0;7.0;21.0;19.0;1.0;1.0;127;4930;2778;2152;496;238;16.0
4115;Zaterdag 10 september 2005;454;219;235;340;170;170;253;252;1.0;0.0;0.0;0.0;0.0;0.0;0;1218;890;328;5;86;2.0
4116;Zondag 11 september 2005;468;257;211;294;135;159;4;4;0.0;0.0;0.0;0.0;0.0;0.0;0;184;101;83;6;31;3.0
4117;Maandag 12 september 2005;567;290;277;324;148;176;191;190;0.0;1.0;61.0;58.0;2.0;1.0;102;6213;3567;2646;727;343;23.0
4118;Dinsdag 13 september 2005;573;292;281;341;174;167;120;116;1.0;3.0;38.0;34.0;2.0;2.0;130;4876;2797;2079;618;241;11.0
4119;Woensdag 14 september 2005;560;282;278;312;182;130;180;176;1.0;3.0;39.0;37.0;1.0;1.0;157;5191;3024;2167;602;245;218.0
4120;Donderdag 15 september 2005;529;276;253;341;179;162;280;276;1.0;3.0;40.0;38.0;0.0;2.0;101;8107;4838;3269;594;328;7.0
4121;Vrijdag 16 september 2005;562;293;269;347;168;179;1040;1031;5.0;4.0;24.0;22.0;0.0;2.0;159;5287;3175;2112;443;267;672.0
4122;Zaterdag 17 september 2005;437;209;228;327;157;170;237;233;2.0;2.0;4.0;3.0;0.0;1.0;1;873;601;272;6;54;2.0
4123;Zondag 18 september 2005;451;241;210;331;166;165;10;10;0.0;0.0;0.0;0.0;0.0;0.0;0;249;156;93;4;46;0.0
4124;Maandag 19 september 2005;542;263;279;319;142;177;194;191;2.0;1.0;65.0;63.0;0.0;2.0;87;6137;3713;2424;690;266;256.0
4125;Dinsdag 20 september 2005;625;301;324;298;147;151;167;164;2.0;1.0;40.0;36.0;2.0;2.0;121;5194;2947;2247;679;271;132.0
4126;Woensdag 21 september 2005;556;285;271;346;167;179;187;182;3.0;2.0;42.0;40.0;1.0;1.0;114;4618;2596;2022;741;249;29.0
4127;Donderdag 22 september 2005;567;288;279;304;147;157;251;239;3.0;9.0;27.0;26.0;0.0;1.0;122;5332;3095;2237;610;264;52.0
4128;Vrijdag 23 september 2005;567;278;289;341;173;168;864;856;3.0;5.0;29.0;27.0;0.0;2.0;119;5124;3033;2091;560;282;18.0
4129;Zaterdag 24 september 2005;510;269;241;313;153;160;189;187;1.0;1.0;0.0;0.0;0.0;0.0;1;1482;1032;450;3;53;3.0
4130;Zondag 25 september 2005;420;212;208;298;136;162;13;13;0.0;0.0;0.0;0.0;0.0;0.0;0;460;268;192;1;51;0.0
4131;Maandag 26 september 2005;571;296;275;345;174;171;188;185;3.0;0.0;76.0;72.0;3.0;1.0;117;6155;3714;2441;564;324;41.0
4132;Dinsdag 27 september 2005;560;294;266;337;177;160;152;149;1.0;2.0;45.0;44.0;0.0;1.0;135;5061;2898;2163;512;328;39.0
4133;Woensdag 28 september 2005;615;325;290;339;188;151;136;133;0.0;3.0;35.0;33.0;1.0;1.0;111;4929;3028;1901;482;310;34.0
4134;Donderdag 29 september 2005;600;316;284;341;163;178;214;206;4.0;4.0;41.0;40.0;1.0;0.0;100;5758;3337;2421;478;374;353.0
4135;Vrijdag 30 september 2005;567;305;262;340;166;174;774;767;3.0;4.0;24.0;22.0;1.0;1.0;124;8772;5456;3316;375;546;381.0
4136;Totaal oktober 2005;16024;8184;7840;10805;5234;5571;4956;4872;47.0;37.0;1024.0;964.0;25.0;35.0;2434;143819;87964;55855;8457;7524;1969.0
4137;Zaterdag 1 oktober 2005;490;252;238;337;159;178;149;149;0.0;0.0;0.0;0.0;0.0;0.0;1;14671;9571;5100;37;560;9.0
4138;Zondag 2 oktober 2005;423;199;224;303;152;151;8;8;0.0;0.0;0.0;0.0;0.0;0.0;0;161;84;77;2;72;0.0
4139;Maandag 3 oktober 2005;565;300;265;371;183;188;162;157;3.0;2.0;80.0;78.0;2.0;0.0;100;8309;4931;3378;580;460;26.0
4140;Dinsdag 4 oktober 2005;578;310;268;340;170;170;131;127;2.0;2.0;64.0;59.0;2.0;3.0;101;5770;3458;2312;514;303;228.0
4141;Woensdag 5 oktober 2005;579;284;295;344;163;181;141;140;0.0;1.0;49.0;46.0;0.0;3.0;125;5597;3220;2377;397;279;43.0
4142;Donderdag 6 oktober 2005;566;286;280;320;146;174;163;162;1.0;0.0;42.0;41.0;0.0;1.0;114;5998;3515;2483;398;290;80.0
4143;Vrijdag 7 oktober 2005;541;284;257;384;166;218;561;556;4.0;1.0;24.0;22.0;1.0;1.0;98;5303;3181;2122;332;255;338.0
4144;Zaterdag 8 oktober 2005;472;236;236;329;154;175;116;115;1.0;0.0;1.0;0.0;1.0;0.0;0;961;668;293;0;38;1.0
4145;Zondag 9 oktober 2005;413;204;209;309;156;153;5;5;0.0;0.0;0.0;0.0;0.0;0.0;0;164;104;60;2;32;0.0
4146;Maandag 10 oktober 2005;539;265;274;332;144;188;231;227;2.0;2.0;68.0;65.0;0.0;3.0;119;6734;4051;2683;441;387;23.0
4147;Dinsdag 11 oktober 2005;577;308;269;323;171;152;125;122;2.0;1.0;47.0;45.0;1.0;1.0;118;4760;2785;1975;484;293;32.0
4148;Woensdag 12 oktober 2005;575;278;297;370;168;202;155;152;1.0;2.0;38.0;37.0;1.0;0.0;156;4992;2941;2051;436;274;40.0
4149;Donderdag 13 oktober 2005;554;282;272;353;172;181;132;130;1.0;1.0;34.0;33.0;1.0;0.0;130;5194;3107;2087;363;238;44.0
4150;Vrijdag 14 oktober 2005;563;312;251;371;179;192;548;544;3.0;1.0;22.0;19.0;1.0;2.0;105;5993;3763;2230;318;289;30.0
4151;Zaterdag 15 oktober 2005;431;225;206;359;179;180;112;111;0.0;1.0;0.0;0.0;0.0;0.0;1;3092;2155;937;11;128;64.0
4152;Zondag 16 oktober 2005;409;210;199;308;146;162;4;4;0.0;0.0;0.0;0.0;0.0;0.0;0;328;207;121;0;40;0.0
4153;Maandag 17 oktober 2005;544;279;265;335;173;162;154;150;3.0;1.0;83.0;78.0;2.0;3.0;104;6756;4139;2617;411;360;58.0
4154;Dinsdag 18 oktober 2005;568;299;269;356;177;179;105;102;2.0;1.0;57.0;56.0;0.0;1.0;134;5172;3074;2098;458;254;59.0
4155;Woensdag 19 oktober 2005;563;281;282;342;154;188;102;101;0.0;1.0;55.0;52.0;1.0;2.0;110;4688;2816;1872;374;195;619.0
4156;Donderdag 20 oktober 2005;607;314;293;394;202;192;234;228;3.0;3.0;40.0;37.0;1.0;2.0;116;5810;3561;2249;352;283;31.0
4157;Vrijdag 21 oktober 2005;545;297;248;394;202;192;416;406;6.0;4.0;25.0;22.0;3.0;0.0;97;5131;3187;1944;314;253;14.0
4158;Zaterdag 22 oktober 2005;454;225;229;349;167;182;79;78;1.0;0.0;0.0;0.0;0.0;0.0;0;1393;978;415;5;43;1.0
4159;Zondag 23 oktober 2005;433;232;201;354;151;203;3;3;0.0;0.0;1.0;1.0;0.0;0.0;0;246;175;71;4;30;1.0
4160;Maandag 24 oktober 2005;507;273;234;333;152;181;157;153;3.0;1.0;75.0;68.0;1.0;6.0;130;5962;3547;2415;375;311;56.0
4161;Dinsdag 25 oktober 2005;539;273;266;345;172;173;120;116;1.0;3.0;52.0;48.0;2.0;2.0;116;4914;2910;2004;424;291;41.0
4162;Woensdag 26 oktober 2005;514;264;250;394;194;200;117;114;3.0;0.0;33.0;32.0;0.0;1.0;109;4904;2910;1994;402;330;44.0
4163;Donderdag 27 oktober 2005;545;267;278;338;164;174;121;120;1.0;0.0;42.0;38.0;3.0;1.0;137;5478;3224;2254;351;269;28.0
4164;Vrijdag 28 oktober 2005;539;261;278;366;192;174;365;361;2.0;2.0;27.0;26.0;0.0;1.0;112;5754;3571;2183;221;342;30.0
4165;Zaterdag 29 oktober 2005;436;218;218;349;177;172;66;64;1.0;1.0;0.0;0.0;0.0;0.0;0;1248;853;395;3;45;1.0
4166;Zondag 30 oktober 2005;437;215;222;374;184;190;3;3;0.0;0.0;0.0;0.0;0.0;0.0;0;629;425;204;2;68;1.0
4167;Maandag 31 oktober 2005;518;251;267;329;165;164;171;164;1.0;6.0;65.0;61.0;2.0;2.0;101;7707;4853;2854;446;512;27.0
4168;Totaal november 2005;14728;7467;7261;10796;5251;5545;3641;3582;30.0;29.0;1071.0;1022.0;27.0;22.0;2693;137607;84705;52902;7528;6409;2701.0
4169;Dinsdag 1 november 2005;522;246;276;333;183;150;126;124;0.0;2.0;70.0;67.0;1.0;2.0;142;22448;14186;8262;474;744;44.0
4170;Woensdag 2 november 2005;523;255;268;323;152;171;86;85;1.0;0.0;49.0;47.0;1.0;1.0;128;5612;3230;2382;371;227;908.0
4171;Donderdag 3 november 2005;515;258;257;336;159;177;93;90;0.0;3.0;43.0;40.0;3.0;0.0;130;5792;3368;2424;377;253;44.0
4172;Vrijdag 4 november 2005;545;284;261;359;163;196;297;297;0.0;0.0;20.0;20.0;0.0;0.0;118;5045;2964;2081;296;243;31.0
4173;Zaterdag 5 november 2005;439;219;220;326;174;152;64;64;0.0;0.0;1.0;1.0;0.0;0.0;2;875;622;253;3;64;0.0
4174;Zondag 6 november 2005;392;197;195;316;145;171;3;3;0.0;0.0;0.0;0.0;0.0;0.0;1;174;119;55;8;17;0.0
4175;Maandag 7 november 2005;517;270;247;362;181;181;135;132;2.0;1.0;79.0;75.0;4.0;0.0;136;5895;3520;2375;386;269;143.0
4176;Dinsdag 8 november 2005;553;280;273;324;165;159;104;102;1.0;1.0;67.0;64.0;1.0;2.0;146;4728;2802;1926;373;179;33.0
4177;Woensdag 9 november 2005;538;293;245;364;193;171;65;61;3.0;1.0;38.0;34.0;2.0;2.0;147;4461;2529;1932;357;242;29.0
4178;Donderdag 10 november 2005;518;260;258;323;157;166;95;93;0.0;2.0;32.0;31.0;0.0;1.0;137;5161;3144;2017;325;239;420.0
4179;Vrijdag 11 november 2005;485;241;244;332;163;169;381;373;5.0;3.0;31.0;30.0;0.0;1.0;104;4765;2933;1832;339;238;31.0
4180;Zaterdag 12 november 2005;460;225;235;352;184;168;49;49;0.0;0.0;1.0;0.0;0.0;1.0;0;1046;740;306;4;40;1.0
4181;Zondag 13 november 2005;413;204;209;360;179;181;1;1;0.0;0.0;0.0;0.0;0.0;0.0;2;202;149;53;5;44;0.0
4182;Maandag 14 november 2005;496;263;233;367;177;190;162;160;0.0;2.0;66.0;60.0;3.0;3.0;104;6189;3709;2480;373;273;17.0
4183;Dinsdag 15 november 2005;508;253;255;350;170;180;119;116;2.0;1.0;55.0;54.0;1.0;0.0;105;7437;4694;2743;322;327;349.0
4184;Woensdag 16 november 2005;552;283;269;355;167;188;113;109;2.0;2.0;43.0;41.0;2.0;0.0;99;4686;2864;1822;360;209;50.0
4185;Donderdag 17 november 2005;493;274;219;360;159;201;115;112;3.0;0.0;45.0;44.0;1.0;0.0;151;4823;2962;1861;319;247;39.0
4186;Vrijdag 18 november 2005;532;264;268;373;178;195;312;311;0.0;1.0;26.0;24.0;1.0;1.0;103;4532;2846;1686;334;154;25.0
4187;Zaterdag 19 november 2005;387;194;193;337;164;173;47;47;0.0;0.0;4.0;3.0;0.0;1.0;0;1063;768;295;1;28;3.0
4188;Zondag 20 november 2005;413;219;194;347;171;176;3;3;0.0;0.0;0.0;0.0;0.0;0.0;0;622;463;159;4;32;0.0
4189;Maandag 21 november 2005;492;252;240;370;177;193;149;149;0.0;0.0;75.0;73.0;1.0;1.0;108;5586;3362;2224;370;242;311.0
4190;Dinsdag 22 november 2005;524;256;268;378;185;193;129;126;2.0;1.0;50.0;47.0;1.0;2.0;113;4457;2727;1730;307;247;36.0
4191;Woensdag 23 november 2005;485;264;221;364;172;192;113;112;1.0;0.0;41.0;41.0;0.0;0.0;156;4145;2504;1641;317;220;24.0
4192;Donderdag 24 november 2005;539;284;255;404;188;216;123;121;0.0;2.0;48.0;46.0;1.0;1.0;113;4655;2840;1815;282;218;36.0
4193;Vrijdag 25 november 2005;536;258;278;405;205;200;336;331;2.0;3.0;27.0;26.0;0.0;1.0;119;4798;3089;1709;215;297;40.0
4194;Zaterdag 26 november 2005;443;215;228;405;184;221;45;44;0.0;1.0;0.0;0.0;0.0;0.0;0;1652;1226;426;2;72;0.0
4195;Zondag 27 november 2005;425;204;221;366;175;191;2;2;0.0;0.0;0.0;0.0;0.0;0.0;1;234;135;99;1;20;0.0
4196;Maandag 28 november 2005;473;230;243;369;174;195;151;148;3.0;0.0;70.0;69.0;0.0;1.0;86;5494;3434;2060;368;312;23.0
4197;Dinsdag 29 november 2005;485;257;228;420;199;221;105;102;1.0;2.0;48.0;44.0;3.0;1.0;117;4545;2679;1866;330;282;29.0
4198;Woensdag 30 november 2005;525;265;260;416;208;208;118;115;2.0;1.0;42.0;41.0;1.0;0.0;125;6485;4097;2388;305;430;35.0
4199;Totaal december 2005;14776;7561;7215;11907;5720;6187;3970;3885;49.0;36.0;1003.0;948.0;24.0;31.0;2619;143179;89681;53498;6255;8145;2657.0
4200;Donderdag 1 december 2005;495;239;256;369;172;197;134;127;5.0;2.0;34.0;32.0;2.0;0.0;143;22094;14517;7577;350;684;36.0
4201;Vrijdag 2 december 2005;475;252;223;352;159;193;223;219;2.0;2.0;20.0;20.0;0.0;0.0;108;5605;3384;2221;265;311;19.0
4202;Zaterdag 3 december 2005;405;195;210;378;189;189;43;41;2.0;0.0;0.0;0.0;0.0;0.0;1;830;623;207;2;72;0.0
4203;Zondag 4 december 2005;376;185;191;365;182;183;2;2;0.0;0.0;0.0;0.0;0.0;0.0;0;180;110;70;1;38;0.0
4204;Maandag 5 december 2005;479;257;222;416;191;225;183;181;2.0;0.0;71.0;68.0;1.0;2.0;97;6125;3702;2423;363;367;26.0
4205;Dinsdag 6 december 2005;516;265;251;414;201;213;115;112;2.0;1.0;56.0;50.0;2.0;4.0;124;4777;2901;1876;330;242;33.0
4206;Woensdag 7 december 2005;544;282;262;392;191;201;88;86;2.0;0.0;44.0;43.0;0.0;1.0;140;4993;2971;2022;294;274;30.0
4207;Donderdag 8 december 2005;482;254;228;397;196;201;116;115;1.0;0.0;38.0;37.0;0.0;1.0;136;5486;3435;2051;318;249;38.0
4208;Vrijdag 9 december 2005;490;261;229;400;180;220;254;249;3.0;2.0;33.0;33.0;0.0;0.0;123;4613;2785;1828;263;323;694.0
4209;Zaterdag 10 december 2005;405;204;201;367;172;195;78;76;2.0;0.0;1.0;1.0;0.0;0.0;0;1985;1457;528;5;34;0.0
4210;Zondag 11 december 2005;362;202;160;319;161;158;6;6;0.0;0.0;0.0;0.0;0.0;0.0;0;188;129;59;3;23;0.0
4211;Maandag 12 december 2005;496;254;242;376;195;181;252;244;4.0;4.0;88.0;84.0;2.0;2.0;117;6158;3813;2345;372;318;704.0
4212;Dinsdag 13 december 2005;543;288;255;401;190;211;92;91;1.0;0.0;55.0;53.0;0.0;2.0;128;4484;2744;1740;334;266;32.0
4213;Woensdag 14 december 2005;532;265;267;397;196;201;112;105;1.0;6.0;56.0;55.0;0.0;1.0;160;4608;2760;1848;296;261;34.0
4214;Donderdag 15 december 2005;519;273;246;387;188;199;152;148;1.0;3.0;38.0;37.0;0.0;1.0;144;8514;5501;3013;357;375;36.0
4215;Vrijdag 16 december 2005;549;274;275;412;206;206;393;388;4.0;1.0;34.0;30.0;2.0;2.0;108;5637;3631;2006;236;389;7.0
4216;Zaterdag 17 december 2005;433;216;217;378;167;211;82;81;1.0;0.0;1.0;1.0;0.0;0.0;1;2092;1529;563;3;48;0.0
4217;Zondag 18 december 2005;396;211;185;363;165;198;3;3;0.0;0.0;0.0;0.0;0.0;0.0;1;331;244;87;1;44;0.0
4218;Maandag 19 december 2005;527;258;269;387;179;208;205;199;3.0;3.0;92.0;85.0;4.0;3.0;110;6943;4422;2521;378;392;215.0
4219;Dinsdag 20 december 2005;531;268;263;409;192;217;161;155;3.0;3.0;73.0;69.0;0.0;4.0;116;5911;3780;2131;336;318;19.0
4220;Woensdag 21 december 2005;515;261;254;358;167;191;174;172;0.0;2.0;46.0;44.0;1.0;1.0;131;4860;2895;1965;334;262;29.0
4221;Donderdag 22 december 2005;491;250;241;395;186;209;164;163;1.0;0.0;45.0;42.0;1.0;2.0;119;5401;3264;2137;316;335;345.0
4222;Vrijdag 23 december 2005;516;262;254;397;198;199;302;300;2.0;0.0;25.0;23.0;2.0;0.0;100;5090;3124;1966;169;257;14.0
4223;Zaterdag 24 december 2005;415;210;205;365;173;192;18;17;1.0;0.0;0.0;0.0;0.0;0.0;1;729;487;242;3;31;0.0
4224;Zondag 25 december 2005;419;218;201;365;166;199;0;0;0.0;0.0;0.0;0.0;0.0;0.0;0;163;108;55;0;35;0.0
4225;Maandag 26 december 2005;382;197;185;336;163;173;8;8;0.0;0.0;0.0;0.0;0.0;0.0;1;134;83;51;0;24;0.0
4226;Dinsdag 27 december 2005;487;243;244;428;234;194;130;129;1.0;0.0;71.0;68.0;2.0;1.0;149;5578;3350;2228;275;409;20.0
4227;Woensdag 28 december 2005;529;272;257;386;185;201;152;149;0.0;3.0;39.0;36.0;2.0;1.0;135;6224;3721;2503;233;448;11.0
4228;Donderdag 29 december 2005;543;271;272;360;179;181;124;118;2.0;4.0;32.0;28.0;2.0;2.0;121;6214;3741;2473;238;459;44.0
4229;Vrijdag 30 december 2005;523;276;247;387;202;185;162;160;2.0;0.0;11.0;9.0;1.0;1.0;105;5890;3584;2306;174;459;271.0
4230;Zaterdag 31 december 2005;401;198;203;451;195;256;42;41;1.0;0.0;0.0;0.0;0.0;0.0;0;1342;886;456;6;398;0.0
4231;Totaal op zondag in 2005;22231;11432;10799;18645;8966;9679;345;342;3.0;0.0;1.0;1.0;0.0;0.0;21;26874;17949;8925;170;2484;38.0
4232;Totaal op maandag in 2005;27557;14086;13471;19281;9344;9937;9450;9269;92.0;89.0;3295.0;3135.0;72.0;88.0;5545;331879;201251;130628;20127;17134;4491.0
4233;Totaal op dinsdag in 2005;28935;14894;14041;19434;9473;9961;7416;7253;82.0;81.0;2730.0;2566.0;72.0;92.0;6849;313688;190343;123345;20340;15291;4260.0
4234;Totaal op woensdag in 2005;28971;14753;14218;19818;9720;10098;7278;7144;61.0;73.0;2148.0;2050.0;42.0;56.0;7012;271934;162153;109781;18738;13731;5874.0
4235;Totaal op donderdag in 2005;28372;14595;13777;19460;9518;9942;9913;9735;89.0;89.0;1864.0;1777.0;46.0;41.0;6604;312855;188966;123889;18257;15296;6539.0
4236;Totaal op vrijdag in 2005;28082;14467;13615;19953;9663;10290;31374;30962;195.0;217.0;1231.0;1143.0;43.0;45.0;5848;303960;187178;116782;14382;15310;5562.0
4237;Totaal op zaterdag in 2005;23762;12111;11651;19811;9678;10133;6487;6408;48.0;31.0;38.0;27.0;4.0;7.0;26;90385;61646;28739;283;4153;1724.0
4238;Totaal 2006;185057;94979;90078;135372;65294;70078;72369;71157;579.0;633.0;10801.0;10182.0;295.0;324.0;31734;1678119;1025817;652302;101150;91028;29089.0
4239;Totaal januari 2006;15399;7781;7618;12261;5930;6331;2931;2888;19.0;24.0;928.0;879.0;18.0;31.0;2903;145730;89420;56310;7426;7534;1903.0
4240;Zondag 1 januari 2006;408;203;205;352;182;170;11;11;0.0;0.0;0.0;0.0;0.0;0.0;0;12061;7321;4740;85;721;3.0
4241;Maandag 2 januari 2006;464;250;214;430;214;216;78;76;1.0;1.0;23.0;22.0;0.0;1.0;95;8445;5135;3310;354;467;18.0
4242;Dinsdag 3 januari 2006;554;282;272;429;186;243;99;97;1.0;1.0;51.0;48.0;0.0;3.0;126;6325;3619;2706;403;325;33.0
4243;Woensdag 4 januari 2006;518;264;254;361;164;197;98;98;0.0;0.0;53.0;53.0;0.0;0.0;117;6534;3910;2624;299;309;24.0
4244;Donderdag 5 januari 2006;494;260;234;380;180;200;106;105;0.0;1.0;42.0;41.0;1.0;0.0;128;7049;4112;2937;393;350;17.0
4245;Vrijdag 6 januari 2006;527;255;272;399;200;199;180;180;0.0;0.0;29.0;27.0;1.0;1.0;156;6032;3546;2486;288;304;45.0
4246;Zaterdag 7 januari 2006;404;211;193;400;198;202;42;41;0.0;1.0;2.0;2.0;0.0;0.0;1;1079;776;303;4;59;3.0
4247;Zondag 8 januari 2006;394;205;189;347;157;190;14;14;0.0;0.0;0.0;0.0;0.0;0.0;0;276;173;103;0;35;0.0
4248;Maandag 9 januari 2006;473;242;231;393;209;184;145;143;2.0;0.0;57.0;52.0;0.0;5.0;120;6704;4034;2670;344;358;36.0
4249;Dinsdag 10 januari 2006;540;264;276;409;202;207;99;97;1.0;1.0;52.0;49.0;2.0;1.0;131;5424;3248;2176;373;284;25.0
4250;Woensdag 11 januari 2006;535;260;275;410;187;223;80;78;0.0;2.0;36.0;35.0;1.0;0.0;164;4673;2717;1956;306;209;29.0
4251;Donderdag 12 januari 2006;487;246;241;400;180;220;86;83;2.0;1.0;35.0;35.0;0.0;0.0;129;5325;3331;1994;324;272;22.0
4252;Vrijdag 13 januari 2006;503;254;249;425;203;222;101;100;0.0;1.0;21.0;18.0;2.0;1.0;119;4985;3029;1956;249;227;34.0
4253;Zaterdag 14 januari 2006;437;205;232;403;171;232;48;48;0.0;0.0;0.0;0.0;0.0;0.0;1;1118;826;292;1;60;0.0
4254;Zondag 15 januari 2006;397;187;210;394;187;207;16;16;0.0;0.0;0.0;0.0;0.0;0.0;0;1750;1247;503;6;86;1.0
4255;Maandag 16 januari 2006;542;257;285;366;179;187;158;152;1.0;5.0;56.0;55.0;0.0;1.0;148;7553;4801;2752;355;311;57.0
4256;Dinsdag 17 januari 2006;526;255;271;420;214;206;101;98;2.0;1.0;39.0;33.0;2.0;4.0;141;4968;3078;1890;337;203;162.0
4257;Woensdag 18 januari 2006;549;276;273;407;211;196;105;105;0.0;0.0;41.0;41.0;0.0;0.0;104;4732;2928;1804;353;256;474.0
4258;Donderdag 19 januari 2006;509;261;248;422;199;223;107;107;0.0;0.0;41.0;41.0;0.0;0.0;149;5020;3057;1963;326;236;45.0
4259;Vrijdag 20 januari 2006;513;265;248;387;197;190;271;270;1.0;0.0;20.0;19.0;0.0;1.0;111;5188;3278;1910;245;275;29.0
4260;Zaterdag 21 januari 2006;465;220;245;413;206;207;56;55;1.0;0.0;0.0;0.0;0.0;0.0;3;1301;909;392;5;37;0.0
4261;Zondag 22 januari 2006;420;202;218;355;165;190;7;7;0.0;0.0;1.0;1.0;0.0;0.0;1;278;182;96;2;30;0.0
4262;Maandag 23 januari 2006;529;259;270;379;204;175;126;123;0.0;3.0;57.0;56.0;1.0;0.0;135;5555;3458;2097;401;269;422.0
4263;Dinsdag 24 januari 2006;540;265;275;395;204;191;110;108;1.0;1.0;40.0;38.0;1.0;1.0;157;4550;2698;1852;398;221;37.0
4264;Woensdag 25 januari 2006;555;304;251;399;193;206;95;94;1.0;0.0;46.0;44.0;1.0;1.0;110;4783;2889;1894;317;244;37.0
4265;Donderdag 26 januari 2006;569;282;287;405;195;210;101;100;1.0;0.0;36.0;35.0;0.0;1.0;160;5126;3129;1997;268;264;260.0
4266;Vrijdag 27 januari 2006;548;282;266;394;193;201;207;204;2.0;1.0;38.0;34.0;2.0;2.0;133;4933;3085;1848;258;285;24.0
4267;Zaterdag 28 januari 2006;461;245;216;384;189;195;41;41;0.0;0.0;1.0;1.0;0.0;0.0;0;1669;1219;450;5;53;1.0
4268;Zondag 29 januari 2006;419;214;205;391;172;219;6;6;0.0;0.0;0.0;0.0;0.0;0.0;1;241;139;102;3;35;1.0
4269;Maandag 30 januari 2006;544;303;241;410;197;213;146;142;1.0;3.0;58.0;53.0;2.0;3.0;125;5929;3642;2287;349;344;31.0
4270;Dinsdag 31 januari 2006;575;303;272;402;192;210;91;89;1.0;1.0;53.0;46.0;2.0;5.0;138;6124;3904;2220;375;405;33.0
4271;Totaal februari 2006;14286;7354;6932;11377;5382;5995;3170;3112;28.0;30.0;911.0;859.0;22.0;30.0;2550;131851;81948;49903;7450;6135;2855.0
4272;Woensdag 1 februari 2006;529;291;238;454;205;249;103;100;1.0;2.0;46.0;45.0;0.0;1.0;135;21351;13696;7655;425;632;633.0
4273;Donderdag 2 februari 2006;556;279;277;394;189;205;122;119;2.0;1.0;36.0;35.0;0.0;1.0;167;6273;3694;2579;388;250;52.0
4274;Vrijdag 3 februari 2006;493;262;231;385;193;192;151;150;0.0;1.0;23.0;23.0;0.0;0.0;109;5148;3032;2116;315;278;152.0
4275;Zaterdag 4 februari 2006;481;248;233;395;186;209;51;51;0.0;0.0;1.0;1.0;0.0;0.0;0;864;620;244;0;64;1.0
4276;Zondag 5 februari 2006;428;221;207;398;190;208;4;4;0.0;0.0;0.0;0.0;0.0;0.0;0;255;131;124;4;34;1.0
4277;Maandag 6 februari 2006;596;326;270;395;189;206;170;165;1.0;4.0;71.0;66.0;1.0;4.0;102;6476;3875;2601;421;285;37.0
4278;Dinsdag 7 februari 2006;570;302;268;418;207;211;93;92;0.0;1.0;54.0;52.0;2.0;0.0;143;5106;3038;2068;455;233;28.0
4279;Woensdag 8 februari 2006;530;271;259;424;201;223;79;78;1.0;0.0;31.0;29.0;2.0;0.0;120;4867;2947;1920;404;259;49.0
4280;Donderdag 9 februari 2006;528;262;266;437;200;237;94;93;1.0;0.0;28.0;28.0;0.0;0.0;118;5092;3117;1975;405;216;682.0
4281;Vrijdag 10 februari 2006;536;256;280;427;205;222;256;252;3.0;1.0;19.0;19.0;0.0;0.0;115;5209;3283;1926;274;253;16.0
4282;Zaterdag 11 februari 2006;449;230;219;364;167;197;54;53;0.0;1.0;0.0;0.0;0.0;0.0;0;978;707;271;4;31;2.0
4283;Zondag 12 februari 2006;405;226;179;354;161;193;8;8;0.0;0.0;0.0;0.0;0.0;0.0;1;270;187;83;1;35;0.0
4284;Maandag 13 februari 2006;535;293;242;413;205;208;121;118;3.0;0.0;56.0;50.0;1.0;5.0;111;5860;3585;2275;478;259;16.0
4285;Dinsdag 14 februari 2006;586;294;292;413;210;203;348;338;4.0;6.0;59.0;54.0;3.0;2.0;120;4779;2857;1922;378;227;484.0
4286;Woensdag 15 februari 2006;492;248;244;411;181;230;126;123;1.0;2.0;44.0;39.0;1.0;4.0;147;6713;4303;2410;299;312;32.0
4287;Donderdag 16 februari 2006;535;287;248;420;201;219;112;111;1.0;0.0;46.0;46.0;0.0;0.0;141;5405;3299;2106;353;236;47.0
4288;Vrijdag 17 februari 2006;574;302;272;408;195;213;203;200;2.0;1.0;29.0;26.0;2.0;1.0;113;4849;3050;1799;298;267;18.0
4289;Zaterdag 18 februari 2006;439;231;208;369;184;185;47;47;0.0;0.0;0.0;0.0;0.0;0.0;0;1537;1119;418;3;51;1.0
4290;Zondag 19 februari 2006;425;207;218;407;183;224;3;3;0.0;0.0;0.0;0.0;0.0;0.0;1;232;171;61;3;27;1.0
4291;Maandag 20 februari 2006;518;261;257;386;185;201;181;180;1.0;0.0;83.0;78.0;2.0;3.0;120;6675;4116;2559;388;353;312.0
4292;Dinsdag 21 februari 2006;572;290;282;428;183;245;119;115;1.0;3.0;55.0;48.0;3.0;4.0;131;4989;3043;1946;449;245;32.0
4293;Woensdag 22 februari 2006;544;270;274;423;191;232;121;119;1.0;1.0;36.0;34.0;2.0;0.0;148;4591;2746;1845;428;243;22.0
4294;Donderdag 23 februari 2006;534;264;270;397;184;213;108;106;1.0;1.0;40.0;40.0;0.0;0.0;171;5422;3284;2138;329;313;21.0
4295;Vrijdag 24 februari 2006;517;255;262;418;195;223;215;210;2.0;3.0;29.0;27.0;0.0;2.0;128;5412;3347;2065;282;265;155.0
4296;Zaterdag 25 februari 2006;433;219;214;396;190;206;34;34;0.0;0.0;1.0;1.0;0.0;0.0;1;1857;1333;524;4;52;3.0
4297;Zondag 26 februari 2006;437;218;219;408;199;209;7;7;0.0;0.0;0.0;0.0;0.0;0.0;0;330;242;88;0;45;0.0
4298;Maandag 27 februari 2006;499;247;252;412;192;220;132;130;0.0;2.0;69.0;66.0;2.0;1.0;82;5372;3339;2033;302;280;21.0
4299;Dinsdag 28 februari 2006;545;294;251;423;211;212;108;106;2.0;0.0;55.0;52.0;1.0;2.0;126;5939;3787;2152;360;390;37.0
4300;Totaal maart 2006;15646;7974;7672;12689;6065;6624;3889;3830;32.0;27.0;971.0;918.0;24.0;29.0;2900;148044;93559;54485;7757;7220;3112.0
4301;Woensdag 1 maart 2006;516;265;251;439;216;223;117;114;1.0;2.0;42.0;39.0;1.0;2.0;119;21740;14078;7662;390;704;495.0
4302;Donderdag 2 maart 2006;555;292;263;414;202;212;103;101;2.0;0.0;38.0;35.0;2.0;1.0;89;6344;3809;2535;366;274;110.0
4303;Vrijdag 3 maart 2006;542;273;269;405;172;233;364;356;6.0;2.0;24.0;21.0;1.0;2.0;114;6092;3759;2333;317;261;431.0
4304;Zaterdag 4 maart 2006;426;222;204;435;235;200;40;40;0.0;0.0;0.0;0.0;0.0;0.0;1;882;640;242;5;65;0.0
4305;Zondag 5 maart 2006;455;220;235;352;172;180;4;4;0.0;0.0;0.0;0.0;0.0;0.0;3;217;151;66;3;38;5.0
4306;Maandag 6 maart 2006;480;245;235;380;175;205;171;170;1.0;0.0;83.0;80.0;1.0;2.0;133;6842;4106;2736;417;274;54.0
4307;Dinsdag 7 maart 2006;515;252;263;413;220;193;93;90;2.0;1.0;30.0;29.0;0.0;1.0;129;5147;3199;1948;330;287;47.0
4308;Woensdag 8 maart 2006;540;289;251;418;214;204;96;93;1.0;2.0;34.0;33.0;0.0;1.0;129;5260;3191;2069;323;218;20.0
4309;Donderdag 9 maart 2006;518;251;267;445;218;227;115;114;0.0;1.0;38.0;35.0;1.0;2.0;128;5540;3279;2261;394;229;45.0
4310;Vrijdag 10 maart 2006;582;279;303;461;208;253;286;282;2.0;2.0;16.0;15.0;1.0;0.0;103;5102;3247;1855;259;212;23.0
4311;Zaterdag 11 maart 2006;412;215;197;406;197;209;49;47;1.0;1.0;1.0;1.0;0.0;0.0;1;1073;808;265;2;34;0.0
4312;Zondag 12 maart 2006;413;206;207;397;179;218;7;7;0.0;0.0;0.0;0.0;0.0;0.0;2;167;102;65;2;32;0.0
4313;Maandag 13 maart 2006;479;227;252;397;187;210;94;90;2.0;2.0;71.0;68.0;1.0;2.0;146;5948;3643;2305;390;274;290.0
4314;Dinsdag 14 maart 2006;526;247;279;400;179;221;103;103;0.0;0.0;46.0;43.0;1.0;2.0;153;4665;2938;1727;319;240;61.0
4315;Woensdag 15 maart 2006;513;246;267;397;191;206;85;84;1.0;0.0;44.0;41.0;1.0;2.0;138;7437;4909;2528;338;316;145.0
4316;Donderdag 16 maart 2006;532;271;261;378;193;185;99;99;0.0;0.0;30.0;30.0;0.0;0.0;153;5076;3174;1902;377;224;36.0
4317;Vrijdag 17 maart 2006;504;246;258;402;178;224;240;238;0.0;2.0;21.0;20.0;0.0;1.0;88;4676;2963;1713;291;256;20.0
4318;Zaterdag 18 maart 2006;433;217;216;375;185;190;61;60;0.0;1.0;1.0;1.0;0.0;0.0;0;1093;786;307;4;34;0.0
4319;Zondag 19 maart 2006;408;207;201;413;209;204;4;4;0.0;0.0;0.0;0.0;0.0;0.0;0;163;106;57;3;31;1.0
4320;Maandag 20 maart 2006;548;274;274;457;205;252;161;159;2.0;0.0;66.0;62.0;2.0;2.0;117;6133;3938;2195;379;371;23.0
4321;Dinsdag 21 maart 2006;566;289;277;420;209;211;165;158;4.0;3.0;60.0;56.0;1.0;3.0;138;4647;2938;1709;368;253;148.0
4322;Woensdag 22 maart 2006;559;292;267;413;214;199;102;99;2.0;1.0;33.0;33.0;0.0;0.0;149;4366;2590;1776;343;199;742.0
4323;Donderdag 23 maart 2006;543;283;260;410;207;203;117;117;0.0;0.0;35.0;33.0;0.0;2.0;113;4771;2994;1777;304;204;171.0
4324;Vrijdag 24 maart 2006;491;278;213;423;185;238;302;297;2.0;3.0;25.0;23.0;2.0;0.0;126;4653;3006;1647;205;231;32.0
4325;Zaterdag 25 maart 2006;424;213;211;421;225;196;62;60;2.0;0.0;0.0;0.0;0.0;0.0;0;1985;1450;535;3;71;0.0
4326;Zondag 26 maart 2006;427;240;187;376;167;209;4;4;0.0;0.0;0.0;0.0;0.0;0.0;0;233;154;79;2;59;1.0
4327;Maandag 27 maart 2006;533;272;261;442;173;269;146;145;0.0;1.0;66.0;59.0;6.0;1.0;123;5493;3502;1991;364;326;24.0
4328;Dinsdag 28 maart 2006;569;296;273;412;187;225;101;101;0.0;0.0;61.0;59.0;1.0;1.0;142;4323;2730;1593;313;288;54.0
4329;Woensdag 29 maart 2006;536;292;244;377;177;200;76;76;0.0;0.0;44.0;42.0;2.0;0.0;144;4416;2632;1784;344;318;46.0
4330;Donderdag 30 maart 2006;561;299;262;398;184;214;154;153;0.0;1.0;37.0;35.0;0.0;2.0;116;5709;3654;2055;347;344;31.0
4331;Vrijdag 31 maart 2006;540;276;264;413;202;211;368;365;1.0;2.0;25.0;25.0;0.0;0.0;103;7851;5083;2768;255;553;57.0
4332;Totaal april 2006;14543;7431;7112;11474;5593;5881;4850;4774;32.0;44.0;848.0;807.0;25.0;16.0;2456;121788;76937;44851;6466;6249;3333.0
4333;Zaterdag 1 april 2006;374;173;201;433;216;217;114;111;2.0;1.0;6.0;6.0;0.0;0.0;1;13687;9125;4562;39;539;2.0
4334;Zondag 2 april 2006;365;175;190;392;196;196;4;4;0.0;0.0;0.0;0.0;0.0;0.0;1;233;153;80;0;40;1.0
4335;Maandag 3 april 2006;512;268;244;386;184;202;142;138;1.0;3.0;73.0;67.0;4.0;2.0;134;8000;5019;2981;421;351;31.0
4336;Dinsdag 4 april 2006;567;287;280;362;182;180;131;129;2.0;0.0;64.0;59.0;1.0;4.0;127;5611;3346;2265;379;270;44.0
4337;Woensdag 5 april 2006;492;240;252;362;157;205;112;111;1.0;0.0;37.0;36.0;0.0;1.0;148;5324;3288;2036;364;187;885.0
4338;Donderdag 6 april 2006;522;285;237;374;191;183;175;172;2.0;1.0;36.0;34.0;2.0;0.0;133;5332;3255;2077;405;268;154.0
4339;Vrijdag 7 april 2006;510;262;248;423;208;215;414;409;2.0;3.0;15.0;13.0;1.0;1.0;114;4923;2964;1959;237;284;449.0
4340;Zaterdag 8 april 2006;412;215;197;365;169;196;93;91;1.0;1.0;0.0;0.0;0.0;0.0;2;1110;817;293;3;45;0.0
4341;Zondag 9 april 2006;400;204;196;374;176;198;3;3;0.0;0.0;0.0;0.0;0.0;0.0;0;200;135;65;4;48;0.0
4342;Maandag 10 april 2006;486;248;238;354;187;167;169;168;1.0;0.0;74.0;72.0;2.0;0.0;123;6200;3898;2302;389;312;262.0
4343;Dinsdag 11 april 2006;520;267;253;414;199;215;112;111;0.0;1.0;59.0;58.0;0.0;1.0;108;4466;2716;1750;372;233;32.0
4344;Woensdag 12 april 2006;528;267;261;391;182;209;118;118;0.0;0.0;41.0;40.0;1.0;0.0;136;4653;2865;1788;397;237;197.0
4345;Donderdag 13 april 2006;537;258;279;412;217;195;154;151;2.0;1.0;35.0;33.0;1.0;1.0;152;5562;3399;2163;376;320;42.0
4346;Vrijdag 14 april 2006;547;303;244;405;208;197;111;106;1.0;4.0;4.0;4.0;0.0;0.0;14;2159;1525;634;32;72;5.0
4347;Zaterdag 15 april 2006;441;217;224;394;185;209;61;60;0.0;1.0;0.0;0.0;0.0;0.0;0;2370;1607;763;6;73;0.0
4348;Zondag 16 april 2006;449;231;218;373;183;190;6;6;0.0;0.0;0.0;0.0;0.0;0.0;0;335;255;80;4;26;1.0
4349;Maandag 17 april 2006;398;192;206;396;190;206;13;13;0.0;0.0;0.0;0.0;0.0;0.0;3;464;335;129;1;32;1.0
4350;Dinsdag 18 april 2006;533;271;262;386;195;191;159;159;0.0;0.0;52.0;48.0;2.0;2.0;146;6320;4011;2309;405;309;34.0
4351;Woensdag 19 april 2006;517;268;249;389;201;188;130;126;2.0;2.0;42.0;40.0;2.0;0.0;158;5056;3037;2019;330;247;46.0
4352;Donderdag 20 april 2006;519;265;254;404;198;206;223;220;0.0;3.0;41.0;39.0;1.0;1.0;160;5642;3600;2042;367;236;67.0
4353;Vrijdag 21 april 2006;537;287;250;408;189;219;726;717;3.0;6.0;24.0;23.0;1.0;0.0;127;5019;3238;1781;294;324;273.0
4354;Zaterdag 22 april 2006;464;222;242;356;184;172;148;145;3.0;0.0;0.0;0.0;0.0;0.0;1;1497;1057;440;4;36;0.0
4355;Zondag 23 april 2006;443;245;198;345;161;184;5;5;0.0;0.0;0.0;0.0;0.0;0.0;0;266;172;94;2;36;0.0
4356;Maandag 24 april 2006;508;236;272;381;187;194;199;194;2.0;3.0;84.0;81.0;3.0;0.0;160;5628;3506;2122;366;267;48.0
4357;Dinsdag 25 april 2006;515;274;241;362;169;193;147;142;2.0;3.0;57.0;52.0;2.0;3.0;143;4498;2795;1703;287;261;505.0
4358;Woensdag 26 april 2006;574;299;275;353;164;189;172;167;0.0;5.0;43.0;42.0;1.0;0.0;132;4408;2609;1799;372;346;24.0
4359;Donderdag 27 april 2006;536;263;273;385;181;204;227;224;1.0;2.0;43.0;42.0;1.0;0.0;134;5292;3266;2026;337;297;22.0
4360;Vrijdag 28 april 2006;503;258;245;392;187;205;705;698;3.0;4.0;17.0;17.0;0.0;0.0;98;5898;3776;2122;267;330;208.0
4361;Zaterdag 29 april 2006;399;213;186;368;184;184;61;60;1.0;0.0;0.0;0.0;0.0;0.0;1;787;544;243;5;61;0.0
4362;Zondag 30 april 2006;435;238;197;335;163;172;16;16;0.0;0.0;1.0;1.0;0.0;0.0;0;848;624;224;1;162;0.0
4363;Totaal mei 2006;15673;8043;7630;10992;5285;5707;8037;7917;55.0;65.0;969.0;906.0;25.0;38.0;2912;132290;83716;48574;7221;6432;2271.0
4364;Maandag 1 mei 2006;513;258;255;371;171;200;193;189;3.0;1.0;63.0;59.0;0.0;4.0;131;20140;13067;7073;371;805;41.0
4365;Dinsdag 2 mei 2006;561;312;249;369;173;196;166;162;2.0;2.0;47.0;43.0;3.0;1.0;168;6208;3722;2486;411;325;54.0
4366;Woensdag 3 mei 2006;518;254;264;386;199;187;173;171;1.0;1.0;44.0;40.0;3.0;1.0;147;5432;3184;2248;371;216;34.0
4367;Donderdag 4 mei 2006;563;291;272;377;174;203;132;128;3.0;1.0;31.0;29.0;1.0;1.0;138;4890;2925;1965;314;243;23.0
4368;Vrijdag 5 mei 2006;493;260;233;393;190;203;132;130;1.0;1.0;0.0;0.0;0.0;0.0;9;1014;698;316;7;78;1.0
4369;Zaterdag 6 mei 2006;480;246;234;349;178;171;210;207;1.0;2.0;1.0;1.0;0.0;0.0;0;841;611;230;3;35;0.0
4370;Zondag 7 mei 2006;409;205;204;314;145;169;6;6;0.0;0.0;0.0;0.0;0.0;0.0;0;217;147;70;1;31;0.0
4371;Maandag 8 mei 2006;553;292;261;384;191;193;211;210;1.0;0.0;65.0;61.0;2.0;2.0;148;7505;4699;2806;441;283;642.0
4372;Dinsdag 9 mei 2006;571;290;281;364;181;183;135;130;3.0;2.0;51.0;50.0;1.0;0.0;143;4904;3044;1860;360;289;46.0
4373;Woensdag 10 mei 2006;569;280;289;401;190;211;168;164;3.0;1.0;33.0;32.0;0.0;1.0;148;5104;3160;1944;392;172;43.0
4374;Donderdag 11 mei 2006;551;277;274;366;177;189;250;246;1.0;3.0;43.0;38.0;2.0;3.0;149;4876;2968;1908;373;208;25.0
4375;Vrijdag 12 mei 2006;516;274;242;384;171;213;1000;992;4.0;4.0;29.0;26.0;1.0;2.0;129;4683;2935;1748;248;249;37.0
4376;Zaterdag 13 mei 2006;416;200;216;367;182;185;126;126;0.0;0.0;1.0;0.0;1.0;0.0;0;869;635;234;2;32;2.0
4377;Zondag 14 mei 2006;416;214;202;325;142;183;5;5;0.0;0.0;0.0;0.0;0.0;0.0;0;269;186;83;1;37;0.0
4378;Maandag 15 mei 2006;537;289;248;330;162;168;206;202;3.0;1.0;68.0;67.0;0.0;1.0;120;8171;5436;2735;455;362;47.0
4379;Dinsdag 16 mei 2006;536;269;267;361;184;177;175;171;3.0;1.0;42.0;40.0;1.0;1.0;159;4508;2839;1669;367;213;28.0
4380;Woensdag 17 mei 2006;516;267;249;362;178;184;173;170;1.0;2.0;38.0;35.0;0.0;3.0;126;4451;2674;1777;346;164;56.0
4381;Donderdag 18 mei 2006;477;229;248;358;160;198;342;338;1.0;3.0;42.0;40.0;0.0;2.0;156;4983;3062;1921;298;316;426.0
4382;Vrijdag 19 mei 2006;532;269;263;371;183;188;1070;1054;5.0;11.0;33.0;28.0;2.0;3.0;143;4152;2639;1513;237;192;416.0
4383;Zaterdag 20 mei 2006;402;204;198;334;160;174;272;266;1.0;5.0;1.0;1.0;0.0;0.0;0;1422;1061;361;4;55;0.0
4384;Zondag 21 mei 2006;420;221;199;334;151;183;9;9;0.0;0.0;0.0;0.0;0.0;0.0;0;201;144;57;5;31;1.0
4385;Maandag 22 mei 2006;552;299;253;354;164;190;218;214;2.0;2.0;70.0;65.0;2.0;3.0;132;5536;3546;1990;349;272;46.0
4386;Dinsdag 23 mei 2006;577;278;299;285;138;147;199;195;2.0;2.0;53.0;51.0;0.0;2.0;151;4615;2832;1783;380;197;49.0
4387;Woensdag 24 mei 2006;558;290;268;380;194;186;841;830;3.0;8.0;45.0;40.0;3.0;2.0;154;5243;3280;1963;271;287;27.0
4388;Donderdag 25 mei 2006;470;260;210;332;165;167;36;36;0.0;0.0;0.0;0.0;0.0;0.0;3;781;565;216;2;60;0.0
4389;Vrijdag 26 mei 2006;478;246;232;350;168;182;774;762;5.0;7.0;6.0;6.0;0.0;0.0;15;1549;1025;524;60;74;2.0
4390;Zaterdag 27 mei 2006;442;238;204;333;148;185;217;212;5.0;0.0;2.0;2.0;0.0;0.0;1;1063;740;323;0;45;0.0
4391;Zondag 28 mei 2006;450;219;231;315;153;162;9;9;0.0;0.0;0.0;0.0;0.0;0.0;2;378;233;145;5;18;1.0
4392;Maandag 29 mei 2006;511;255;256;348;172;176;235;234;0.0;1.0;68.0;63.0;1.0;4.0;127;6795;4289;2506;410;433;161.0
4393;Dinsdag 30 mei 2006;561;284;277;335;166;169;165;163;1.0;1.0;50.0;47.0;2.0;1.0;141;5308;3431;1877;397;349;31.0
4394;Woensdag 31 mei 2006;525;273;252;360;175;185;189;186;0.0;3.0;43.0;42.0;0.0;1.0;172;6182;3939;2243;340;361;32.0
4395;Totaal juni 2006;15171;7851;7320;10764;5243;5521;12370;12139;110.0;121.0;879.0;831.0;23.0;25.0;2883;136823;86733;50090;7338;7390;2179.0
4396;Donderdag 1 juni 2006;569;303;266;338;171;167;388;376;8.0;4.0;40.0;40.0;0.0;0.0;139;21099;13880;7219;410;649;40.0
4397;Vrijdag 2 juni 2006;489;256;233;331;149;182;1404;1382;12.0;10.0;25.0;23.0;1.0;1.0;97;5957;3601;2356;296;282;572.0
4398;Zaterdag 3 juni 2006;449;238;211;375;174;201;228;226;2.0;0.0;0.0;0.0;0.0;0.0;0;713;506;207;1;50;0.0
4399;Zondag 4 juni 2006;428;227;201;317;155;162;9;9;0.0;0.0;0.0;0.0;0.0;0.0;0;145;96;49;1;34;2.0
4400;Maandag 5 juni 2006;420;208;212;309;157;152;12;12;0.0;0.0;0.0;0.0;0.0;0.0;1;434;301;133;2;63;1.0
4401;Dinsdag 6 juni 2006;543;273;270;387;204;183;1274;1233;16.0;25.0;53.0;51.0;1.0;1.0;145;6341;3828;2513;428;226;160.0
4402;Woensdag 7 juni 2006;606;290;316;345;177;168;208;204;1.0;3.0;46.0;41.0;2.0;3.0;146;5600;3374;2226;433;249;52.0
4403;Donderdag 8 juni 2006;548;274;274;383;198;185;280;278;2.0;0.0;36.0;32.0;1.0;3.0;160;5580;3402;2178;347;180;289.0
4404;Vrijdag 9 juni 2006;551;290;261;386;201;185;1075;1052;11.0;12.0;23.0;20.0;1.0;2.0;141;4738;3032;1706;259;212;32.0
4405;Zaterdag 10 juni 2006;410;209;201;363;172;191;263;259;2.0;2.0;0.0;0.0;0.0;0.0;2;1356;994;362;2;56;5.0
4406;Zondag 11 juni 2006;437;250;187;338;159;179;9;9;0.0;0.0;0.0;0.0;0.0;0.0;0;243;171;72;1;39;1.0
4407;Maandag 12 juni 2006;598;323;275;389;205;184;275;266;4.0;5.0;52.0;49.0;2.0;1.0;149;5597;3488;2109;375;283;34.0
4408;Dinsdag 13 juni 2006;551;274;277;440;206;234;117;114;2.0;1.0;59.0;54.0;2.0;3.0;169;4030;2518;1512;364;236;41.0
4409;Woensdag 14 juni 2006;524;279;245;422;197;225;201;198;2.0;1.0;40.0;39.0;1.0;0.0;167;4612;2882;1730;295;238;47.0
4410;Donderdag 15 juni 2006;517;247;270;366;154;212;303;298;1.0;4.0;47.0;45.0;2.0;0.0;141;7013;4589;2424;365;332;170.0
4411;Vrijdag 16 juni 2006;492;255;237;346;178;168;1219;1203;4.0;12.0;16.0;14.0;1.0;1.0;116;5022;3276;1746;267;281;124.0
4412;Zaterdag 17 juni 2006;453;249;204;350;172;178;210;210;0.0;0.0;2.0;2.0;0.0;0.0;0;1084;791;293;3;52;1.0
4413;Zondag 18 juni 2006;422;221;201;369;185;184;6;6;0.0;0.0;0.0;0.0;0.0;0.0;0;214;139;75;6;29;1.0
4414;Maandag 19 juni 2006;539;263;276;400;195;205;188;185;2.0;1.0;86.0;83.0;2.0;1.0;136;5701;3625;2076;355;298;43.0
4415;Dinsdag 20 juni 2006;517;285;232;368;187;181;793;771;14.0;8.0;48.0;45.0;0.0;3.0;168;4848;3059;1789;337;291;39.0
4416;Woensdag 21 juni 2006;526;275;251;395;193;202;277;268;4.0;5.0;44.0;41.0;2.0;1.0;102;4547;2670;1877;318;266;43.0
4417;Donderdag 22 juni 2006;521;287;234;344;167;177;277;270;5.0;2.0;37.0;35.0;2.0;0.0;142;4749;2929;1820;356;268;45.0
4418;Vrijdag 23 juni 2006;489;259;230;357;177;180;1094;1078;6.0;10.0;26.0;22.0;1.0;3.0;130;4658;2982;1676;256;272;276.0
4419;Zaterdag 24 juni 2006;421;203;218;310;136;174;225;222;0.0;3.0;0.0;0.0;0.0;0.0;0;1809;1288;521;3;55;0.0
4420;Zondag 25 juni 2006;423;225;198;352;169;183;10;10;0.0;0.0;0.0;0.0;0.0;0.0;1;416;276;140;9;49;0.0
4421;Maandag 26 juni 2006;517;260;257;315;142;173;278;271;3.0;4.0;60.0;59.0;0.0;1.0;153;5849;3604;2245;457;473;32.0
4422;Dinsdag 27 juni 2006;523;268;255;331;157;174;167;162;4.0;1.0;46.0;46.0;0.0;0.0;114;4769;3029;1740;355;345;49.0
4423;Woensdag 28 juni 2006;565;301;264;349;160;189;162;160;0.0;2.0;45.0;44.0;0.0;1.0;128;5217;3283;1934;398;396;25.0
4424;Donderdag 29 juni 2006;526;260;266;311;144;167;310;308;2.0;0.0;29.0;29.0;0.0;0.0;132;5627;3488;2139;325;443;40.0
4425;Vrijdag 30 juni 2006;597;299;298;378;202;176;1108;1099;3.0;6.0;19.0;17.0;2.0;0.0;104;8855;5632;3223;314;743;15.0
4426;Totaal juli 2006;15999;8309;7690;12164;5656;6508;6712;6600;54.0;58.0;854.0;796.0;26.0;32.0;2464;144085;85794;58291;8614;9435;1801.0
4427;Zaterdag 1 juli 2006;458;248;210;349;172;177;262;257;4.0;1.0;0.0;0.0;0.0;0.0;0;15003;9390;5613;52;639;1.0
4428;Zondag 2 juli 2006;409;200;209;357;158;199;7;7;0.0;0.0;1.0;1.0;0.0;0.0;1;210;117;93;5;93;0.0
4429;Maandag 3 juli 2006;544;269;275;333;164;169;198;195;1.0;2.0;76.0;72.0;1.0;3.0;147;8485;4996;3489;643;518;35.0
4430;Dinsdag 4 juli 2006;536;283;253;432;197;235;159;153;1.0;5.0;54.0;52.0;1.0;1.0;139;5908;3353;2555;414;320;178.0
4431;Woensdag 5 juli 2006;627;328;299;402;184;218;158;156;1.0;1.0;36.0;29.0;1.0;6.0;131;5679;3304;2375;389;389;755.0
4432;Donderdag 6 juli 2006;622;327;295;384;185;199;299;293;2.0;4.0;30.0;29.0;0.0;1.0;134;5991;3514;2477;437;388;36.0
4433;Vrijdag 7 juli 2006;536;283;253;385;183;202;1098;1079;9.0;10.0;16.0;13.0;2.0;1.0;102;5787;3346;2441;304;400;19.0
4434;Zaterdag 8 juli 2006;438;220;218;414;191;223;245;238;6.0;1.0;1.0;1.0;0.0;0.0;0;1132;714;418;2;101;2.0
4435;Zondag 9 juli 2006;422;236;186;372;173;199;2;2;0.0;0.0;0.0;0.0;0.0;0.0;1;254;169;85;2;39;0.0
4436;Maandag 10 juli 2006;520;257;263;371;188;183;206;201;1.0;4.0;55.0;54.0;1.0;0.0;125;7116;4330;2786;504;442;23.0
4437;Dinsdag 11 juli 2006;537;266;271;386;176;210;148;145;0.0;3.0;45.0;43.0;0.0;2.0;129;5337;3107;2230;400;337;33.0
4438;Woensdag 12 juli 2006;557;298;259;363;182;181;177;172;3.0;2.0;32.0;31.0;1.0;0.0;86;5034;2993;2041;396;303;41.0
4439;Donderdag 13 juli 2006;552;296;256;369;165;204;158;158;0.0;0.0;32.0;30.0;2.0;0.0;149;5409;3192;2217;357;269;259.0
4440;Vrijdag 14 juli 2006;541;274;267;351;182;169;735;726;5.0;4.0;17.0;16.0;0.0;1.0;101;6242;3775;2467;386;369;17.0
4441;Zaterdag 15 juli 2006;450;240;210;351;168;183;152;149;1.0;2.0;0.0;0.0;0.0;0.0;0;3033;2010;1023;13;196;1.0
4442;Zondag 16 juli 2006;462;256;206;317;158;159;8;8;0.0;0.0;0.0;0.0;0.0;0.0;0;348;224;124;3;59;0.0
4443;Maandag 17 juli 2006;554;280;274;325;165;160;202;200;0.0;2.0;69.0;66.0;1.0;2.0;133;6957;4092;2865;466;398;23.0
4444;Dinsdag 18 juli 2006;564;288;276;369;169;200;145;144;1.0;0.0;55.0;52.0;2.0;1.0;129;5114;3023;2091;380;265;179.0
4445;Woensdag 19 juli 2006;528;264;264;403;188;215;139;137;0.0;2.0;27.0;24.0;2.0;1.0;100;4373;2524;1849;387;267;23.0
4446;Donderdag 20 juli 2006;531;271;260;407;187;220;201;195;3.0;3.0;36.0;36.0;0.0;0.0;93;5469;3263;2206;351;301;33.0
4447;Vrijdag 21 juli 2006;547;291;256;444;191;253;497;490;5.0;2.0;21.0;21.0;0.0;0.0;107;4682;2816;1866;267;341;17.0
4448;Zaterdag 22 juli 2006;522;279;243;435;190;245;115;114;0.0;1.0;0.0;0.0;0.0;0.0;0;1291;869;422;8;104;1.0
4449;Zondag 23 juli 2006;453;240;213;446;194;252;11;11;0.0;0.0;0.0;0.0;0.0;0.0;0;256;171;85;4;59;0.0
4450;Maandag 24 juli 2006;540;287;253;419;194;225;212;207;3.0;2.0;63.0;56.0;4.0;3.0;96;6280;3816;2464;372;465;22.0
4451;Dinsdag 25 juli 2006;554;271;283;419;187;232;158;155;2.0;1.0;48.0;42.0;2.0;4.0;92;4790;2743;2047;401;301;23.0
4452;Woensdag 26 juli 2006;567;321;246;463;212;251;152;150;0.0;2.0;28.0;25.0;1.0;2.0;122;4698;2674;2024;329;392;21.0
4453;Donderdag 27 juli 2006;531;266;265;447;215;232;158;157;1.0;0.0;25.0;24.0;0.0;1.0;125;5158;3019;2139;392;395;23.0
4454;Vrijdag 28 juli 2006;531;277;254;458;191;267;399;394;3.0;2.0;23.0;21.0;2.0;0.0;97;5370;3116;2254;298;386;13.0
4455;Zaterdag 29 juli 2006;435;222;213;435;191;244;108;106;1.0;1.0;0.0;0.0;0.0;0.0;0;960;596;364;5;77;1.0
4456;Zondag 30 juli 2006;417;209;208;405;176;229;12;12;0.0;0.0;0.0;0.0;0.0;0.0;0;370;226;144;3;95;0.0
4457;Maandag 31 juli 2006;514;262;252;353;180;173;191;189;1.0;1.0;64.0;58.0;3.0;3.0;125;7349;4312;3037;644;727;22.0
4458;Totaal augustus 2006;16262;8354;7908;10409;5089;5320;7297;7178;56.0;63.0;890.0;838.0;27.0;25.0;2655;155356;86112;69244;11694;10346;2855.0
4459;Dinsdag 1 augustus 2006;571;291;280;349;167;182;185;182;2.0;1.0;50.0;49.0;1.0;0.0;122;23392;13361;10031;754;1196;40.0
4460;Woensdag 2 augustus 2006;541;269;272;355;164;191;141;139;1.0;1.0;29.0;28.0;1.0;0.0;103;6161;3407;2754;472;347;18.0
4461;Donderdag 3 augustus 2006;590;302;288;334;150;184;163;161;2.0;0.0;33.0;31.0;1.0;1.0;113;6209;3462;2747;431;327;31.0
4462;Vrijdag 4 augustus 2006;529;277;252;348;169;179;390;384;2.0;4.0;16.0;15.0;1.0;0.0;101;5417;3057;2360;353;355;20.0
4463;Zaterdag 5 augustus 2006;467;256;211;323;148;175;121;119;2.0;0.0;1.0;1.0;0.0;0.0;0;900;550;350;5;79;1010.0
4464;Zondag 6 augustus 2006;435;199;236;290;138;152;14;14;0.0;0.0;0.0;0.0;0.0;0.0;0;233;133;100;3;57;0.0
4465;Maandag 7 augustus 2006;522;260;262;368;168;200;223;222;0.0;1.0;69.0;65.0;2.0;2.0;110;6646;3777;2869;516;385;14.0
4466;Dinsdag 8 augustus 2006;581;296;285;327;163;164;206;204;1.0;1.0;37.0;33.0;1.0;3.0;112;5374;2956;2418;457;277;334.0
4467;Woensdag 9 augustus 2006;566;309;257;336;168;168;138;136;2.0;0.0;36.0;35.0;1.0;0.0;101;4960;2640;2320;396;335;43.0
4468;Donderdag 10 augustus 2006;546;287;259;345;171;174;201;199;0.0;2.0;37.0;35.0;2.0;0.0;118;5600;3173;2427;488;374;16.0
4469;Vrijdag 11 augustus 2006;527;274;253;343;160;183;427;420;2.0;5.0;8.0;8.0;0.0;0.0;101;4829;2699;2130;331;317;30.0
4470;Zaterdag 12 augustus 2006;454;229;225;305;153;152;139;136;3.0;0.0;0.0;0.0;0.0;0.0;0;954;599;355;5;54;0.0
4471;Zondag 13 augustus 2006;439;229;210;308;155;153;5;5;0.0;0.0;0.0;0.0;0.0;0.0;1;218;108;110;8;38;0.0
4472;Maandag 14 augustus 2006;504;269;235;344;173;171;212;207;3.0;2.0;66.0;63.0;3.0;0.0;110;6449;3678;2771;511;438;18.0
4473;Dinsdag 15 augustus 2006;608;323;285;342;163;179;177;176;1.0;0.0;40.0;40.0;0.0;0.0;133;8016;4508;3508;513;426;24.0
4474;Woensdag 16 augustus 2006;552;280;272;324;142;182;180;175;1.0;4.0;34.0;31.0;1.0;2.0;116;5458;2904;2554;438;282;462.0
4475;Donderdag 17 augustus 2006;553;282;271;311;163;148;201;190;3.0;8.0;29.0;26.0;1.0;2.0;123;5565;2957;2608;503;343;44.0
4476;Vrijdag 18 augustus 2006;552;283;269;366;196;170;756;748;4.0;4.0;25.0;23.0;0.0;2.0;108;5295;2927;2368;359;307;19.0
4477;Zaterdag 19 augustus 2006;432;234;198;316;147;169;184;183;0.0;1.0;0.0;0.0;0.0;0.0;0;906;542;364;11;91;1.0
4478;Zondag 20 augustus 2006;425;228;197;339;147;192;13;13;0.0;0.0;0.0;0.0;0.0;0.0;0;672;351;321;2;103;0.0
4479;Maandag 21 augustus 2006;526;294;232;331;177;154;207;204;2.0;1.0;70.0;65.0;0.0;5.0;73;6417;3466;2951;581;409;312.0
4480;Dinsdag 22 augustus 2006;569;285;284;349;175;174;182;180;1.0;1.0;43.0;40.0;1.0;2.0;144;5209;2765;2444;563;342;25.0
4481;Woensdag 23 augustus 2006;575;307;268;354;179;175;179;176;0.0;3.0;30.0;26.0;2.0;2.0;120;5073;2830;2243;557;355;33.0
4482;Donderdag 24 augustus 2006;583;295;288;373;193;180;311;306;2.0;3.0;35.0;34.0;1.0;0.0;133;5013;2720;2293;511;319;23.0
4483;Vrijdag 25 augustus 2006;578;311;267;342;178;164;1089;1073;8.0;8.0;25.0;25.0;0.0;0.0;105;5312;3024;2288;439;427;7.0
4484;Zaterdag 26 augustus 2006;423;211;212;327;155;172;284;281;2.0;1.0;0.0;0.0;0.0;0.0;0;1339;862;477;6;73;0.0
4485;Zondag 27 augustus 2006;445;234;211;320;168;152;9;9;0.0;0.0;0.0;0.0;0.0;0.0;0;314;143;171;11;82;0.0
4486;Maandag 28 augustus 2006;524;255;269;322;159;163;237;229;4.0;4.0;67.0;63.0;3.0;1.0;116;6310;3248;3062;591;536;19.0
4487;Dinsdag 29 augustus 2006;562;265;297;350;174;176;155;154;1.0;0.0;47.0;46.0;0.0;1.0;112;4744;2362;2382;526;468;245.0
4488;Woensdag 30 augustus 2006;545;254;291;365;177;188;204;197;4.0;3.0;26.0;23.0;2.0;1.0;139;5319;2829;2490;675;511;35.0
4489;Donderdag 31 augustus 2006;538;266;272;303;149;154;364;356;3.0;5.0;37.0;33.0;3.0;1.0;141;7052;4074;2978;678;693;32.0
4490;Totaal september 2006;16123;8261;7862;10398;4995;5403;10613;10444;78.0;91.0;808.0;756.0;24.0;28.0;2447;145048;83179;61869;13733;8795;1304.0
4491;Vrijdag 1 september 2006;558;271;287;353;169;184;1517;1495;11.0;11.0;18.0;15.0;1.0;2.0;80;24400;13613;10787;612;1359;16.0
4492;Zaterdag 2 september 2006;505;237;268;351;166;185;356;352;3.0;1.0;2.0;2.0;0.0;0.0;0;795;491;304;12;106;2.0
4493;Zondag 3 september 2006;437;234;203;331;160;171;11;11;0.0;0.0;0.0;0.0;0.0;0.0;0;367;135;232;4;69;0.0
4494;Maandag 4 september 2006;495;268;227;319;150;169;234;225;6.0;3.0;68.0;64.0;2.0;2.0;91;7800;4203;3597;707;390;25.0
4495;Dinsdag 5 september 2006;535;280;255;351;156;195;176;173;2.0;1.0;44.0;41.0;2.0;1.0;128;6166;3307;2859;815;507;392.0
4496;Woensdag 6 september 2006;567;292;275;354;178;176;300;291;4.0;5.0;25.0;23.0;2.0;0.0;133;5724;2963;2761;650;274;148.0
4497;Donderdag 7 september 2006;550;270;280;371;185;186;379;374;4.0;1.0;39.0;36.0;0.0;3.0;121;6075;3363;2712;784;284;23.0
4498;Vrijdag 8 september 2006;520;235;285;334;147;187;1243;1230;5.0;8.0;21.0;20.0;1.0;0.0;84;5201;2936;2265;560;292;10.0
4499;Zaterdag 9 september 2006;491;269;222;340;153;187;354;350;2.0;2.0;0.0;0.0;0.0;0.0;0;853;585;268;13;56;1.0
4500;Zondag 10 september 2006;455;256;199;310;167;143;10;9;1.0;0.0;0.0;0.0;0.0;0.0;1;453;284;169;11;61;0.0
4501;Maandag 11 september 2006;549;276;273;353;175;178;192;189;1.0;2.0;58.0;56.0;1.0;1.0;99;5900;3309;2591;813;386;135.0
4502;Dinsdag 12 september 2006;585;316;269;384;176;208;172;168;3.0;1.0;48.0;44.0;2.0;2.0;113;4911;2705;2206;769;283;35.0
4503;Woensdag 13 september 2006;558;302;256;393;176;217;145;143;0.0;2.0;32.0;30.0;1.0;1.0;135;4685;2515;2170;615;273;31.0
4504;Donderdag 14 september 2006;585;305;280;389;195;194;342;337;3.0;2.0;31.0;28.0;1.0;2.0;98;5229;2883;2346;670;299;17.0
4505;Vrijdag 15 september 2006;586;290;296;360;177;183;1170;1153;7.0;10.0;17.0;16.0;1.0;0.0;86;7527;4644;2883;408;362;29.0
4506;Zaterdag 16 september 2006;430;223;207;395;194;201;231;230;0.0;1.0;1.0;1.0;0.0;0.0;1;998;675;323;5;67;0.0
4507;Zondag 17 september 2006;465;244;221;359;165;194;14;13;1.0;0.0;0.0;0.0;0.0;0.0;0;234;134;100;1;47;0.0
4508;Maandag 18 september 2006;547;264;283;375;194;181;227;220;2.0;5.0;59.0;55.0;4.0;0.0;119;6212;3543;2669;735;380;41.0
4509;Dinsdag 19 september 2006;563;285;278;344;156;188;167;159;4.0;4.0;48.0;47.0;0.0;1.0;107;4949;2940;2009;675;326;43.0
4510;Woensdag 20 september 2006;573;268;305;340;157;183;184;179;2.0;3.0;32.0;29.0;1.0;2.0;155;5035;2872;2163;665;300;30.0
4511;Donderdag 21 september 2006;570;316;254;308;152;156;331;327;2.0;2.0;33.0;32.0;0.0;1.0;134;5246;3039;2207;654;312;40.0
4512;Vrijdag 22 september 2006;589;311;278;346;163;183;954;941;4.0;9.0;16.0;15.0;0.0;1.0;127;4871;2938;1933;399;300;38.0
4513;Zaterdag 23 september 2006;487;237;250;339;170;169;192;189;2.0;1.0;1.0;1.0;0.0;0.0;0;1593;1147;446;12;60;3.0
4514;Zondag 24 september 2006;454;236;218;330;157;173;3;3;0.0;0.0;0.0;0.0;0.0;0.0;0;259;175;84;2;32;1.0
4515;Maandag 25 september 2006;558;279;279;342;167;175;193;191;1.0;1.0;74.0;67.0;2.0;5.0;109;6112;3685;2427;597;382;32.0
4516;Dinsdag 26 september 2006;586;293;293;347;172;175;140;138;0.0;2.0;45.0;42.0;2.0;1.0;119;4766;2734;2032;681;322;43.0
4517;Woensdag 27 september 2006;628;327;301;299;138;161;162;158;1.0;3.0;38.0;36.0;1.0;1.0;135;4693;2771;1922;586;274;48.0
4518;Donderdag 28 september 2006;626;325;301;311;152;159;246;243;2.0;1.0;36.0;35.0;0.0;1.0;129;5560;3217;2343;504;362;65.0
4519;Vrijdag 29 september 2006;608;313;295;352;186;166;783;771;5.0;7.0;22.0;21.0;0.0;1.0;143;6575;4021;2554;763;435;56.0
4520;Zaterdag 30 september 2006;463;239;224;318;142;176;185;182;0.0;3.0;0.0;0.0;0.0;0.0;0;1859;1352;507;11;195;0.0
4521;Totaal oktober 2006;16144;8301;7843;10349;5045;5304;5184;5090;47.0;47.0;970.0;914.0;30.0;26.0;2592;141470;85790;55680;9631;7629;3019.0
4522;Zondag 1 oktober 2006;426;232;194;323;151;172;7;7;0.0;0.0;0.0;0.0;0.0;0.0;0;11037;7084;3953;63;539;0.0
4523;Maandag 2 oktober 2006;545;283;262;312;171;141;166;164;1.0;1.0;75.0;70.0;3.0;2.0;95;8894;5338;3556;568;526;767.0
4524;Dinsdag 3 oktober 2006;569;294;275;349;173;176;116;112;2.0;2.0;56.0;52.0;2.0;2.0;116;5819;3421;2398;482;331;106.0
4525;Woensdag 4 oktober 2006;552;264;288;320;158;162;113;110;0.0;3.0;32.0;31.0;0.0;1.0;118;5708;3272;2436;438;290;18.0
4526;Donderdag 5 oktober 2006;602;311;291;324;146;178;170;167;1.0;2.0;35.0;34.0;0.0;1.0;180;6217;3676;2541;469;370;20.0
4527;Vrijdag 6 oktober 2006;574;306;268;358;174;184;683;671;4.0;8.0;21.0;19.0;2.0;0.0;84;5107;3026;2081;345;284;8.0
4528;Zaterdag 7 oktober 2006;507;244;263;304;146;158;148;146;2.0;0.0;0.0;0.0;0.0;0.0;1;991;698;293;0;56;1.0
4529;Zondag 8 oktober 2006;464;239;225;311;139;172;8;8;0.0;0.0;0.0;0.0;0.0;0.0;0;281;181;100;2;48;0.0
4530;Maandag 9 oktober 2006;505;249;256;312;156;156;146;144;2.0;0.0;73.0;69.0;3.0;1.0;91;6033;3593;2440;701;325;26.0
4531;Dinsdag 10 oktober 2006;542;281;261;327;167;160;180;177;1.0;2.0;54.0;53.0;1.0;0.0;125;5370;3185;2185;402;228;400.0
4532;Woensdag 11 oktober 2006;551;263;288;358;185;173;93;90;0.0;3.0;37.0;35.0;1.0;1.0;115;4868;2887;1981;409;227;25.0
4533;Donderdag 12 oktober 2006;552;272;280;351;169;182;195;190;3.0;2.0;38.0;35.0;2.0;1.0;130;5096;2863;2233;450;274;35.0
4534;Vrijdag 13 oktober 2006;533;256;277;334;160;174;359;355;2.0;2.0;18.0;17.0;0.0;1.0;93;4702;2864;1838;358;283;50.0
4535;Zaterdag 14 oktober 2006;435;224;211;311;156;155;124;123;0.0;1.0;2.0;1.0;1.0;0.0;0;1352;955;397;2;53;5.0
4536;Zondag 15 oktober 2006;432;217;215;308;145;163;5;5;0.0;0.0;0.0;0.0;0.0;0.0;0;1539;1103;436;3;82;1.0
4537;Maandag 16 oktober 2006;575;301;274;315;151;164;175;168;3.0;4.0;70.0;68.0;0.0;2.0;116;6966;4279;2687;517;317;31.0
4538;Dinsdag 17 oktober 2006;570;316;254;355;172;183;115;114;1.0;0.0;57.0;53.0;3.0;1.0;115;4617;2766;1851;455;203;28.0
4539;Woensdag 18 oktober 2006;559;313;246;352;171;181;158;156;1.0;1.0;37.0;33.0;1.0;3.0;109;4752;2829;1923;476;201;26.0
4540;Donderdag 19 oktober 2006;528;276;252;356;187;169;178;174;2.0;2.0;34.0;32.0;1.0;1.0;146;4897;2959;1938;413;253;43.0
4541;Vrijdag 20 oktober 2006;571;283;288;350;174;176;592;583;5.0;4.0;14.0;14.0;0.0;0.0;104;5443;3435;2008;321;283;165.0
4542;Zaterdag 21 oktober 2006;473;261;212;347;158;189;99;99;0.0;0.0;0.0;0.0;0.0;0.0;1;1381;924;457;5;35;2.0
4543;Zondag 22 oktober 2006;428;219;209;319;153;166;10;10;0.0;0.0;0.0;0.0;0.0;0.0;0;288;191;97;2;36;1.0
4544;Maandag 23 oktober 2006;561;289;272;352;167;185;155;150;4.0;1.0;64.0;62.0;2.0;0.0;146;5674;3325;2349;491;333;22.0
4545;Dinsdag 24 oktober 2006;586;303;283;393;186;207;111;108;3.0;0.0;49.0;46.0;2.0;1.0;131;4533;2709;1824;374;248;551.0
4546;Woensdag 25 oktober 2006;531;281;250;329;166;163;125;123;0.0;2.0;44.0;41.0;2.0;1.0;102;5184;3035;2149;376;301;21.0
4547;Donderdag 26 oktober 2006;537;271;266;347;169;178;163;161;1.0;1.0;37.0;34.0;0.0;3.0;126;5257;3165;2092;386;292;272.0
4548;Vrijdag 27 oktober 2006;541;277;264;337;153;184;400;393;5.0;2.0;22.0;20.0;1.0;1.0;109;4975;3025;1950;268;273;286.0
4549;Zaterdag 28 oktober 2006;444;219;225;325;161;164;82;81;1.0;0.0;1.0;1.0;0.0;0.0;0;1571;1064;507;3;67;1.0
4550;Zondag 29 oktober 2006;448;239;209;324;160;164;4;4;0.0;0.0;0.0;0.0;0.0;0.0;0;317;226;91;6;44;0.0
4551;Maandag 30 oktober 2006;494;249;245;315;151;164;185;180;2.0;3.0;59.0;56.0;1.0;2.0;124;6600;4080;2520;380;395;31.0
4552;Dinsdag 31 oktober 2006;509;269;240;331;170;161;119;117;1.0;1.0;41.0;38.0;2.0;1.0;115;6001;3632;2369;466;432;77.0
4553;Totaal november 2006;15005;7683;7322;10865;5367;5498;3506;3442;28.0;36.0;924.0;879.0;22.0;23.0;2698;142441;88393;54048;7782;6725;2765.0
4554;Woensdag 1 november 2006;549;298;251;353;180;173;113;109;0.0;4.0;36.0;36.0;0.0;0.0;123;20224;12749;7475;419;833;28.0
4555;Donderdag 2 november 2006;523;270;253;329;141;188;104;102;1.0;1.0;41.0;40.0;0.0;1.0;152;6447;3879;2568;337;286;41.0
4556;Vrijdag 3 november 2006;574;290;284;359;182;177;294;291;0.0;3.0;24.0;23.0;0.0;1.0;88;5564;3225;2339;314;271;20.0
4557;Zaterdag 4 november 2006;427;204;223;346;166;180;56;55;1.0;0.0;0.0;0.0;0.0;0.0;0;895;606;289;1;23;438.0
4558;Zondag 5 november 2006;409;219;190;337;179;158;5;5;0.0;0.0;0.0;0.0;0.0;0.0;0;296;180;116;3;44;0.0
4559;Maandag 6 november 2006;507;290;217;333;178;155;149;145;2.0;2.0;75.0;69.0;3.0;3.0;108;6581;4011;2570;482;308;32.0
4560;Dinsdag 7 november 2006;593;323;270;357;179;178;124;123;1.0;0.0;44.0;40.0;2.0;2.0;116;5345;3262;2083;381;221;28.0
4561;Woensdag 8 november 2006;538;281;257;394;217;177;100;98;1.0;1.0;36.0;33.0;1.0;2.0;114;5057;2893;2164;349;229;35.0
4562;Donderdag 9 november 2006;529;250;279;374;187;187;124;120;3.0;1.0;30.0;30.0;0.0;0.0;110;5207;3008;2199;375;235;24.0
4563;Vrijdag 10 november 2006;525;286;239;360;165;195;278;273;4.0;1.0;23.0;20.0;0.0;3.0;122;5301;3319;1982;289;238;47.0
4564;Zaterdag 11 november 2006;399;211;188;369;187;182;88;87;1.0;0.0;1.0;1.0;0.0;0.0;0;1247;865;382;5;42;0.0
4565;Zondag 12 november 2006;412;195;217;368;172;196;1;1;0.0;0.0;0.0;0.0;0.0;0.0;0;282;175;107;2;30;0.0
4566;Maandag 13 november 2006;527;257;270;352;187;165;126;123;1.0;2.0;69.0;67.0;0.0;2.0;118;6108;3858;2250;383;284;34.0
4567;Dinsdag 14 november 2006;514;249;265;407;184;223;130;129;1.0;0.0;51.0;49.0;1.0;1.0;138;4941;3050;1891;359;233;34.0
4568;Woensdag 15 november 2006;525;275;250;366;166;200;108;103;2.0;3.0;42.0;38.0;1.0;3.0;110;7456;4793;2663;326;260;67.0
4569;Donderdag 16 november 2006;531;276;255;390;193;197;116;113;1.0;2.0;42.0;40.0;2.0;0.0;121;5637;3373;2264;357;261;39.0
4570;Vrijdag 17 november 2006;559;288;271;366;171;195;260;257;0.0;3.0;18.0;17.0;0.0;1.0;92;5039;3119;1920;276;241;46.0
4571;Zaterdag 18 november 2006;411;204;207;339;173;166;57;56;0.0;1.0;0.0;0.0;0.0;0.0;0;1209;843;366;6;34;0.0
4572;Zondag 19 november 2006;405;211;194;339;162;177;4;4;0.0;0.0;0.0;0.0;0.0;0.0;0;221;144;77;2;25;0.0
4573;Maandag 20 november 2006;524;256;268;369;182;187;156;153;3.0;0.0;67.0;66.0;0.0;1.0;121;6105;3929;2176;410;277;963.0
4574;Dinsdag 21 november 2006;552;283;269;404;191;213;84;84;0.0;0.0;45.0;44.0;1.0;0.0;132;4753;2976;1777;364;207;143.0
4575;Woensdag 22 november 2006;542;295;247;346;169;177;66;65;0.0;1.0;22.0;19.0;3.0;0.0;134;4400;2726;1674;290;250;92.0
4576;Donderdag 23 november 2006;509;253;256;350;173;177;106;104;0.0;2.0;28.0;28.0;0.0;0.0;132;5126;3159;1967;332;234;152.0
4577;Vrijdag 24 november 2006;532;275;257;370;206;164;289;284;2.0;3.0;23.0;22.0;1.0;0.0;131;4917;3103;1814;336;274;153.0
4578;Zaterdag 25 november 2006;403;195;208;357;156;201;60;59;1.0;0.0;0.0;0.0;0.0;0.0;1;2240;1560;680;0;50;0.0
4579;Zondag 26 november 2006;421;202;219;354;172;182;2;2;0.0;0.0;0.0;0.0;0.0;0.0;0;365;252;113;1;29;0.0
4580;Maandag 27 november 2006;509;256;253;367;189;178;164;163;0.0;1.0;78.0;74.0;2.0;2.0;121;5689;3473;2216;367;299;77.0
4581;Dinsdag 28 november 2006;537;261;276;353;182;171;116;114;1.0;1.0;47.0;44.0;2.0;1.0;151;4613;2828;1785;414;282;167.0
4582;Woensdag 29 november 2006;505;269;236;382;198;184;103;103;0.0;0.0;50.0;50.0;0.0;0.0;128;4765;2964;1801;302;290;47.0
4583;Donderdag 30 november 2006;514;261;253;375;180;195;123;117;2.0;4.0;32.0;29.0;3.0;0.0;135;6411;4071;2340;300;435;58.0
4584;Totaal december 2006;14806;7637;7169;11630;5644;5986;3810;3743;40.0;27.0;849.0;799.0;29.0;21.0;2274;133193;84236;48957;6038;7138;1692.0
4585;Vrijdag 1 december 2006;523;283;240;359;177;182;331;325;4.0;2.0;22.0;19.0;1.0;2.0;102;20682;13404;7278;325;669;188.0
4586;Zaterdag 2 december 2006;442;235;207;357;158;199;52;51;0.0;1.0;0.0;0.0;0.0;0.0;0;801;570;231;0;49;1.0
4587;Zondag 3 december 2006;435;232;203;399;197;202;2;2;0.0;0.0;0.0;0.0;0.0;0.0;0;210;146;64;2;35;0.0
4588;Maandag 4 december 2006;490;254;236;391;192;199;158;155;1.0;2.0;64.0;59.0;3.0;2.0;115;6681;4185;2496;423;352;57.0
4589;Dinsdag 5 december 2006;480;267;213;373;184;189;107;101;4.0;2.0;48.0;46.0;1.0;1.0;138;4919;3016;1903;411;289;150.0
4590;Woensdag 6 december 2006;464;243;221;350;160;190;112;109;2.0;1.0;52.0;47.0;5.0;0.0;118;5045;3006;2039;334;224;35.0
4591;Donderdag 7 december 2006;508;260;248;391;187;204;116;115;1.0;0.0;29.0;28.0;0.0;1.0;131;5256;3306;1950;336;206;29.0
4592;Vrijdag 8 december 2006;545;291;254;359;184;175;208;203;2.0;3.0;29.0;29.0;0.0;0.0;108;5216;3264;1952;273;238;22.0
4593;Zaterdag 9 december 2006;424;243;181;341;171;170;59;58;0.0;1.0;0.0;0.0;0.0;0.0;0;1339;1021;318;3;43;0.0
4594;Zondag 10 december 2006;393;199;194;337;150;187;2;2;0.0;0.0;0.0;0.0;0.0;0.0;2;539;377;162;3;47;0.0
4595;Maandag 11 december 2006;519;250;269;382;179;203;151;147;1.0;3.0;74.0;68.0;4.0;2.0;74;5941;3648;2293;337;307;468.0
4596;Dinsdag 12 december 2006;558;279;279;363;177;186;188;186;2.0;0.0;48.0;46.0;2.0;0.0;112;5004;3114;1890;345;240;26.0
4597;Woensdag 13 december 2006;502;283;219;374;185;189;83;80;2.0;1.0;37.0;35.0;0.0;2.0;146;4432;2737;1695;308;211;28.0
4598;Donderdag 14 december 2006;514;263;251;346;169;177;138;135;2.0;1.0;53.0;53.0;0.0;0.0;115;5380;3409;1971;313;250;189.0
4599;Vrijdag 15 december 2006;498;234;264;375;172;203;394;388;5.0;1.0;20.0;18.0;1.0;1.0;99;8885;5882;3003;250;405;278.0
4600;Zaterdag 16 december 2006;441;228;213;383;188;195;72;68;1.0;3.0;1.0;1.0;0.0;0.0;2;1931;1444;487;5;77;0.0
4601;Zondag 17 december 2006;405;184;221;341;169;172;6;6;0.0;0.0;0.0;0.0;0.0;0.0;0;301;216;85;4;32;0.0
4602;Maandag 18 december 2006;501;250;251;373;198;175;229;229;0.0;0.0;96.0;90.0;2.0;4.0;161;6962;4400;2562;400;363;56.0
4603;Dinsdag 19 december 2006;507;259;248;407;196;211;134;131;2.0;1.0;56.0;53.0;1.0;2.0;111;4908;3034;1874;317;275;23.0
4604;Woensdag 20 december 2006;516;269;247;371;192;179;155;147;5.0;3.0;58.0;55.0;3.0;0.0;136;5665;3605;2060;318;311;40.0
4605;Donderdag 21 december 2006;536;262;274;349;149;200;203;203;0.0;0.0;49.0;44.0;2.0;3.0;166;5483;3370;2113;350;304;43.0
4606;Vrijdag 22 december 2006;549;287;262;407;198;209;336;330;5.0;1.0;26.0;25.0;0.0;1.0;117;6058;3803;2255;270;365;17.0
4607;Zaterdag 23 december 2006;446;228;218;413;204;209;57;57;0.0;0.0;3.0;1.0;2.0;0.0;0;1215;775;440;7;53;0.0
4608;Zondag 24 december 2006;393;187;206;406;178;228;6;6;0.0;0.0;0.0;0.0;0.0;0.0;0;223;156;67;0;23;1.0
4609;Maandag 25 december 2006;386;210;176;362;171;191;12;12;0.0;0.0;0.0;0.0;0.0;0.0;0;171;114;57;0;26;0.0
4610;Dinsdag 26 december 2006;391;200;191;361;180;181;17;17;0.0;0.0;0.0;0.0;0.0;0.0;0;93;67;26;4;27;0.0
4611;Woensdag 27 december 2006;514;260;254;420;205;215;125;125;0.0;0.0;35.0;33.0;2.0;0.0;133;5765;3507;2258;243;417;16.0
4612;Donderdag 28 december 2006;522;277;245;389;211;178;140;139;1.0;0.0;37.0;37.0;0.0;0.0;85;6451;3963;2488;265;403;6.0
4613;Vrijdag 29 december 2006;573;299;274;416;214;202;162;161;0.0;1.0;12.0;12.0;0.0;0.0;103;5954;3578;2376;185;422;19.0
4614;Zaterdag 30 december 2006;439;230;209;380;167;213;47;47;0.0;0.0;0.0;0.0;0.0;0.0;0;842;587;255;2;78;0.0
4615;Zondag 31 december 2006;392;191;201;355;182;173;8;8;0.0;0.0;0.0;0.0;0.0;0.0;0;841;532;309;5;397;0.0
4616;Totaal op zondag in 2006;22514;11598;10916;18732;8886;9846;381;379;2.0;0.0;3.0;3.0;0.0;0.0;19;41366;26370;14996;311;4033;26.0
4617;Totaal op maandag in 2006;26924;13761;13163;19067;9347;9720;8874;8701;82.0;91.0;3301.0;3115.0;87.0;99.0;5917;335443;204675;130768;22473;18373;6015.0
4618;Totaal op dinsdag in 2006;28518;14591;13927;19675;9517;10158;9081;8878;108.0;95.0;2536.0;2386.0;68.0;82.0;6736;283004;169171;113833;21822;15731;5620.0
4619;Totaal op woensdag in 2006;28166;14564;13602;19694;9509;10185;7920;7761;60.0;99.0;1994.0;1876.0;62.0;56.0;6750;317505;192010;125495;20339;15931;6425.0
4620;Totaal op donderdag in 2006;28059;14346;13713;19373;9352;10021;9751;9589;83.0;79.0;1860.0;1778.0;38.0;44.0;6841;300019;181338;118681;20292;15701;4475.0
4621;Totaal op vrijdag in 2006;27903;14346;13557;19803;9559;10244;29620;29204;189.0;227.0;1073.0;994.0;36.0;43.0;5449;308108;188990;119118;15599;16956;5036.0
4622;Totaal op zaterdag in 2006;22973;11773;11200;19028;9124;9904;6742;6645;55.0;42.0;34.0;30.0;4.0;0.0;22;92674;63263;29411;314;4303;1492.0
4623;Totaal 2007;181336;92560;88776;133022;64797;68225;72485;71114;663.0;708.0;10550.0;9945.0;269.0;336.0;31983;1639180;992616;646564;116819;91287;30653.0
4624;Totaal januari 2007;15019;7697;7322;12221;5966;6255;2692;2634;26.0;32.0;895.0;847.0;21.0;27.0;2901;145654;88908;56746;9313;8019;3161.0
4625;Maandag 1 januari 2007;348;173;175;408;196;212;3;3;0.0;0.0;0.0;0.0;0.0;0.0;0;10503;6258;4245;82;655;0.0
4626;Dinsdag 2 januari 2007;510;259;251;369;178;191;69;68;0.0;1.0;37.0;33.0;4.0;0.0;116;8764;5213;3551;470;534;27.0
4627;Woensdag 3 januari 2007;537;264;273;416;205;211;90;89;0.0;1.0;41.0;41.0;0.0;0.0;114;7340;4205;3135;404;429;27.0
4628;Donderdag 4 januari 2007;578;294;284;421;191;230;97;95;1.0;1.0;36.0;35.0;0.0;1.0;129;7334;4171;3163;513;394;38.0
4629;Vrijdag 5 januari 2007;546;273;273;444;203;241;146;140;3.0;3.0;23.0;23.0;0.0;0.0;133;6952;4176;2776;390;401;25.0
4630;Zaterdag 6 januari 2007;421;208;213;401;201;200;36;35;1.0;0.0;0.0;0.0;0.0;0.0;1;899;616;283;6;53;5.0
4631;Zondag 7 januari 2007;421;223;198;343;164;179;6;6;0.0;0.0;0.0;0.0;0.0;0.0;2;349;223;126;9;54;0.0
4632;Maandag 8 januari 2007;501;261;240;431;216;215;161;159;1.0;1.0;74.0;72.0;1.0;1.0;118;7238;4247;2991;478;367;29.0
4633;Dinsdag 9 januari 2007;504;243;261;424;203;221;102;100;1.0;1.0;44.0;41.0;1.0;2.0;128;5505;3273;2232;451;242;55.0
4634;Woensdag 10 januari 2007;489;241;248;397;202;195;105;103;0.0;2.0;37.0;35.0;2.0;0.0;157;5826;3521;2305;405;266;50.0
4635;Donderdag 11 januari 2007;492;239;253;358;181;177;89;87;1.0;1.0;39.0;37.0;0.0;2.0;153;5285;3248;2037;354;261;195.0
4636;Vrijdag 12 januari 2007;546;291;255;419;194;225;149;145;1.0;3.0;15.0;14.0;0.0;1.0;114;5204;3262;1942;371;275;74.0
4637;Zaterdag 13 januari 2007;414;217;197;419;197;222;21;20;1.0;0.0;0.0;0.0;0.0;0.0;2;865;635;230;6;43;5.0
4638;Zondag 14 januari 2007;391;199;192;389;191;198;5;5;0.0;0.0;0.0;0.0;0.0;0.0;0;275;183;92;5;39;1.0
4639;Maandag 15 januari 2007;495;243;252;392;193;199;123;119;2.0;2.0;74.0;67.0;3.0;4.0;105;8900;5741;3159;521;410;815.0
4640;Dinsdag 16 januari 2007;505;265;240;406;184;222;91;89;0.0;2.0;43.0;40.0;3.0;0.0;165;5024;3025;1999;417;210;25.0
4641;Woensdag 17 januari 2007;533;265;268;372;174;198;90;90;0.0;0.0;31.0;29.0;0.0;2.0;143;5020;3087;1933;417;195;46.0
4642;Donderdag 18 januari 2007;511;256;255;404;208;196;110;108;1.0;1.0;35.0;33.0;1.0;1.0;130;4282;2614;1668;350;292;203.0
4643;Vrijdag 19 januari 2007;487;245;242;360;175;185;204;201;2.0;1.0;23.0;23.0;0.0;0.0;86;4853;3004;1849;330;250;669.0
4644;Zaterdag 20 januari 2007;401;213;188;383;185;198;51;51;0.0;0.0;0.0;0.0;0.0;0.0;0;1575;1165;410;3;73;0.0
4645;Zondag 21 januari 2007;365;197;168;377;191;186;9;9;0.0;0.0;0.0;0.0;0.0;0.0;1;251;163;88;2;40;0.0
4646;Maandag 22 januari 2007;486;242;244;373;181;192;130;125;2.0;3.0;56.0;51.0;2.0;3.0;135;5677;3513;2164;469;294;49.0
4647;Dinsdag 23 januari 2007;552;277;275;400;202;198;82;81;1.0;0.0;42.0;42.0;0.0;0.0;145;4532;2754;1778;425;230;125.0
4648;Woensdag 24 januari 2007;513;279;234;357;193;164;89;87;0.0;2.0;27.0;26.0;1.0;0.0;143;4809;2958;1851;406;242;62.0
4649;Donderdag 25 januari 2007;526;275;251;381;166;215;86;83;2.0;1.0;33.0;27.0;0.0;6.0;135;5500;3343;2157;351;267;61.0
4650;Vrijdag 26 januari 2007;535;272;263;403;201;202;207;203;2.0;2.0;37.0;36.0;1.0;0.0;108;4777;3021;1756;308;262;288.0
4651;Zaterdag 27 januari 2007;434;219;215;398;201;197;46;46;0.0;0.0;1.0;1.0;0.0;0.0;1;1346;995;351;3;40;1.0
4652;Zondag 28 januari 2007;390;228;162;368;172;196;4;4;0.0;0.0;0.0;0.0;0.0;0.0;2;341;243;98;0;60;1.0
4653;Maandag 29 januari 2007;515;275;240;395;202;193;130;126;3.0;1.0;62.0;62.0;0.0;0.0;152;5544;3280;2264;497;412;29.0
4654;Dinsdag 30 januari 2007;539;285;254;417;219;198;89;86;1.0;2.0;47.0;44.0;0.0;3.0;165;4873;3028;1845;415;321;210.0
4655;Woensdag 31 januari 2007;534;276;258;396;197;199;72;71;0.0;1.0;38.0;35.0;2.0;1.0;118;6011;3743;2268;455;408;46.0
4656;Totaal februari 2007;13909;7040;6869;10884;5356;5528;3073;3020;24.0;29.0;851.0;815.0;18.0;18.0;2397;128219;79045;49174;8648;6083;2027.0
4657;Donderdag 1 februari 2007;525;262;263;362;204;158;112;110;1.0;1.0;43.0;41.0;2.0;0.0;111;20176;12779;7397;512;679;69.0
4658;Vrijdag 2 februari 2007;596;298;298;407;207;200;231;228;1.0;2.0;18.0;17.0;1.0;0.0;110;5718;3433;2285;389;247;15.0
4659;Zaterdag 3 februari 2007;413;197;216;370;184;186;37;35;0.0;2.0;0.0;0.0;0.0;0.0;1;737;494;243;5;48;1.0
4660;Zondag 4 februari 2007;422;214;208;370;161;209;0;0;0.0;0.0;0.0;0.0;0.0;0.0;0;211;121;90;1;31;0.0
4661;Maandag 5 februari 2007;506;260;246;354;177;177;153;151;2.0;0.0;61.0;59.0;0.0;2.0;138;6660;3962;2698;480;308;47.0
4662;Dinsdag 6 februari 2007;533;275;258;402;193;209;76;76;0.0;0.0;46.0;46.0;0.0;0.0;121;5230;3084;2146;582;247;38.0
4663;Woensdag 7 februari 2007;552;284;268;406;196;210;165;158;2.0;5.0;39.0;37.0;1.0;1.0;117;4971;2957;2014;449;252;66.0
4664;Donderdag 8 februari 2007;539;277;262;404;206;198;86;85;0.0;1.0;42.0;40.0;2.0;0.0;113;4938;3072;1866;368;206;179.0
4665;Vrijdag 9 februari 2007;520;264;256;412;202;210;162;159;1.0;2.0;22.0;21.0;0.0;1.0;99;4874;2956;1918;301;207;505.0
4666;Zaterdag 10 februari 2007;449;221;228;372;203;169;43;43;0.0;0.0;0.0;0.0;0.0;0.0;0;1304;954;350;3;55;0.0
4667;Zondag 11 februari 2007;419;200;219;368;200;168;2;2;0.0;0.0;0.0;0.0;0.0;0.0;1;220;161;59;0;42;0.0
4668;Maandag 12 februari 2007;527;259;268;387;187;200;133;126;1.0;6.0;71.0;70.0;0.0;1.0;111;5697;3408;2289;542;271;151.0
4669;Dinsdag 13 februari 2007;529;271;258;377;180;197;78;76;2.0;0.0;50.0;49.0;0.0;1.0;126;4801;2846;1955;455;250;44.0
4670;Woensdag 14 februari 2007;558;273;285;401;210;191;321;314;5.0;2.0;37.0;34.0;2.0;1.0;99;4896;3035;1861;398;209;48.0
4671;Donderdag 15 februari 2007;525;275;250;405;201;204;107;104;2.0;1.0;32.0;30.0;1.0;1.0;129;7243;4580;2663;482;293;58.0
4672;Vrijdag 16 februari 2007;556;276;280;387;179;208;195;194;0.0;1.0;24.0;23.0;1.0;0.0;135;5011;3086;1925;466;234;53.0
4673;Zaterdag 17 februari 2007;424;227;197;396;186;210;48;47;1.0;0.0;0.0;0.0;0.0;0.0;0;947;666;281;4;26;387.0
4674;Zondag 18 februari 2007;380;192;188;363;171;192;6;6;0.0;0.0;0.0;0.0;0.0;0.0;0;239;161;78;3;36;0.0
4675;Maandag 19 februari 2007;483;236;247;379;185;194;128;125;2.0;1.0;55.0;53.0;1.0;1.0;94;4946;3022;1924;469;226;45.0
4676;Dinsdag 20 februari 2007;507;262;245;380;182;198;108;106;1.0;1.0;32.0;29.0;3.0;0.0;142;4387;2703;1684;346;222;24.0
4677;Woensdag 21 februari 2007;524;249;275;382;181;201;96;95;0.0;1.0;41.0;38.0;1.0;2.0;134;5001;3046;1955;427;255;55.0
4678;Donderdag 22 februari 2007;525;257;268;355;176;179;133;133;0.0;0.0;35.0;35.0;0.0;0.0;102;5263;3230;2033;438;279;41.0
4679;Vrijdag 23 februari 2007;487;252;235;409;199;210;202;201;1.0;0.0;19.0;18.0;1.0;0.0;96;5150;3117;2033;298;327;40.0
4680;Zaterdag 24 februari 2007;408;209;199;407;203;204;47;47;0.0;0.0;0.0;0.0;0.0;0.0;0;1577;1054;523;4;54;1.0
4681;Zondag 25 februari 2007;417;212;205;394;178;216;8;8;0.0;0.0;0.0;0.0;0.0;0.0;0;463;309;154;2;45;0.0
4682;Maandag 26 februari 2007;525;277;248;392;190;202;151;148;1.0;2.0;86.0;82.0;1.0;3.0;124;6276;3865;2411;411;380;43.0
4683;Dinsdag 27 februari 2007;516;278;238;427;213;214;142;140;1.0;1.0;52.0;49.0;1.0;2.0;160;4840;2917;1923;407;254;52.0
4684;Woensdag 28 februari 2007;544;283;261;416;202;214;103;103;0.0;0.0;46.0;44.0;0.0;2.0;134;6443;4027;2416;406;400;65.0
4685;Totaal maart 2007;15211;7711;7500;12019;5882;6137;3713;3634;37.0;42.0;878.0;827.0;23.0;28.0;3004;140177;88390;51787;8257;6742;4259.0
4686;Donderdag 1 maart 2007;568;283;285;403;199;204;149;142;0.0;7.0;30.0;29.0;0.0;1.0;142;20645;13342;7303;353;723;74.0
4687;Vrijdag 2 maart 2007;547;277;270;395;208;187;217;214;2.0;1.0;26.0;21.0;1.0;4.0;131;6135;3806;2329;336;263;24.0
4688;Zaterdag 3 maart 2007;433;218;215;385;187;198;63;63;0.0;0.0;1.0;1.0;0.0;0.0;4;794;533;261;2;46;0.0
4689;Zondag 4 maart 2007;429;234;195;411;208;203;2;2;0.0;0.0;0.0;0.0;0.0;0.0;0;249;162;87;0;36;0.0
4690;Maandag 5 maart 2007;524;268;256;414;206;208;164;159;2.0;3.0;60.0;57.0;2.0;1.0;107;7032;4317;2715;475;291;45.0
4691;Dinsdag 6 maart 2007;507;254;253;393;203;190;95;93;1.0;1.0;45.0;44.0;1.0;0.0;122;5234;3168;2066;419;227;1360.0
4692;Woensdag 7 maart 2007;530;272;258;423;201;222;84;81;2.0;1.0;24.0;24.0;0.0;0.0;127;5421;3298;2123;368;210;60.0
4693;Donderdag 8 maart 2007;540;278;262;410;208;202;86;85;0.0;1.0;33.0;33.0;0.0;0.0;113;5608;3378;2230;408;223;85.0
4694;Vrijdag 9 maart 2007;537;270;267;418;199;219;194;189;5.0;0.0;22.0;19.0;1.0;2.0;111;4694;2950;1744;301;237;47.0
4695;Zaterdag 10 maart 2007;420;217;203;364;187;177;49;47;1.0;1.0;0.0;0.0;0.0;0.0;0;1250;941;309;6;47;0.0
4696;Zondag 11 maart 2007;411;212;199;406;188;218;3;3;0.0;0.0;0.0;0.0;0.0;0.0;0;168;115;53;3;27;0.0
4697;Maandag 12 maart 2007;507;254;253;380;189;191;157;152;5.0;0.0;63.0;60.0;1.0;2.0;125;5743;3535;2208;426;266;70.0
4698;Dinsdag 13 maart 2007;549;273;276;383;172;211;92;89;1.0;2.0;50.0;44.0;4.0;2.0;163;4444;2722;1722;400;217;500.0
4699;Woensdag 14 maart 2007;527;258;269;388;199;189;124;124;0.0;0.0;42.0;41.0;0.0;1.0;126;4840;2934;1906;333;216;53.0
4700;Donderdag 15 maart 2007;498;277;221;387;179;208;108;107;0.0;1.0;37.0;35.0;0.0;2.0;149;7383;4812;2571;377;328;54.0
4701;Vrijdag 16 maart 2007;547;264;283;363;176;187;229;227;1.0;1.0;20.0;19.0;0.0;1.0;94;5057;3144;1913;284;240;418.0
4702;Zaterdag 17 maart 2007;426;205;221;392;189;203;36;36;0.0;0.0;1.0;1.0;0.0;0.0;1;973;717;256;2;59;0.0
4703;Zondag 18 maart 2007;382;188;194;357;193;164;8;8;0.0;0.0;0.0;0.0;0.0;0.0;0;241;181;60;2;46;0.0
4704;Maandag 19 maart 2007;511;251;260;378;190;188;145;142;2.0;1.0;70.0;69.0;0.0;1.0;120;5489;3286;2203;447;313;57.0
4705;Dinsdag 20 maart 2007;509;261;248;388;184;204;107;103;2.0;2.0;42.0;39.0;1.0;2.0;209;4861;3048;1813;393;256;172.0
4706;Woensdag 21 maart 2007;513;273;240;385;193;192;184;179;1.0;4.0;42.0;42.0;0.0;0.0;135;4556;2851;1705;358;213;48.0
4707;Donderdag 22 maart 2007;557;277;280;375;190;185;119;117;2.0;0.0;25.0;24.0;1.0;0.0;169;5065;3161;1904;346;234;30.0
4708;Vrijdag 23 maart 2007;530;258;272;396;195;201;272;267;3.0;2.0;20.0;17.0;3.0;0.0;107;4656;2930;1726;304;251;32.0
4709;Zaterdag 24 maart 2007;386;207;179;394;185;209;52;52;0.0;0.0;1.0;1.0;0.0;0.0;0;1444;1010;434;6;46;0.0
4710;Zondag 25 maart 2007;414;208;206;326;155;171;7;7;0.0;0.0;0.0;0.0;0.0;0.0;0;417;303;114;4;42;0.0
4711;Maandag 26 maart 2007;505;260;245;375;193;182;157;152;4.0;1.0;68.0;64.0;4.0;0.0;132;5643;3483;2160;401;365;265.0
4712;Dinsdag 27 maart 2007;499;238;261;373;173;200;106;103;0.0;3.0;51.0;43.0;2.0;6.0;169;4185;2646;1539;394;225;51.0
4713;Woensdag 28 maart 2007;500;236;264;376;177;199;110;105;1.0;4.0;35.0;33.0;0.0;2.0;159;4614;2800;1814;401;263;466.0
4714;Donderdag 29 maart 2007;491;243;248;416;177;239;110;109;0.0;1.0;43.0;41.0;1.0;1.0;150;5017;3188;1829;410;302;34.0
4715;Vrijdag 30 maart 2007;516;288;228;405;192;213;418;411;2.0;5.0;27.0;26.0;1.0;0.0;139;6634;4407;2227;296;337;314.0
4716;Zaterdag 31 maart 2007;398;209;189;360;187;173;66;66;0.0;0.0;0.0;0.0;0.0;0.0;0;1685;1222;463;2;193;0.0
4717;Totaal april 2007;14385;7437;6948;11021;5409;5612;4555;4478;37.0;40.0;847.0;792.0;24.0;31.0;2614;118505;74175;44330;7045;6033;2105.0
4718;Zondag 1 april 2007;404;218;186;357;182;175;3;3;0.0;0.0;0.0;0.0;0.0;0.0;0;10087;6511;3576;21;454;2.0
4719;Maandag 2 april 2007;515;257;258;370;182;188;176;171;3.0;2.0;82.0;79.0;2.0;1.0;118;9283;5681;3602;496;384;56.0
4720;Dinsdag 3 april 2007;505;253;252;374;185;189;117;116;0.0;1.0;44.0;42.0;0.0;2.0;146;5763;3593;2170;391;301;42.0
4721;Woensdag 4 april 2007;536;275;261;331;153;178;153;151;2.0;0.0;36.0;32.0;2.0;2.0;133;5469;3274;2195;389;309;60.0
4722;Donderdag 5 april 2007;477;234;243;398;192;206;221;212;4.0;5.0;37.0;35.0;2.0;0.0;147;6384;3872;2512;429;302;14.0
4723;Vrijdag 6 april 2007;493;248;245;368;164;204;74;73;0.0;1.0;5.0;4.0;0.0;1.0;20;1646;1051;595;32;71;18.0
4724;Zaterdag 7 april 2007;420;231;189;353;169;184;80;79;0.0;1.0;0.0;0.0;0.0;0.0;0;813;595;218;6;31;0.0
4725;Zondag 8 april 2007;394;192;202;334;156;178;8;8;0.0;0.0;0.0;0.0;0.0;0.0;0;167;119;48;0;25;0.0
4726;Maandag 9 april 2007;430;224;206;358;178;180;10;10;0.0;0.0;0.0;0.0;0.0;0.0;1;337;244;93;2;38;1.0
4727;Dinsdag 10 april 2007;517;266;251;371;183;188;136;133;2.0;1.0;54.0;53.0;1.0;0.0;165;6592;4064;2528;466;348;194.0
4728;Woensdag 11 april 2007;519;270;249;375;200;175;95;94;1.0;0.0;50.0;43.0;1.0;6.0;155;5421;3338;2083;476;226;312.0
4729;Donderdag 12 april 2007;569;297;272;348;159;189;155;149;3.0;3.0;37.0;36.0;0.0;1.0;141;5547;3460;2087;439;241;260.0
4730;Vrijdag 13 april 2007;541;292;249;409;201;208;279;274;1.0;4.0;20.0;19.0;0.0;1.0;125;4703;2888;1815;297;230;23.0
4731;Zaterdag 14 april 2007;387;198;189;386;170;216;99;98;0.0;1.0;0.0;0.0;0.0;0.0;0;985;723;262;3;54;4.0
4732;Zondag 15 april 2007;428;212;216;368;169;199;6;6;0.0;0.0;0.0;0.0;0.0;0.0;0;1248;902;346;4;81;1.0
4733;Maandag 16 april 2007;497;253;244;350;181;169;175;171;3.0;1.0;87.0;80.0;4.0;3.0;190;6646;4221;2425;399;272;52.0
4734;Dinsdag 17 april 2007;522;264;258;376;190;186;127;124;2.0;1.0;55.0;52.0;3.0;0.0;167;4587;2779;1808;366;243;36.0
4735;Woensdag 18 april 2007;503;257;246;372;183;189;135;133;2.0;0.0;33.0;31.0;1.0;1.0;134;4418;2675;1743;369;230;52.0
4736;Donderdag 19 april 2007;508;276;232;349;172;177;135;132;3.0;0.0;34.0;33.0;0.0;1.0;160;4732;2897;1835;342;226;518.0
4737;Vrijdag 20 april 2007;519;280;239;388;181;207;684;673;3.0;8.0;25.0;20.0;3.0;2.0;122;5131;3218;1913;265;246;253.0
4738;Zaterdag 21 april 2007;379;207;172;357;185;172;110;110;0.0;0.0;2.0;2.0;0.0;0.0;2;1057;790;267;1;22;0.0
4739;Zondag 22 april 2007;447;236;211;355;171;184;4;4;0.0;0.0;0.0;0.0;0.0;0.0;0;223;153;70;1;31;1.0
4740;Maandag 23 april 2007;459;242;217;361;190;171;184;183;0.0;1.0;83.0;77.0;2.0;4.0;105;5487;3546;1941;415;317;37.0
4741;Dinsdag 24 april 2007;553;285;268;419;212;207;152;148;2.0;2.0;51.0;47.0;2.0;2.0;172;4316;2644;1672;413;299;34.0
4742;Woensdag 25 april 2007;476;236;240;401;202;199;143;143;0.0;0.0;39.0;38.0;0.0;1.0;154;4624;2700;1924;352;240;37.0
4743;Donderdag 26 april 2007;554;264;290;367;182;185;214;210;1.0;3.0;43.0;40.0;0.0;3.0;146;4918;2940;1978;380;262;22.0
4744;Vrijdag 27 april 2007;550;291;259;379;202;177;703;695;5.0;3.0;30.0;29.0;1.0;0.0;107;5567;3600;1967;284;281;74.0
4745;Zaterdag 28 april 2007;455;248;207;363;176;187;142;140;0.0;2.0;0.0;0.0;0.0;0.0;2;1286;904;382;3;69;0.0
4746;Zondag 29 april 2007;422;229;193;329;163;166;14;14;0.0;0.0;0.0;0.0;0.0;0.0;0;198;145;53;1;45;1.0
4747;Maandag 30 april 2007;406;202;204;355;176;179;21;21;0.0;0.0;0.0;0.0;0.0;0.0;2;870;648;222;3;155;1.0
4748;Totaal mei 2007;15144;7815;7329;10799;5283;5516;7807;7657;61.0;89.0;890.0;824.0;24.0;42.0;2882;131882;83244;48638;8044;6469;2674.0
4749;Dinsdag 1 mei 2007;468;233;235;334;163;171;175;172;3.0;0.0;42.0;40.0;1.0;1.0;121;17698;11401;6297;485;715;184.0
4750;Woensdag 2 mei 2007;590;305;285;389;180;209;192;191;1.0;0.0;37.0;34.0;0.0;3.0;137;6854;4121;2733;478;306;31.0
4751;Donderdag 3 mei 2007;525;277;248;357;171;186;254;248;2.0;4.0;24.0;23.0;0.0;1.0;144;6726;4078;2648;461;257;323.0
4752;Vrijdag 4 mei 2007;470;253;217;384;178;206;141;138;2.0;1.0;12.0;10.0;1.0;1.0;138;5246;3223;2023;308;309;29.0
4753;Zaterdag 5 mei 2007;418;220;198;344;167;177;78;74;0.0;4.0;0.0;0.0;0.0;0.0;1;875;632;243;4;42;1.0
4754;Zondag 6 mei 2007;408;222;186;330;137;193;8;8;0.0;0.0;0.0;0.0;0.0;0.0;1;188;119;69;2;36;2.0
4755;Maandag 7 mei 2007;505;265;240;376;168;208;278;270;2.0;6.0;78.0;72.0;3.0;3.0;143;6202;3767;2435;446;208;32.0
4756;Dinsdag 8 mei 2007;532;278;254;345;173;172;140;139;0.0;1.0;51.0;48.0;2.0;1.0;143;5081;3073;2008;380;207;65.0
4757;Woensdag 9 mei 2007;515;259;256;361;168;193;145;140;2.0;3.0;43.0;38.0;3.0;2.0;173;5087;3275;1812;387;306;41.0
4758;Donderdag 10 mei 2007;502;252;250;370;168;202;263;262;1.0;0.0;43.0;40.0;0.0;3.0;133;5448;3373;2075;368;240;473.0
4759;Vrijdag 11 mei 2007;520;285;235;360;202;158;921;906;6.0;9.0;29.0;28.0;0.0;1.0;120;4493;2815;1678;250;210;14.0
4760;Zaterdag 12 mei 2007;428;218;210;355;188;167;219;212;3.0;4.0;0.0;0.0;0.0;0.0;0;926;714;212;6;55;0.0
4761;Zondag 13 mei 2007;430;221;209;327;164;163;3;3;0.0;0.0;0.0;0.0;0.0;0.0;1;162;119;43;2;33;0.0
4762;Maandag 14 mei 2007;513;265;248;341;172;169;251;245;3.0;3.0;84.0;79.0;1.0;4.0;115;5886;3753;2133;404;262;277.0
4763;Dinsdag 15 mei 2007;534;274;260;319;168;151;185;179;4.0;2.0;35.0;32.0;1.0;2.0;147;6717;4425;2292;413;250;50.0
4764;Woensdag 16 mei 2007;537;258;279;326;157;169;734;716;6.0;12.0;46.0;40.0;2.0;4.0;136;5454;3455;1999;360;339;242.0
4765;Donderdag 17 mei 2007;439;229;210;355;184;171;15;15;0.0;0.0;0.0;0.0;0.0;0.0;3;415;272;143;0;18;0.0
4766;Vrijdag 18 mei 2007;464;249;215;331;159;172;691;679;4.0;8.0;8.0;6.0;0.0;2.0;15;1155;767;388;88;67;27.0
4767;Zaterdag 19 mei 2007;430;234;196;353;196;157;168;164;1.0;3.0;1.0;0.0;1.0;0.0;0;608;449;159;4;37;0.0
4768;Zondag 20 mei 2007;394;201;193;335;167;168;5;5;0.0;0.0;0.0;0.0;0.0;0.0;0;431;311;120;5;48;0.0
4769;Maandag 21 mei 2007;506;263;243;359;180;179;252;246;1.0;5.0;69.0;62.0;5.0;2.0;152;7065;4422;2643;428;297;178.0
4770;Dinsdag 22 mei 2007;520;284;236;342;166;176;147;143;2.0;2.0;48.0;46.0;0.0;2.0;186;4894;3064;1830;408;244;62.0
4771;Woensdag 23 mei 2007;532;260;272;372;174;198;186;183;2.0;1.0;34.0;33.0;0.0;1.0;144;4781;2988;1793;383;205;52.0
4772;Donderdag 24 mei 2007;501;243;258;330;168;162;305;301;1.0;3.0;33.0;30.0;1.0;2.0;163;5168;3268;1900;420;237;359.0
4773;Vrijdag 25 mei 2007;552;291;261;379;192;187;1255;1235;10.0;10.0;31.0;28.0;2.0;1.0;124;5243;3268;1975;264;273;19.0
4774;Zaterdag 26 mei 2007;471;237;234;338;165;173;216;215;1.0;0.0;0.0;0.0;0.0;0.0;1;1151;785;366;1;65;0.0
4775;Zondag 27 mei 2007;417;203;214;322;158;164;6;6;0.0;0.0;0.0;0.0;0.0;0.0;0;200;130;70;0;32;1.0
4776;Maandag 28 mei 2007;451;238;213;320;159;161;13;13;0.0;0.0;0.0;0.0;0.0;0.0;4;435;295;140;2;49;0.0
4777;Dinsdag 29 mei 2007;532;271;261;310;151;159;150;145;2.0;3.0;62.0;59.0;1.0;2.0;130;4923;3016;1907;495;341;54.0
4778;Woensdag 30 mei 2007;510;253;257;361;169;192;160;158;1.0;1.0;50.0;49.0;0.0;1.0;127;5750;3617;2133;418;328;43.0
4779;Donderdag 31 mei 2007;530;274;256;374;171;203;251;246;1.0;4.0;30.0;27.0;0.0;3.0;180;6620;4249;2371;374;453;115.0
4780;Totaal juni 2007;14659;7375;7284;10423;5045;5378;10869;10689;89.0;91.0;907.0;864.0;17.0;26.0;2671;134759;84629;50130;8644;7460;2085.0
4781;Vrijdag 1 juni 2007;531;280;251;356;170;186;1234;1217;5.0;12.0;30.0;28.0;1.0;1.0;106;18896;12328;6568;419;738;14.0
4782;Zaterdag 2 juni 2007;445;214;231;333;156;177;233;227;3.0;3.0;2.0;2.0;0.0;0.0;1;714;477;237;4;41;1.0
4783;Zondag 3 juni 2007;410;197;213;327;172;155;6;6;0.0;0.0;0.0;0.0;0.0;0.0;0;187;111;76;4;34;0.0
4784;Maandag 4 juni 2007;478;241;237;359;175;184;234;229;4.0;1.0;72.0;68.0;1.0;3.0;120;6900;4059;2841;488;305;14.0
4785;Dinsdag 5 juni 2007;517;265;252;384;191;193;538;522;6.0;10.0;54.0;51.0;1.0;2.0;194;5570;3371;2199;434;203;383.0
4786;Woensdag 6 juni 2007;539;264;275;350;178;172;202;199;2.0;1.0;35.0;34.0;1.0;0.0;119;5439;3207;2232;450;174;47.0
4787;Donderdag 7 juni 2007;515;249;266;379;181;198;375;372;1.0;2.0;28.0;28.0;0.0;0.0;143;5585;3523;2062;382;212;25.0
4788;Vrijdag 8 juni 2007;517;267;250;417;186;231;1075;1058;6.0;11.0;15.0;14.0;1.0;0.0;109;4654;2919;1735;312;254;14.0
4789;Zaterdag 9 juni 2007;467;239;228;358;163;195;214;210;4.0;0.0;2.0;2.0;0.0;0.0;1;876;582;294;3;46;0.0
4790;Zondag 10 juni 2007;395;196;199;330;184;146;9;9;0.0;0.0;0.0;0.0;0.0;0.0;0;435;321;114;5;40;0.0
4791;Maandag 11 juni 2007;503;278;225;366;186;180;192;187;2.0;3.0;71.0;68.0;1.0;2.0;123;5593;3585;2008;483;253;32.0
4792;Dinsdag 12 juni 2007;571;281;290;349;159;190;145;144;1.0;0.0;50.0;49.0;0.0;1.0;128;4454;2734;1720;408;268;28.0
4793;Woensdag 13 juni 2007;497;225;272;335;150;185;125;121;2.0;2.0;55.0;52.0;2.0;1.0;117;4518;2822;1696;375;225;26.0
4794;Donderdag 14 juni 2007;518;259;259;335;172;163;263;255;1.0;7.0;40.0;38.0;0.0;2.0;128;5081;3251;1830;429;259;39.0
4795;Vrijdag 15 juni 2007;553;268;285;352;164;188;1042;1031;5.0;6.0;28.0;28.0;0.0;0.0;89;6742;4392;2350;297;345;526.0
4796;Zaterdag 16 juni 2007;420;201;219;328;165;163;244;239;3.0;2.0;0.0;0.0;0.0;0.0;1;1042;753;289;3;55;0.0
4797;Zondag 17 juni 2007;432;219;213;357;167;190;9;9;0.0;0.0;0.0;0.0;0.0;0.0;0;225;158;67;3;47;1.0
4798;Maandag 18 juni 2007;504;253;251;334;164;170;214;210;2.0;2.0;68.0;64.0;1.0;3.0;111;5978;3732;2246;488;284;30.0
4799;Dinsdag 19 juni 2007;525;252;273;373;193;180;131;130;0.0;1.0;47.0;46.0;0.0;1.0;160;4746;2920;1826;412;224;25.0
4800;Woensdag 20 juni 2007;557;287;270;377;164;213;234;229;3.0;2.0;41.0;35.0;5.0;1.0;97;5141;3110;2031;370;302;42.0
4801;Donderdag 21 juni 2007;491;268;223;340;185;155;440;429;4.0;7.0;35.0;33.0;1.0;1.0;157;5075;3201;1874;427;276;576.0
4802;Vrijdag 22 juni 2007;525;261;264;360;171;189;1109;1101;4.0;4.0;32.0;32.0;0.0;0.0;137;4861;3119;1742;302;281;55.0
4803;Zaterdag 23 juni 2007;438;215;223;308;141;167;271;265;5.0;1.0;1.0;1.0;0.0;0.0;1;1474;1067;407;3;59;1.0
4804;Zondag 24 juni 2007;365;193;172;300;138;162;9;8;1.0;0.0;0.0;0.0;0.0;0.0;0;261;157;104;3;40;0.0
4805;Maandag 25 juni 2007;480;230;250;366;177;189;236;230;3.0;3.0;81.0;79.0;1.0;1.0;117;6004;3684;2320;467;435;45.0
4806;Dinsdag 26 juni 2007;490;257;233;336;159;177;177;172;2.0;3.0;37.0;36.0;1.0;0.0;126;4762;2947;1815;376;342;47.0
4807;Woensdag 27 juni 2007;491;264;227;317;152;165;191;188;1.0;2.0;31.0;28.0;0.0;3.0;171;4987;2943;2044;421;368;53.0
4808;Donderdag 28 juni 2007;517;273;244;314;149;165;298;295;3.0;0.0;34.0;31.0;0.0;3.0;118;6030;3712;2318;469;412;16.0
4809;Vrijdag 29 juni 2007;546;285;261;329;177;152;1086;1066;14.0;6.0;18.0;17.0;0.0;1.0;97;6710;4135;2575;406;625;43.0
4810;Zaterdag 30 juni 2007;422;194;228;354;156;198;333;331;2.0;0.0;0.0;0.0;0.0;0.0;0;1819;1309;510;1;313;2.0
4811;Totaal juli 2007;15989;8136;7853;10484;5058;5426;9682;9477;109.0;96.0;909.0;859.0;19.0;31.0;2761;149214;88261;60953;10685;10015;2730.0
4812;Zondag 1 juli 2007;421;203;218;350;175;175;11;11;0.0;0.0;0.0;0.0;0.0;0.0;0;11618;7096;4522;75;692;2.0
4813;Maandag 2 juli 2007;564;293;271;355;168;187;300;294;3.0;3.0;72.0;69.0;1.0;2.0;117;9637;5810;3827;604;550;642.0
4814;Dinsdag 3 juli 2007;477;235;242;328;148;180;159;154;3.0;2.0;48.0;46.0;1.0;1.0;128;6665;3929;2736;490;404;38.0
4815;Woensdag 4 juli 2007;515;278;237;350;178;172;194;194;0.0;0.0;36.0;34.0;0.0;2.0;164;6398;3660;2738;495;363;55.0
4816;Donderdag 5 juli 2007;562;293;269;388;195;193;289;283;2.0;4.0;32.0;30.0;1.0;1.0;151;6536;3766;2770;524;394;41.0
4817;Vrijdag 6 juli 2007;547;288;259;322;152;170;1122;1101;16.0;5.0;23.0;20.0;2.0;1.0;117;5736;3462;2274;392;337;29.0
4818;Zaterdag 7 juli 2007;462;255;207;363;175;188;1888;1842;25.0;21.0;6.0;6.0;0.0;0.0;0;1345;822;523;8;121;0.0
4819;Zondag 8 juli 2007;431;221;210;328;153;175;12;12;0.0;0.0;0.0;0.0;0.0;0.0;1;281;167;114;5;94;1.0
4820;Maandag 9 juli 2007;508;259;249;349;173;176;222;220;2.0;0.0;60.0;58.0;1.0;1.0;135;6783;3888;2895;580;395;273.0
4821;Dinsdag 10 juli 2007;532;270;262;328;135;193;165;163;2.0;0.0;40.0;34.0;1.0;5.0;146;5797;3423;2374;495;375;212.0
4822;Woensdag 11 juli 2007;542;288;254;324;153;171;163;158;2.0;3.0;33.0;33.0;0.0;0.0;139;5393;3140;2253;499;309;24.0
4823;Donderdag 12 juli 2007;535;261;274;343;153;190;254;249;3.0;2.0;33.0;33.0;0.0;0.0;136;5755;3431;2324;498;341;26.0
4824;Vrijdag 13 juli 2007;556;270;286;375;174;201;478;468;6.0;4.0;20.0;17.0;0.0;3.0;124;5210;3132;2078;376;281;10.0
4825;Zaterdag 14 juli 2007;469;239;230;355;161;194;266;259;2.0;5.0;1.0;0.0;0.0;1.0;0;1275;851;424;0;66;0.0
4826;Zondag 15 juli 2007;430;220;210;338;158;180;12;12;0.0;0.0;0.0;0.0;0.0;0.0;0;1507;997;510;16;154;0.0
4827;Maandag 16 juli 2007;526;267;259;350;163;187;180;178;0.0;2.0;69.0;65.0;2.0;2.0;131;7502;4402;3100;540;484;19.0
4828;Dinsdag 17 juli 2007;541;251;290;346;171;175;205;200;2.0;3.0;50.0;48.0;1.0;1.0;129;5138;2917;2221;555;281;15.0
4829;Woensdag 18 juli 2007;595;306;289;304;153;151;159;159;0.0;0.0;25.0;23.0;0.0;2.0;92;5207;3062;2145;443;270;27.0
4830;Donderdag 19 juli 2007;550;296;254;332;178;154;202;197;2.0;3.0;34.0;33.0;0.0;1.0;108;5041;2874;2167;416;284;29.0
4831;Vrijdag 20 juli 2007;525;250;275;305;142;163;1508;1469;17.0;22.0;18.0;15.0;1.0;2.0;112;5356;3246;2110;308;422;22.0
4832;Zaterdag 21 juli 2007;455;219;236;320;144;176;161;159;2.0;0.0;0.0;0.0;0.0;0.0;0;1085;733;352;4;50;1060.0
4833;Zondag 22 juli 2007;440;213;227;331;178;153;13;13;0.0;0.0;0.0;0.0;0.0;0.0;1;219;137;82;4;31;0.0
4834;Maandag 23 juli 2007;540;305;235;359;184;175;198;193;3.0;2.0;63.0;61.0;1.0;1.0;119;6210;3577;2633;522;406;35.0
4835;Dinsdag 24 juli 2007;561;295;266;354;182;172;137;135;1.0;1.0;48.0;46.0;1.0;1.0;130;4823;2793;2030;442;297;17.0
4836;Woensdag 25 juli 2007;550;273;277;348;160;188;166;163;2.0;1.0;42.0;41.0;1.0;0.0;122;5111;3030;2081;427;415;21.0
4837;Donderdag 26 juli 2007;560;269;291;342;182;160;168;162;3.0;3.0;24.0;22.0;1.0;1.0;129;5163;2950;2213;410;490;24.0
4838;Vrijdag 27 juli 2007;588;298;290;311;153;158;587;572;6.0;9.0;14.0;14.0;0.0;0.0;120;5031;2942;2089;317;467;25.0
4839;Zaterdag 28 juli 2007;468;235;233;318;149;169;142;140;1.0;1.0;1.0;1.0;0.0;0.0;0;1084;776;308;2;88;0.0
4840;Zondag 29 juli 2007;427;212;215;322;143;179;10;9;1.0;0.0;0.0;0.0;0.0;0.0;0;370;269;101;3;69;0.0
4841;Maandag 30 juli 2007;551;283;268;316;163;153;183;181;2.0;0.0;70.0;67.0;2.0;1.0;75;6027;3486;2541;650;479;33.0
4842;Dinsdag 31 juli 2007;561;291;270;330;162;168;128;127;1.0;0.0;47.0;43.0;2.0;2.0;135;5911;3493;2418;585;606;50.0
4843;Totaal augustus 2007;16262;8270;7992;10450;5079;5371;7704;7558;69.0;77.0;850.0;806.0;23.0;21.0;2806;152665;84582;68083;13270;10329;2753.0
4844;Woensdag 1 augustus 2007;550;268;282;344;160;184;168;164;2.0;2.0;38.0;34.0;1.0;3.0;89;21506;12458;9048;670;1110;25.0
4845;Donderdag 2 augustus 2007;529;271;258;354;184;170;151;147;2.0;2.0;28.0;27.0;0.0;1.0;97;6147;3390;2757;523;455;35.0
4846;Vrijdag 3 augustus 2007;551;298;253;368;181;187;322;314;5.0;3.0;19.0;18.0;1.0;0.0;101;5277;2880;2397;434;311;20.0
4847;Zaterdag 4 augustus 2007;455;239;216;329;167;162;128;128;0.0;0.0;0.0;0.0;0.0;0.0;1;643;395;248;11;42;1.0
4848;Zondag 5 augustus 2007;445;222;223;326;151;175;18;18;0.0;0.0;0.0;0.0;0.0;0.0;1;226;142;84;4;56;0.0
4849;Maandag 6 augustus 2007;543;277;266;365;169;196;235;228;4.0;3.0;61.0;59.0;1.0;1.0;128;5969;3268;2701;609;345;23.0
4850;Dinsdag 7 augustus 2007;572;297;275;354;196;158;178;175;1.0;2.0;44.0;41.0;2.0;1.0;137;5124;2608;2516;648;254;19.0
4851;Woensdag 8 augustus 2007;571;288;283;335;163;172;195;190;2.0;3.0;36.0;33.0;2.0;1.0;117;5428;2988;2440;488;293;45.0
4852;Donderdag 9 augustus 2007;519;279;240;360;172;188;269;263;2.0;4.0;33.0;31.0;1.0;1.0;105;5205;2895;2310;537;325;990.0
4853;Vrijdag 10 augustus 2007;566;293;273;378;184;194;438;432;3.0;3.0;18.0;18.0;0.0;0.0;96;5501;3129;2372;376;318;14.0
4854;Zaterdag 11 augustus 2007;485;248;237;332;157;175;117;116;1.0;0.0;0.0;0.0;0.0;0.0;0;836;551;285;1;35;2.0
4855;Zondag 12 augustus 2007;449;228;221;340;163;177;16;16;0.0;0.0;0.0;0.0;0.0;0.0;0;311;147;164;4;56;1.0
4856;Maandag 13 augustus 2007;532;257;275;309;149;160;179;174;3.0;2.0;60.0;58.0;1.0;1.0;101;6454;3611;2843;596;420;27.0
4857;Dinsdag 14 augustus 2007;567;279;288;336;175;161;152;148;1.0;3.0;37.0;36.0;1.0;0.0;137;5122;2818;2304;512;345;36.0
4858;Woensdag 15 augustus 2007;552;273;279;333;158;175;155;152;1.0;2.0;38.0;36.0;1.0;1.0;141;7495;4273;3222;531;439;28.0
4859;Donderdag 16 augustus 2007;577;301;276;328;151;177;172;170;1.0;1.0;40.0;37.0;2.0;1.0;131;5633;3078;2555;569;359;14.0
4860;Vrijdag 17 augustus 2007;544;274;270;348;178;170;620;610;4.0;6.0;13.0;12.0;1.0;0.0;93;5069;2933;2136;443;306;780.0
4861;Zaterdag 18 augustus 2007;428;225;203;330;146;184;173;168;5.0;0.0;0.0;0.0;0.0;0.0;0;882;539;343;6;70;0.0
4862;Zondag 19 augustus 2007;470;230;240;304;154;150;8;8;0.0;0.0;0.0;0.0;0.0;0.0;0;238;96;142;3;70;1.0
4863;Maandag 20 augustus 2007;511;245;266;333;172;161;203;196;3.0;4.0;63.0;61.0;0.0;2.0;124;7133;3828;3305;647;465;30.0
4864;Dinsdag 21 augustus 2007;552;269;283;376;197;179;173;168;2.0;3.0;46.0;45.0;1.0;0.0;158;5297;2897;2400;616;330;15.0
4865;Woensdag 22 augustus 2007;532;254;278;341;155;186;174;171;2.0;1.0;28.0;27.0;0.0;1.0;148;5109;2793;2316;592;325;30.0
4866;Donderdag 23 augustus 2007;574;285;289;318;148;170;223;215;3.0;5.0;25.0;24.0;1.0;0.0;159;5268;2862;2406;635;385;38.0
4867;Vrijdag 24 augustus 2007;603;312;291;345;156;189;877;865;5.0;7.0;17.0;16.0;1.0;0.0;113;5158;2811;2347;442;386;40.0
4868;Zaterdag 25 augustus 2007;451;245;206;309;154;155;244;241;2.0;1.0;2.0;2.0;0.0;0.0;3;1372;840;532;8;117;2.0
4869;Zondag 26 augustus 2007;432;216;216;349;167;182;8;8;0.0;0.0;0.0;0.0;0.0;0.0;0;352;163;189;4;110;1.0
4870;Maandag 27 augustus 2007;530;279;251;292;146;146;230;226;1.0;3.0;66.0;62.0;0.0;4.0;107;6347;3418;2929;966;577;8.0
4871;Dinsdag 28 augustus 2007;521;243;278;360;156;204;168;165;0.0;3.0;54.0;50.0;3.0;1.0;136;5057;2758;2299;583;382;8.0
4872;Woensdag 29 augustus 2007;536;275;261;315;146;169;164;159;2.0;3.0;25.0;24.0;0.0;1.0;143;4896;2610;2286;524;418;23.0
4873;Donderdag 30 augustus 2007;575;322;253;321;168;153;334;327;3.0;4.0;34.0;34.0;0.0;0.0;152;6319;3365;2954;691;494;22.0
4874;Vrijdag 31 augustus 2007;540;278;262;318;156;162;1212;1196;9.0;7.0;25.0;21.0;3.0;1.0;88;7291;4038;3253;597;731;475.0
4875;Totaal september 2007;16021;8155;7866;9906;4853;5053;9826;9655;79.0;92.0;812.0;753.0;27.0;32.0;2414;134102;75376;58726;14779;8109;1887.0
4876;Zaterdag 1 september 2007;461;237;224;306;139;167;367;363;2.0;2.0;0.0;0.0;0.0;0.0;0;13821;7526;6295;82;832;0.0
4877;Zondag 2 september 2007;433;231;202;316;149;167;12;12;0.0;0.0;0.0;0.0;0.0;0.0;0;432;170;262;2;74;0.0
4878;Maandag 3 september 2007;525;252;273;320;174;146;223;217;3.0;3.0;76.0;71.0;3.0;2.0;109;8883;4744;4139;904;423;9.0
4879;Dinsdag 4 september 2007;557;298;259;337;156;181;154;149;3.0;2.0;44.0;41.0;1.0;2.0;154;6458;3167;3291;809;376;14.0
4880;Woensdag 5 september 2007;538;269;269;340;163;177;199;191;3.0;5.0;27.0;23.0;4.0;0.0;113;6258;3162;3096;665;310;317.0
4881;Donderdag 6 september 2007;540;292;248;342;147;195;412;402;7.0;3.0;26.0;23.0;1.0;2.0;119;6332;3342;2990;898;319;29.0
4882;Vrijdag 7 september 2007;587;300;287;357;170;187;1677;1655;7.0;15.0;23.0;20.0;2.0;1.0;92;5419;2961;2458;497;304;19.0
4883;Zaterdag 8 september 2007;456;247;209;314;165;149;305;302;2.0;1.0;1.0;0.0;1.0;0.0;0;796;476;320;1;69;0.0
4884;Zondag 9 september 2007;420;220;200;313;151;162;10;10;0.0;0.0;1.0;0.0;0.0;1.0;0;208;120;88;2;56;0.0
4885;Maandag 10 september 2007;563;297;266;319;158;161;266;261;2.0;3.0;71.0;68.0;0.0;3.0;125;6878;3994;2884;728;358;28.0
4886;Dinsdag 11 september 2007;582;286;296;349;181;168;119;115;1.0;3.0;41.0;38.0;0.0;3.0;140;5155;2821;2334;783;248;22.0
4887;Woensdag 12 september 2007;560;273;287;339;161;178;196;194;1.0;1.0;37.0;34.0;2.0;1.0;142;5427;3059;2368;682;278;49.0
4888;Donderdag 13 september 2007;587;293;294;364;187;177;216;209;4.0;3.0;33.0;31.0;1.0;1.0;115;5195;2904;2291;766;360;268.0
4889;Vrijdag 14 september 2007;557;291;266;330;161;169;1271;1258;5.0;8.0;25.0;23.0;1.0;1.0;87;5543;3243;2300;888;286;24.0
4890;Zaterdag 15 september 2007;468;235;233;336;184;152;279;274;2.0;3.0;1.0;0.0;0.0;1.0;0;2006;1292;714;8;170;0.0
4891;Zondag 16 september 2007;418;217;201;332;153;179;6;6;0.0;0.0;0.0;0.0;0.0;0.0;0;330;195;135;1;49;1.0
4892;Maandag 17 september 2007;554;265;289;327;151;176;186;182;1.0;3.0;65.0;64.0;0.0;1.0;101;6425;3826;2599;1066;358;126.0
4893;Dinsdag 18 september 2007;594;310;284;312;160;152;161;157;1.0;3.0;52.0;49.0;1.0;2.0;153;4793;2727;2066;759;253;168.0
4894;Woensdag 19 september 2007;569;291;278;331;162;169;160;152;3.0;5.0;39.0;37.0;2.0;0.0;128;4654;2602;2052;660;241;29.0
4895;Donderdag 20 september 2007;570;262;308;344;174;170;342;337;3.0;2.0;35.0;32.0;2.0;1.0;113;5515;3232;2283;688;315;141.0
4896;Vrijdag 21 september 2007;623;315;308;358;183;175;1157;1141;5.0;11.0;16.0;15.0;0.0;1.0;104;4722;2776;1946;456;310;28.0
4897;Zaterdag 22 september 2007;486;240;246;303;144;159;246;244;1.0;1.0;1.0;1.0;0.0;0.0;0;1032;755;277;1;60;2.0
4898;Zondag 23 september 2007;450;215;235;301;152;149;9;9;0.0;0.0;0.0;0.0;0.0;0.0;0;256;155;101;6;54;0.0
4899;Maandag 24 september 2007;588;301;287;326;149;177;194;190;3.0;1.0;70.0;66.0;1.0;3.0;150;5642;3228;2414;924;370;229.0
4900;Dinsdag 25 september 2007;574;278;296;350;180;170;120;112;3.0;5.0;41.0;38.0;2.0;1.0;112;4704;2691;2013;670;275;21.0
4901;Woensdag 26 september 2007;627;316;311;313;148;165;167;162;3.0;2.0;23.0;22.0;1.0;0.0;127;4900;2794;2106;740;349;303.0
4902;Donderdag 27 september 2007;576;296;280;365;188;177;271;267;4.0;0.0;34.0;32.0;1.0;1.0;117;5288;3140;2148;626;292;40.0
4903;Vrijdag 28 september 2007;596;316;280;311;147;164;922;906;9.0;7.0;27.0;24.0;0.0;3.0;112;5423;3255;2168;453;432;20.0
4904;Zaterdag 29 september 2007;498;266;232;352;159;193;173;172;1.0;0.0;3.0;1.0;1.0;1.0;1;879;543;336;10;78;0.0
4905;Zondag 30 september 2007;464;246;218;299;157;142;6;6;0.0;0.0;0.0;0.0;0.0;0.0;0;728;476;252;4;210;0.0
4906;Totaal oktober 2007;15662;8052;7610;11049;5349;5700;5456;5358;48.0;50.0;972.0;918.0;31.0;23.0;2673;142656;84936;57720;11874;7566;2754.0
4907;Maandag 1 oktober 2007;564;299;265;335;160;175;202;194;5.0;3.0;82.0;78.0;3.0;1.0;97;20065;12231;7834;690;1018;133.0
4908;Dinsdag 2 oktober 2007;579;297;282;383;183;200;114;112;0.0;2.0;40.0;37.0;1.0;2.0;132;5958;3373;2585;656;327;211.0
4909;Woensdag 3 oktober 2007;551;275;276;330;165;165;110;107;1.0;2.0;33.0;31.0;1.0;1.0;100;5673;3306;2367;635;295;165.0
4910;Donderdag 4 oktober 2007;555;270;285;350;164;186;146;143;2.0;1.0;22.0;21.0;0.0;1.0;114;6227;3513;2714;565;285;151.0
4911;Vrijdag 5 oktober 2007;561;291;270;348;173;175;651;639;3.0;9.0;18.0;16.0;1.0;1.0;106;5219;3012;2207;399;297;12.0
4912;Zaterdag 6 oktober 2007;464;258;206;327;148;179;125;125;0.0;0.0;0.0;0.0;0.0;0.0;0;727;510;217;7;41;0.0
4913;Zondag 7 oktober 2007;462;241;221;305;149;156;8;8;0.0;0.0;0.0;0.0;0.0;0.0;0;237;156;81;1;35;4.0
4914;Maandag 8 oktober 2007;566;289;277;370;186;184;144;144;0.0;0.0;70.0;65.0;3.0;2.0;109;6113;3594;2519;727;300;49.0
4915;Dinsdag 9 oktober 2007;538;274;264;358;191;167;123;119;2.0;2.0;43.0;43.0;0.0;0.0;124;4787;2814;1973;555;252;46.0
4916;Woensdag 10 oktober 2007;500;231;269;362;181;181;207;201;1.0;5.0;34.0;31.0;1.0;2.0;111;5345;3235;2110;548;276;45.0
4917;Donderdag 11 oktober 2007;543;286;257;344;166;178;148;144;2.0;2.0;27.0;27.0;0.0;0.0;143;5182;3014;2168;530;226;28.0
4918;Vrijdag 12 oktober 2007;533;282;251;367;180;187;561;549;6.0;6.0;16.0;14.0;1.0;1.0;98;4787;2872;1915;344;276;568.0
4919;Zaterdag 13 oktober 2007;435;229;206;362;186;176;114;110;4.0;0.0;0.0;0.0;0.0;0.0;2;807;534;273;6;47;0.0
4920;Zondag 14 oktober 2007;406;208;198;325;147;178;6;6;0.0;0.0;0.0;0.0;0.0;0.0;0;249;146;103;3;51;0.0
4921;Maandag 15 oktober 2007;503;250;253;356;167;189;184;181;1.0;2.0;67.0;64.0;2.0;1.0;89;8016;5029;2987;711;373;34.0
4922;Dinsdag 16 oktober 2007;563;294;269;373;175;198;125;124;0.0;1.0;55.0;52.0;3.0;0.0;114;4877;2814;2063;514;246;24.0
4923;Woensdag 17 oktober 2007;515;263;252;338;165;173;155;153;2.0;0.0;31.0;29.0;1.0;1.0;128;4547;2596;1951;442;184;29.0
4924;Donderdag 18 oktober 2007;553;295;258;376;173;203;207;206;1.0;0.0;30.0;28.0;1.0;1.0;126;5186;3093;2093;536;232;17.0
4925;Vrijdag 19 oktober 2007;499;259;240;349;175;174;523;513;5.0;5.0;22.0;19.0;2.0;1.0;92;4478;2656;1822;381;265;29.0
4926;Zaterdag 20 oktober 2007;397;214;183;365;163;202;119;118;1.0;0.0;3.0;2.0;0.0;1.0;0;1443;1012;431;2;51;377.0
4927;Zondag 21 oktober 2007;384;205;179;374;179;195;4;4;0.0;0.0;1.0;0.0;1.0;0.0;0;271;188;83;4;38;1.0
4928;Maandag 22 oktober 2007;466;251;215;357;191;166;194;186;5.0;3.0;62.0;61.0;1.0;0.0;124;5644;3235;2409;505;307;14.0
4929;Dinsdag 23 oktober 2007;483;243;240;343;159;184;117;115;1.0;1.0;60.0;56.0;2.0;2.0;122;4450;2597;1853;372;241;33.0
4930;Woensdag 24 oktober 2007;551;291;260;330;157;173;110;109;0.0;1.0;42.0;41.0;0.0;1.0;102;4638;2655;1983;455;250;36.0
4931;Donderdag 25 oktober 2007;516;268;248;382;182;200;161;160;0.0;1.0;31.0;30.0;1.0;0.0;149;5276;3139;2137;494;250;20.0
4932;Vrijdag 26 oktober 2007;554;288;266;386;184;202;435;433;1.0;1.0;29.0;27.0;1.0;1.0;112;4844;2933;1911;348;265;12.0
4933;Zaterdag 27 oktober 2007;447;238;209;351;152;199;89;86;3.0;0.0;1.0;1.0;0.0;0.0;1;1231;855;376;5;69;0.0
4934;Zondag 28 oktober 2007;431;221;210;359;165;194;4;4;0.0;0.0;0.0;0.0;0.0;0.0;0;363;214;149;13;41;0.0
4935;Maandag 29 oktober 2007;505;246;259;395;207;188;152;149;1.0;2.0;72.0;72.0;0.0;0.0;133;5577;3274;2303;502;331;28.0
4936;Dinsdag 30 oktober 2007;496;248;248;362;181;181;118;116;1.0;1.0;48.0;43.0;3.0;2.0;128;4972;3019;1953;481;288;649.0
4937;Woensdag 31 oktober 2007;542;248;294;387;195;192;100;100;0.0;0.0;33.0;30.0;2.0;1.0;117;5467;3317;2150;443;409;39.0
4938;Totaal november 2007;14531;7455;7076;11281;5469;5812;3677;3602;42.0;33.0;917.0;864.0;23.0;30.0;2748;137390;84125;53265;9360;7332;2476.0
4939;Donderdag 1 november 2007;520;269;251;355;182;173;139;137;1.0;1.0;30.0;28.0;0.0;2.0;126;19293;12031;7262;549;845;22.0
4940;Vrijdag 2 november 2007;526;270;256;381;178;203;313;308;4.0;1.0;33.0;28.0;4.0;1.0;103;5678;3258;2420;358;320;56.0
4941;Zaterdag 3 november 2007;430;241;189;380;180;200;44;43;0.0;1.0;0.0;0.0;0.0;0.0;0;776;511;265;1;61;2.0
4942;Zondag 4 november 2007;407;214;193;339;170;169;1;1;0.0;0.0;0.0;0.0;0.0;0.0;0;264;178;86;3;44;0.0
4943;Maandag 5 november 2007;513;272;241;355;177;178;156;153;2.0;1.0;68.0;67.0;0.0;1.0;144;6553;3861;2692;529;315;135.0
4944;Dinsdag 6 november 2007;520;259;261;353;181;172;97;95;1.0;1.0;46.0;46.0;0.0;0.0;139;5313;3076;2237;421;342;297.0
4945;Woensdag 7 november 2007;529;283;246;360;182;178;148;143;3.0;2.0;45.0;44.0;1.0;0.0;92;4982;2984;1998;385;204;20.0
4946;Donderdag 8 november 2007;501;243;258;372;167;205;99;95;1.0;3.0;28.0;26.0;1.0;1.0;129;5328;3163;2165;426;432;23.0
4947;Vrijdag 9 november 2007;484;264;220;380;187;193;285;279;3.0;3.0;17.0;15.0;1.0;1.0;112;4747;2883;1864;290;221;27.0
4948;Zaterdag 10 november 2007;419;219;200;389;172;217;64;64;0.0;0.0;1.0;1.0;0.0;0.0;0;1187;837;350;2;47;0.0
4949;Zondag 11 november 2007;428;212;216;358;156;202;11;11;0.0;0.0;1.0;1.0;0.0;0.0;1;226;154;72;3;37;2.0
4950;Maandag 12 november 2007;519;245;274;344;171;173;144;141;2.0;1.0;67.0;66.0;0.0;1.0;128;5744;3445;2299;517;261;425.0
4951;Dinsdag 13 november 2007;505;265;240;360;188;172;84;84;0.0;0.0;45.0;42.0;1.0;2.0;125;4470;2702;1768;377;233;23.0
4952;Woensdag 14 november 2007;561;281;280;337;152;185;103;99;2.0;2.0;36.0;32.0;3.0;1.0;130;4400;2571;1829;401;181;31.0
4953;Donderdag 15 november 2007;517;252;265;386;166;220;105;101;1.0;3.0;28.0;24.0;2.0;2.0;140;7054;4353;2701;405;336;12.0
4954;Vrijdag 16 november 2007;519;261;258;400;207;193;268;262;4.0;2.0;21.0;19.0;2.0;0.0;120;5053;3104;1949;330;348;41.0
4955;Zaterdag 17 november 2007;424;228;196;398;207;191;59;57;1.0;1.0;1.0;1.0;0.0;0.0;1;1009;654;355;2;36;0.0
4956;Zondag 18 november 2007;368;195;173;362;166;196;6;6;0.0;0.0;0.0;0.0;0.0;0.0;0;304;212;92;1;36;0.0
4957;Maandag 19 november 2007;506;249;257;350;174;176;143;137;2.0;4.0;72.0;67.0;3.0;2.0;120;5734;3422;2312;525;315;464.0
4958;Dinsdag 20 november 2007;518;243;275;374;173;201;124;121;1.0;2.0;55.0;54.0;0.0;1.0;145;5018;3050;1968;432;221;25.0
4959;Woensdag 21 november 2007;504;262;242;414;203;211;96;94;2.0;0.0;30.0;28.0;0.0;2.0;140;4568;2794;1774;406;227;34.0
4960;Donderdag 22 november 2007;511;273;238;403;207;196;141;138;0.0;3.0;31.0;29.0;1.0;1.0;129;4963;2975;1988;348;209;19.0
4961;Vrijdag 23 november 2007;525;263;262;404;188;216;254;252;2.0;0.0;30.0;29.0;0.0;1.0;99;4497;2812;1685;292;238;14.0
4962;Zaterdag 24 november 2007;368;182;186;355;169;186;56;55;1.0;0.0;0.0;0.0;0.0;0.0;0;1369;1003;366;4;43;0.0
4963;Zondag 25 november 2007;379;195;184;363;169;194;3;3;0.0;0.0;0.0;0.0;0.0;0.0;0;411;303;108;5;29;0.0
4964;Maandag 26 november 2007;469;235;234;408;198;210;157;153;4.0;0.0;90.0;83.0;3.0;4.0;133;5688;3467;2221;494;373;422.0
4965;Dinsdag 27 november 2007;525;261;264;391;183;208;98;95;2.0;1.0;43.0;41.0;0.0;2.0;127;4794;2904;1890;503;276;21.0
4966;Woensdag 28 november 2007;508;262;246;429;217;212;90;89;0.0;1.0;32.0;30.0;0.0;2.0;100;5001;3055;1946;493;289;28.0
4967;Donderdag 29 november 2007;513;284;229;371;186;185;101;101;0.0;0.0;39.0;37.0;0.0;2.0;134;5550;3540;2010;476;315;313.0
4968;Vrijdag 30 november 2007;515;273;242;410;213;197;288;285;3.0;0.0;28.0;26.0;1.0;1.0;131;7416;4823;2593;382;498;20.0
4969;Totaal december 2007;14544;7417;7127;12485;6048;6437;3431;3352;42.0;37.0;822.0;776.0;19.0;27.0;2112;123957;76945;47012;6900;7130;1742.0
4970;Zaterdag 1 december 2007;387;212;175;386;178;208;72;71;1.0;0.0;1.0;1.0;0.0;0.0;1;11427;7565;3862;27;403;0.0
4971;Zondag 2 december 2007;364;179;185;409;209;200;0;0;0.0;0.0;0.0;0.0;0.0;0.0;0;275;159;116;3;38;0.0
4972;Maandag 3 december 2007;465;241;224;402;202;200;138;135;1.0;2.0;83.0;81.0;1.0;1.0;119;7790;4671;3119;509;416;50.0
4973;Dinsdag 4 december 2007;506;267;239;376;181;195;93;91;1.0;1.0;47.0;43.0;2.0;2.0;128;5627;3334;2293;417;292;11.0
4974;Woensdag 5 december 2007;400;194;206;392;194;198;84;83;1.0;0.0;28.0;24.0;1.0;3.0;141;5220;3182;2038;367;288;23.0
4975;Donderdag 6 december 2007;491;264;227;419;198;221;86;81;2.0;3.0;37.0;36.0;1.0;0.0;129;5598;3382;2216;484;209;302.0
4976;Vrijdag 7 december 2007;514;238;276;400;207;193;275;272;1.0;2.0;27.0;25.0;0.0;2.0;110;5065;3162;1903;337;220;34.0
4977;Zaterdag 8 december 2007;416;210;206;398;199;199;45;45;0.0;0.0;0.0;0.0;0.0;0.0;1;1098;767;331;3;46;1.0
4978;Zondag 9 december 2007;338;168;170;361;157;204;1;1;0.0;0.0;0.0;0.0;0.0;0.0;0;255;197;58;4;22;0.0
4979;Maandag 10 december 2007;493;251;242;433;211;222;159;153;1.0;5.0;78.0;76.0;0.0;2.0;104;6393;3993;2400;511;302;120.0
4980;Dinsdag 11 december 2007;492;259;233;414;195;219;102;96;1.0;5.0;56.0;54.0;0.0;2.0;123;5064;3071;1993;399;277;35.0
4981;Woensdag 12 december 2007;519;262;257;367;187;180;151;149;2.0;0.0;48.0;44.0;2.0;2.0;116;5078;3102;1976;406;295;21.0
4982;Donderdag 13 december 2007;487;243;244;380;185;195;110;107;2.0;1.0;29.0;27.0;0.0;2.0;129;5326;3245;2081;410;303;18.0
4983;Vrijdag 14 december 2007;519;266;253;387;164;223;341;337;1.0;3.0;26.0;21.0;2.0;3.0;106;5991;3808;2183;321;301;628.0
4984;Zaterdag 15 december 2007;432;224;208;365;195;170;71;68;3.0;0.0;2.0;2.0;0.0;0.0;0;3192;2237;955;2;100;0.0
4985;Zondag 16 december 2007;400;218;182;376;171;205;4;4;0.0;0.0;0.0;0.0;0.0;0.0;0;414;291;123;0;24;0.0
4986;Maandag 17 december 2007;505;248;257;368;179;189;226;221;3.0;2.0;91.0;86.0;1.0;4.0;130;6982;4313;2669;532;311;39.0
4987;Dinsdag 18 december 2007;545;267;278;403;188;215;157;149;3.0;5.0;57.0;56.0;0.0;1.0;126;4884;3009;1875;330;276;27.0
4988;Woensdag 19 december 2007;481;246;235;399;185;214;136;135;1.0;0.0;44.0;40.0;3.0;1.0;124;4837;2945;1892;369;307;26.0
4989;Donderdag 20 december 2007;521;274;247;408;199;209;148;142;6.0;0.0;45.0;44.0;1.0;0.0;152;6035;3688;2347;389;336;69.0
4990;Vrijdag 21 december 2007;544;276;268;409;197;212;435;424;6.0;5.0;35.0;34.0;1.0;0.0;110;5849;3591;2258;284;358;24.0
4991;Zaterdag 22 december 2007;458;245;213;445;225;220;89;88;1.0;0.0;2.0;2.0;0.0;0.0;0;1477;966;511;5;88;0.0
4992;Zondag 23 december 2007;407;204;203;407;186;221;3;3;0.0;0.0;0.0;0.0;0.0;0.0;0;254;162;92;0;46;0.0
4993;Maandag 24 december 2007;529;296;233;413;215;198;78;77;1.0;0.0;19.0;16.0;2.0;1.0;26;2169;1323;846;116;142;4.0
4994;Dinsdag 25 december 2007;422;220;202;410;195;215;5;5;0.0;0.0;0.0;0.0;0.0;0.0;2;165;108;57;1;41;0.0
4995;Woensdag 26 december 2007;417;222;195;401;202;199;4;4;0.0;0.0;0.0;0.0;0.0;0.0;0;143;102;41;0;32;0.0
4996;Donderdag 27 december 2007;505;262;243;427;212;215;110;109;0.0;1.0;31.0;31.0;0.0;0.0;109;7178;4313;2865;358;543;298.0
4997;Vrijdag 28 december 2007;620;288;332;432;215;217;187;183;3.0;1.0;21.0;21.0;0.0;0.0;104;6611;4002;2609;242;439;5.0
4998;Zaterdag 29 december 2007;493;235;258;440;205;235;44;43;0.0;1.0;2.0;1.0;0.0;1.0;0;618;406;212;1;75;0.0
4999;Zondag 30 december 2007;424;209;215;441;200;241;3;3;0.0;0.0;0.0;0.0;0.0;0.0;0;454;285;169;0;63;0.0
5000;Maandag 31 december 2007;450;229;221;417;212;205;74;73;1.0;0.0;13.0;11.0;2.0;0.0;22;2488;1566;922;73;537;7.0
5001;Totaal op zondag in 2007;21515;11009;10506;18171;8728;9443;355;353;2.0;0.0;3.0;1.0;1.0;1.0;12;38489;24556;13933;255;3723;25.0
5002;Totaal op maandag in 2007;26768;13651;13117;19296;9562;9734;8921;8710;109.0;102.0;3375.0;3216.0;70.0;89.0;5762;336880;202058;134822;26496;18748;5806.0
5003;Totaal op dinsdag in 2007;27428;13903;13525;19131;9351;9780;6933;6767;71.0;95.0;2398.0;2266.0;62.0;70.0;7246;277206;165371;111835;24426;15158;5924.0
5004;Totaal op woensdag in 2007;27471;13838;13633;18945;9205;9740;8082;7920;74.0;88.0;1873.0;1751.0;55.0;67.0;6569;285372;169462;115910;23221;15473;3603.0
5005;Totaal op donderdag in 2007;27508;14091;13417;19171;9354;9817;9585;9383;92.0;110.0;1700.0;1611.0;31.0;58.0;6829;333061;201692;131369;23933;17210;6850.0
5006;Totaal op vrijdag in 2007;28027;14380;13647;19509;9482;10027;30127;29648;228.0;251.0;1160.0;1067.0;47.0;46.0;5534;285733;174739;110994;18185;16398;6589.0
5007;Totaal op zaterdag in 2007;22619;11688;10931;18799;9115;9684;8482;8333;87.0;62.0;41.0;33.0;3.0;5.0;31;82439;54738;27701;303;4577;1856.0
5008;Totaal 2008;184634;94838;89796;135136;64902;70234;75438;74030;656.0;752.0;10842.0;10231.0;298.0;313.0;32236;1632391;983138;649253;143516;90067;28229.0
5009;Totaal januari 2008;15071;7792;7279;12849;6162;6687;2765;2717;23.0;25.0;839.0;787.0;30.0;22.0;2909;150835;91428;59407;11236;7602;2145.0
5010;Dinsdag 1 januari 2008;416;230;186;431;205;226;11;11;0.0;0.0;0.0;0.0;0.0;0.0;0;9967;5915;4052;73;723;0.0
5011;Woensdag 2 januari 2008;491;271;220;433;203;230;85;80;3.0;2.0;20.0;18.0;2.0;0.0;108;9909;5643;4266;619;542;22.0
5012;Donderdag 3 januari 2008;528;280;248;427;219;208;94;90;2.0;2.0;35.0;32.0;1.0;2.0;142;8376;4815;3561;570;383;13.0
5013;Vrijdag 4 januari 2008;579;294;285;444;205;239;120;118;0.0;2.0;14.0;14.0;0.0;0.0;109;7215;4186;3029;438;364;19.0
5014;Zaterdag 5 januari 2008;487;252;235;382;206;176;42;42;0.0;0.0;0.0;0.0;0.0;0.0;2;995;651;344;7;99;1.0
5015;Zondag 6 januari 2008;404;213;191;415;209;206;10;10;0.0;0.0;0.0;0.0;0.0;0.0;1;363;224;139;2;53;1.0
5016;Maandag 7 januari 2008;503;249;254;464;209;255;160;157;2.0;1.0;82.0;71.0;6.0;5.0;149;8073;4746;3327;625;392;209.0
5017;Dinsdag 8 januari 2008;528;279;249;465;229;236;137;134;1.0;2.0;52.0;50.0;1.0;1.0;151;6241;3541;2700;580;282;35.0
5018;Woensdag 9 januari 2008;530;278;252;437;204;233;100;98;0.0;2.0;30.0;28.0;1.0;1.0;135;6134;3743;2391;554;220;43.0
5019;Donderdag 10 januari 2008;499;241;258;430;220;210;94;91;3.0;0.0;22.0;20.0;2.0;0.0;130;6694;4153;2541;515;247;41.0
5020;Vrijdag 11 januari 2008;504;275;229;435;195;240;125;124;1.0;0.0;16.0;14.0;1.0;1.0;137;5345;3366;1979;420;223;27.0
5021;Zaterdag 12 januari 2008;419;204;215;412;186;226;33;33;0.0;0.0;0.0;0.0;0.0;0.0;2;969;692;277;3;42;0.0
5022;Zondag 13 januari 2008;397;208;189;402;187;215;3;3;0.0;0.0;0.0;0.0;0.0;0.0;0;251;161;90;3;45;0.0
5023;Maandag 14 januari 2008;522;255;267;443;225;218;147;145;0.0;2.0;75.0;73.0;0.0;2.0;128;6561;4066;2495;544;314;39.0
5024;Dinsdag 15 januari 2008;516;251;265;436;209;227;106;104;2.0;0.0;43.0;42.0;1.0;0.0;146;7008;4399;2609;513;315;42.0
5025;Woensdag 16 januari 2008;534;263;271;419;196;223;96;95;0.0;1.0;31.0;29.0;1.0;1.0;127;5644;3449;2195;446;254;39.0
5026;Donderdag 17 januari 2008;509;264;245;422;204;218;87;86;0.0;1.0;30.0;27.0;1.0;2.0;129;5625;3347;2278;516;219;18.0
5027;Vrijdag 18 januari 2008;521;269;252;373;177;196;186;185;1.0;0.0;22.0;21.0;0.0;1.0;137;4859;3078;1781;366;214;306.0
5028;Zaterdag 19 januari 2008;422;200;222;394;188;206;44;43;1.0;0.0;1.0;0.0;0.0;1.0;2;962;641;321;8;38;0.0
5029;Zondag 20 januari 2008;384;203;181;441;201;240;6;6;0.0;0.0;0.0;0.0;0.0;0.0;0;604;384;220;8;58;0.0
5030;Maandag 21 januari 2008;502;272;230;427;197;230;134;131;2.0;1.0;75.0;69.0;4.0;2.0;129;5988;3708;2280;616;288;460.0
5031;Dinsdag 22 januari 2008;514;256;258;407;218;189;90;90;0.0;0.0;40.0;40.0;0.0;0.0;143;4841;2978;1863;487;238;13.0
5032;Woensdag 23 januari 2008;545;286;259;407;215;192;77;75;1.0;1.0;35.0;34.0;1.0;0.0;140;4825;2970;1855;455;230;19.0
5033;Donderdag 24 januari 2008;534;259;275;408;182;226;94;94;0.0;0.0;36.0;31.0;5.0;0.0;144;5215;3242;1973;444;222;230.0
5034;Vrijdag 25 januari 2008;470;250;220;406;187;219;218;214;1.0;3.0;18.0;15.0;1.0;2.0;123;4910;2957;1953;371;240;12.0
5035;Zaterdag 26 januari 2008;406;236;170;379;186;193;47;47;0.0;0.0;0.0;0.0;0.0;0.0;0;1282;909;373;2;46;2.0
5036;Zondag 27 januari 2008;408;190;218;339;162;177;8;8;0.0;0.0;0.0;0.0;0.0;0.0;1;260;171;89;3;54;2.0
5037;Maandag 28 januari 2008;495;271;224;393;196;197;150;147;1.0;2.0;67.0;67.0;0.0;0.0;118;5838;3576;2262;599;339;186.0
5038;Dinsdag 29 januari 2008;498;264;234;396;178;218;87;87;0.0;0.0;30.0;29.0;1.0;0.0;120;4669;2846;1823;452;226;15.0
5039;Woensdag 30 januari 2008;528;268;260;379;180;199;81;77;1.0;3.0;33.0;32.0;1.0;0.0;120;5034;3044;1990;468;304;320.0
5040;Donderdag 31 januari 2008;478;261;217;403;184;219;93;92;1.0;0.0;32.0;31.0;0.0;1.0;136;6178;3827;2351;529;388;31.0
5041;Totaal februari 2008;14236;7316;6920;11380;5499;5881;3483;3423;37.0;23.0;806.0;768.0;22.0;16.0;2633;130931;80077;50854;10954;6706;2289.0
5042;Vrijdag 1 februari 2008;497;263;234;405;204;201;153;153;0.0;0.0;9.0;7.0;1.0;1.0;119;18501;11390;7111;443;716;29.0
5043;Zaterdag 2 februari 2008;462;236;226;390;189;201;46;46;0.0;0.0;0.0;0.0;0.0;0.0;0;751;480;271;5;69;1.0
5044;Zondag 3 februari 2008;391;204;187;367;176;191;6;5;1.0;0.0;0.0;0.0;0.0;0.0;1;241;149;92;27;62;0.0
5045;Maandag 4 februari 2008;510;270;240;391;199;192;133;132;0.0;1.0;52.0;52.0;0.0;0.0;110;5941;3583;2358;499;260;354.0
5046;Dinsdag 5 februari 2008;534;277;257;388;185;203;80;78;1.0;1.0;38.0;35.0;3.0;0.0;115;4862;2911;1951;449;384;30.0
5047;Woensdag 6 februari 2008;510;273;237;425;211;214;66;63;3.0;0.0;46.0;44.0;1.0;1.0;131;5566;3158;2408;509;251;34.0
5048;Donderdag 7 februari 2008;533;274;259;356;177;179;86;85;1.0;0.0;23.0;21.0;1.0;1.0;118;5585;3229;2356;469;242;23.0
5049;Vrijdag 8 februari 2008;535;286;249;383;182;201;304;300;2.0;2.0;23.0;22.0;1.0;0.0;169;5003;3025;1978;414;269;265.0
5050;Zaterdag 9 februari 2008;428;208;220;348;177;171;35;34;0.0;1.0;3.0;3.0;0.0;0.0;1;826;595;231;7;42;128.0
5051;Zondag 10 februari 2008;398;225;173;385;210;175;4;4;0.0;0.0;0.0;0.0;0.0;0.0;0;426;276;150;6;66;0.0
5052;Maandag 11 februari 2008;504;262;242;389;177;212;123;120;2.0;1.0;65.0;63.0;1.0;1.0;133;5863;3421;2442;660;303;27.0
5053;Dinsdag 12 februari 2008;500;252;248;399;179;220;103;103;0.0;0.0;41.0;40.0;1.0;0.0;153;4659;2812;1847;653;211;26.0
5054;Woensdag 13 februari 2008;473;239;234;381;180;201;58;57;1.0;0.0;37.0;37.0;0.0;0.0;109;4575;2837;1738;624;177;27.0
5055;Donderdag 14 februari 2008;549;285;264;402;200;202;298;295;1.0;2.0;41.0;41.0;0.0;0.0;134;5244;3170;2074;639;211;36.0
5056;Vrijdag 15 februari 2008;527;274;253;388;195;193;193;190;1.0;2.0;14.0;14.0;0.0;0.0;112;6562;4206;2356;624;312;25.0
5057;Zaterdag 16 februari 2008;439;215;224;375;174;201;53;51;2.0;0.0;0.0;0.0;0.0;0.0;1;1109;778;331;1;49;1.0
5058;Zondag 17 februari 2008;399;219;180;369;169;200;4;4;0.0;0.0;0.0;0.0;0.0;0.0;0;267;186;81;3;34;2.0
5059;Maandag 18 februari 2008;480;251;229;386;197;189;152;150;1.0;1.0;54.0;54.0;0.0;0.0;130;5732;3445;2287;660;279;41.0
5060;Dinsdag 19 februari 2008;519;262;257;419;185;234;92;88;4.0;0.0;55.0;50.0;3.0;2.0;118;4494;2599;1895;559;231;18.0
5061;Woensdag 20 februari 2008;505;261;244;412;219;193;113;108;3.0;2.0;33.0;32.0;1.0;0.0;130;4905;3053;1852;489;228;28.0
5062;Donderdag 21 februari 2008;545;267;278;418;199;219;128;126;1.0;1.0;31.0;29.0;0.0;2.0;113;4911;3022;1889;478;276;37.0
5063;Vrijdag 22 februari 2008;537;274;263;388;179;209;254;251;2.0;1.0;18.0;18.0;0.0;0.0;109;4715;2974;1741;340;241;22.0
5064;Zaterdag 23 februari 2008;422;221;201;394;181;213;46;45;1.0;0.0;0.0;0.0;0.0;0.0;0;1444;1041;403;4;82;1.0
5065;Zondag 24 februari 2008;410;205;205;404;179;225;4;4;0.0;0.0;0.0;0.0;0.0;0.0;0;299;192;107;2;46;2.0
5066;Maandag 25 februari 2008;544;274;270;426;195;231;169;168;1.0;0.0;79.0;74.0;3.0;2.0;125;5831;3595;2236;596;332;574.0
5067;Dinsdag 26 februari 2008;568;290;278;362;172;190;103;102;0.0;1.0;45.0;40.0;3.0;2.0;134;4748;2892;1856;438;255;272.0
5068;Woensdag 27 februari 2008;524;249;275;408;188;220;96;96;0.0;0.0;29.0;29.0;0.0;0.0;115;4877;2935;1942;411;249;100.0
5069;Donderdag 28 februari 2008;512;260;252;409;211;198;131;128;2.0;1.0;34.0;32.0;2.0;0.0;132;5770;3594;2176;513;376;45.0
5070;Vrijdag 29 februari 2008;481;240;241;413;210;203;450;437;7.0;6.0;36.0;31.0;1.0;4.0;121;7224;4529;2695;432;453;141.0
5071;Totaal maart 2008;14771;7615;7156;12079;5838;6241;3445;3388;21.0;36.0;873.0;815.0;30.0;28.0;2684;128084;79884;48200;9580;6295;2768.0
5072;Zaterdag 1 maart 2008;450;242;208;388;181;207;55;54;1.0;0.0;1.0;1.0;0.0;0.0;1;11696;7479;4217;45;460;1.0
5073;Zondag 2 maart 2008;414;218;196;369;177;192;3;3;0.0;0.0;0.0;0.0;0.0;0.0;1;334;223;111;0;36;2.0
5074;Maandag 3 maart 2008;531;265;266;398;205;193;187;182;3.0;2.0;80.0;78.0;1.0;1.0;125;8283;5123;3160;593;320;276.0
5075;Dinsdag 4 maart 2008;491;247;244;413;230;183;104;102;0.0;2.0;50.0;46.0;2.0;2.0;150;5913;3536;2377;581;234;43.0
5076;Woensdag 5 maart 2008;538;282;256;412;205;207;120;116;0.0;4.0;39.0;38.0;1.0;0.0;173;5779;3363;2416;444;210;22.0
5077;Donderdag 6 maart 2008;486;233;253;397;191;206;104;101;1.0;2.0;23.0;22.0;0.0;1.0;156;5850;3540;2310;463;226;281.0
5078;Vrijdag 7 maart 2008;503;255;248;426;217;209;252;251;1.0;0.0;21.0;19.0;1.0;1.0;108;5147;3156;1991;318;211;6.0
5079;Zaterdag 8 maart 2008;455;235;220;391;198;193;73;72;0.0;1.0;1.0;1.0;0.0;0.0;0;964;716;248;7;48;0.0
5080;Zondag 9 maart 2008;426;219;207;403;187;216;5;5;0.0;0.0;0.0;0.0;0.0;0.0;1;199;134;65;4;41;0.0
5081;Maandag 10 maart 2008;470;251;219;399;181;218;159;157;1.0;1.0;61.0;56.0;3.0;2.0;117;6144;3785;2359;577;261;390.0
5082;Dinsdag 11 maart 2008;568;299;269;376;171;205;87;86;1.0;0.0;52.0;48.0;2.0;2.0;136;4684;2923;1761;502;193;35.0
5083;Woensdag 12 maart 2008;505;251;254;396;191;205;118;117;0.0;1.0;33.0;32.0;0.0;1.0;147;4486;2751;1735;465;226;37.0
5084;Donderdag 13 maart 2008;504;278;226;371;187;184;65;64;0.0;1.0;31.0;30.0;0.0;1.0;150;4979;3114;1865;462;202;24.0
5085;Vrijdag 14 maart 2008;550;292;258;416;231;185;251;250;0.0;1.0;20.0;15.0;2.0;3.0;131;5305;3332;1973;391;215;23.0
5086;Zaterdag 15 maart 2008;380;211;169;397;192;205;55;53;1.0;1.0;1.0;1.0;0.0;0.0;0;2414;1641;773;7;116;1.0
5087;Zondag 16 maart 2008;404;195;209;363;159;204;2;2;0.0;0.0;0.0;0.0;0.0;0.0;0;344;223;121;4;47;0.0
5088;Maandag 17 maart 2008;491;256;235;409;200;209;160;158;0.0;2.0;87.0;81.0;1.0;5.0;133;6089;3878;2211;578;344;523.0
5089;Dinsdag 18 maart 2008;534;261;273;384;168;216;114;113;0.0;1.0;55.0;55.0;0.0;0.0;149;4774;3001;1773;487;227;33.0
5090;Woensdag 19 maart 2008;523;300;223;375;183;192;118;116;1.0;1.0;34.0;30.0;3.0;1.0;128;4550;2775;1775;485;200;45.0
5091;Donderdag 20 maart 2008;534;282;252;361;163;198;178;174;0.0;4.0;38.0;34.0;3.0;1.0;164;5572;3440;2132;463;278;518.0
5092;Vrijdag 21 maart 2008;508;258;250;374;205;169;116;116;0.0;0.0;6.0;6.0;0.0;0.0;8;1844;1224;620;85;112;7.0
5093;Zaterdag 22 maart 2008;413;215;198;408;202;206;51;51;0.0;0.0;0.0;0.0;0.0;0.0;0;1069;802;267;1;41;3.0
5094;Zondag 23 maart 2008;404;192;212;353;164;189;5;5;0.0;0.0;0.0;0.0;0.0;0.0;0;208;135;73;4;25;0.0
5095;Maandag 24 maart 2008;404;208;196;374;177;197;16;15;1.0;0.0;0.0;0.0;0.0;0.0;5;374;268;106;1;37;0.0
5096;Dinsdag 25 maart 2008;477;254;223;363;158;205;128;125;1.0;2.0;61.0;55.0;4.0;2.0;140;6290;3793;2497;529;368;9.0
5097;Woensdag 26 maart 2008;494;262;232;388;175;213;119;117;1.0;1.0;30.0;30.0;0.0;0.0;142;4972;3024;1948;586;348;24.0
5098;Donderdag 27 maart 2008;485;245;240;436;208;228;140;135;1.0;4.0;39.0;35.0;3.0;1.0;152;5438;3430;2008;520;338;20.0
5099;Vrijdag 28 maart 2008;538;273;265;405;186;219;386;380;2.0;4.0;26.0;22.0;0.0;4.0;138;5531;3431;2100;405;338;11.0
5100;Zaterdag 29 maart 2008;377;186;191;349;174;175;71;70;1.0;0.0;2.0;2.0;0.0;0.0;0;1150;780;370;1;76;0.0
5101;Zondag 30 maart 2008;406;195;211;385;196;189;7;6;1.0;0.0;0.0;0.0;0.0;0.0;0;415;286;129;4;59;0.0
5102;Maandag 31 maart 2008;508;255;253;400;176;224;196;192;3.0;1.0;82.0;78.0;4.0;0.0;129;7287;4578;2709;568;458;434.0
5103;Totaal april 2008;14804;7480;7324;11366;5391;5975;6081;5984;40.0;57.0;946.0;884.0;27.0;35.0;2861;132793;83110;49683;10337;6466;2536.0
5104;Dinsdag 1 april 2008;501;255;246;417;193;224;198;192;2.0;4.0;59.0;53.0;3.0;3.0;137;19478;12653;6825;599;808;33.0
5105;Woensdag 2 april 2008;529;257;272;391;186;205;134;132;0.0;2.0;37.0;35.0;1.0;1.0;138;5791;3483;2308;545;231;37.0
5106;Donderdag 3 april 2008;563;295;268;369;175;194;125;125;0.0;0.0;24.0;22.0;0.0;2.0;125;6126;3624;2502;524;240;39.0
5107;Vrijdag 4 april 2008;507;250;257;408;202;206;651;640;6.0;5.0;24.0;21.0;0.0;3.0;100;5585;3483;2102;449;329;395.0
5108;Zaterdag 5 april 2008;398;207;191;369;180;189;98;96;2.0;0.0;0.0;0.0;0.0;0.0;0;937;643;294;5;67;1.0
5109;Zondag 6 april 2008;405;208;197;358;159;199;3;3;0.0;0.0;0.0;0.0;0.0;0.0;0;235;155;80;2;33;0.0
5110;Maandag 7 april 2008;518;261;257;343;171;172;154;151;1.0;2.0;67.0;65.0;2.0;0.0;126;5878;3555;2323;593;321;20.0
5111;Dinsdag 8 april 2008;514;238;276;370;175;195;145;142;1.0;2.0;39.0;38.0;0.0;1.0;151;4813;2863;1950;583;199;36.0
5112;Woensdag 9 april 2008;495;259;236;382;192;190;100;96;3.0;1.0;44.0;42.0;0.0;2.0;144;4615;2770;1845;482;189;159.0
5113;Donderdag 10 april 2008;531;267;264;367;178;189;137;136;0.0;1.0;31.0;29.0;1.0;1.0;151;5377;3358;2019;502;290;418.0
5114;Vrijdag 11 april 2008;481;251;230;438;203;235;344;337;2.0;5.0;24.0;19.0;2.0;3.0;142;4406;2810;1596;395;183;18.0
5115;Zaterdag 12 april 2008;433;229;204;389;191;198;112;111;1.0;0.0;2.0;2.0;0.0;0.0;0;1110;772;338;4;63;2.0
5116;Zondag 13 april 2008;375;181;194;354;163;191;3;3;0.0;0.0;0.0;0.0;0.0;0.0;0;210;138;72;1;27;0.0
5117;Maandag 14 april 2008;498;267;231;356;176;180;174;171;0.0;3.0;75.0;73.0;1.0;1.0;105;5661;3575;2086;591;290;52.0
5118;Dinsdag 15 april 2008;521;267;254;366;171;195;129;128;1.0;0.0;53.0;50.0;2.0;1.0;134;6293;4010;2283;462;257;24.0
5119;Woensdag 16 april 2008;520;262;258;378;171;207;130;130;0.0;0.0;44.0;44.0;0.0;0.0;149;4891;3003;1888;464;185;512.0
5120;Donderdag 17 april 2008;514;244;270;401;193;208;133;129;1.0;3.0;33.0;32.0;1.0;0.0;125;4794;2953;1841;497;197;26.0
5121;Vrijdag 18 april 2008;555;287;268;404;182;222;571;563;0.0;8.0;17.0;14.0;1.0;2.0;132;4725;3015;1710;395;218;12.0
5122;Zaterdag 19 april 2008;446;228;218;393;185;208;125;123;2.0;0.0;0.0;0.0;0.0;0.0;1;1065;804;261;9;56;2.0
5123;Zondag 20 april 2008;432;238;194;377;185;192;7;7;0.0;0.0;0.0;0.0;0.0;0.0;0;585;420;165;11;44;0.0
5124;Maandag 21 april 2008;536;283;253;387;187;200;186;182;3.0;1.0;82.0;79.0;2.0;1.0;102;5352;3406;1946;578;284;44.0
5125;Dinsdag 22 april 2008;540;275;265;387;175;212;157;155;0.0;2.0;53.0;50.0;1.0;2.0;143;4343;2707;1636;490;210;17.0
5126;Woensdag 23 april 2008;506;268;238;351;164;187;169;163;3.0;3.0;37.0;35.0;0.0;2.0;159;4124;2490;1634;401;220;30.0
5127;Donderdag 24 april 2008;526;242;284;382;189;193;309;306;2.0;1.0;30.0;26.0;2.0;2.0;143;4813;3051;1762;415;268;593.0
5128;Vrijdag 25 april 2008;543;263;280;346;171;175;880;871;4.0;5.0;27.0;21.0;2.0;4.0;150;5195;3276;1919;361;272;20.0
5129;Zaterdag 26 april 2008;398;210;188;371;175;196;195;193;1.0;1.0;3.0;2.0;1.0;0.0;2;1530;1086;444;7;48;3.0
5130;Zondag 27 april 2008;443;243;200;361;169;192;10;10;0.0;0.0;0.0;0.0;0.0;0.0;0;273;179;94;0;33;0.0
5131;Maandag 28 april 2008;545;272;273;401;178;223;308;301;3.0;4.0;78.0;76.0;2.0;0.0;138;6834;4164;2670;474;362;19.0
5132;Dinsdag 29 april 2008;566;246;320;377;182;195;346;340;2.0;4.0;63.0;56.0;3.0;4.0;162;6930;4119;2811;495;388;24.0
5133;Woensdag 30 april 2008;465;227;238;373;170;203;48;48;0.0;0.0;0.0;0.0;0.0;0.0;2;824;545;279;3;154;0.0
5134;Totaal mei 2008;15597;8126;7471;11328;5443;5885;8767;8606;80.0;81.0;764.0;735.0;15.0;14.0;2504;120613;75326;45287;8961;5817;1927.0
5135;Donderdag 1 mei 2008;461;247;214;353;169;184;19;19;0.0;0.0;0.0;0.0;0.0;0.0;0;9347;6147;3200;36;390;2.0
5136;Vrijdag 2 mei 2008;512;275;237;343;152;191;490;484;4.0;2.0;5.0;5.0;0.0;0.0;33;2734;1755;979;184;172;1.0
5137;Zaterdag 3 mei 2008;461;239;222;356;171;185;175;173;1.0;1.0;1.0;1.0;0.0;0.0;0;511;373;138;5;35;0.0
5138;Zondag 4 mei 2008;403;225;178;363;180;183;6;6;0.0;0.0;0.0;0.0;0.0;0.0;0;219;145;74;2;43;0.0
5139;Maandag 5 mei 2008;444;242;202;410;202;208;40;39;0.0;1.0;5.0;5.0;0.0;0.0;10;1548;1041;507;17;75;1.0
5140;Dinsdag 6 mei 2008;569;308;261;351;178;173;200;196;3.0;1.0;52.0;50.0;2.0;0.0;182;9012;5185;3827;706;343;16.0
5141;Woensdag 7 mei 2008;578;304;274;414;202;212;207;204;2.0;1.0;38.0;37.0;0.0;1.0;149;6069;3592;2477;576;251;41.0
5142;Donderdag 8 mei 2008;600;307;293;395;190;205;329;320;2.0;7.0;35.0;35.0;0.0;0.0;149;5898;3528;2370;578;209;581.0
5143;Vrijdag 9 mei 2008;541;297;244;370;170;200;729;721;3.0;5.0;31.0;30.0;0.0;1.0;103;5253;3225;2028;432;220;11.0
5144;Zaterdag 10 mei 2008;459;228;231;404;198;206;178;175;2.0;1.0;1.0;1.0;0.0;0.0;1;1083;777;306;4;56;0.0
5145;Zondag 11 mei 2008;459;242;217;374;179;195;10;9;1.0;0.0;0.0;0.0;0.0;0.0;1;171;125;46;1;27;0.0
5146;Maandag 12 mei 2008;427;208;219;342;158;184;12;11;1.0;0.0;0.0;0.0;0.0;0.0;3;487;322;165;2;43;0.0
5147;Dinsdag 13 mei 2008;493;250;243;414;208;206;151;149;1.0;1.0;54.0;52.0;1.0;1.0;133;5281;3222;2059;507;225;21.0
5148;Woensdag 14 mei 2008;543;295;248;388;185;203;180;177;2.0;1.0;49.0;48.0;0.0;1.0;139;5381;3302;2079;532;228;65.0
5149;Donderdag 15 mei 2008;528;268;260;379;179;200;283;279;2.0;2.0;40.0;38.0;0.0;2.0;140;7294;4583;2711;455;284;22.0
5150;Vrijdag 16 mei 2008;529;270;259;363;159;204;937;922;8.0;7.0;26.0;26.0;0.0;0.0;121;5352;3347;2005;383;216;26.0
5151;Zaterdag 17 mei 2008;489;259;230;334;146;188;212;207;4.0;1.0;0.0;0.0;0.0;0.0;0;884;621;263;3;47;0.0
5152;Zondag 18 mei 2008;434;196;238;335;172;163;4;4;0.0;0.0;0.0;0.0;0.0;0.0;0;276;172;104;4;30;0.0
5153;Maandag 19 mei 2008;485;239;246;321;169;152;240;231;5.0;4.0;90.0;89.0;1.0;0.0;118;5679;3498;2181;551;278;34.0
5154;Dinsdag 20 mei 2008;520;277;243;358;187;171;179;175;1.0;3.0;52.0;50.0;0.0;2.0;114;4968;3092;1876;473;217;324.0
5155;Woensdag 21 mei 2008;553;284;269;357;162;195;182;175;3.0;4.0;39.0;36.0;1.0;2.0;149;4444;2723;1721;427;190;48.0
5156;Donderdag 22 mei 2008;534;276;258;357;168;189;278;272;3.0;3.0;29.0;27.0;1.0;1.0;134;4645;2892;1753;478;223;41.0
5157;Vrijdag 23 mei 2008;560;286;274;404;189;215;1046;1030;7.0;9.0;23.0;23.0;0.0;0.0;112;4652;2954;1698;346;248;541.0
5158;Zaterdag 24 mei 2008;448;209;239;379;176;203;267;266;1.0;0.0;0.0;0.0;0.0;0.0;0;1226;886;340;3;41;1.0
5159;Zondag 25 mei 2008;425;213;212;368;183;185;7;7;0.0;0.0;0.0;0.0;0.0;0.0;1;421;320;101;3;38;0.0
5160;Maandag 26 mei 2008;546;277;269;338;164;174;252;247;4.0;1.0;58.0;55.0;2.0;1.0;143;5564;3489;2075;505;308;42.0
5161;Dinsdag 27 mei 2008;548;297;251;369;178;191;182;177;3.0;2.0;55.0;52.0;3.0;0.0;153;4757;3014;1743;505;263;33.0
5162;Woensdag 28 mei 2008;544;279;265;337;162;175;204;195;3.0;6.0;39.0;37.0;1.0;1.0;156;4768;2890;1878;425;250;42.0
5163;Donderdag 29 mei 2008;512;296;216;335;156;179;290;284;3.0;3.0;22.0;19.0;2.0;1.0;151;5207;3277;1930;426;287;18.0
5164;Vrijdag 30 mei 2008;543;307;236;350;174;176;1228;1209;9.0;10.0;20.0;19.0;1.0;0.0;108;6162;3856;2306;389;360;16.0
5165;Zaterdag 31 mei 2008;449;226;223;367;177;190;250;243;2.0;5.0;0.0;0.0;0.0;0.0;1;1320;973;347;3;220;0.0
5166;Totaal juni 2008;15418;7916;7502;10444;5074;5370;9407;9253;67.0;87.0;907.0;849.0;23.0;35.0;2708;129630;79894;49736;10372;7570;2768.0
5167;Zondag 1 juni 2008;438;210;228;361;183;178;9;9;0.0;0.0;0.0;0.0;0.0;0.0;2;8877;5741;3136;42;441;1.0
5168;Maandag 2 juni 2008;496;268;228;343;161;182;243;239;2.0;2.0;85.0;81.0;2.0;2.0;118;8622;5231;3391;591;318;472.0
5169;Dinsdag 3 juni 2008;549;286;263;348;172;176;148;146;0.0;2.0;57.0;54.0;2.0;1.0;145;5492;3216;2276;526;257;25.0
5170;Woensdag 4 juni 2008;579;301;278;384;178;206;278;271;2.0;5.0;31.0;29.0;1.0;1.0;149;5347;3107;2240;497;210;34.0
5171;Donderdag 5 juni 2008;525;275;250;337;160;177;303;297;2.0;4.0;34.0;32.0;0.0;2.0;149;5680;3421;2259;531;209;27.0
5172;Vrijdag 6 juni 2008;554;285;269;353;186;167;1302;1287;9.0;6.0;23.0;20.0;1.0;2.0;123;5124;3133;1991;365;245;20.0
5173;Zaterdag 7 juni 2008;429;221;208;320;154;166;326;317;4.0;5.0;0.0;0.0;0.0;0.0;1;904;643;261;10;50;0.0
5174;Zondag 8 juni 2008;453;220;233;309;150;159;13;13;0.0;0.0;0.0;0.0;0.0;0.0;0;293;196;97;4;41;2.0
5175;Maandag 9 juni 2008;528;253;275;343;155;188;192;187;5.0;0.0;58.0;52.0;2.0;4.0;128;5871;3588;2283;530;276;24.0
5176;Dinsdag 10 juni 2008;544;283;261;365;187;178;168;164;1.0;3.0;41.0;39.0;0.0;2.0;154;4615;2868;1747;490;205;171.0
5177;Woensdag 11 juni 2008;541;285;256;361;188;173;178;176;1.0;1.0;36.0;32.0;0.0;4.0;136;4274;2646;1628;432;213;15.0
5178;Donderdag 12 juni 2008;552;280;272;378;179;199;292;289;0.0;3.0;31.0;29.0;0.0;2.0;134;4891;3053;1838;481;214;274.0
5179;Vrijdag 13 juni 2008;544;273;271;356;183;173;669;657;4.0;8.0;24.0;20.0;1.0;3.0;129;4467;2791;1676;379;308;13.0
5180;Zaterdag 14 juni 2008;413;226;187;322;153;169;283;276;2.0;5.0;1.0;1.0;0.0;0.0;2;1004;700;304;4;87;0.0
5181;Zondag 15 juni 2008;418;204;214;337;151;186;11;11;0.0;0.0;0.0;0.0;0.0;0.0;0;1344;925;419;5;120;0.0
5182;Maandag 16 juni 2008;507;272;235;349;166;183;201;194;2.0;5.0;71.0;66.0;4.0;1.0;120;6776;4150;2626;547;344;320.0
5183;Dinsdag 17 juni 2008;548;271;277;312;150;162;132;130;1.0;1.0;49.0;48.0;0.0;1.0;140;4552;2660;1892;517;224;24.0
5184;Woensdag 18 juni 2008;596;308;288;332;165;167;168;167;0.0;1.0;27.0;27.0;0.0;0.0;124;4673;2830;1843;467;238;24.0
5185;Donderdag 19 juni 2008;544;273;271;364;177;187;250;248;1.0;1.0;33.0;31.0;2.0;0.0;144;4715;2870;1845;458;276;15.0
5186;Vrijdag 20 juni 2008;552;281;271;347;163;184;1343;1321;10.0;12.0;18.0;12.0;3.0;3.0;110;5130;3246;1884;375;332;30.0
5187;Zaterdag 21 juni 2008;430;237;193;350;169;181;362;354;4.0;4.0;1.0;1.0;0.0;0.0;1;1181;803;378;3;87;1.0
5188;Zondag 22 juni 2008;471;226;245;337;171;166;8;8;0.0;0.0;0.0;0.0;0.0;0.0;1;312;216;96;3;53;1.0
5189;Maandag 23 juni 2008;530;266;264;366;181;185;233;227;4.0;2.0;61.0;60.0;0.0;1.0;140;5538;3483;2055;525;376;673.0
5190;Dinsdag 24 juni 2008;549;301;248;335;170;165;184;180;2.0;2.0;52.0;47.0;2.0;3.0;117;4872;2930;1942;444;293;16.0
5191;Woensdag 25 juni 2008;583;304;279;389;183;206;209;204;3.0;2.0;37.0;36.0;0.0;1.0;100;4937;2991;1946;466;328;25.0
5192;Donderdag 26 juni 2008;564;283;281;316;151;165;298;295;2.0;1.0;39.0;37.0;2.0;0.0;131;5251;3199;2052;516;374;16.0
5193;Vrijdag 27 juni 2008;556;300;256;379;178;201;1096;1085;3.0;8.0;24.0;24.0;0.0;0.0;105;5217;3212;2005;394;474;531.0
5194;Zaterdag 28 juni 2008;465;237;228;369;184;185;290;286;1.0;3.0;2.0;2.0;0.0;0.0;1;1413;956;457;5;151;0.0
5195;Zondag 29 juni 2008;435;221;214;360;176;184;7;7;0.0;0.0;0.0;0.0;0.0;0.0;0;328;236;92;7;100;1.0
5196;Maandag 30 juni 2008;525;266;259;322;150;172;211;208;2.0;1.0;72.0;69.0;1.0;2.0;104;7930;4853;3077;758;726;13.0
5197;Totaal juli 2008;16903;8694;8209;10854;5140;5714;6551;6437;51.0;63.0;970.0;918.0;24.0;28.0;2961;151001;88984;62017;12782;10289;2208.0
5198;Dinsdag 1 juli 2008;576;321;255;366;183;183;218;212;3.0;3.0;51.0;48.0;2.0;1.0;145;22076;13336;8740;749;1121;19.0
5199;Woensdag 2 juli 2008;578;288;290;396;170;226;147;143;3.0;1.0;39.0;37.0;1.0;1.0;125;6460;3639;2821;575;379;21.0
5200;Donderdag 3 juli 2008;534;283;251;356;164;192;220;212;3.0;5.0;32.0;31.0;1.0;0.0;161;6639;3743;2896;596;349;331.0
5201;Vrijdag 4 juli 2008;546;300;246;346;179;167;918;906;5.0;7.0;27.0;26.0;0.0;1.0;122;5715;3340;2375;427;367;9.0
5202;Zaterdag 5 juli 2008;423;222;201;372;164;208;226;224;1.0;1.0;3.0;3.0;0.0;0.0;1;1010;643;367;8;93;414.0
5203;Zondag 6 juli 2008;491;239;252;349;164;185;27;26;1.0;0.0;0.0;0.0;0.0;0.0;0;298;191;107;8;46;0.0
5204;Maandag 7 juli 2008;541;258;283;341;167;174;268;265;1.0;2.0;89.0;84.0;2.0;3.0;146;6766;3851;2915;699;417;23.0
5205;Dinsdag 8 juli 2008;614;311;303;320;146;174;205;201;2.0;2.0;38.0;31.0;3.0;4.0;142;5717;3242;2475;561;291;29.0
5206;Woensdag 9 juli 2008;515;273;242;343;162;181;149;146;1.0;2.0;57.0;54.0;1.0;2.0;127;5379;3130;2249;506;292;17.0
5207;Donderdag 10 juli 2008;551;281;270;372;168;204;208;205;2.0;1.0;30.0;27.0;2.0;1.0;175;6146;3600;2546;521;566;28.0
5208;Vrijdag 11 juli 2008;640;329;311;349;169;180;673;665;4.0;4.0;24.0;24.0;0.0;0.0;102;5243;3110;2133;425;347;8.0
5209;Zaterdag 12 juli 2008;477;249;228;325;144;181;165;163;1.0;1.0;0.0;0.0;0.0;0.0;0;1131;815;316;4;92;6.0
5210;Zondag 13 juli 2008;420;225;195;298;138;160;12;12;0.0;0.0;0.0;0.0;0.0;0.0;0;235;138;97;0;64;0.0
5211;Maandag 14 juli 2008;552;296;256;348;164;184;229;224;1.0;4.0;68.0;67.0;1.0;0.0;156;6541;3921;2620;626;421;25.0
5212;Dinsdag 15 juli 2008;613;313;300;366;193;173;147;143;2.0;2.0;59.0;57.0;1.0;1.0;123;7249;4409;2840;546;509;252.0
5213;Woensdag 16 juli 2008;538;297;241;401;199;202;157;152;1.0;4.0;33.0;29.0;1.0;3.0;118;5157;3046;2111;541;307;41.0
5214;Donderdag 17 juli 2008;568;297;271;336;148;188;203;200;1.0;2.0;27.0;26.0;0.0;1.0;117;5343;3209;2134;509;295;19.0
5215;Vrijdag 18 juli 2008;577;273;304;334;175;159;499;494;2.0;3.0;12.0;11.0;1.0;0.0;111;5000;2953;2047;401;337;15.0
5216;Zaterdag 19 juli 2008;463;243;220;334;164;170;136;133;2.0;1.0;1.0;1.0;0.0;0.0;1;920;603;317;8;65;0.0
5217;Zondag 20 juli 2008;455;235;220;294;125;169;15;14;1.0;0.0;0.0;0.0;0.0;0.0;0;527;332;195;2;108;0.0
5218;Maandag 21 juli 2008;592;305;287;312;138;174;197;190;1.0;6.0;75.0;72.0;1.0;2.0;130;6229;3555;2674;631;444;30.0
5219;Dinsdag 22 juli 2008;619;309;310;330;150;180;141;138;2.0;1.0;48.0;47.0;1.0;0.0;138;4963;2827;2136;526;307;12.0
5220;Woensdag 23 juli 2008;552;302;250;304;146;158;142;140;2.0;0.0;32.0;29.0;2.0;1.0;115;4705;2676;2029;505;282;15.0
5221;Donderdag 24 juli 2008;555;285;270;339;161;178;155;152;1.0;2.0;33.0;31.0;2.0;0.0;129;4835;2896;1939;467;336;22.0
5222;Vrijdag 25 juli 2008;644;323;321;323;157;166;383;379;1.0;3.0;18.0;17.0;0.0;1.0;108;4871;2965;1906;392;353;14.0
5223;Zaterdag 26 juli 2008;538;265;273;383;182;201;106;104;2.0;0.0;0.0;0.0;0.0;0.0;0;979;624;355;6;83;797.0
5224;Zondag 27 juli 2008;500;263;237;377;177;200;14;14;0.0;0.0;0.0;0.0;0.0;0.0;0;281;200;81;1;71;0.0
5225;Maandag 28 juli 2008;545;266;279;376;184;192;198;193;2.0;3.0;66.0;61.0;1.0;4.0;116;5502;3146;2356;695;437;8.0
5226;Dinsdag 29 juli 2008;591;303;288;381;177;204;132;131;1.0;0.0;44.0;43.0;0.0;1.0;90;4493;2557;1936;611;350;27.0
5227;Woensdag 30 juli 2008;548;257;291;404;197;207;124;121;2.0;1.0;33.0;33.0;0.0;0.0;154;4916;2924;1992;720;478;17.0
5228;Donderdag 31 juli 2008;547;283;264;379;185;194;137;135;0.0;2.0;31.0;29.0;1.0;1.0;109;5675;3363;2312;516;682;9.0
5229;Totaal augustus 2008;16350;8411;7939;10434;5020;5414;12480;12218;121.0;141.0;879.0;828.0;25.0;26.0;2535;143260;78991;64269;15119;10015;2392.0
5230;Vrijdag 1 augustus 2008;653;331;322;376;175;201;694;683;6.0;5.0;17.0;15.0;1.0;1.0;102;21660;12127;9533;702;1197;13.0
5231;Zaterdag 2 augustus 2008;439;232;207;347;164;183;174;170;4.0;0.0;1.0;1.0;0.0;0.0;1;732;454;278;15;88;0.0
5232;Zondag 3 augustus 2008;464;238;226;309;147;162;7;7;0.0;0.0;0.0;0.0;0.0;0.0;0;286;152;134;0;77;1.0
5233;Maandag 4 augustus 2008;527;276;251;303;144;159;239;235;1.0;3.0;72.0;66.0;3.0;3.0;115;7361;4128;3233;887;466;21.0
5234;Dinsdag 5 augustus 2008;601;296;305;375;174;201;174;170;2.0;2.0;55.0;52.0;1.0;2.0;107;5724;2976;2748;747;337;675.0
5235;Woensdag 6 augustus 2008;586;323;263;350;174;176;189;186;2.0;1.0;26.0;26.0;0.0;0.0;143;5369;2958;2411;582;277;23.0
5236;Donderdag 7 augustus 2008;568;313;255;339;154;185;241;233;4.0;4.0;39.0;37.0;0.0;2.0;131;5323;2931;2392;608;402;10.0
5237;Vrijdag 8 augustus 2008;642;326;316;335;172;163;2980;2913;35.0;32.0;38.0;33.0;3.0;2.0;102;5681;3150;2531;573;312;422.0
5238;Zaterdag 9 augustus 2008;447;230;217;360;189;171;187;185;1.0;1.0;0.0;0.0;0.0;0.0;0;747;476;271;2;51;0.0
5239;Zondag 10 augustus 2008;420;215;205;357;164;193;11;11;0.0;0.0;0.0;0.0;0.0;0.0;0;525;299;226;3;95;1.0
5240;Maandag 11 augustus 2008;555;287;268;356;169;187;225;219;2.0;4.0;80.0;77.0;0.0;3.0;94;6399;3476;2923;721;355;14.0
5241;Dinsdag 12 augustus 2008;590;308;282;339;153;186;186;182;2.0;2.0;44.0;42.0;1.0;1.0;140;4933;2733;2200;701;291;19.0
5242;Woensdag 13 augustus 2008;532;276;256;298;144;154;124;122;0.0;2.0;33.0;33.0;0.0;0.0;116;4857;2653;2204;582;347;8.0
5243;Donderdag 14 augustus 2008;563;295;268;320;147;173;220;216;2.0;2.0;27.0;25.0;2.0;0.0;122;5453;3125;2328;655;344;18.0
5244;Vrijdag 15 augustus 2008;568;266;302;313;163;150;791;776;7.0;8.0;29.0;26.0;1.0;2.0;131;7721;4429;3292;573;548;16.0
5245;Zaterdag 16 augustus 2008;470;239;231;369;191;178;219;214;2.0;3.0;0.0;0.0;0.0;0.0;0;1002;567;435;6;74;1.0
5246;Zondag 17 augustus 2008;426;214;212;317;150;167;9;9;0.0;0.0;0.0;0.0;0.0;0.0;0;276;135;141;3;70;0.0
5247;Maandag 18 augustus 2008;538;279;259;334;162;172;271;264;6.0;1.0;80.0;76.0;3.0;1.0;132;6682;3486;3196;793;436;555.0
5248;Dinsdag 19 augustus 2008;556;299;257;325;140;185;153;152;0.0;1.0;48.0;44.0;1.0;3.0;128;5101;2671;2430;648;310;22.0
5249;Woensdag 20 augustus 2008;561;305;256;351;173;178;935;902;13.0;20.0;35.0;32.0;2.0;1.0;143;5417;2852;2565;681;397;30.0
5250;Donderdag 21 augustus 2008;553;287;266;340;155;185;261;258;2.0;1.0;38.0;35.0;3.0;0.0;104;5332;2881;2451;733;292;23.0
5251;Vrijdag 22 augustus 2008;600;313;287;339;162;177;1154;1135;8.0;11.0;17.0;15.0;1.0;1.0;102;5072;2837;2235;572;389;273.0
5252;Zaterdag 23 augustus 2008;475;233;242;333;153;180;298;294;1.0;3.0;0.0;0.0;0.0;0.0;0;1223;774;449;6;94;0.0
5253;Zondag 24 augustus 2008;457;239;218;329;168;161;9;9;0.0;0.0;0.0;0.0;0.0;0.0;0;363;179;184;0;70;0.0
5254;Maandag 25 augustus 2008;531;253;278;323;167;156;219;211;3.0;5.0;80.0;79.0;1.0;0.0;117;6593;3665;2928;1373;513;15.0
5255;Dinsdag 26 augustus 2008;562;281;281;309;142;167;170;165;2.0;3.0;37.0;35.0;1.0;1.0;160;4988;2686;2302;861;369;193.0
5256;Woensdag 27 augustus 2008;492;248;244;325;154;171;219;214;2.0;3.0;32.0;29.0;0.0;3.0;111;4983;2584;2399;684;368;17.0
5257;Donderdag 28 augustus 2008;556;275;281;340;169;171;517;502;3.0;12.0;34.0;34.0;0.0;0.0;128;5915;3344;2571;698;450;11.0
5258;Vrijdag 29 augustus 2008;520;261;259;333;163;170;1194;1180;7.0;7.0;15.0;15.0;0.0;0.0;106;5729;3190;2539;700;478;11.0
5259;Zaterdag 30 augustus 2008;453;238;215;343;174;169;397;388;4.0;5.0;2.0;1.0;1.0;0.0;0;1045;669;376;8;174;0.0
5260;Zondag 31 augustus 2008;445;235;210;347;164;183;13;13;0.0;0.0;0.0;0.0;0.0;0.0;0;768;404;364;2;344;0.0
5261;Totaal september 2008;16393;8274;8119;10137;4911;5226;9530;9332;87.0;111.0;972.0;917.0;24.0;31.0;2688;145107;81926;63181;19940;8348;2549.0
5262;Maandag 1 september 2008;541;254;287;331;164;167;252;248;0.0;4.0;72.0;69.0;0.0;3.0;112;23894;13038;10856;1011;1348;14.0
5263;Dinsdag 2 september 2008;577;291;286;331;169;162;133;127;2.0;4.0;64.0;60.0;2.0;2.0;149;6657;3429;3228;917;368;27.0
5264;Woensdag 3 september 2008;576;288;288;356;181;175;173;170;3.0;0.0;36.0;33.0;0.0;3.0;127;6369;3240;3129;956;278;37.0
5265;Donderdag 4 september 2008;590;290;300;328;142;186;343;338;3.0;2.0;33.0;31.0;1.0;1.0;168;6794;3632;3162;1024;323;19.0
5266;Vrijdag 5 september 2008;568;298;270;364;166;198;1323;1308;6.0;9.0;21.0;18.0;2.0;1.0;82;5568;3091;2477;708;262;13.0
5267;Zaterdag 6 september 2008;486;236;250;311;138;173;372;367;5.0;0.0;4.0;2.0;1.0;1.0;0;782;526;256;7;72;0.0
5268;Zondag 7 september 2008;450;238;212;328;152;176;14;12;1.0;1.0;0.0;0.0;0.0;0.0;0;359;182;177;4;57;0.0
5269;Maandag 8 september 2008;569;306;263;305;158;147;225;214;7.0;4.0;74.0;72.0;1.0;1.0;117;6200;3311;2889;1032;354;15.0
5270;Dinsdag 9 september 2008;592;292;300;340;188;152;160;157;2.0;1.0;50.0;47.0;3.0;0.0;138;5113;2772;2341;1202;289;877.0
5271;Woensdag 10 september 2008;590;306;284;349;175;174;472;462;0.0;10.0;34.0;32.0;1.0;1.0;123;5348;2908;2440;1114;322;21.0
5272;Donderdag 11 september 2008;558;272;286;361;162;199;196;190;4.0;2.0;32.0;30.0;2.0;0.0;120;5661;3160;2501;936;264;44.0
5273;Vrijdag 12 september 2008;642;326;316;358;190;168;1216;1192;8.0;16.0;18.0;18.0;0.0;0.0;129;4838;2825;2013;597;294;8.0
5274;Zaterdag 13 september 2008;439;227;212;328;170;158;202;199;1.0;2.0;0.0;0.0;0.0;0.0;0;753;503;250;7;72;0.0
5275;Zondag 14 september 2008;448;226;222;309;140;169;8;8;0.0;0.0;0.0;0.0;0.0;0.0;0;344;195;149;2;60;0.0
5276;Maandag 15 september 2008;592;309;283;351;164;187;170;166;1.0;3.0;68.0;63.0;0.0;5.0;89;7868;4759;3109;988;449;262.0
5277;Dinsdag 16 september 2008;605;289;316;336;155;181;139;135;2.0;2.0;59.0;56.0;1.0;2.0;106;5124;2877;2247;955;256;124.0
5278;Woensdag 17 september 2008;589;308;281;347;180;167;176;171;2.0;3.0;41.0;39.0;2.0;0.0;129;5022;2836;2186;870;195;21.0
5279;Donderdag 18 september 2008;560;292;268;351;177;174;302;296;4.0;2.0;30.0;28.0;0.0;2.0;132;5112;2877;2235;945;240;19.0
5280;Vrijdag 19 september 2008;574;276;298;342;166;176;1097;1085;3.0;9.0;23.0;21.0;1.0;1.0;108;4464;2597;1867;1158;224;18.0
5281;Zaterdag 20 september 2008;453;220;233;342;172;170;312;301;8.0;3.0;1.0;1.0;0.0;0.0;0;1245;835;410;68;88;1.0
5282;Zondag 21 september 2008;468;226;242;346;164;182;8;8;0.0;0.0;0.0;0.0;0.0;0.0;0;285;161;124;3;62;0.0
5283;Maandag 22 september 2008;539;254;285;326;153;173;213;203;6.0;4.0;75.0;69.0;2.0;4.0;103;5661;3338;2323;849;311;299.0
5284;Dinsdag 23 september 2008;580;303;277;327;162;165;142;134;5.0;3.0;50.0;48.0;1.0;1.0;122;4469;2590;1879;793;220;251.0
5285;Woensdag 24 september 2008;573;275;298;345;162;183;144;140;1.0;3.0;40.0;37.0;1.0;2.0;115;4520;2517;2003;740;281;28.0
5286;Donderdag 25 september 2008;606;316;290;358;168;190;268;261;3.0;4.0;34.0;33.0;0.0;1.0;126;5167;3110;2057;683;305;23.0
5287;Vrijdag 26 september 2008;554;284;270;330;144;186;963;942;5.0;16.0;22.0;21.0;1.0;0.0;103;4850;2906;1944;768;327;17.0
5288;Zaterdag 27 september 2008;459;242;217;352;172;180;216;215;1.0;0.0;0.0;0.0;0.0;0.0;1;1245;857;388;14;84;373.0
5289;Zondag 28 september 2008;470;230;240;325;167;158;4;4;0.0;0.0;0.0;0.0;0.0;0.0;0;310;191;119;1;73;1.0
5290;Maandag 29 september 2008;555;297;258;318;147;171;156;152;1.0;3.0;59.0;58.0;1.0;0.0;151;5617;3333;2284;875;391;27.0
5291;Dinsdag 30 september 2008;590;303;287;342;163;179;131;127;3.0;1.0;32.0;31.0;1.0;0.0;138;5468;3330;2138;713;479;10.0
5292;Totaal oktober 2008;15685;8144;7541;10992;5369;5623;5960;5840;61.0;59.0;938.0;882.0;31.0;25.0;2699;142426;85626;56800;13957;7623;3009.0
5293;Woensdag 1 oktober 2008;555;284;271;425;200;225;154;148;6.0;0.0;32.0;31.0;1.0;0.0;119;19107;11669;7438;835;965;278.0
5294;Donderdag 2 oktober 2008;555;285;270;360;172;188;160;156;2.0;2.0;31.0;29.0;1.0;1.0;135;6160;3522;2638;852;384;27.0
5295;Vrijdag 3 oktober 2008;582;300;282;380;180;200;602;596;3.0;3.0;28.0;27.0;1.0;0.0;82;5380;3113;2267;648;332;252.0
5296;Zaterdag 4 oktober 2008;447;229;218;361;175;186;150;147;1.0;2.0;1.0;1.0;0.0;0.0;0;755;506;249;7;66;0.0
5297;Zondag 5 oktober 2008;442;256;186;369;157;212;6;5;1.0;0.0;0.0;0.0;0.0;0.0;0;354;230;124;5;69;1.0
5298;Maandag 6 oktober 2008;545;292;253;318;148;170;195;193;1.0;1.0;72.0;69.0;3.0;0.0;122;6332;3725;2607;701;349;14.0
5299;Dinsdag 7 oktober 2008;587;326;261;353;176;177;116;113;2.0;1.0;48.0;46.0;2.0;0.0;117;5307;3052;2255;638;242;134.0
5300;Woensdag 8 oktober 2008;580;299;281;337;161;176;198;196;2.0;0.0;27.0;25.0;0.0;2.0;139;5080;3079;2001;571;228;31.0
5301;Donderdag 9 oktober 2008;536;274;262;360;179;181;185;180;2.0;3.0;37.0;34.0;1.0;2.0;117;5351;3130;2221;745;264;35.0
5302;Vrijdag 10 oktober 2008;538;267;271;370;186;184;930;920;4.0;6.0;28.0;26.0;0.0;2.0;94;5099;3033;2066;510;276;389.0
5303;Zaterdag 11 oktober 2008;419;213;206;333;155;178;143;140;3.0;0.0;0.0;0.0;0.0;0.0;0;892;634;258;10;55;247.0
5304;Zondag 12 oktober 2008;420;205;215;312;176;136;12;12;0.0;0.0;0.0;0.0;0.0;0.0;2;292;188;104;5;30;1.0
5305;Maandag 13 oktober 2008;512;268;244;328;166;162;159;151;5.0;3.0;68.0;65.0;1.0;2.0;123;5553;3304;2249;701;304;29.0
5306;Dinsdag 14 oktober 2008;555;275;280;348;166;182;139;134;0.0;5.0;50.0;47.0;3.0;0.0;105;4646;2752;1894;563;232;11.0
5307;Woensdag 15 oktober 2008;567;287;280;336;159;177;140;138;1.0;1.0;39.0;35.0;3.0;1.0;129;6597;4074;2523;680;328;18.0
5308;Donderdag 16 oktober 2008;530;268;262;372;183;189;174;171;0.0;3.0;30.0;25.0;4.0;1.0;118;5284;3167;2117;593;247;33.0
5309;Vrijdag 17 oktober 2008;537;268;269;336;162;174;495;483;9.0;3.0;16.0;13.0;3.0;0.0;94;4638;2843;1795;477;250;17.0
5310;Zaterdag 18 oktober 2008;425;222;203;359;175;184;131;130;0.0;1.0;0.0;0.0;0.0;0.0;1;1072;713;359;6;50;0.0
5311;Zondag 19 oktober 2008;394;213;181;330;151;179;8;8;0.0;0.0;0.0;0.0;0.0;0.0;0;246;134;112;5;28;0.0
5312;Maandag 20 oktober 2008;513;253;260;342;166;176;188;187;1.0;0.0;69.0;68.0;1.0;0.0;94;6108;3657;2451;641;339;269.0
5313;Dinsdag 21 oktober 2008;494;268;226;333;171;162;134;127;3.0;4.0;43.0;40.0;1.0;2.0;139;4760;2732;2028;533;218;161.0
5314;Woensdag 22 oktober 2008;553;293;260;338;160;178;124;118;2.0;4.0;32.0;30.0;1.0;1.0;133;4865;2851;2014;589;170;17.0
5315;Donderdag 23 oktober 2008;540;287;253;350;167;183;128;127;0.0;1.0;39.0;37.0;1.0;1.0;138;5020;2938;2082;536;228;19.0
5316;Vrijdag 24 oktober 2008;504;248;256;336;181;155;390;381;5.0;4.0;24.0;22.0;1.0;1.0;105;4715;2827;1888;404;220;237.0
5317;Zaterdag 25 oktober 2008;429;225;204;372;194;178;86;84;1.0;1.0;0.0;0.0;0.0;0.0;1;1604;1158;446;5;56;0.0
5318;Zondag 26 oktober 2008;417;223;194;389;196;193;3;3;0.0;0.0;0.0;0.0;0.0;0.0;0;256;179;77;2;58;0.0
5319;Maandag 27 oktober 2008;481;238;243;358;189;169;163;158;3.0;2.0;79.0;75.0;1.0;3.0;99;5399;3200;2199;624;355;267.0
5320;Dinsdag 28 oktober 2008;520;274;246;382;171;211;107;105;1.0;1.0;52.0;49.0;1.0;2.0;145;4534;2733;1801;562;227;41.0
5321;Woensdag 29 oktober 2008;510;268;242;365;188;177;98;95;1.0;2.0;35.0;34.0;0.0;1.0;114;4660;2799;1861;551;282;165.0
5322;Donderdag 30 oktober 2008;473;263;210;374;183;191;123;122;0.0;1.0;30.0;27.0;0.0;3.0;132;5586;3390;2196;496;303;31.0
5323;Vrijdag 31 oktober 2008;525;273;252;366;176;190;319;312;2.0;5.0;28.0;27.0;1.0;0.0;102;6774;4294;2480;462;468;285.0
5324;Totaal november 2008;14556;7481;7075;10906;5266;5640;3252;3196;32.0;24.0;897.0;855.0;20.0;22.0;2469;123497;75390;48107;10849;5989;1677.0
5325;Zaterdag 1 november 2008;445;251;194;386;183;203;72;71;1.0;0.0;0.0;0.0;0.0;0.0;0;11288;7059;4229;54;429;0.0
5326;Zondag 2 november 2008;410;210;200;370;171;199;1;0;0.0;1.0;0.0;0.0;0.0;0.0;0;324;198;126;4;45;0.0
5327;Maandag 3 november 2008;461;253;208;345;149;196;137;136;0.0;1.0;60.0;57.0;1.0;2.0;110;7597;4509;3088;656;331;159.0
5328;Dinsdag 4 november 2008;516;247;269;342;172;170;110;108;1.0;1.0;50.0;48.0;0.0;2.0;142;5728;3384;2344;648;202;22.0
5329;Woensdag 5 november 2008;533;260;273;391;199;192;83;82;0.0;1.0;37.0;35.0;0.0;2.0;111;5352;3146;2206;607;199;9.0
5330;Donderdag 6 november 2008;539;286;253;362;168;194;87;87;0.0;0.0;39.0;36.0;1.0;2.0;129;5508;3191;2317;586;247;227.0
5331;Vrijdag 7 november 2008;536;277;259;391;188;203;281;279;2.0;0.0;22.0;19.0;3.0;0.0;110;4948;2984;1964;418;211;20.0
5332;Zaterdag 8 november 2008;443;226;217;367;172;195;79;76;1.0;2.0;0.0;0.0;0.0;0.0;2;942;653;289;9;56;0.0
5333;Zondag 9 november 2008;409;196;213;306;143;163;2;1;1.0;0.0;0.0;0.0;0.0;0.0;0;249;154;95;3;36;0.0
5334;Maandag 10 november 2008;533;281;252;370;183;187;124;121;0.0;3.0;81.0;78.0;2.0;1.0;100;6109;3772;2337;553;273;23.0
5335;Dinsdag 11 november 2008;545;273;272;376;175;201;160;159;1.0;0.0;52.0;49.0;1.0;2.0;134;4712;2778;1934;502;214;14.0
5336;Woensdag 12 november 2008;526;277;249;334;163;171;105;104;0.0;1.0;39.0;35.0;2.0;2.0;131;4658;2754;1904;569;211;328.0
5337;Donderdag 13 november 2008;528;280;248;369;176;193;83;81;1.0;1.0;31.0;31.0;0.0;0.0;130;4712;2898;1814;579;247;14.0
5338;Vrijdag 14 november 2008;515;277;238;373;190;183;273;269;2.0;2.0;26.0;23.0;2.0;1.0;111;5368;3379;1989;535;219;99.0
5339;Zaterdag 15 november 2008;416;211;205;346;168;178;46;45;0.0;1.0;0.0;0.0;0.0;0.0;0;2191;1503;688;6;135;0.0
5340;Zondag 16 november 2008;395;196;199;349;160;189;2;2;0.0;0.0;0.0;0.0;0.0;0.0;1;400;262;138;3;40;1.0
5341;Maandag 17 november 2008;493;260;233;329;169;160;146;142;2.0;2.0;84.0;80.0;2.0;2.0;117;6102;3667;2435;542;310;21.0
5342;Dinsdag 18 november 2008;502;251;251;352;166;186;90;89;1.0;0.0;54.0;52.0;0.0;2.0;132;4727;2919;1808;595;242;41.0
5343;Woensdag 19 november 2008;536;270;266;397;192;205;99;96;2.0;1.0;45.0;45.0;0.0;0.0;148;4618;2725;1893;523;205;29.0
5344;Donderdag 20 november 2008;505;224;281;351;171;180;113;108;4.0;1.0;30.0;30.0;0.0;0.0;138;5122;3181;1941;525;323;8.0
5345;Vrijdag 21 november 2008;515;275;240;377;187;190;297;294;2.0;1.0;18.0;17.0;1.0;0.0;109;4753;2913;1840;461;199;32.0
5346;Zaterdag 22 november 2008;411;217;194;340;168;172;54;53;1.0;0.0;1.0;1.0;0.0;0.0;0;1270;869;401;4;58;0.0
5347;Zondag 23 november 2008;396;195;201;361;159;202;3;3;0.0;0.0;0.0;0.0;0.0;0.0;0;287;205;82;1;35;0.0
5348;Maandag 24 november 2008;514;268;246;367;176;191;152;150;0.0;2.0;69.0;66.0;2.0;1.0;141;5315;3224;2091;504;264;163.0
5349;Dinsdag 25 november 2008;527;283;244;348;161;187;112;110;2.0;0.0;43.0;42.0;0.0;1.0;90;4613;2751;1862;498;245;434.0
5350;Woensdag 26 november 2008;526;268;258;385;185;200;90;89;1.0;0.0;35.0;35.0;0.0;0.0;164;4394;2571;1823;497;245;11.0
5351;Donderdag 27 november 2008;483;245;238;401;204;197;109;107;0.0;2.0;42.0;40.0;2.0;0.0;114;5051;3148;1903;542;268;16.0
5352;Vrijdag 28 november 2008;546;283;263;398;200;198;289;284;4.0;1.0;37.0;34.0;1.0;2.0;105;5344;3286;2058;406;307;6.0
5353;Zaterdag 29 november 2008;438;229;209;362;182;180;53;50;3.0;0.0;2.0;2.0;0.0;0.0;0;1043;751;292;13;56;0.0
5354;Zondag 30 november 2008;414;212;202;361;186;175;0;0;0.0;0.0;0.0;0.0;0.0;0.0;0;772;556;216;6;137;0.0
5355;Totaal december 2008;14850;7589;7261;12367;5789;6578;3717;3636;36.0;45.0;1051.0;993.0;27.0;31.0;2585;134214;82502;51712;9429;7347;1961.0
5356;Maandag 1 december 2008;524;263;261;378;177;201;191;187;1.0;3.0;85.0;81.0;1.0;3.0;91;19178;12410;6768;625;686;376.0
5357;Dinsdag 2 december 2008;492;273;219;398;179;219;98;95;1.0;2.0;58.0;57.0;1.0;0.0;148;5660;3392;2268;553;259;25.0
5358;Woensdag 3 december 2008;499;239;260;385;175;210;93;89;1.0;3.0;38.0;37.0;1.0;0.0;113;5483;3234;2249;459;192;22.0
5359;Donderdag 4 december 2008;482;240;242;392;168;224;79;76;1.0;2.0;33.0;32.0;0.0;1.0;154;5667;3396;2271;538;255;14.0
5360;Vrijdag 5 december 2008;474;244;230;402;173;229;82;82;0.0;0.0;15.0;14.0;1.0;0.0;80;4861;2918;1943;384;239;30.0
5361;Zaterdag 6 december 2008;373;189;184;394;189;205;37;37;0.0;0.0;1.0;1.0;0.0;0.0;0;857;591;266;4;42;1.0
5362;Zondag 7 december 2008;388;207;181;344;154;190;2;2;0.0;0.0;0.0;0.0;0.0;0.0;0;257;178;79;1;46;1.0
5363;Maandag 8 december 2008;483;243;240;401;197;204;180;174;4.0;2.0;89.0;84.0;2.0;3.0;174;5915;3549;2366;564;257;253.0
5364;Dinsdag 9 december 2008;531;277;254;405;198;207;96;95;1.0;0.0;61.0;58.0;2.0;1.0;139;4441;2626;1815;432;224;22.0
5365;Woensdag 10 december 2008;523;273;250;387;179;208;108;101;2.0;5.0;29.0;29.0;0.0;0.0;112;4865;3037;1828;464;258;18.0
5366;Donderdag 11 december 2008;529;250;279;376;179;197;104;103;1.0;0.0;41.0;37.0;1.0;3.0;126;4688;2860;1828;454;230;23.0
5367;Vrijdag 12 december 2008;556;310;246;409;199;210;493;481;4.0;8.0;28.0;27.0;0.0;1.0;119;4876;3107;1769;405;256;593.0
5368;Zaterdag 13 december 2008;415;209;206;426;202;224;53;52;1.0;0.0;1.0;1.0;0.0;0.0;0;1186;864;322;7;59;1.0
5369;Zondag 14 december 2008;400;216;184;377;168;209;3;3;0.0;0.0;0.0;0.0;0.0;0.0;0;263;178;85;2;34;0.0
5370;Maandag 15 december 2008;498;263;235;392;179;213;173;171;1.0;1.0;79.0;72.0;2.0;5.0;102;8639;5538;3101;494;381;49.0
5371;Dinsdag 16 december 2008;546;291;255;405;209;196;131;128;2.0;1.0;60.0;56.0;3.0;1.0;129;4774;2933;1841;481;270;21.0
5372;Woensdag 17 december 2008;513;253;260;390;188;202;111;108;1.0;2.0;54.0;49.0;4.0;1.0;122;4814;2866;1948;405;223;15.0
5373;Donderdag 18 december 2008;529;247;282;422;210;212;166;163;1.0;2.0;37.0;36.0;0.0;1.0;137;4969;3047;1922;453;237;15.0
5374;Vrijdag 19 december 2008;562;289;273;430;208;222;353;349;3.0;1.0;21.0;19.0;1.0;1.0;101;4951;2981;1970;403;376;25.0
5375;Zaterdag 20 december 2008;434;205;229;378;192;186;93;91;1.0;1.0;1.0;1.0;0.0;0.0;0;2311;1591;720;2;127;0.0
5376;Zondag 21 december 2008;389;197;192;395;179;216;8;8;0.0;0.0;0.0;0.0;0.0;0.0;0;293;180;113;2;67;0.0
5377;Maandag 22 december 2008;491;245;246;425;194;231;267;262;1.0;4.0;89.0;84.0;2.0;3.0;125;7285;4366;2919;536;379;17.0
5378;Dinsdag 23 december 2008;557;291;266;370;171;199;177;172;2.0;3.0;51.0;49.0;0.0;2.0;139;5591;3186;2405;485;328;24.0
5379;Woensdag 24 december 2008;513;256;257;425;179;246;152;146;3.0;3.0;36.0;36.0;0.0;0.0;126;4302;2522;1780;278;248;363.0
5380;Donderdag 25 december 2008;352;176;176;415;178;237;6;6;0.0;0.0;0.0;0.0;0.0;0.0;1;181;131;50;2;43;5.0
5381;Vrijdag 26 december 2008;376;193;183;395;201;194;4;4;0.0;0.0;0.0;0.0;0.0;0.0;0;114;79;35;1;28;0.0
5382;Zaterdag 27 december 2008;400;197;203;419;189;230;34;34;0.0;0.0;0.0;0.0;0.0;0.0;0;697;460;237;6;60;1.0
5383;Zondag 28 december 2008;430;238;192;366;164;202;5;5;0.0;0.0;0.0;0.0;0.0;0.0;0;397;229;168;4;47;0.0
5384;Maandag 29 december 2008;548;283;265;440;219;221;182;179;2.0;1.0;68.0;65.0;2.0;1.0;123;6426;3922;2504;416;416;13.0
5385;Dinsdag 30 december 2008;566;289;277;384;181;203;120;119;1.0;0.0;55.0;48.0;4.0;3.0;134;5726;3345;2381;360;403;24.0
5386;Woensdag 31 december 2008;477;243;234;442;211;231;116;114;1.0;1.0;21.0;20.0;0.0;1.0;90;4547;2786;1761;209;677;10.0
5387;Totaal op zondag in 2008;22054;11300;10754;18503;8781;9722;371;361;8.0;2.0;0.0;0.0;0.0;0.0;13;27002;17342;9660;227;3525;21.0
5388;Totaal op maandag in 2008;26822;13763;13059;19037;9145;9892;9451;9237;102.0;112.0;3611.0;3443.0;80.0;88.0;5985;347015;207977;139038;32115;18914;8188.0
5389;Totaal op dinsdag in 2008;28829;14813;14016;19591;9404;10187;7382;7225;76.0;81.0;2597.0;2451.0;77.0;69.0;7039;315850;187703;128147;30480;16579;4846.0
5390;Totaal op woensdag in 2008;28373;14632;13741;20015;9614;10401;8256;8046;91.0;119.0;1858.0;1770.0;39.0;49.0;6796;283238;167193;116045;28565;14960;3402.0
5391;Totaal op donderdag in 2008;27540;14076;13464;19396;9247;10149;9426;9245;75.0;106.0;1636.0;1533.0;54.0;49.0;6767;286169;171749;114420;28270;15193;4432.0
5392;Totaal op vrijdag in 2008;28221;14538;13683;19522;9497;10025;32987;32488;224.0;275.0;1101.0;1000.0;45.0;56.0;5609;294396;178234;116162;23404;16301;5349.0
5393;Totaal op zaterdag in 2008;22795;11716;11079;19072;9214;9858;7565;7428;80.0;57.0;39.0;34.0;3.0;2.0;27;78721;52940;25781;455;4595;1991.0
5394;Totaal 2009;184915;94619;90296;134235;65365;68870;73477;72119;573.0;785.0;9497.0;9002.0;221.0;274.0;30779;1497820;900320;597500;146378;85357;29754.0
5395;Totaal januari 2009;15391;7824;7567;14371;6888;7483;2642;2595;29.0;18.0;770.0;739.0;15.0;16.0;2582;132773;80808;51965;11816;7220;2671.0
5396;Donderdag 1 januari 2009;357;168;189;432;210;222;8;8;0.0;0.0;0.0;0.0;0.0;0.0;0;11233;6630;4603;71;618;1.0
5397;Vrijdag 2 januari 2009;433;205;228;477;226;251;51;51;0.0;0.0;4.0;4.0;0.0;0.0;15;2696;1626;1070;130;193;16.0
5398;Zaterdag 3 januari 2009;417;231;186;463;224;239;26;26;0.0;0.0;0.0;0.0;0.0;0.0;1;648;457;191;11;87;1.0
5399;Zondag 4 januari 2009;449;245;204;456;214;242;9;9;0.0;0.0;0.0;0.0;0.0;0.0;0;401;263;138;7;52;1.0
5400;Maandag 5 januari 2009;569;297;272;471;239;232;121;121;0.0;0.0;42.0;41.0;1.0;0.0;73;8995;5312;3683;690;494;711.0
5401;Dinsdag 6 januari 2009;538;279;259;433;207;226;108;106;2.0;0.0;54.0;50.0;3.0;1.0;158;6665;3901;2764;646;289;23.0
5402;Woensdag 7 januari 2009;552;301;251;443;216;227;87;86;1.0;0.0;37.0;37.0;0.0;0.0;141;6097;3555;2542;624;239;13.0
5403;Donderdag 8 januari 2009;538;298;240;435;216;219;79;79;0.0;0.0;32.0;32.0;0.0;0.0;126;6243;3645;2598;688;263;31.0
5404;Vrijdag 9 januari 2009;495;250;245;451;225;226;252;247;3.0;2.0;31.0;29.0;1.0;1.0;148;5336;3214;2122;580;251;47.0
5405;Zaterdag 10 januari 2009;391;205;186;483;244;239;45;44;0.0;1.0;0.0;0.0;0.0;0.0;2;1155;802;353;9;84;0.0
5406;Zondag 11 januari 2009;409;200;209;499;214;285;5;5;0.0;0.0;0.0;0.0;0.0;0.0;0;267;169;98;8;47;0.0
5407;Maandag 12 januari 2009;516;245;271;497;236;261;130;127;2.0;1.0;70.0;64.0;4.0;2.0;96;6107;3507;2600;590;302;48.0
5408;Dinsdag 13 januari 2009;563;291;272;512;261;251;92;90;1.0;1.0;40.0;38.0;2.0;0.0;152;4828;2907;1921;509;258;23.0
5409;Woensdag 14 januari 2009;572;293;279;509;247;262;93;91;0.0;2.0;31.0;28.0;1.0;2.0;132;5114;3073;2041;593;196;710.0
5410;Donderdag 15 januari 2009;581;291;290;482;231;251;84;82;2.0;0.0;29.0;29.0;0.0;0.0;131;7180;4490;2690;547;279;26.0
5411;Vrijdag 16 januari 2009;514;276;238;516;262;254;178;176;2.0;0.0;27.0;25.0;1.0;1.0;113;5129;3210;1919;478;234;12.0
5412;Zaterdag 17 januari 2009;393;205;188;437;187;250;33;33;0.0;0.0;0.0;0.0;0.0;0.0;1;1011;702;309;5;58;0.0
5413;Zondag 18 januari 2009;413;212;201;455;224;231;3;3;0.0;0.0;0.0;0.0;0.0;0.0;0;321;215;106;4;43;1.0
5414;Maandag 19 januari 2009;506;255;251;432;205;227;139;137;2.0;0.0;59.0;59.0;0.0;0.0;145;5872;3594;2278;608;285;37.0
5415;Dinsdag 20 januari 2009;582;286;296;460;218;242;92;89;1.0;2.0;43.0;41.0;0.0;2.0;152;5060;3189;1871;548;260;41.0
5416;Woensdag 21 januari 2009;559;264;295;451;201;250;79;79;0.0;0.0;21.0;21.0;0.0;0.0;128;4607;2776;1831;578;234;33.0
5417;Donderdag 22 januari 2009;543;265;278;467;230;237;89;87;2.0;0.0;27.0;25.0;0.0;2.0;92;4870;3020;1850;513;229;30.0
5418;Vrijdag 23 januari 2009;531;272;259;489;247;242;152;148;2.0;2.0;19.0;19.0;0.0;0.0;140;4294;2650;1644;439;280;36.0
5419;Zaterdag 24 januari 2009;443;231;212;493;245;248;58;58;0.0;0.0;0.0;0.0;0.0;0.0;1;1208;842;366;6;65;0.0
5420;Zondag 25 januari 2009;421;229;192;426;194;232;4;4;0.0;0.0;0.0;0.0;0.0;0.0;1;371;254;117;1;59;0.0
5421;Maandag 26 januari 2009;563;272;291;455;223;232;126;124;1.0;1.0;76.0;73.0;2.0;1.0;140;5470;3326;2144;588;316;724.0
5422;Dinsdag 27 januari 2009;531;266;265;448;213;235;88;87;0.0;1.0;42.0;41.0;0.0;1.0;139;4288;2649;1639;675;259;24.0
5423;Woensdag 28 januari 2009;548;278;270;462;214;248;92;88;1.0;3.0;32.0;31.0;0.0;1.0;118;4792;2937;1855;686;285;28.0
5424;Donderdag 29 januari 2009;493;240;253;452;219;233;79;77;2.0;0.0;29.0;29.0;0.0;0.0;126;5243;3248;1995;533;307;31.0
5425;Vrijdag 30 januari 2009;552;273;279;466;201;265;189;183;4.0;2.0;24.0;22.0;0.0;2.0;111;5806;3604;2202;443;422;22.0
5426;Zaterdag 31 januari 2009;419;201;218;419;195;224;51;50;1.0;0.0;1.0;1.0;0.0;0.0;0;1466;1041;425;8;232;1.0
5427;Totaal februari 2009;13704;6977;6727;11695;5487;6208;2989;2937;23.0;29.0;948.0;909.0;18.0;21.0;2480;119504;72518;46986;11329;5975;2944.0
5428;Zondag 1 februari 2009;395;206;189;459;213;246;9;9;0.0;0.0;0.0;0.0;0.0;0.0;1;9220;5502;3718;34;387;2.0
5429;Maandag 2 februari 2009;509;269;240;471;253;218;159;158;0.0;1.0;80.0;76.0;2.0;2.0;103;8391;5005;3386;605;363;30.0
5430;Dinsdag 3 februari 2009;584;298;286;449;209;240;93;89;3.0;1.0;48.0;47.0;0.0;1.0;146;5778;3365;2413;647;302;28.0
5431;Woensdag 4 februari 2009;531;272;259;457;214;243;84;81;2.0;1.0;33.0;32.0;1.0;0.0;141;5433;3124;2309;669;239;31.0
5432;Donderdag 5 februari 2009;522;268;254;477;225;252;75;72;2.0;1.0;20.0;20.0;0.0;0.0;133;5839;3473;2366;576;206;38.0
5433;Vrijdag 6 februari 2009;607;321;286;460;200;260;215;210;2.0;3.0;22.0;21.0;0.0;1.0;119;5054;3055;1999;494;201;35.0
5434;Zaterdag 7 februari 2009;416;206;210;420;185;235;59;59;0.0;0.0;0.0;0.0;0.0;0.0;0;847;593;254;6;60;1057.0
5435;Zondag 8 februari 2009;404;212;192;431;191;240;3;3;0.0;0.0;1.0;1.0;0.0;0.0;0;367;238;129;2;42;2.0
5436;Maandag 9 februari 2009;492;257;235;425;195;230;202;196;2.0;4.0;77.0;72.0;1.0;4.0;142;5632;3362;2270;675;253;35.0
5437;Dinsdag 10 februari 2009;530;278;252;411;189;222;99;96;1.0;2.0;51.0;49.0;2.0;0.0;110;4766;2905;1861;736;259;28.0
5438;Woensdag 11 februari 2009;547;267;280;420;195;225;88;87;1.0;0.0;27.0;26.0;0.0;1.0;143;4500;2693;1807;559;219;41.0
5439;Donderdag 12 februari ;500;275;225;434;217;217;122;118;1.0;3.0;35.0;34.0;0.0;1.0;141;4943;2982;1961;545;210;22.0
5440;Vrijdag 13 februari 2009;506;250;256;442;197;245;149;147;0.0;2.0;13.0;13.0;0.0;0.0;128;4540;2809;1731;478;262;23.0
5441;Zaterdag 14 februari 2009;446;226;220;374;185;189;151;151;0.0;0.0;2.0;1.0;1.0;0.0;0;1296;905;391;7;47;984.0
5442;Zondag 15 februari 2009;381;185;196;371;173;198;6;6;0.0;0.0;0.0;0.0;0.0;0.0;1;1071;748;323;3;83;1.0
5443;Maandag 16 februari 2009;490;247;243;416;179;237;170;168;1.0;1.0;71.0;65.0;3.0;3.0;114;6415;4059;2356;581;265;41.0
5444;Dinsdag 17 februari 2009;537;275;262;417;194;223;105;105;0.0;0.0;67.0;65.0;0.0;2.0;149;4407;2619;1788;547;213;36.0
5445;Woensdag 18 februari 2009;527;266;261;384;185;199;117;114;2.0;1.0;55.0;55.0;0.0;0.0;148;4486;2704;1782;542;237;34.0
5446;Donderdag 19 februari 2009;500;257;243;419;197;222;105;104;1.0;0.0;44.0;43.0;1.0;0.0;127;4824;2809;2015;529;219;30.0
5447;Vrijdag 20 februari 2009;536;272;264;432;197;235;230;228;0.0;2.0;27.0;26.0;0.0;1.0;81;4811;3036;1775;584;222;22.0
5448;Zaterdag 21 februari 2009;416;204;212;387;185;202;46;45;1.0;0.0;1.0;1.0;0.0;0.0;1;1080;739;341;2;57;246.0
5449;Zondag 22 februari 2009;396;202;194;399;196;203;5;5;0.0;0.0;0.0;0.0;0.0;0.0;0;269;180;89;3;42;0.0
5450;Maandag 23 februari 2009;502;252;250;421;220;201;117;115;0.0;2.0;74.0;68.0;3.0;3.0;114;4632;2905;1727;545;283;63.0
5451;Dinsdag 24 februari 2009;474;221;253;409;205;204;96;94;1.0;1.0;64.0;63.0;0.0;1.0;86;3907;2340;1567;507;219;40.0
5452;Woensdag 25 februari 2009;522;259;263;359;178;181;100;97;1.0;2.0;62.0;58.0;3.0;1.0;118;4487;2607;1880;448;290;24.0
5453;Donderdag 26 februari 2009;491;253;238;377;186;191;103;103;0.0;0.0;45.0;45.0;0.0;0.0;128;5322;3276;2046;520;312;14.0
5454;Vrijdag 27 februari 2009;537;282;255;378;162;216;228;225;2.0;1.0;29.0;28.0;1.0;0.0;105;5585;3415;2170;477;287;34.0
5455;Zaterdag 28 februari 2009;406;197;209;396;162;234;53;52;0.0;1.0;0.0;0.0;0.0;0.0;1;1602;1070;532;8;196;3.0
5456;Totaal maart 2009;15409;7983;7426;11546;5679;5867;3607;3539;25.0;43.0;724.0;687.0;17.0;20.0;2709;128475;79710;48765;11334;6511;3323.0
5457;Zondag 1 maart 2009;424;222;202;373;184;189;3;3;0.0;0.0;0.0;0.0;0.0;0.0;0;8910;5725;3185;21;388;3.0
5458;Maandag 2 maart 2009;493;262;231;347;183;164;156;155;0.0;1.0;60.0;57.0;0.0;3.0;92;8717;5399;3318;690;378;24.0
5459;Dinsdag 3 maart 2009;509;272;237;347;162;185;143;138;1.0;4.0;25.0;22.0;1.0;2.0;126;6158;3755;2403;687;292;39.0
5460;Woensdag 4 maart 2009;520;256;264;408;207;201;99;99;0.0;0.0;23.0;23.0;0.0;0.0;112;5875;3534;2341;546;241;36.0
5461;Donderdag 5 maart 2009;546;289;257;397;193;204;109;108;1.0;0.0;13.0;10.0;2.0;1.0;131;5926;3594;2332;509;200;23.0
5462;Vrijdag 6 maart 2009;533;275;258;402;210;192;304;299;1.0;4.0;9.0;8.0;1.0;0.0;112;5366;3325;2041;460;196;476.0
5463;Zaterdag 7 maart 2009;412;212;200;347;157;190;47;45;2.0;0.0;0.0;0.0;0.0;0.0;0;802;585;217;9;36;0.0
5464;Zondag 8 maart 2009;410;194;216;351;172;179;6;6;0.0;0.0;0.0;0.0;0.0;0.0;0;337;230;107;4;34;0.0
5465;Maandag 9 maart 2009;505;254;251;352;177;175;172;165;2.0;5.0;53.0;52.0;0.0;1.0;134;5700;3437;2263;640;271;266.0
5466;Dinsdag 10 maart 2009;553;280;273;393;188;205;99;96;1.0;2.0;34.0;33.0;0.0;1.0;126;4833;2929;1904;498;201;39.0
5467;Woensdag 11 maart 2009;525;264;261;385;175;210;76;75;0.0;1.0;32.0;29.0;0.0;3.0;120;4638;2755;1883;465;175;29.0
5468;Donderdag 12 maart 2009;529;270;259;390;191;199;97;95;1.0;1.0;15.0;14.0;0.0;1.0;115;4955;3053;1902;463;221;577.0
5469;Vrijdag 13 maart 2009;555;285;270;372;173;199;171;166;0.0;5.0;4.0;4.0;0.0;0.0;111;4494;2824;1670;443;223;434.0
5470;Zaterdag 14 maart 2009;429;215;214;366;179;187;50;49;1.0;0.0;1.0;1.0;0.0;0.0;1;957;687;270;8;49;0.0
5471;Zondag 15 maart 2009;416;214;202;363;174;189;5;5;0.0;0.0;0.0;0.0;0.0;0.0;1;1020;715;305;7;83;0.0
5472;Maandag 16 maart 2009;517;281;236;387;207;180;148;145;0.0;3.0;78.0;77.0;0.0;1.0;108;6304;3882;2422;559;251;33.0
5473;Dinsdag 17 maart 2009;585;310;275;333;150;183;112;110;0.0;2.0;35.0;34.0;1.0;0.0;120;4453;2743;1710;496;170;29.0
5474;Woensdag 18 maart 2009;505;251;254;362;185;177;84;84;0.0;0.0;25.0;24.0;0.0;1.0;148;4252;2658;1594;484;205;39.0
5475;Donderdag 19 maart 2009;509;273;236;390;188;202;103;101;1.0;1.0;17.0;16.0;1.0;0.0;165;4540;2755;1785;454;235;28.0
5476;Vrijdag 20 maart 2009;518;281;237;400;188;212;368;365;0.0;3.0;20.0;17.0;3.0;0.0;115;4565;2858;1707;420;224;27.0
5477;Zaterdag 21 maart 2009;465;252;213;384;200;184;101;100;0.0;1.0;1.0;1.0;0.0;0.0;0;1038;690;348;3;44;0.0
5478;Zondag 22 maart 2009;414;207;207;363;177;186;4;4;0.0;0.0;0.0;0.0;0.0;0.0;0;246;169;77;1;36;0.0
5479;Maandag 23 maart 2009;474;257;217;389;203;186;157;149;6.0;2.0;67.0;63.0;4.0;0.0;125;5094;3116;1978;622;262;19.0
5480;Dinsdag 24 maart 2009;563;304;259;400;202;198;104;102;0.0;2.0;33.0;32.0;1.0;0.0;125;3934;2443;1491;528;236;567.0
5481;Woensdag 25 maart 2009;505;266;239;355;180;175;100;98;1.0;1.0;26.0;22.0;0.0;4.0;109;4223;2619;1604;435;270;19.0
5482;Donderdag 26 maart 2009;527;272;255;364;203;161;119;118;1.0;0.0;26.0;26.0;0.0;0.0;138;4567;2824;1743;463;315;48.0
5483;Vrijdag 27 maart 2009;561;294;267;372;180;192;337;333;2.0;2.0;13.0;11.0;2.0;0.0;105;4692;2997;1695;361;318;510.0
5484;Zaterdag 28 maart 2009;454;221;233;363;177;186;66;65;0.0;1.0;0.0;0.0;0.0;0.0;0;1275;881;394;3;86;0.0
5485;Zondag 29 maart 2009;399;210;189;332;155;177;4;4;0.0;0.0;0.0;0.0;0.0;0.0;0;229;149;80;2;66;0.0
5486;Maandag 30 maart 2009;520;276;244;360;186;174;172;167;3.0;2.0;82.0;81.0;1.0;0.0;141;5122;3136;1986;554;356;16.0
5487;Dinsdag 31 maart 2009;534;264;270;399;173;226;91;90;1.0;0.0;32.0;30.0;0.0;2.0;129;5253;3243;2010;499;449;42.0
5488;Totaal april 2009;15098;7732;7366;10922;5279;5643;5366;5278;38.0;50.0;646.0;616.0;15.0;15.0;2441;114125;71071;43054;9898;5800;2576.0
5489;Woensdag 1 april 2009;508;259;249;365;170;195;208;201;4.0;3.0;36.0;34.0;0.0;2.0;136;17219;10785;6434;600;751;47.0
5490;Donderdag 2 april 2009;528;266;262;387;189;198;120;118;1.0;1.0;17.0;17.0;0.0;0.0;128;5822;3525;2297;585;272;49.0
5491;Vrijdag 3 april 2009;546;280;266;398;220;178;339;335;1.0;3.0;14.0;14.0;0.0;0.0;114;4830;2968;1862;479;247;545.0
5492;Zaterdag 4 april 2009;445;211;234;360;156;204;91;87;3.0;1.0;0.0;0.0;0.0;0.0;1;857;597;260;5;54;0.0
5493;Zondag 5 april 2009;376;175;201;370;183;187;9;9;0.0;0.0;0.0;0.0;0.0;0.0;0;302;193;109;3;60;0.0
5494;Maandag 6 april 2009;526;264;262;393;194;199;214;209;3.0;2.0;70.0;67.0;2.0;1.0;138;5802;3448;2354;616;262;49.0
5495;Dinsdag 7 april 2009;542;288;254;352;175;177;128;127;0.0;1.0;41.0;38.0;1.0;2.0;128;4614;2850;1764;541;222;292.0
5496;Woensdag 8 april 2009;536;253;283;393;188;205;118;117;1.0;0.0;29.0;28.0;1.0;0.0;118;4479;2715;1764;512;188;41.0
5497;Donderdag 9 april 2009;571;290;281;358;171;187;211;208;0.0;3.0;24.0;22.0;0.0;2.0;118;4969;3091;1878;513;248;39.0
5498;Vrijdag 10 april 2009;552;264;288;406;207;199;130;127;2.0;1.0;5.0;5.0;0.0;0.0;18;1732;1178;554;116;87;3.0
5499;Zaterdag 11 april 2009;464;238;226;367;163;204;61;60;1.0;0.0;1.0;1.0;0.0;0.0;0;726;511;215;5;36;0.0
5500;Zondag 12 april 2009;390;211;179;352;177;175;11;11;0.0;0.0;0.0;0.0;0.0;0.0;0;208;139;69;3;21;0.0
5501;Maandag 13 april 2009;423;220;203;376;162;214;16;16;0.0;0.0;0.0;0.0;0.0;0.0;3;373;249;124;2;32;0.0
5502;Dinsdag 14 april 2009;527;276;251;371;188;183;153;151;1.0;1.0;42.0;41.0;1.0;0.0;149;5339;3237;2102;622;276;21.0
5503;Woensdag 15 april 2009;547;276;271;379;180;199;134;129;3.0;2.0;33.0;31.0;1.0;1.0;110;6112;3796;2316;540;344;32.0
5504;Donderdag 16 april 2009;576;282;294;385;184;201;155;154;0.0;1.0;20.0;20.0;0.0;0.0;119;5025;3145;1880;554;202;387.0
5505;Vrijdag 17 april 2009;560;277;283;415;210;205;563;557;1.0;5.0;13.0;13.0;0.0;0.0;120;4475;2756;1719;411;193;209.0
5506;Zaterdag 18 april 2009;447;220;227;365;185;180;116;115;0.0;1.0;2.0;2.0;0.0;0.0;1;1004;722;282;5;38;0.0
5507;Zondag 19 april 2009;414;236;178;326;160;166;11;11;0.0;0.0;0.0;0.0;0.0;0.0;0;244;147;97;2;21;0.0
5508;Maandag 20 april 2009;532;279;253;345;172;173;222;216;4.0;2.0;81.0;78.0;2.0;1.0;105;5303;3360;1943;520;248;22.0
5509;Dinsdag 21 april 2009;528;284;244;359;165;194;136;133;1.0;2.0;33.0;32.0;1.0;0.0;135;4053;2498;1555;488;215;29.0
5510;Woensdag 22 april 2009;520;264;256;319;163;156;170;169;0.0;1.0;23.0;22.0;1.0;0.0;142;4205;2697;1508;478;189;38.0
5511;Donderdag 23 april 2009;515;267;248;365;183;182;235;229;0.0;6.0;19.0;19.0;0.0;0.0;126;4447;2740;1707;518;182;22.0
5512;Vrijdag 24 april 2009;571;303;268;341;153;188;862;852;2.0;8.0;14.0;12.0;1.0;1.0;105;4303;2654;1649;347;222;670.0
5513;Zaterdag 25 april;454;244;210;357;159;198;168;165;3.0;0.0;0.0;0.0;0.0;0.0;0;1318;919;399;0;46;4.0
5514;Zondag 26 april 2009;397;209;188;343;159;184;6;6;0.0;0.0;1.0;1.0;0.0;0.0;0;269;184;85;0;38;1.0
5515;Maandag 27 april 2009;530;285;245;362;157;205;286;283;1.0;2.0;55.0;51.0;1.0;3.0;133;5042;3048;1994;487;329;25.0
5516;Dinsdag 28 april 2009;545;259;286;346;185;161;171;165;2.0;4.0;44.0;41.0;2.0;1.0;176;4824;2978;1846;479;256;23.0
5517;Woensdag 29 april 2009;565;309;256;322;165;157;275;271;4.0;0.0;29.0;27.0;1.0;1.0;114;5332;3316;2016;466;336;28.0
5518;Donderdag 30 april 2009;463;243;220;345;156;189;47;47;0.0;0.0;0.0;0.0;0.0;0.0;4;897;625;272;1;185;0.0
5519;Totaal mei 2009;15254;7772;7482;10670;5239;5431;8898;8738;59.0;101.0;566.0;540.0;10.0;16.0;2182;110364;68995;41369;8961;5379;2023.0
5520;Vrijdag 1 mei 2009;523;266;257;345;168;177;535;527;2.0;6.0;6.0;5.0;0.0;1.0;24;12260;7952;4308;171;472;10.0
5521;Zaterdag 2 mei 2009;485;234;251;343;153;190;158;157;0.0;1.0;0.0;0.0;0.0;0.0;0;622;440;182;6;76;0.0
5522;Zondag 3 mei 2009;450;243;207;306;149;157;17;17;0.0;0.0;0.0;0.0;0.0;0.0;0;256;184;72;2;37;1.0
5523;Maandag 4 mei 2009;456;243;213;311;153;158;95;93;0.0;2.0;38.0;36.0;1.0;1.0;69;5356;3202;2154;391;212;45.0
5524;Dinsdag 5 mei 2009;504;248;256;344;163;181;50;50;0.0;0.0;3.0;3.0;0.0;0.0;14;1026;702;324;31;53;4.0
5525;Woensdag 6 mei 2009;475;248;227;340;175;165;195;188;3.0;4.0;18.0;17.0;0.0;1.0;182;7773;4598;3175;670;311;40.0
5526;Donderdag 7 mei 2009;559;273;286;342;170;172;227;225;1.0;1.0;21.0;21.0;0.0;0.0;170;6304;3806;2498;662;213;18.0
5527;Vrijdag 8 mei 2009;581;301;280;383;180;203;910;894;4.0;12.0;19.0;19.0;0.0;0.0;111;4850;2900;1950;464;226;28.0
5528;Zaterdag  9 mei 2009;451;234;217;306;155;151;248;246;0.0;2.0;0.0;0.0;0.0;0.0;1;731;522;209;10;28;0.0
5529;Zondag 10 mei 2009;389;212;177;345;170;175;9;9;0.0;0.0;0.0;0.0;0.0;0.0;0;373;251;122;1;33;0.0
5530;Maandag 11 mei 2009;517;250;267;312;159;153;225;221;2.0;2.0;80.0;80.0;0.0;0.0;124;5357;3277;2080;543;359;63.0
5531;Dinsdag 12 mei 2009;524;263;261;360;177;183;168;164;0.0;4.0;44.0;42.0;0.0;2.0;129;4520;2729;1791;542;179;34.0
5532;Woensdag 13 mei 2009;537;303;234;371;168;203;159;157;0.0;2.0;14.0;14.0;0.0;0.0;123;4379;2680;1699;520;156;50.0
5533;Donderdag 14 mei 2009;548;285;263;353;175;178;255;249;2.0;4.0;25.0;22.0;2.0;1.0;116;4413;2737;1676;467;192;39.0
5534;Vrijdag 15 mei 2009;502;248;254;350;179;171;947;933;7.0;7.0;13.0;13.0;0.0;0.0;102;5628;3684;1944;370;238;17.0
5535;Zaterdag 16 mei 2009;416;216;200;367;191;176;183;179;2.0;2.0;0.0;0.0;0.0;0.0;1;770;532;238;8;47;0.0
5536;Zondag 17 mei 2009;394;193;201;337;165;172;6;6;0.0;0.0;0.0;0.0;0.0;0.0;0;212;129;83;2;29;1.0
5537;Maandag 18 mei 2009;504;245;259;355;168;187;204;199;3.0;2.0;52.0;49.0;0.0;3.0;87;4822;2720;2102;540;199;831.0
5538;Dinsdag 19 mei 2009;527;262;265;371;187;184;176;169;4.0;3.0;38.0;37.0;0.0;1.0;145;4556;2891;1665;480;176;37.0
5539;Woensdag 20 mei 2009;560;308;252;328;158;170;741;725;5.0;11.0;25.0;21.0;2.0;2.0;137;5470;3483;1987;508;305;32.0
5540;Donderdag 21 mei 2009;449;209;240;322;157;165;21;20;1.0;0.0;0.0;0.0;0.0;0.0;2;434;308;126;7;50;0.0
5541;Vrijdag 22 mei 2009;500;239;261;363;174;189;757;745;5.0;7.0;7.0;5.0;2.0;0.0;20;1842;1285;557;105;98;5.0
5542;Zaterdag 23 mei 2009;427;215;212;338;169;169;238;232;1.0;5.0;1.0;0.0;1.0;0.0;0;808;599;209;7;36;2.0
5543;Zondag 24 mei 2009;407;200;207;344;153;191;11;11;0.0;0.0;0.0;0.0;0.0;0.0;1;234;173;61;3;25;0.0
5544;Maandag 25 mei 2009;525;257;268;322;164;158;282;279;1.0;2.0;64.0;62.0;0.0;2.0;97;6354;4007;2347;582;295;635.0
5545;Dinsdag 26 mei 2009;547;277;270;378;205;173;138;134;2.0;2.0;30.0;30.0;0.0;0.0;166;4292;2673;1619;491;217;36.0
5546;Woensdag 27 mei 2009;507;264;243;339;181;158;192;187;3.0;2.0;25.0;24.0;0.0;1.0;113;4408;2710;1698;532;247;50.0
5547;Donderdag 28 mei 2009;546;289;257;376;166;210;361;356;1.0;4.0;25.0;23.0;1.0;1.0;139;5208;3214;1994;508;275;16.0
5548;Vrijdag 29 mei 2009;561;294;267;362;186;176;1140;1124;6.0;10.0;17.0;16.0;1.0;0.0;109;5552;3505;2047;330;289;29.0
5549;Zaterdag 30 mei 2009;485;248;237;326;160;166;242;234;4.0;4.0;1.0;1.0;0.0;0.0;0;1073;765;308;5;135;0.0
5550;Zondag 31 mei 2009;398;205;193;331;161;170;8;8;0.0;0.0;0.0;0.0;0.0;0.0;0;481;337;144;3;171;0.0
5551;Totaal juni 2009;15522;7844;7678;10254;4967;5287;9435;9281;62.0;92.0;680.0;636.0;21.0;23.0;2585;119485;73989;45496;10783;7293;2076.0
5552;Maandag 1 juni 2009;406;208;198;351;167;184;11;11;0.0;0.0;0.0;0.0;0.0;0.0;1;8318;5317;3001;31;415;0.0
5553;Dinsdag 2 juni 2009;513;268;245;359;165;194;195;192;1.0;2.0;46.0;42.0;3.0;1.0;110;6994;4279;2715;622;285;31.0
5554;Woensdag 3 juni 2009;517;272;245;362;171;191;405;394;3.0;8.0;21.0;19.0;1.0;1.0;113;5677;3367;2310;532;221;26.0
5555;Donderdag 4 juni 2009;548;276;272;320;160;160;211;207;1.0;3.0;14.0;14.0;0.0;0.0;121;5413;3302;2111;427;227;31.0
5556;Vrijdag 5 juni 2009;524;260;264;325;158;167;1072;1058;7.0;7.0;14.0;11.0;1.0;2.0;81;5099;3086;2013;358;215;12.0
5557;Zaterdag 6 juni 2009;451;240;211;336;164;172;367;360;2.0;5.0;0.0;0.0;0.0;0.0;0;722;489;233;11;46;3.0
5558;Zondag 7 juni 2009;413;202;211;338;165;173;9;9;0.0;0.0;0.0;0.0;0.0;0.0;0;249;167;82;0;40;0.0
5559;Maandag 8 juni 2009;548;260;288;372;173;199;287;282;2.0;3.0;65.0;63.0;1.0;1.0;128;5938;3759;2179;651;242;247.0
5560;Dinsdag 9 juni 2009;529;261;268;357;178;179;227;224;3.0;0.0;28.0;27.0;0.0;1.0;143;4586;2823;1763;565;212;40.0
5561;Woensdag 10 juni 2009;599;299;300;346;169;177;183;180;2.0;1.0;23.0;20.0;2.0;1.0;129;4764;2937;1827;508;210;449.0
5562;Donderdag 11 juni 2009;546;258;288;318;158;160;219;214;2.0;3.0;22.0;22.0;0.0;0.0;136;4962;3036;1926;518;202;13.0
5563;Vrijdag 12 juni 2009;539;275;264;355;172;183;1096;1090;1.0;5.0;10.0;10.0;0.0;0.0;123;4405;2763;1642;385;233;22.0
5564;Zaterdag 13 juni 2009;451;221;230;355;167;188;189;187;1.0;1.0;0.0;0.0;0.0;0.0;0;701;468;233;8;51;0.0
5565;Zondag 14 juni 2009;464;232;232;343;151;192;7;7;0.0;0.0;0.0;0.0;0.0;0.0;0;319;208;111;4;51;0.0
5566;Maandag 15 juni 2009;520;251;269;354;174;180;224;221;1.0;2.0;71.0;66.0;2.0;3.0;128;7153;4550;2603;516;362;20.0
5567;Dinsdag 16 juni 2009;549;288;261;345;159;186;165;162;1.0;2.0;31.0;28.0;1.0;2.0;166;4474;2781;1693;528;240;350.0
5568;Woensdag 17 juni 2009;568;286;282;360;172;188;159;156;3.0;0.0;30.0;28.0;0.0;2.0;104;4337;2563;1774;500;230;27.0
5569;Donderdag 18 juni 2009;558;269;289;355;180;175;255;251;1.0;3.0;18.0;17.0;1.0;0.0;136;4463;2787;1676;472;275;34.0
5570;Vrijdag 19 juni 2009;555;282;273;328;164;164;1100;1085;3.0;12.0;11.0;10.0;1.0;0.0;100;4030;2539;1491;365;293;25.0
5571;Zaterdag 20 juni 2009;469;241;228;326;176;150;345;339;3.0;3.0;1.0;1.0;0.0;0.0;1;1307;917;390;5;115;0.0
5572;Zondag 21 juni 2009;425;236;189;304;148;156;10;10;0.0;0.0;0.0;0.0;0.0;0.0;0;248;170;78;4;50;0.0
5573;Maandag 22 juni 2009;550;252;298;324;160;164;224;217;4.0;3.0;77.0;73.0;1.0;3.0;138;5001;3079;1922;596;329;32.0
5574;Dinsdag 23 juni 2009;554;286;268;341;157;184;157;152;3.0;2.0;36.0;34.0;1.0;1.0;144;4197;2585;1612;583;269;27.0
5575;Woensdag 24 juni 2009;585;304;281;325;162;163;166;161;2.0;3.0;28.0;25.0;1.0;2.0;128;4178;2580;1598;442;283;26.0
5576;Donderdag 25 juni 2009;586;288;298;367;172;195;285;278;5.0;2.0;17.0;17.0;0.0;0.0;123;4630;2839;1791;445;363;38.0
5577;Vrijdag 26 juni 2009;592;296;296;337;163;174;1182;1158;7.0;17.0;11.0;11.0;0.0;0.0;97;4519;2772;1747;375;370;16.0
5578;Zaterdag 27 juni 2009;470;248;222;346;167;179;278;276;0.0;2.0;2.0;1.0;1.0;0.0;1;1079;746;333;7;151;0.0
5579;Zondag 28 juni 2009;405;210;195;291;146;145;13;13;0.0;0.0;0.0;0.0;0.0;0.0;1;415;297;118;3;83;0.0
5580;Maandag 29 juni 2009;554;294;260;355;166;189;225;221;3.0;1.0;72.0;67.0;3.0;2.0;130;5412;3232;2180;624;481;44.0
5581;Dinsdag 30 juni 2009;534;281;253;359;183;176;169;166;1.0;2.0;32.0;30.0;1.0;1.0;103;5895;3551;2344;698;749;563.0
5582;Totaal juli 2009;16669;8606;8063;10573;5094;5479;7328;7181;71.0;76.0;747.0;701.0;18.0;28.0;2881;139316;82284;57032;13149;10124;2048.0
5583;Woensdag 1 juli 2009;528;275;253;364;174;190;212;210;0.0;2.0;30.0;28.0;2.0;0.0;164;19123;11496;7627;694;1059;314.0
5584;Donderdag 2 juli 2009;558;275;283;382;203;179;226;224;1.0;1.0;22.0;19.0;0.0;3.0;135;5932;3487;2445;595;352;44.0
5585;Vrijdag 3 juli 2009;614;345;269;379;190;189;915;898;8.0;9.0;11.0;10.0;0.0;1.0;82;5303;3104;2199;527;376;23.0
5586;Zaterdag 4 juli 2009;442;230;212;333;153;180;266;261;2.0;3.0;0.0;0.0;0.0;0.0;0;898;557;341;17;99;4.0
5587;Zondag 5 juli 2009;442;221;221;322;165;157;5;5;0.0;0.0;0.0;0.0;0.0;0.0;0;386;250;136;2;111;0.0
5588;Maandag 6 juli 2009;535;283;252;344;176;168;221;212;5.0;4.0;61.0;58.0;2.0;1.0;153;6504;3678;2826;714;386;38.0
5589;Dinsdag 7 juli 2009;559;283;276;336;146;190;215;208;4.0;3.0;30.0;26.0;0.0;4.0;132;5178;2963;2215;637;414;40.0
5590;Woensdag 8 juli 2009;543;285;258;356;178;178;168;163;4.0;1.0;34.0;32.0;1.0;1.0;140;4932;2898;2034;552;366;24.0
5591;Donderdag 9 juli 2009;565;286;279;326;159;167;297;287;5.0;5.0;14.0;13.0;1.0;0.0;147;5166;2920;2246;598;322;37.0
5592;Vrijdag 10 juli 2009;580;287;293;353;170;183;773;761;4.0;8.0;19.0;17.0;0.0;2.0;107;5034;2953;2081;402;352;39.0
5593;Zaterdag 11 juli 2009;468;236;232;337;165;172;184;179;2.0;3.0;0.0;0.0;0.0;0.0;0;999;648;351;1;113;1.0
5594;Zondag 12 juli 2009;430;238;192;326;147;179;8;8;0.0;0.0;0.0;0.0;0.0;0.0;0;354;251;103;3;98;0.0
5595;Maandag 13 juli 2009;530;279;251;345;168;177;178;176;1.0;1.0;62.0;61.0;1.0;0.0;115;5996;3488;2508;672;398;28.0
5596;Dinsdag 14 juli 2009;611;314;297;370;178;192;169;164;1.0;4.0;42.0;39.0;1.0;2.0;145;4634;2641;1993;597;317;45.0
5597;Woensdag 15 juli 2009;589;310;279;337;160;177;186;181;1.0;4.0;26.0;26.0;0.0;0.0;133;6858;4202;2656;615;487;32.0
5598;Donderdag 16 juli 2009;575;289;286;347;163;184;167;163;2.0;2.0;20.0;20.0;0.0;0.0;130;5235;3117;2118;610;295;35.0
5599;Vrijdag 17 juli 2009;580;303;277;403;200;203;597;586;4.0;7.0;18.0;17.0;0.0;1.0;111;4777;2894;1883;412;314;24.0
5600;Zaterdag 18 juli 2009;490;243;247;344;167;177;147;142;4.0;1.0;0.0;0.0;0.0;0.0;0;991;670;321;16;101;1085.0
5601;Zondag 19 juli 2009;438;235;203;291;123;168;9;9;0.0;0.0;0.0;0.0;0.0;0.0;0;264;171;93;1;61;0.0
5602;Maandag 20 juli 2009;569;314;255;329;164;165;247;244;1.0;2.0;71.0;68.0;1.0;2.0;91;6121;3523;2598;646;380;33.0
5603;Dinsdag 21 juli 2009;560;273;287;324;149;175;159;154;4.0;1.0;46.0;45.0;1.0;0.0;144;4651;2676;1975;560;293;23.0
5604;Woensdag 22 juli 2009;615;322;293;348;169;179;161;160;1.0;0.0;26.0;22.0;2.0;2.0;111;4373;2564;1809;558;276;21.0
5605;Donderdag 23 juli 2009;589;306;283;354;161;193;152;150;1.0;1.0;20.0;16.0;3.0;1.0;119;4746;2757;1989;563;305;38.0
5606;Vrijdag 24 juli 2009;574;301;273;357;179;178;427;423;1.0;3.0;12.0;10.0;0.0;2.0;112;4196;2499;1697;448;349;14.0
5607;Zaterdag 25 juli 2009;432;239;193;307;138;169;136;135;1.0;0.0;1.0;1.0;0.0;0.0;1;1273;854;419;13;103;1.0
5608;Zondag 26 juli 2009;409;207;202;283;137;146;7;7;0.0;0.0;0.0;0.0;0.0;0.0;0;274;173;101;3;56;1.0
5609;Maandag 27 juli 2009;545;267;278;370;186;184;233;227;2.0;4.0;67.0;62.0;2.0;3.0;121;5404;3184;2220;649;461;24.0
5610;Dinsdag 28 juli 2009;555;276;279;325;154;171;158;156;0.0;2.0;49.0;47.0;0.0;2.0;140;4503;2622;1881;566;347;31.0
5611;Woensdag 29 juli 2009;575;295;280;326;157;169;152;148;2.0;2.0;31.0;30.0;1.0;0.0;111;4207;2495;1712;474;314;21.0
5612;Donderdag 30 juli 2009;590;305;285;318;143;175;153;151;1.0;1.0;24.0;23.0;0.0;1.0;147;5004;2892;2112;536;471;21.0
5613;Vrijdag 31 juli 2009;579;284;295;337;172;165;400;389;9.0;2.0;11.0;11.0;0.0;0.0;90;6000;3657;2343;468;748;7.0
5614;Totaal augustus 2009;16238;8325;7913;10239;5035;5204;8594;8428;70.0;96.0;747.0;704.0;19.0;24.0;2422;129890;71119;58771;16244;8981;2713.0
5615;Zaterdag 1 augustus 2009;447;231;216;349;183;166;164;157;3.0;4.0;1.0;1.0;0.0;0.0;0;13313;7318;5995;131;781;0.0
5616;Zondag 2 augustus 2009;443;216;227;331;160;171;14;14;0.0;0.0;0.0;0.0;0.0;0.0;0;337;197;140;4;69;0.0
5617;Maandag 3 augustus 2009;585;302;283;296;149;147;244;239;4.0;1.0;61.0;59.0;0.0;2.0;100;7469;4176;3293;781;416;33.0
5618;Dinsdag 4 augustus 2009;573;314;259;313;146;167;145;144;0.0;1.0;38.0;38.0;0.0;0.0;132;5569;3094;2475;776;323;20.0
5619;Woensdag 5 augustus 2009;564;300;264;380;181;199;156;155;0.0;1.0;40.0;40.0;0.0;0.0;102;5095;2693;2402;662;288;1008.0
5620;Donderdag 6 augustus 2009;575;296;279;328;162;166;201;198;2.0;1.0;20.0;19.0;0.0;1.0;130;4662;2570;2092;678;267;21.0
5621;Vrijdag 7 augustus 2009;542;290;252;368;172;196;1436;1407;11.0;18.0;22.0;18.0;1.0;3.0;98;4565;2590;1975;513;248;32.0
5622;Zaterdag 8 augustus 2009;464;235;229;315;160;155;183;181;1.0;1.0;0.0;0.0;0.0;0.0;0;799;499;300;5;75;0.0
5623;Zondag 9 augustus 2009;421;217;204;348;174;174;17;17;0.0;0.0;0.0;0.0;0.0;0.0;0;307;151;156;2;49;0.0
5624;Maandag 10 augustus 2009;527;270;257;339;169;170;237;235;0.0;2.0;71.0;63.0;4.0;4.0;101;6020;3325;2695;760;359;6.0
5625;Dinsdag 11 augustus 2009;571;316;255;312;142;170;152;150;0.0;2.0;49.0;46.0;2.0;1.0;122;4524;2567;1957;730;252;485.0
5626;Woensdag 12 augustus 2009;573;278;295;295;137;158;158;154;2.0;2.0;27.0;25.0;0.0;2.0;129;4290;2328;1962;614;280;13.0
5627;Donderdag 13 augustus 2009;602;295;307;345;172;173;124;122;1.0;1.0;24.0;24.0;0.0;0.0;147;4654;2631;2023;703;265;11.0
5628;Vrijdag 14 augustus 2009;563;286;277;359;171;188;601;590;6.0;5.0;16.0;14.0;2.0;0.0;95;5084;2903;2181;562;239;434.0
5629;Zaterdag 15 augustus 2009;469;233;236;324;151;173;156;154;0.0;2.0;1.0;1.0;0.0;0.0;0;2225;1248;977;8;221;0.0
5630;Zondag 16 augustus 2009;427;212;215;273;138;135;14;14;0.0;0.0;0.0;0.0;0.0;0.0;2;476;238;238;5;61;0.0
5631;Maandag 17 augustus 2009;538;293;245;329;176;153;254;247;6.0;1.0;65.0;62.0;2.0;1.0;105;6235;3367;2868;883;385;17.0
5632;Dinsdag 18 augustus 2009;595;306;289;311;151;160;192;190;1.0;1.0;33.0;29.0;0.0;4.0;120;4848;2622;2226;697;274;16.0
5633;Woensdag 19 augustus 2009;574;280;294;324;161;163;172;168;2.0;2.0;13.0;11.0;1.0;1.0;141;4256;2305;1951;721;283;24.0
5634;Donderdag 20 augustus 2009;604;306;298;359;190;169;291;285;3.0;3.0;17.0;17.0;0.0;0.0;139;4983;2734;2249;739;348;32.0
5635;Vrijdag 21 augustus 2009;575;299;276;347;168;179;829;813;7.0;9.0;16.0;15.0;0.0;1.0;82;4403;2347;2056;600;282;28.0
5636;Zaterdag 22 augustus 2009;450;213;237;363;179;184;229;227;2.0;0.0;0.0;0.0;0.0;0.0;1;860;521;339;8;93;0.0
5637;Zondag 23 augustus 2009;426;221;205;313;149;164;6;5;1.0;0.0;0.0;0.0;0.0;0.0;0;366;157;209;5;62;0.0
5638;Maandag 24 augustus 2009;557;280;277;337;185;152;234;228;1.0;5.0;67.0;65.0;2.0;0.0;102;5842;2967;2875;1239;387;419.0
5639;Dinsdag 25 augustus 2009;581;306;275;333;175;158;188;182;3.0;3.0;32.0;32.0;0.0;0.0;147;4853;2587;2266;1336;282;25.0
5640;Woensdag 26 augustus 2009;515;263;252;309;137;172;182;179;1.0;2.0;32.0;27.0;2.0;3.0;121;4630;2505;2125;822;339;23.0
5641;Donderdag 27 augustus 2009;530;269;261;334;153;181;268;259;2.0;7.0;20.0;20.0;0.0;0.0;103;5039;2790;2249;783;329;22.0
5642;Vrijdag 28 augustus 2009;543;284;259;348;162;186;1178;1158;7.0;13.0;13.0;10.0;3.0;0.0;102;4861;2584;2277;582;623;19.0
5643;Zaterdag 29 augustus 2009;426;231;195;320;176;144;326;319;1.0;6.0;1.0;1.0;0.0;0.0;2;877;504;373;10;159;0.0
5644;Zondag 30 augustus 2009;434;222;212;322;157;165;7;7;0.0;0.0;0.0;0.0;0.0;0.0;0;610;265;345;5;166;0.0
5645;Maandag 31 augustus 2009;544;261;283;315;149;166;236;230;3.0;3.0;68.0;67.0;0.0;1.0;99;7838;4336;3502;880;776;25.0
5646;Totaal september 2009;16246;8279;7967;10253;4949;5304;11349;11120;85.0;144.0;854.0;792.0;24.0;38.0;2690;134354;75149;59205;20067;7997;2469.0
5647;Dinsdag 1 september 2009;615;326;289;322;160;162;225;220;2.0;3.0;45.0;39.0;4.0;2.0;139;21083;11217;9866;1012;1101;38.0
5648;Woensdag 2 september 2009;550;274;276;326;155;171;244;241;1.0;2.0;24.0;20.0;4.0;0.0;136;6517;3341;3176;1034;331;22.0
5649;Donderdag 3 september 2009;543;262;281;379;167;212;311;302;2.0;7.0;31.0;29.0;0.0;2.0;118;6429;3411;3018;1004;279;29.0
5650;Vrijdag 4 september 2009;529;257;272;332;150;182;1287;1271;5.0;11.0;18.0;15.0;1.0;2.0;111;5488;2940;2548;726;278;10.0
5651;Zaterdag 5 september 2009;474;248;226;325;176;149;380;371;4.0;5.0;1.0;1.0;0.0;0.0;1;881;549;332;11;77;1.0
5652;Zondag 6 september 2009;444;215;229;301;142;159;8;8;0.0;0.0;0.0;0.0;0.0;0.0;0;427;204;223;8;56;0.0
5653;Maandag 7 september 2009;531;293;238;364;176;188;253;243;5.0;5.0;89.0;87.0;0.0;2.0;121;6412;3357;3055;1222;297;12.0
5654;Dinsdag 8 september 2009;560;276;284;370;173;197;161;159;2.0;0.0;25.0;23.0;2.0;0.0;123;5098;2748;2350;1151;214;505.0
5655;Woensdag 9 september 2009;604;316;288;350;172;178;1713;1671;15.0;27.0;59.0;53.0;3.0;3.0;117;4853;2553;2300;952;264;37.0
5656;Donderdag 10 september 2009;570;297;273;312;151;161;328;323;0.0;5.0;24.0;23.0;1.0;0.0;116;5396;2960;2436;881;289;395.0
5657;Vrijdag 11 september 2009;563;280;283;360;195;165;936;923;3.0;10.0;12.0;10.0;0.0;2.0;90;4574;2786;1788;702;248;20.0
5658;Zaterdag 12 september 2009;461;240;221;357;169;188;295;292;2.0;1.0;2.0;2.0;0.0;0.0;0;770;490;280;9;90;0.0
5659;Zondag 13 september 2009;448;230;218;313;157;156;9;9;0.0;0.0;0.0;0.0;0.0;0.0;0;316;188;128;1;44;1.0
5660;Maandag 14 september 2009;583;309;274;327;176;151;230;222;4.0;4.0;60.0;56.0;2.0;2.0;128;5709;3258;2451;864;339;27.0
5661;Dinsdag15 september 2009;591;297;294;371;173;198;134;123;4.0;7.0;48.0;44.0;2.0;2.0;143;6076;3554;2522;1058;370;363.0
5662;Woensdag 16 september 2009;591;284;307;342;148;194;199;194;1.0;4.0;33.0;32.0;1.0;0.0;119;4869;2813;2056;753;270;34.0
5663;Donderdag 17 september 2009;554;280;274;365;178;187;255;251;2.0;2.0;21.0;20.0;0.0;1.0;118;5034;2840;2194;779;273;26.0
5664;Vrijdag 18 september 2009;571;289;282;324;148;176;1326;1302;8.0;16.0;21.0;21.0;0.0;0.0;87;4194;2509;1685;1263;264;387.0
5665;Zaterdag 19 september 2009;480;255;225;356;163;193;352;347;1.0;4.0;3.0;2.0;0.0;1.0;0;783;490;293;16;87;0.0
5666;Zondag 20 september 2009;452;234;218;305;147;158;39;38;1.0;0.0;1.0;1.0;0.0;0.0;0;523;309;214;9;73;0.0
5667;Maandag 21 september 2009;561;280;281;358;186;172;236;233;3.0;0.0;68.0;62.0;2.0;4.0;96;5339;3062;2277;784;299;17.0
5668;Dinsdag 22 september 2009;601;304;297;338;161;177;156;154;1.0;1.0;37.0;35.0;0.0;2.0;146;4040;2290;1750;791;219;14.0
5669;Woensdag 23 september 2009;601;292;309;382;184;198;169;164;1.0;4.0;34.0;30.0;0.0;4.0;145;4163;2322;1841;797;285;21.0
5670;Donderdag 24 september 2009;585;323;262;345;156;189;240;236;2.0;2.0;24.0;21.0;0.0;3.0;128;4617;2641;1976;684;279;30.0
5671;Vrijdag 25 september 2009;559;283;276;361;169;192;1025;1002;9.0;14.0;14.0;14.0;0.0;0.0;114;4501;2737;1764;673;344;12.0
5672;Zaterdag 26 sseptember 2009;453;236;217;322;158;164;241;236;1.0;4.0;2.0;2.0;0.0;0.0;0;1090;761;329;209;77;1.0
5673;Zondag 27 september 2009;450;237;213;298;159;139;14;14;0.0;0.0;0.0;0.0;0.0;0.0;1;311;177;134;3;74;1.0
5674;Maandag 28 september 2009;542;266;276;352;169;183;233;230;0.0;3.0;76.0;71.0;2.0;3.0;94;5157;2956;2201;703;370;16.0
5675;Dinsdag 29 september 2009;614;308;306;356;172;184;193;187;4.0;2.0;49.0;47.0;0.0;2.0;155;4354;2500;1854;959;294;430.0
5676;Woensdag 30 september 2009;566;288;278;340;159;181;157;154;2.0;1.0;33.0;32.0;0.0;1.0;144;5350;3186;2164;1009;512;20.0
5677;Totaal oktober 2009;15424;7858;7566;11176;5574;5602;5797;5686;44.0;67.0;787.0;751.0;19.0;17.0;2659;125777;75065;50712;13601;7234;2981.0
5678;Donderdag 1 oktober 2009;583;310;273;365;193;172;206;204;0.0;2.0;24.0;24.0;0.0;0.0;114;17624;10741;6883;845;835;29.0
5679;Vrijdag 2 oktober 2009;568;263;305;338;158;180;593;583;2.0;8.0;13.0;13.0;0.0;0.0;97;5211;2990;2221;676;303;15.0
5680;Zaterdag 3 oktober 2009;420;221;199;319;189;130;139;138;1.0;0.0;1.0;1.0;0.0;0.0;0;758;444;314;6;60;2.0
5681;Zondag 4 oktober 2009;438;227;211;323;163;160;2;2;0.0;0.0;0.0;0.0;0.0;0.0;0;344;208;136;2;52;0.0
5682;Maandag 5 oktober 2009;543;287;256;347;165;182;221;213;2.0;6.0;73.0;70.0;2.0;1.0;129;6250;3444;2806;830;324;693.0
5683;Dinsdag 6 oktober 2009;535;281;254;350;181;169;118;116;1.0;1.0;39.0;37.0;1.0;1.0;140;4866;2820;2046;719;221;18.0
5684;Woensdag 7 oktober 2009;581;290;291;388;204;184;130;125;2.0;3.0;33.0;31.0;2.0;0.0;104;4741;2750;1991;814;240;16.0
5685;Donderdag 8 oktober 2009;515;263;252;358;183;175;174;171;3.0;0.0;26.0;26.0;0.0;0.0;129;5050;2971;2079;638;250;16.0
5686;Vrijdag 9 oktober 2009;547;276;271;374;194;180;713;701;4.0;8.0;18.0;18.0;0.0;0.0;100;4289;2515;1774;560;209;322.0
5687;Zaterdag 10 oktober 2009;433;226;207;367;170;197;166;163;1.0;2.0;1.0;1.0;0.0;0.0;0;1109;704;405;6;82;0.0
5688;Zondag 11 oktober 2009;416;217;199;357;161;196;8;8;0.0;0.0;0.0;0.0;0.0;0.0;0;307;183;124;4;45;0.0
5689;Maandag 12 oktober 2009;465;242;223;351;178;173;197;193;0.0;4.0;57.0;56.0;1.0;0.0;100;5088;2923;2165;828;242;21.0
5690;Dinsdag 13 oktober 2009;524;258;266;306;150;156;110;106;2.0;2.0;30.0;28.0;1.0;1.0;149;4112;2515;1597;737;221;11.0
5691;Woensdag 14 oktober 2009;528;285;243;362;178;184;141;141;0.0;0.0;27.0;25.0;1.0;1.0;125;4429;2639;1790;579;194;23.0
5692;Donderdag 15 oktober 2009;553;272;281;366;169;197;182;177;3.0;2.0;22.0;20.0;2.0;0.0;100;5969;3719;2250;562;287;25.0
5693;Vrijdag 16 oktober 2009;519;239;280;407;191;216;535;528;2.0;5.0;17.0;17.0;0.0;0.0;125;4599;2868;1731;441;264;23.0
5694;Zaterdag 17 oktober 2009;397;189;208;352;169;183;81;79;2.0;0.0;1.0;1.0;0.0;0.0;1;994;663;331;6;49;565.0
5695;Zondag 18 oktober 2009;384;173;211;334;168;166;3;3;0.0;0.0;0.0;0.0;0.0;0.0;0;331;202;129;0;32;0.0
5696;Maandag 19 oktober 2009;486;255;231;376;197;179;223;218;3.0;2.0;86.0;83.0;2.0;1.0;118;5344;3150;2194;628;254;18.0
5697;Dinsdag 20 oktober 2009;497;249;248;384;192;192;155;153;1.0;1.0;36.0;34.0;1.0;1.0;141;4542;2676;1866;558;301;26.0
5698;Woensdag 21 oktober 2009;534;290;244;359;172;187;153;148;2.0;3.0;32.0;28.0;1.0;3.0;100;4278;2522;1756;565;337;45.0
5699;Donderdag 22 oktober 2009;514;247;267;370;185;185;152;149;1.0;2.0;28.0;27.0;0.0;1.0;119;4679;2809;1870;602;243;39.0
5700;Vrijdag 23 oktober 2009;525;270;255;398;219;179;384;373;4.0;7.0;13.0;12.0;1.0;0.0;125;4356;2693;1663;380;245;16.0
5701;Zaterdag 24 oktober 2009;469;241;228;348;151;197;86;86;0.0;0.0;0.0;0.0;0.0;0.0;0;1085;785;300;0;56;0.0
5702;Zondag 25 oktober 2009;428;198;230;367;187;180;5;4;1.0;0.0;0.0;0.0;0.0;0.0;0;418;286;132;1;54;0.0
5703;Maandag 26 oktober 2009;462;257;205;353;179;174;181;177;3.0;1.0;80.0;79.0;0.0;1.0;136;5020;2998;2022;523;360;510.0
5704;Dinsdag 27 oktober 2009;506;270;236;406;208;198;105;103;0.0;2.0;51.0;47.0;1.0;3.0;106;4177;2317;1860;603;253;35.0
5705;Woensdag 28 oktober 2009;535;275;260;380;199;181;114;113;0.0;1.0;31.0;30.0;0.0;1.0;143;4387;2551;1836;531;302;24.0
5706;Donderdag 29 oktober 2009;533;290;243;352;176;176;116;113;1.0;2.0;32.0;29.0;2.0;1.0;145;4623;2660;1963;506;282;27.0
5707;Vrijdag 30 oktober 2009;545;273;272;358;181;177;357;354;2.0;1.0;16.0;14.0;1.0;1.0;113;5543;3398;2145;444;448;19.0
5708;Zaterdag 31 oktober 2009;441;224;217;361;164;197;47;44;1.0;2.0;0.0;0.0;0.0;0.0;0;1254;921;333;7;189;443.0
5709;Totaal november 2009;14952;7671;7281;10719;5289;5430;3621;3563;30.0;28.0;941.0;892.0;22.0;27.0;2535;118667;72136;46531;10573;5914;1910.0
5710;Zondag 1 november 2009;426;221;205;355;168;187;3;3;0.0;0.0;0.0;0.0;0.0;0.0;1;9250;5797;3453;25;410;1.0
5711;Maandag 2 november 2009;520;264;256;353;167;186;188;184;3.0;1.0;87.0;84.0;1.0;2.0;107;7595;4629;2966;637;364;39.0
5712;Dinsdag 3 november 2009;541;297;244;360;185;175;94;94;0.0;0.0;41.0;38.0;1.0;2.0;119;5236;3001;2235;621;271;18.0
5713;Woensdag 4 november 2009;563;294;269;369;191;178;80;80;0.0;0.0;25.0;25.0;0.0;0.0;110;5028;2909;2119;579;180;40.0
5714;Donderdag 5 november 2009;525;268;257;386;187;199;111;110;1.0;0.0;23.0;20.0;2.0;1.0;124;5522;3231;2291;536;243;34.0
5715;Vrijdag 6 november 2009;541;272;269;365;171;194;249;243;4.0;2.0;21.0;20.0;0.0;1.0;97;4751;2814;1937;427;214;19.0
5716;Zaterdag 7 november 2009;431;238;193;345;156;189;63;63;0.0;0.0;3.0;2.0;1.0;0.0;2;768;505;263;8;39;0.0
5717;Zondag 8 november 2009;424;205;219;354;179;175;1;1;0.0;0.0;0.0;0.0;0.0;0.0;0;313;194;119;0;29;0.0
5718;Maandag 9 november 2009;524;259;265;399;208;191;201;194;0.0;7.0;86.0;84.0;1.0;1.0;131;5361;3168;2193;566;255;363.0
5719;Dinsdag 10 november 2009;574;302;272;345;160;185;119;117;2.0;0.0;41.0;40.0;1.0;0.0;132;4571;2727;1844;528;210;33.0
5720;Woensdag 11 november 2009;555;277;278;390;189;201;164;160;2.0;2.0;40.0;37.0;3.0;0.0;116;4406;2608;1798;581;193;23.0
5721;Donderdag 12 november 2009;542;280;262;349;152;197;119;118;1.0;0.0;28.0;26.0;0.0;2.0;131;4832;2934;1898;526;190;36.0
5722;Vrijdag 13 november 2009;538;273;265;379;205;174;218;216;1.0;1.0;14.0;14.0;0.0;0.0;100;4127;2487;1640;377;220;466.0
5723;Zaterdag 14 november 2009;428;213;215;369;179;190;52;52;0.0;0.0;0.0;0.0;0.0;0.0;0;979;717;262;6;69;2.0
5724;Zondag 15 november 2009;418;187;231;337;188;149;0;0;0.0;0.0;0.0;0.0;0.0;0.0;0;1214;798;416;4;80;2.0
5725;Maandag 16 november 2009;493;260;233;355;168;187;170;165;3.0;2.0;87.0;80.0;2.0;5.0;120;5917;3643;2274;472;212;23.0
5726;Dinsdag 17 november 2009;522;284;238;365;171;194;123;122;1.0;0.0;40.0;39.0;0.0;1.0;130;4342;2566;1776;507;186;161.0
5727;Woensdag 18 november 2009;534;260;274;401;217;184;102;99;3.0;0.0;39.0;36.0;2.0;1.0;110;4206;2555;1651;457;217;28.0
5728;Donderdag 19 november 2009;537;260;277;346;165;181;111;111;0.0;0.0;28.0;27.0;0.0;1.0;130;4536;2770;1766;449;232;41.0
5729;Vrijdag 20 november 2009;582;302;280;355;165;190;321;317;1.0;3.0;16.0;15.0;1.0;0.0;112;4590;2863;1727;410;237;32.0
5730;Zaterdag 21 november 2009;404;210;194;367;182;185;58;57;0.0;1.0;1.0;1.0;0.0;0.0;0;1144;812;332;4;62;0.0
5731;Zondag 22 november 2009;410;208;202;308;143;165;4;4;0.0;0.0;0.0;0.0;0.0;0.0;0;315;196;119;7;41;0.0
5732;Maandag 23 november 2009;486;238;248;372;176;196;180;177;2.0;1.0;98.0;94.0;3.0;1.0;131;5002;3027;1975;510;275;397.0
5733;Dinsdag 24 november 2009;513;254;259;382;173;209;125;122;1.0;2.0;50.0;47.0;2.0;1.0;154;4053;2413;1640;566;257;34.0
5734;Woensdag 25 november 2009;522;277;245;359;177;182;122;118;2.0;2.0;34.0;31.0;0.0;3.0;107;4259;2538;1721;445;252;62.0
5735;Donderdag 26 november 2009;564;296;268;329;182;147;114;114;0.0;0.0;28.0;26.0;1.0;1.0;120;4424;2745;1679;432;207;19.0
5736;Vrijdag 27 november 2009;536;284;252;342;181;161;279;275;2.0;2.0;20.0;17.0;0.0;3.0;136;4252;2604;1648;336;256;12.0
5737;Zaterdag 28 november 2009;445;245;200;326;169;157;60;59;1.0;0.0;0.0;0.0;0.0;0.0;0;1203;891;312;5;68;0.0
5738;Zondag 29 november 2009;399;207;192;326;165;161;1;1;0.0;0.0;0.0;0.0;0.0;0.0;0;258;143;115;0;42;0.0
5739;Maandag 30 november 2009;455;236;219;331;170;161;189;187;0.0;2.0;91.0;89.0;1.0;1.0;115;6213;3851;2362;552;403;25.0
5740;Totaal december 2009;15008;7748;7260;11817;5885;5932;3851;3773;37.0;41.0;1087.0;1035.0;23.0;29.0;2613;125090;77476;47614;8623;6929;2020.0
5741;Dinsdag 1 december 2009;544;274;270;399;195;204;124;121;1.0;2.0;47.0;44.0;0.0;3.0;110;17212;10992;6220;504;549;57.0
5742;Woensdag 2 december 2009;560;286;274;378;181;197;82;82;0.0;0.0;37.0;33.0;3.0;1.0;108;5527;3317;2210;441;235;367.0
5743;Donderdag 3 december 2009;503;257;246;360;189;171;94;91;0.0;3.0;26.0;24.0;2.0;0.0;136;5554;3335;2219;450;185;32.0
5744;Vrijdag 4 december 2009;486;259;227;324;180;144;127;123;1.0;3.0;18.0;18.0;0.0;0.0;92;4584;2730;1854;378;242;26.0
5745;Zaterdag 5 december 2009;379;218;161;348;172;176;13;13;0.0;0.0;1.0;1.0;0.0;0.0;1;855;613;242;4;56;0.0
5746;Zondag 6 december 2009;383;192;191;369;176;193;2;1;0.0;1.0;0.0;0.0;0.0;0.0;0;330;231;99;0;31;0.0
5747;Maandag 7 december 2009;519;261;258;363;185;178;177;175;1.0;1.0;95.0;91.0;1.0;3.0;133;5710;3532;2178;572;256;30.0
5748;Dinsdag 8 december 2009;544;276;268;379;180;199;126;126;0.0;0.0;49.0;46.0;2.0;1.0;134;4338;2589;1749;433;285;31.0
5749;Woensdag 9 december 2009;523;291;232;367;166;201;115;110;2.0;3.0;35.0;35.0;0.0;0.0;133;4247;2608;1639;455;218;21.0
5750;Donderdag 10 december 2009;474;250;224;339;175;164;128;126;1.0;1.0;38.0;35.0;1.0;2.0;120;4821;3036;1785;440;201;30.0
5751;Vrijdag 11 december 2009;501;237;264;374;194;180;296;291;2.0;3.0;25.0;24.0;1.0;0.0;100;4159;2563;1596;322;193;381.0
5752;Zaterdag 12 december 2009;409;212;197;343;179;164;87;83;2.0;2.0;1.0;1.0;0.0;0.0;0;1429;1050;379;11;64;0.0
5753;Zondag 13 december 2009;374;199;175;324;151;173;0;0;0.0;0.0;0.0;0.0;0.0;0.0;0;299;212;87;2;37;2.0
5754;Maandag 14 december 2009;447;251;196;409;208;201;215;208;4.0;3.0;109.0;106.0;1.0;2.0;111;5234;3221;2013;489;294;30.0
5755;Dinsdag 15 december 2009;542;266;276;379;178;201;132;127;3.0;2.0;58.0;55.0;2.0;1.0;121;5782;3624;2158;422;304;84.0
5756;Woensdag 16 december 2009;545;272;273;398;189;209;110;108;2.0;0.0;39.0;38.0;1.0;0.0;102;4765;2898;1867;395;259;362.0
5757;Donderdag 17 december 2009;513;259;254;397;197;200;146;143;3.0;0.0;32.0;31.0;0.0;1.0;111;4280;2595;1685;380;271;23.0
5758;Vrijdag 18 december 2009;500;250;250;425;207;218;401;393;4.0;4.0;21.0;19.0;0.0;2.0;107;4600;2861;1739;294;324;5.0
5759;Zaterdag 19 december 2009;441;212;229;392;205;187;72;69;2.0;1.0;1.0;1.0;0.0;0.0;1;1378;941;437;2;84;0.0
5760;Zondag 20 december 2009;399;216;183;368;173;195;3;3;0.0;0.0;0.0;0.0;0.0;0.0;0;754;539;215;0;91;0.0
5761;Maandag 21 december 2009;495;252;243;394;202;192;281;279;1.0;1.0;122.0;113.0;6.0;3.0;123;5553;3469;2084;422;303;40.0
5762;Dinsdag 22 december 2009;535;274;261;451;237;214;158;154;1.0;3.0;53.0;53.0;0.0;0.0;110;4608;2794;1814;351;228;27.0
5763;Woensdag 23 december 2009;572;299;273;409;216;193;182;180;0.0;2.0;50.0;49.0;0.0;1.0;140;4617;2749;1868;371;240;377.0
5764;Donderdag 24 december 2009;559;322;237;419;201;218;132;131;1.0;0.0;24.0;22.0;0.0;2.0;125;3519;2134;1385;214;183;9.0
5765;Vrijdag 25 december 2009;399;213;186;348;175;173;5;4;1.0;0.0;0.0;0.0;0.0;0.0;1;216;145;71;0;57;0.0
5766;Zaterdag 26 december 2009;378;201;177;408;218;190;7;7;0.0;0.0;0.0;0.0;0.0;0.0;0;143;92;51;2;47;0.0
5767;Zondag 27 december 2009;395;195;200;382;187;195;9;9;0.0;0.0;0.0;0.0;0.0;0.0;0;348;231;117;3;50;0.0
5768;Maandag 28 december 2009;525;268;257;394;197;197;212;208;2.0;2.0;91.0;85.0;3.0;3.0;112;5429;3276;2153;372;350;39.0
5769;Dinsdag 29 december 2009;529;272;257;413;193;220;153;153;0.0;0.0;59.0;58.0;0.0;1.0;115;4865;2920;1945;349;329;18.0
5770;Woensdag 30 december 2009;556;274;282;381;186;195;137;133;2.0;2.0;34.0;33.0;0.0;1.0;157;5875;3649;2226;312;359;18.0
5771;Donderdag 31 december 2009;479;240;239;383;193;190;125;122;1.0;2.0;22.0;20.0;0.0;2.0;110;4059;2530;1529;233;604;11.0
5772;Totaal op zondag in 2009;21611;11052;10559;18138;8732;9406;391;387;3.0;1.0;3.0;3.0;0.0;0.0;10;46271;29087;17184;226;3995;21.0
5773;Totaal op maandag in 2009;26814;13759;13055;19157;9504;9653;10155;9939;102.0;114.0;3662.0;3495.0;78.0;89.0;5800;306444;182296;124148;32244;16989;6983.0
5774;Totaal op dinsdag in 2009;28498;14621;13877;19353;9341;10012;7244;7086;70.0;88.0;2133.0;2026.0;45.0;62.0;6875;275815;163600;112215;31961;15071;5034.0
5775;Totaal op woensdag in 2009;28533;14614;13919;19264;9356;9908;9865;9653;92.0;120.0;1636.0;1535.0;45.0;56.0;6575;281118;167256;113862;30219;15181;4943.0
5776;Totaal op donderdag in 2009;28463;14517;13946;19722;9632;10090;8697;8539;69.0;89.0;1216.0;1158.0;23.0;35.0;6382;279061;166914;112147;28054;14787;2697.0
5777;Totaal op vrijdag in 2009;28143;14320;13823;19780;9669;10111;29665;29187;178.0;300.0;811.0;754.0;26.0;31.0;5113;244150;148699;95451;22986;14373;5670.0
5778;Totaal op zaterdag in 2009;22853;11736;11117;18821;9131;9690;7460;7328;59.0;73.0;36.0;31.0;4.0;1.0;24;64961;42468;22493;688;4961;4406.0
5779;Totaal 2010;184397;94129;90268;136058;65977;70081;75399;74045;660.0;694.0;9571.0;9084.0;234.0;253.0;33723;1462234;872364;589870;154432;91450;26275.0
5780;Overig 2010;243;129;114;62;34;28;1972;1964;4.0;4.0;16.0;12.0;1.0;3.0;490;1239;782;457;726;239;236.0
5781;Totaal januari 2010;14911;7602;7309;12483;5993;6490;2743;2697;26.0;20.0;724.0;697.0;16.0;11.0;2864;124516;75214;49302;10930;7694;1809.0
5782;Vrijdag 1 januari 2010;366;201;165;388;180;208;10;10;0.0;0.0;0.0;0.0;0.0;0.0;0;12457;7436;5021;100;821;0.0
5783;Zaterdag 2 januari 2010;394;195;199;384;179;205;33;33;0.0;0.0;0.0;0.0;0.0;0.0;0;719;441;278;3;63;1.0
5784;Zondag 3 januari 2010;397;214;183;407;183;224;6;6;0.0;0.0;0.0;0.0;0.0;0.0;0;443;287;156;3;65;1.0
5785;Maandag 4 januari 2010;506;245;261;414;196;218;97;92;2.0;3.0;41.0;41.0;0.0;0.0;60;7492;4404;3088;575;444;21.0
5786;Dinsdag 5 januari 2010;526;252;274;380;175;205;104;101;1.0;2.0;51.0;49.0;2.0;0.0;136;6149;3546;2603;593;341;32.0
5787;Woensdag 6 januari 2010;556;283;273;401;228;173;104;102;0.0;2.0;29.0;29.0;0.0;0.0;167;5889;3367;2522;585;273;31.0
5788;Donderdag 7 januari 2010;473;243;230;404;192;212;91;91;0.0;0.0;21.0;20.0;0.0;1.0;166;5765;3434;2331;523;281;43.0
5789;Vrijdag 8 januari 2010;560;279;281;403;194;209;137;136;0.0;1.0;15.0;13.0;1.0;1.0;104;5013;2990;2023;466;235;55.0
5790;Zaterdag 9 januari 2010;430;220;210;369;177;192;32;30;1.0;1.0;0.0;0.0;0.0;0.0;1;745;518;227;2;52;0.0
5791;Zondag 10 januari 2010;424;211;213;396;211;185;10;10;0.0;0.0;0.0;0.0;0.0;0.0;1;592;401;191;1;68;1.0
5792;Maandag 11 januari 2010;548;278;270;394;185;209;195;191;3.0;1.0;82.0;79.0;2.0;1.0;138;5907;3447;2460;614;306;65.0
5793;Dinsdag 12 januari 2010;550;291;259;393;204;189;116;115;1.0;0.0;48.0;46.0;0.0;2.0;150;4723;2764;1959;523;248;47.0
5794;Woensdag 13 januari 2010;496;265;231;387;175;212;66;65;0.0;1.0;29.0;29.0;0.0;0.0;136;4446;2617;1829;494;204;31.0
5795;Donderdag 14 januari 2010;488;238;250;405;207;198;86;85;0.0;1.0;25.0;22.0;2.0;1.0;176;5073;3130;1943;485;237;459.0
5796;Vrijdag 15 januari 2010;467;239;228;421;187;234;200;197;2.0;1.0;10.0;9.0;1.0;0.0;131;6633;4245;2388;476;335;201.0
5797;Zaterdag 16 januari 2010;413;203;210;423;225;198;44;43;1.0;0.0;1.0;0.0;1.0;0.0;1;1048;719;329;10;60;0.0
5798;Zondag 17 januari 2010;376;191;185;407;188;219;7;7;0.0;0.0;1.0;1.0;0.0;0.0;0;350;236;114;4;51;4.0
5799;Maandag 18 januari 2010;510;242;268;403;178;225;161;155;6.0;0.0;77.0;75.0;1.0;1.0;143;5694;3369;2325;611;262;29.0
5800;Dinsdag 19 januari 2010;529;274;255;402;187;215;109;107;2.0;0.0;30.0;30.0;0.0;0.0;155;4458;2736;1722;508;245;176.0
5801;Woensdag 20 januari 2010;497;252;245;445;210;235;128;126;0.0;2.0;29.0;28.0;0.0;1.0;136;4822;2900;1922;520;242;27.0
5802;Donderdag 21 januari 2010;531;288;243;433;197;236;101;101;0.0;0.0;21.0;18.0;1.0;2.0;179;4679;2866;1813;495;237;27.0
5803;Vrijdag 22 januari 2010;536;273;263;417;196;221;197;195;1.0;1.0;15.0;12.0;3.0;0.0;156;4433;2747;1686;411;268;22.0
5804;Zaterdag 23 januari 2010;461;221;240;384;172;212;40;40;0.0;0.0;0.0;0.0;0.0;0.0;3;1078;788;290;3;75;0.0
5805;Zondag 24 januari 2010;440;234;206;362;174;188;4;4;0.0;0.0;0.0;0.0;0.0;0.0;0;318;190;128;1;60;0.0
5806;Maandag 25 januari 2010;497;270;227;387;198;189;140;139;1.0;0.0;88.0;86.0;1.0;1.0;151;5325;3231;2094;577;335;64.0
5807;Dinsdag 26 januari 2010;522;252;270;382;189;193;123;120;2.0;1.0;36.0;36.0;0.0;0.0;159;4352;2607;1745;599;296;58.0
5808;Woensdag 27 januari 2010;499;258;241;409;197;212;92;91;1.0;0.0;35.0;35.0;0.0;0.0;166;4558;2732;1826;694;440;31.0
5809;Donderdag 28 januari 2010;529;271;258;464;222;242;90;88;0.0;2.0;21.0;21.0;0.0;0.0;136;4784;2966;1818;519;378;323.0
5810;Vrijdag 29 januari 2010;564;283;281;436;202;234;166;163;2.0;1.0;18.0;17.0;1.0;0.0;113;4769;2890;1879;533;365;60.0
5811;Zaterdag 30 januari 2010;435;229;206;421;209;212;51;51;0.0;0.0;1.0;1.0;0.0;0.0;0;1008;679;329;1;148;0.0
5812;Zondag 31 januari 2010;391;207;184;362;176;186;3;3;0.0;0.0;0.0;0.0;0.0;0.0;0;794;531;263;1;259;0.0
5813;Totaal februari 2010;13893;7070;6823;11516;5435;6081;3096;3043;27.0;26.0;749.0;716.0;20.0;13.0;2471;118608;71806;46802;11885;6115;2006.0
5814;Maandag 1 februari 2010;532;277;255;411;187;224;279;271;2.0;6.0;84.0;80.0;2.0;2.0;140;18555;11112;7443;734;705;41.0
5815;Dinsdag 2 februari 2010;527;269;258;374;162;212;139;135;2.0;2.0;41.0;40.0;1.0;0.0;149;5613;3286;2327;654;283;377.0
5816;Woensdag 3 februari 2010;578;289;289;458;225;233;84;82;1.0;1.0;29.0;26.0;3.0;0.0;109;5453;3159;2294;663;199;43.0
5817;Donderdag 4 februari 2010;570;293;277;456;228;228;73;73;0.0;0.0;20.0;17.0;1.0;2.0;140;5726;3334;2392;738;240;508.0
5818;Vrijdag 5 februari 2010;506;272;234;406;194;212;213;210;0.0;3.0;15.0;14.0;0.0;1.0;100;5243;3132;2111;615;205;25.0
5819;Zaterdag 6 februari 2010;410;202;208;353;185;168;43;41;1.0;1.0;0.0;0.0;0.0;0.0;2;907;657;250;11;74;0.0
5820;Zondag 7 februari 2010;410;199;211;400;204;196;9;9;0.0;0.0;0.0;0.0;0.0;0.0;0;395;267;128;0;50;1.0
5821;Maandag 8 februari 2010;502;244;258;357;176;181;180;179;1.0;0.0;74.0;70.0;2.0;2.0;96;5755;3520;2235;640;312;137.0
5822;Dinsdag 9 februari 2010;537;297;240;401;184;217;115;113;1.0;1.0;37.0;36.0;1.0;0.0;176;4534;2666;1868;585;230;49.0
5823;Woensdag 10 februari 2010;527;286;241;427;188;239;162;159;2.0;1.0;27.0;26.0;1.0;0.0;137;4643;2800;1843;591;227;28.0
5824;Donderdag 11 februari 2010;516;258;258;402;202;200;91;88;1.0;2.0;18.0;17.0;0.0;1.0;125;4653;2770;1883;615;211;23.0
5825;Vrijdag 12 februari 2010;578;273;305;438;204;234;222;217;2.0;3.0;8.0;7.0;1.0;0.0;86;4503;2787;1716;459;239;396.0
5826;Zaterdag 13 februari 2010;409;212;197;419;199;220;32;31;1.0;0.0;0.0;0.0;0.0;0.0;1;737;493;244;4;44;2.0
5827;Zondag 14 februari 2010;436;216;220;386;183;203;16;16;0.0;0.0;1.0;1.0;0.0;0.0;0;426;279;147;2;55;1.0
5828;Maandag 15 februari 2010;467;231;236;385;190;195;129;126;3.0;0.0;79.0;76.0;1.0;2.0;97;6094;3840;2254;507;302;37.0
5829;Dinsdag 16 februari 2010;534;280;254;410;183;227;104;102;1.0;1.0;33.0;32.0;1.0;0.0;127;3874;2275;1599;589;187;21.0
5830;Woensdag 17 februari 2010;548;276;272;409;192;217;89;88;1.0;0.0;23.0;23.0;0.0;0.0;148;4441;2718;1723;459;247;41.0
5831;Donderdag 18 februari 2010;560;283;277;440;197;243;101;98;1.0;2.0;23.0;22.0;1.0;0.0;119;4971;2949;2022;587;208;46.0
5832;Vrijdag 19 februari 2010;545;285;260;457;225;232;183;180;2.0;1.0;10.0;10.0;0.0;0.0;96;4435;2691;1744;743;210;47.0
5833;Zaterdag 20 februari 2010;440;219;221;411;182;229;57;57;0.0;0.0;1.0;1.0;0.0;0.0;0;1477;1049;428;8;76;0.0
5834;Zondag 21 februari 2010;369;184;185;388;172;216;9;9;0.0;0.0;0.0;0.0;0.0;0.0;1;390;233;157;2;49;0.0
5835;Maandag 22 februari 2010;489;252;237;410;203;207;202;199;2.0;1.0;85.0;83.0;2.0;0.0;107;5375;3264;2111;557;309;43.0
5836;Dinsdag 23 februari 2010;516;249;267;417;209;208;101;99;2.0;0.0;52.0;50.0;1.0;1.0;126;4370;2634;1736;582;251;55.0
5837;Woensdag 24 februari 2010;548;295;253;425;182;243;89;89;0.0;0.0;37.0;35.0;1.0;1.0;139;4310;2570;1740;481;247;33.0
5838;Donderdag 25 februari 2010;534;280;254;454;201;253;106;105;0.0;1.0;32.0;30.0;1.0;1.0;133;4989;3068;1921;486;296;34.0
5839;Vrijdag 26 februari 2010;506;247;259;419;202;217;211;210;1.0;0.0;20.0;20.0;0.0;0.0;116;4864;2914;1950;452;399;18.0
5840;Zaterdag 27 februari 2010;421;228;193;423;208;215;48;48;0.0;0.0;0.0;0.0;0.0;0.0;1;971;703;268;119;79;0.0
5841;Zondag 28 februari 2010;378;174;204;380;168;212;9;9;0.0;0.0;0.0;0.0;0.0;0.0;0;904;636;268;2;181;0.0
5842;Totaal maart 2010;14978;7673;7305;12025;5788;6237;3770;3689;43.0;38.0;883.0;844.0;19.0;20.0;3098;129412;80108;49304;11644;7281;3369.0
5843;Maandag 1 maart 2010;498;240;258;386;182;204;196;193;3.0;0.0;74.0;71.0;2.0;1.0;96;18930;11828;7102;631;760;766.0
5844;Dinsdag 2 maart 2010;468;228;240;424;196;228;106;105;0.0;1.0;37.0;37.0;0.0;0.0;128;5758;3583;2175;644;273;30.0
5845;Woensdag 3 maart 2010;496;268;228;419;210;209;100;96;2.0;2.0;13.0;13.0;0.0;0.0;157;5350;3283;2067;418;237;29.0
5846;Donderdag 4 maart 2010;517;269;248;391;173;218;104;100;3.0;1.0;16.0;14.0;0.0;2.0;149;5532;3356;2176;472;223;13.0
5847;Vrijdag 5 maart 2010;511;256;255;410;191;219;220;211;6.0;3.0;14.0;13.0;0.0;1.0;101;4897;2967;1930;421;271;22.0
5848;Zaterdag 6 maart 2010;429;223;206;361;178;183;54;54;0.0;0.0;0.0;0.0;0.0;0.0;0;833;557;276;13;59;1.0
5849;Zondag 7 maart 2010;388;199;189;365;169;196;7;7;0.0;0.0;0.0;0.0;0.0;0.0;0;346;230;116;3;34;0.0
5850;Maandag 8 maart 2010;523;267;256;412;217;195;171;165;2.0;4.0;82.0;77.0;3.0;2.0;144;5559;3364;2195;562;269;572.0
5851;Dinsdag 9 maart 2010;493;257;236;405;198;207;107;106;1.0;0.0;48.0;46.0;1.0;1.0;152;4506;2741;1765;503;185;66.0
5852;Woensdag 10 maart 2010;532;283;249;403;191;212;148;146;2.0;0.0;35.0;32.0;0.0;3.0;158;4541;2725;1816;534;251;26.0
5853;Donderdag 11 maart 2010;548;276;272;363;164;199;88;87;0.0;1.0;22.0;22.0;0.0;0.0;144;4369;2649;1720;494;266;35.0
5854;Vrijdag 12 maart 2010;485;252;233;419;209;210;246;242;2.0;2.0;19.0;18.0;1.0;0.0;126;4399;2701;1698;449;230;30.0
5855;Zaterdag 13 maart 2010;374;177;197;375;166;209;44;43;0.0;1.0;0.0;0.0;0.0;0.0;2;796;577;219;6;68;0.0
5856;Zondag 14 maart 2010;397;206;191;383;189;194;6;6;0.0;0.0;0.0;0.0;0.0;0.0;2;305;198;107;0;54;0.0
5857;Maandag 15 maart 2010;492;250;242;379;173;206;165;163;1.0;1.0;74.0;73.0;1.0;0.0;126;7041;4459;2582;626;293;461.0
5858;Dinsdag 16 maart 2010;492;261;231;385;200;185;110;110;0.0;0.0;44.0;44.0;0.0;0.0;122;4280;2647;1633;565;173;42.0
5859;Woensdag 17 maart 2010;530;275;255;396;188;208;99;95;2.0;2.0;30.0;27.0;1.0;2.0;148;4073;2494;1579;508;203;39.0
5860;Donderdag 18 maart 2010;516;266;250;382;192;190;98;95;1.0;2.0;12.0;12.0;0.0;0.0;126;4444;2770;1674;469;258;29.0
5861;Vrijdag 19 maart 2010;504;282;222;376;189;187;257;252;2.0;3.0;15.0;15.0;0.0;0.0;96;4069;2531;1538;342;242;458.0
5862;Zaterdag 20 maart 2010;413;217;196;365;174;191;88;86;0.0;2.0;0.0;0.0;0.0;0.0;0;1115;794;321;2;56;0.0
5863;Zondag 21 maart 2010;398;184;214;403;200;203;14;14;0.0;0.0;0.0;0.0;0.0;0.0;0;329;216;113;1;44;0.0
5864;Maandag 22 maart 2010;490;252;238;402;206;196;175;173;0.0;2.0;73.0;70.0;3.0;0.0;117;5025;3022;2003;500;317;53.0
5865;Dinsdag 23 maart 2010;539;273;266;397;184;213;104;104;0.0;0.0;45.0;43.0;0.0;2.0;153;3804;2326;1478;456;207;30.0
5866;Woensdag 24 maart 2010;519;279;240;368;171;197;107;105;1.0;1.0;30.0;29.0;0.0;1.0;158;4042;2446;1596;452;275;36.0
5867;Donderdag 25 maart 2010;520;257;263;392;195;197;118;117;0.0;1.0;24.0;21.0;2.0;1.0;166;4584;2838;1746;474;269;42.0
5868;Vrijdag 26 maart 2010;567;274;293;398;193;205;345;336;5.0;4.0;17.0;15.0;2.0;0.0;113;4112;2675;1437;397;281;483.0
5869;Zaterdag 27 maart 2010;423;217;206;369;170;199;75;73;2.0;0.0;1.0;1.0;0.0;0.0;1;1192;822;370;5;96;0.0
5870;Zondag 28 maart 2010;375;196;179;361;174;187;5;5;0.0;0.0;0.0;0.0;0.0;0.0;0;444;305;139;4;60;0.0
5871;Maandag 29 maart 2010;504;263;241;375;179;196;175;169;4.0;2.0;92.0;87.0;1.0;4.0;123;4769;2863;1906;662;497;29.0
5872;Dinsdag 30 maart 2010;500;254;246;367;180;187;125;121;2.0;2.0;41.0;40.0;1.0;0.0;142;4327;2584;1743;469;292;34.0
5873;Woensdag 31 maart 2010;537;272;265;394;187;207;113;110;2.0;1.0;25.0;24.0;1.0;0.0;148;5641;3557;2084;562;538;43.0
5874;Totaal april 2010;14739;7551;7188;10975;5410;5565;5593;5491;48.0;54.0;716.0;668.0;21.0;27.0;2738;111547;68999;42548;9649;5931;2367.0
5875;Donderdag 1 april 2010;490;252;238;357;171;186;289;279;3.0;7.0;24.0;23.0;0.0;1.0;122;18373;11733;6640;619;782;11.0
5876;Vrijdag 2 april 2010;557;295;262;378;188;190;106;104;0.0;2.0;5.0;5.0;0.0;0.0;26;1737;1073;664;127;121;12.0
5877;Zaterdag 3 april 2010;386;207;179;363;167;196;51;51;0.0;0.0;0.0;0.0;0.0;0.0;0;624;439;185;3;66;0.0
5878;Zondag 4 april 2010;400;215;185;352;184;168;5;5;0.0;0.0;0.0;0.0;0.0;0.0;0;254;154;100;1;37;0.0
5879;Maandag 5 april 2010;382;192;190;289;133;156;15;15;0.0;0.0;0.0;0.0;0.0;0.0;1;576;392;184;3;73;0.0
5880;Dinsdag 6 april 2010;498;254;244;338;159;179;173;171;2.0;0.0;49.0;46.0;3.0;0.0;113;6096;3609;2487;538;339;40.0
5881;Woensdag 7 april 2010;578;289;289;368;198;170;137;136;0.0;1.0;24.0;24.0;0.0;0.0;155;5210;3043;2167;593;236;49.0
5882;Donderdag 8 april 2010;531;261;270;367;159;208;145;142;3.0;0.0;21.0;21.0;0.0;0.0;209;4869;2951;1918;571;236;33.0
5883;Vrijdag 9 april 2010;546;266;280;368;171;197;446;444;1.0;1.0;18.0;14.0;1.0;3.0;124;4380;2635;1745;480;208;13.0
5884;Zaterdag 10 april 2010;459;246;213;392;187;205;148;146;1.0;1.0;0.0;0.0;0.0;0.0;0;994;707;287;4;55;0.0
5885;Zondag 11 april 2010;381;195;186;350;170;180;8;8;0.0;0.0;0.0;0.0;0.0;0.0;0;309;204;105;1;37;0.0
5886;Maandag 12 april 2010;522;275;247;383;193;190;198;193;2.0;3.0;92.0;88.0;2.0;2.0;117;5000;2956;2044;570;222;38.0
5887;Dinsdag 13 april 2010;507;253;254;373;194;179;113;110;2.0;1.0;31.0;31.0;0.0;0.0;160;4049;2503;1546;462;211;28.0
5888;Woensdag 14 april 2010;527;271;256;354;181;173;134;127;3.0;4.0;42.0;39.0;3.0;0.0;165;4097;2446;1651;461;187;38.0
5889;Donderdag 15 april 2010;514;263;251;374;192;182;158;154;4.0;0.0;22.0;20.0;0.0;2.0;156;5929;3667;2262;540;262;1133.0
5890;Vrijdag 16 april 2010;534;275;259;386;183;203;569;561;2.0;6.0;21.0;19.0;2.0;0.0;122;4399;2739;1660;455;180;30.0
5891;Zaterdag 17 april 2010;442;229;213;362;179;183;105;103;1.0;1.0;1.0;1.0;0.0;0.0;0;798;540;258;2;40;1.0
5892;Zondag 18 april 2010;406;212;194;351;170;181;9;9;0.0;0.0;0.0;0.0;0.0;0.0;1;303;203;100;1;46;0.0
5893;Maandag 19 april 2010;521;274;247;370;188;182;201;197;2.0;2.0;79.0;70.0;3.0;6.0;123;4738;2882;1856;466;237;258.0
5894;Dinsdag 20 april 2010;511;240;271;359;181;178;158;155;1.0;2.0;40.0;36.0;2.0;2.0;169;4042;2439;1603;423;161;162.0
5895;Woensdag 21 april 2010;554;278;276;401;200;201;135;132;1.0;2.0;38.0;37.0;0.0;1.0;133;3996;2427;1569;472;222;48.0
5896;Donderdag 22 april 2010;514;278;236;353;168;185;198;191;2.0;5.0;21.0;19.0;1.0;1.0;143;4118;2534;1584;457;228;26.0
5897;Vrijdag 23 april 2010;550;289;261;373;196;177;715;709;1.0;5.0;26.0;22.0;2.0;2.0;123;3847;2385;1462;380;193;45.0
5898;Zaterdag 24 april 2010;416;207;209;377;181;196;168;165;2.0;1.0;1.0;0.0;1.0;0.0;0;1194;829;365;5;40;0.0
5899;Zondag 25 april 2010;402;210;192;348;168;180;13;13;0.0;0.0;0.0;0.0;0.0;0.0;0;408;263;145;3;63;0.0
5900;Maandag 26 april 2010;505;260;245;365;183;182;235;227;5.0;3.0;76.0;73.0;0.0;3.0;133;5029;3088;1941;486;302;43.0
5901;Dinsdag 27 april 2010;559;276;283;385;206;179;151;150;0.0;1.0;32.0;30.0;1.0;1.0;143;4331;2745;1586;533;242;303.0
5902;Woensdag 28 april 2010;528;254;274;389;195;194;235;231;3.0;1.0;29.0;27.0;0.0;2.0;131;4792;2913;1879;474;327;26.0
5903;Donderdag 29 april 2010;527;271;256;375;193;182;535;523;7.0;5.0;24.0;23.0;0.0;1.0;166;6041;3771;2270;516;332;30.0
5904;Vrijdag 30 april 2010;492;264;228;375;172;203;40;40;0.0;0.0;0.0;0.0;0.0;0.0;3;1014;729;285;3;246;0.0
5905;Totaal mei 2010;15019;7651;7368;11275;5440;5835;9229;9068;84.0;77.0;748.0;714.0;19.0;15.0;2367;107659;66484;41175;9094;5668;1667.0
5906;Zaterdag 1 mei 2010;406;204;202;353;175;178;201;198;1.0;2.0;0.0;0.0;0.0;0.0;1;9361;6102;3259;41;384;1.0
5907;Zondag 2 mei 2010;378;199;179;328;159;169;11;11;0.0;0.0;0.0;0.0;0.0;0.0;0;336;225;111;2;65;0.0
5908;Maandag 3 mei 2010;522;262;260;367;177;190;281;272;6.0;3.0;80.0;79.0;0.0;1.0;101;7446;4505;2941;655;329;14.0
5909;Dinsdag 4 mei 2010;555;277;278;346;177;169;99;98;0.0;1.0;37.0;37.0;0.0;0.0;149;5338;3157;2181;567;253;49.0
5910;Woensdag 5 mei 2010;495;255;240;330;160;170;63;63;0.0;0.0;2.0;2.0;0.0;0.0;4;693;476;217;2;58;3.0
5911;Donderdag 6 mei 2010;517;261;256;372;175;197;232;231;0.0;1.0;32.0;29.0;2.0;1.0;155;5886;3476;2410;611;282;26.0
5912;Vrijdag 7 mei 2010;555;273;282;370;168;202;933;919;9.0;5.0;21.0;20.0;1.0;0.0;101;4830;2981;1849;451;230;537.0
5913;Zaterdag 8 mei 2010;425;217;208;390;190;200;240;233;5.0;2.0;2.0;2.0;0.0;0.0;0;814;606;208;2;48;0.0
5914;Zondag 9 mei 2010;426;206;220;360;165;195;8;7;1.0;0.0;0.0;0.0;0.0;0.0;0;262;185;77;4;31;1.0
5915;Maandag 10 mei 2010;490;268;222;356;149;207;420;411;2.0;7.0;99.0;92.0;4.0;3.0;117;5829;3524;2305;525;241;33.0
5916;Dinsdag 11 mei 2010;546;298;248;385;179;206;181;179;0.0;2.0;37.0;35.0;2.0;0.0;185;4628;2729;1899;530;186;33.0
5917;Woensdag 12 mei 2010;572;295;277;460;220;240;642;638;2.0;2.0;36.0;33.0;1.0;2.0;120;5095;3112;1983;538;234;23.0
5918;Donderdag 13 mei 2010;473;239;234;376;207;169;21;21;0.0;0.0;0.0;0.0;0.0;0.0;2;444;327;117;2;47;0.0
5919;Vrijdag 14 mei 2010;527;265;262;389;177;212;756;743;9.0;4.0;5.0;4.0;1.0;0.0;16;1917;1199;718;130;91;22.0
5920;Zaterdag 15 mei 2010;410;197;213;352;173;179;295;284;8.0;3.0;1.0;1.0;0.0;0.0;2;1480;1027;453;12;89;0.0
5921;Zondag 16 mei 2010;430;222;208;369;163;206;13;11;2.0;0.0;0.0;0.0;0.0;0.0;1;367;217;150;2;28;1.0
5922;Maandag 17 mei 2010;495;268;227;355;177;178;259;246;7.0;6.0;66.0;62.0;2.0;2.0;105;6689;4088;2601;611;304;27.0
5923;Dinsdag 18 mei 2010;520;235;285;337;173;164;170;168;0.0;2.0;36.0;35.0;1.0;0.0;192;4664;2774;1890;513;176;22.0
5924;Woensdag 19 mei 2010;534;278;256;330;162;168;167;164;0.0;3.0;35.0;35.0;0.0;0.0;151;4356;2631;1725;507;174;37.0
5925;Donderdag 20 mei 2010;539;265;274;369;179;190;414;407;4.0;3.0;26.0;25.0;0.0;1.0;140;4951;3057;1894;460;203;36.0
5926;Vrijdag 21 mei 2010;505;267;238;387;182;205;1153;1132;11.0;10.0;26.0;24.0;0.0;2.0;131;4394;2815;1579;378;244;25.0
5927;Zaterdag 22 mei 2010;431;221;210;388;172;216;238;237;1.0;0.0;1.0;0.0;1.0;0.0;2;948;629;319;6;43;0.0
5928;Zondag 23 mei 2010;407;207;200;358;166;192;12;12;0.0;0.0;0.0;0.0;0.0;0.0;0;247;153;94;1;24;0.0
5929;Maandag 24 mei 2010;391;206;185;354;176;178;14;14;0.0;0.0;0.0;0.0;0.0;0.0;4;470;308;162;4;78;3.0
5930;Dinsdag 25 mei 2010;509;274;235;342;177;165;210;203;3.0;4.0;57.0;56.0;0.0;1.0;117;4848;2965;1883;506;260;659.0
5931;Woensdag 26 mei 2010;589;303;286;350;167;183;193;190;1.0;2.0;25.0;24.0;1.0;0.0;137;4597;2699;1898;564;251;36.0
5932;Donderdag 27 mei 2010;535;251;284;354;186;168;269;265;1.0;3.0;20.0;20.0;0.0;0.0;137;4586;2811;1775;451;300;32.0
5933;Vrijdag 28 mei 2010;501;249;252;379;192;187;1195;1182;6.0;7.0;19.0;18.0;1.0;0.0;138;4761;2948;1813;333;318;19.0
5934;Zaterdag 29 mei 2010;414;198;216;377;181;196;276;271;3.0;2.0;0.0;0.0;0.0;0.0;3;823;582;241;70;98;0.0
5935;Zondag 30 mei 2010;411;211;200;329;165;164;11;11;0.0;0.0;0.0;0.0;0.0;0.0;2;455;329;126;1;104;0.0
5936;Maandag 31 mei 2010;511;280;231;363;171;192;252;247;2.0;3.0;85.0;81.0;2.0;2.0;154;6144;3847;2297;615;495;28.0
5937;Totaal juni 2010;15375;7925;7450;10654;5254;5400;9669;9485;91.0;93.0;760.0;711.0;18.0;31.0;2984;118705;73423;45282;11342;7728;2446.0
5938;Dinsdag 1 juni 2010;549;288;261;364;173;191;203;200;1.0;2.0;35.0;34.0;0.0;1.0;143;16841;10650;6191;595;630;31.0
5939;Woensdag 2 juni 2010;528;265;263;371;192;179;197;194;2.0;1.0;30.0;27.0;1.0;2.0;164;5159;3084;2075;545;238;42.0
5940;Donderdag 3 juni 2010;517;267;250;338;168;170;251;248;1.0;2.0;16.0;15.0;0.0;1.0;144;5426;3288;2138;568;197;58.0
5941;Vrijdag 4 juni 2010;535;271;264;383;182;201;1342;1318;10.0;14.0;17.0;14.0;1.0;2.0;134;4462;2770;1692;421;237;611.0
5942;Zaterdag 5 juni 2010;433;212;221;350;158;192;310;307;1.0;2.0;1.0;1.0;0.0;0.0;1;681;488;193;2;63;0.0
5943;Zondag 6 juni 2010;415;226;189;398;203;195;21;21;0.0;0.0;0.0;0.0;0.0;0.0;0;340;226;114;2;50;1.0
5944;Maandag 7 juni 2010;450;247;203;345;176;169;231;221;4.0;6.0;81.0;73.0;6.0;2.0;116;5338;3273;2065;590;268;29.0
5945;Dinsdag 8 juni 2010;556;291;265;364;172;192;153;150;2.0;1.0;30.0;23.0;4.0;3.0;183;4221;2571;1650;560;205;27.0
5946;Woensdag 9 juni 2010;577;287;290;384;194;190;122;120;1.0;1.0;26.0;25.0;0.0;1.0;124;4026;2540;1486;399;172;15.0
5947;Donderdag 10 juni 2010;562;270;292;371;195;176;374;369;2.0;3.0;15.0;15.0;0.0;0.0;110;4847;3021;1826;433;239;510.0
5948;Vrijdag 11 juni 2010;508;254;254;372;210;162;988;972;8.0;8.0;15.0;15.0;0.0;0.0;146;3878;2412;1466;467;245;143.0
5949;Zaterdag 12 juni 2010;438;227;211;349;161;188;291;287;1.0;3.0;0.0;0.0;0.0;0.0;1;898;641;257;5;67;0.0
5950;Zondag 13 juni 2010;462;237;225;317;147;170;6;6;0.0;0.0;0.0;0.0;0.0;0.0;0;258;165;93;3;34;0.0
5951;Maandag 14 juni 2010;497;256;241;346;181;165;241;235;4.0;2.0;69.0;64.0;0.0;5.0;148;4977;3037;1940;566;341;26.0
5952;Dinsdag 15 juni 2010;524;254;270;320;156;164;154;149;4.0;1.0;34.0;34.0;0.0;0.0;162;5405;3437;1968;551;308;40.0
5953;Woensdag 16 juni 2010;546;292;254;351;155;196;208;206;0.0;2.0;30.0;28.0;1.0;1.0;155;4192;2578;1614;493;265;23.0
5954;Donderdag 17 juni 2010;537;283;254;351;166;185;224;215;5.0;4.0;14.0;14.0;0.0;0.0;139;4315;2700;1615;542;213;22.0
5955;Vrijdag 18 juni 2010;564;285;279;339;173;166;1076;1055;10.0;11.0;24.0;22.0;0.0;2.0;84;4104;2493;1611;382;296;26.0
5956;Zaterdag 19 juni 2010;419;223;196;336;164;172;218;214;3.0;1.0;0.0;0.0;0.0;0.0;0;757;535;222;10;89;0.0
5957;Zondag 20 juni 2010;410;212;198;329;168;161;9;9;0.0;0.0;0.0;0.0;0.0;0.0;1;485;327;158;7;94;1.0
5958;Maandag 21 juni 2010;548;284;264;371;189;182;387;379;7.0;1.0;61.0;57.0;2.0;2.0;121;4986;3004;1982;579;326;24.0
5959;Dinsdag 22 juni 2010;563;289;274;330;165;165;172;168;3.0;1.0;35.0;34.0;0.0;1.0;152;4135;2433;1702;445;271;38.0
5960;Woensdag 23 juni 2010;575;303;272;370;180;190;173;167;2.0;4.0;30.0;27.0;1.0;2.0;138;3926;2391;1535;509;290;57.0
5961;Donderdag 24 juni 2010;564;296;268;346;167;179;249;246;1.0;2.0;29.0;27.0;0.0;2.0;125;4103;2518;1585;510;331;361.0
5962;Vrijdag 25 juni 2010;537;287;250;377;197;180;1158;1140;11.0;7.0;13.0;13.0;0.0;0.0;107;4500;2770;1730;420;372;30.0
5963;Zaterdag 26 juni 2010;453;236;217;376;174;202;312;302;4.0;6.0;2.0;1.0;1.0;0.0;1;1138;785;353;9;132;1.0
5964;Zondag 27 juni 2010;453;220;233;363;185;178;10;10;0.0;0.0;0.0;0.0;0.0;0.0;0;281;182;99;0;77;1.0
5965;Maandag 28 juni 2010;542;281;261;348;151;197;227;219;2.0;6.0;78.0;74.0;1.0;3.0;117;5028;2958;2070;599;442;271.0
5966;Dinsdag 29 juni 2010;570;289;281;327;161;166;162;161;0.0;1.0;42.0;41.0;0.0;1.0;124;4195;2507;1688;576;388;28.0
5967;Woensdag 30 juni 2010;543;293;250;368;191;177;200;197;2.0;1.0;33.0;33.0;0.0;0.0;144;5803;3639;2164;554;848;30.0
5968;Totaal juli 2010;16138;8300;7838;11136;5335;5801;7633;7506;60.0;67.0;773.0;732.0;16.0;25.0;2722;129361;75259;54102;13169;10865;1938.0
5969;Donderdag 1 juli 2010;599;297;302;363;160;203;322;313;5.0;4.0;26.0;26.0;0.0;0.0;138;19155;11258;7897;781;1146;29.0
5970;Vrijdag 2 juli 2010;580;302;278;412;210;202;887;876;6.0;5.0;22.0;19.0;1.0;2.0;109;5287;3032;2255;466;549;301.0
5971;Zaterdag 3 juli 2010;475;247;228;376;176;200;229;223;4.0;2.0;1.0;0.0;0.0;1.0;1;867;597;270;7;157;1.0
5972;Zondag 4 juli 2010;473;247;226;385;183;202;11;11;0.0;0.0;0.0;0.0;0.0;0.0;0;401;240;161;3;91;0.0
5973;Maandag 5 juli 2010;542;308;234;359;173;186;249;249;0.0;0.0;88.0;85.0;0.0;3.0;110;6604;3740;2864;787;416;51.0
5974;Dinsdag 6 juli 2010;550;280;270;351;181;170;156;150;3.0;3.0;39.0;37.0;0.0;2.0;105;5029;2770;2259;648;336;31.0
5975;Woensdag 7 juli 2010;524;262;262;358;175;183;243;237;2.0;4.0;33.0;32.0;1.0;0.0;126;4683;2697;1986;642;297;40.0
5976;Donderdag 8 juli 2010;599;301;298;383;175;208;209;205;1.0;3.0;20.0;18.0;0.0;2.0;129;5060;2955;2105;626;243;37.0
5977;Vrijdag 9 juli 2010;573;309;264;360;172;188;776;764;3.0;9.0;22.0;21.0;1.0;0.0;93;4281;2452;1829;459;426;30.0
5978;Zaterdag 10 juli 2010;472;261;211;420;183;237;293;290;2.0;1.0;1.0;0.0;0.0;1.0;2;1196;783;413;12;152;0.0
5979;Zondag 11 juli 2010;404;197;207;420;204;216;5;5;0.0;0.0;0.0;0.0;0.0;0.0;1;299;196;103;1;82;0.0
5980;Maandag 12 juli 2010;532;264;268;379;193;186;242;239;2.0;1.0;87.0;82.0;2.0;3.0;156;5159;2951;2208;598;423;30.0
5981;Dinsdag 13 juli 2010;551;304;247;369;172;197;139;137;2.0;0.0;46.0;44.0;2.0;0.0;138;4268;2392;1876;610;291;349.0
5982;Woensdag 14 juli 2010;523;260;263;372;188;184;198;195;0.0;3.0;31.0;30.0;0.0;1.0;129;4481;2521;1960;592;356;25.0
5983;Donderdag 15 juli 2010;542;294;248;360;182;178;183;178;2.0;3.0;33.0;30.0;1.0;2.0;139;6600;3825;2775;589;854;12.0
5984;Vrijdag 16 juli 2010;528;271;257;354;173;181;610;596;6.0;8.0;17.0;14.0;1.0;2.0;132;4860;2869;1991;480;349;15.0
5985;Zaterdag 17 juli 2010;445;239;206;353;175;178;210;209;1.0;0.0;0.0;0.0;0.0;0.0;1;898;576;322;10;82;0.0
5986;Zondag 18 juli 2010;404;212;192;311;151;160;15;15;0.0;0.0;0.0;0.0;0.0;0.0;0;338;208;130;6;53;0.0
5987;Maandag 19 juli 2010;489;250;239;329;162;167;219;212;4.0;3.0;65.0;65.0;0.0;0.0;101;5500;3297;2203;733;342;26.0
5988;Dinsdag 20 juli 2010;551;298;253;353;156;197;172;168;1.0;3.0;24.0;22.0;2.0;0.0;135;4809;2820;1989;602;347;25.0
5989;Woensdag 21 juli 2010;529;279;250;385;175;210;170;165;3.0;2.0;34.0;30.0;3.0;1.0;143;4211;2362;1849;577;336;34.0
5990;Donderdag 22 juli 2010;567;298;269;350;170;180;179;177;0.0;2.0;21.0;20.0;0.0;1.0;105;4489;2605;1884;595;352;21.0
5991;Vrijdag 23 juli 2010;553;279;274;377;186;191;435;431;3.0;1.0;14.0;14.0;0.0;0.0;113;4217;2432;1785;405;370;28.0
5992;Zaterdag 24 juli 2010;458;211;247;316;134;182;166;164;1.0;1.0;1.0;0.0;1.0;0.0;1;918;592;326;1;104;729.0
5993;Zondag 25 juli 2010;420;214;206;333;150;183;21;21;0.0;0.0;0.0;0.0;0.0;0.0;0;358;226;132;0;84;0.0
5994;Maandag 26 juli 2010;532;266;266;326;161;165;231;227;3.0;1.0;64.0;61.0;1.0;2.0;128;5120;2983;2137;691;399;30.0
5995;Dinsdag 27 juli 2010;584;283;301;356;169;187;159;158;0.0;1.0;32.0;32.0;0.0;0.0;124;4304;2486;1818;565;367;24.0
5996;Woensdag 28 juli 2010;560;274;286;336;161;175;175;173;1.0;1.0;26.0;25.0;0.0;1.0;130;4487;2536;1951;502;387;26.0
5997;Donderdag 29 juli 2010;535;269;266;342;168;174;168;165;1.0;2.0;18.0;17.0;0.0;1.0;132;4727;2728;1999;627;472;21.0
5998;Vrijdag 30 juli 2010;578;289;289;310;150;160;410;404;2.0;4.0;8.0;8.0;0.0;0.0;101;5474;3281;2193;550;569;23.0
5999;Zaterdag 31 juli 2010;466;235;231;338;167;171;151;149;2.0;0.0;0.0;0.0;0.0;0.0;0;1281;849;432;4;433;0.0
6000;Totaal augustus 2010;16089;8123;7966;10417;5090;5327;7683;7561;58.0;64.0;778.0;744.0;15.0;19.0;2805;133933;72653;61280;18876;9574;1705.0
6001;Zondag 1 augustus 2010;428;232;196;305;147;158;12;12;0.0;0.0;0.0;0.0;0.0;0.0;0;11613;6522;5091;62;687;1.0
6002;Maandag 2 augustus 2010;562;297;265;327;174;153;246;246;0.0;0.0;69.0;68.0;1.0;0.0;103;8368;4721;3647;781;494;13.0
6003;Dinsdag 3 augustus 2010;561;291;270;351;183;168;178;177;1.0;0.0;33.0;32.0;1.0;0.0;157;5829;3121;2708;850;288;29.0
6004;Woensdag 4 augustus 2010;581;289;292;339;169;170;151;146;1.0;4.0;26.0;23.0;1.0;2.0;105;5229;2785;2444;679;291;274.0
6005;Donderdag 5 augustus 2010;574;290;284;312;139;173;153;153;0.0;0.0;24.0;22.0;1.0;1.0;149;5494;2996;2498;722;335;16.0
6006;Vrijdag 6 augustus 2010;561;295;266;361;180;181;596;591;0.0;5.0;9.0;8.0;0.0;1.0;144;4749;2661;2088;537;278;18.0
6007;Zaterdag 7 augustus 2010;498;240;258;290;142;148;165;161;2.0;2.0;0.0;0.0;0.0;0.0;2;753;461;292;6;87;1.0
6008;Zondag 8 augustus 2010;437;220;217;307;143;164;21;21;0.0;0.0;0.0;0.0;0.0;0.0;0;389;230;159;14;69;0.0
6009;Maandag 9 augustus 2010;508;249;259;313;150;163;221;219;1.0;1.0;55.0;54.0;0.0;1.0;114;5534;3046;2488;786;320;20.0
6010;Dinsdag 10 augustus 2010;554;281;273;337;176;161;214;213;0.0;1.0;39.0;36.0;3.0;0.0;119;4628;2565;2063;884;265;26.0
6011;Woensdag 11 augustus 2010;563;285;278;371;179;192;116;114;2.0;0.0;30.0;30.0;0.0;0.0;135;4404;2420;1984;735;273;21.0
6012;Donderdag 12 augustus 2010;546;286;260;360;162;198;161;159;1.0;1.0;23.0;23.0;0.0;0.0;117;4693;2606;2087;642;298;403.0
6013;Vrijdag 13 augustus 2010;542;274;268;330;157;173;411;405;1.0;5.0;6.0;5.0;0.0;1.0;95;4273;2429;1844;581;309;11.0
6014;Zaterdag 14 augustus 2010;431;226;205;321;149;172;200;196;1.0;3.0;0.0;0.0;0.0;0.0;1;943;588;355;10;73;0.0
6015;Zondag 15 augustus 2010;419;196;223;347;162;185;9;9;0.0;0.0;0.0;0.0;0.0;0.0;0;1515;776;739;9;190;0.0
6016;Maandag 16 augustus 2010;530;245;285;389;185;204;223;218;4.0;1.0;81.0;79.0;0.0;2.0;117;6987;3756;3231;798;452;29.0
6017;Dinsdag 17 augustus 2010;544;265;279;320;155;165;163;159;1.0;3.0;35.0;34.0;0.0;1.0;135;4533;2415;2118;804;282;33.0
6018;Woensdag 18 augustus 2010;579;308;271;354;178;176;224;217;6.0;1.0;17.0;17.0;0.0;0.0;127;4702;2501;2201;764;291;21.0
6019;Donderdag 19 augustus 2010;517;270;247;323;159;164;189;185;1.0;3.0;17.0;15.0;1.0;1.0;154;4597;2458;2139;744;370;24.0
6020;Vrijdag 20 augustus 2010;587;283;304;399;208;191;990;976;6.0;8.0;20.0;19.0;0.0;1.0;130;4755;2485;2270;879;378;571.0
6021;Zaterdag 21 augustus 2010;468;229;239;342;147;195;261;257;3.0;1.0;2.0;1.0;0.0;1.0;1;879;505;374;4;86;0.0
6022;Zondag 22 augustus 2010;422;211;211;336;171;165;11;11;0.0;0.0;0.0;0.0;0.0;0.0;0;530;199;331;3;64;0.0
6023;Maandag 23 augustus 2010;507;258;249;329;156;173;197;192;3.0;2.0;68.0;62.0;2.0;4.0;115;5934;3038;2896;2245;381;56.0
6024;Dinsdag 24 augustus 2010;586;299;287;320;166;154;152;149;1.0;2.0;44.0;42.0;1.0;1.0;138;4536;2339;2197;899;317;50.0
6025;Woensdag 25 augustus 2010;535;266;269;298;134;164;205;202;2.0;1.0;26.0;25.0;1.0;0.0;126;5014;2827;2187;821;351;31.0
6026;Donderdag 26 augustus 2010;534;267;267;367;178;189;281;274;3.0;4.0;23.0;22.0;1.0;0.0;135;4531;2526;2005;734;340;19.0
6027;Vrijdag 27 augustus 2010;565;293;272;350;168;182;1127;1107;8.0;12.0;16.0;15.0;0.0;1.0;130;4584;2468;2116;709;417;18.0
6028;Zaterdag 28 augustus 2010;462;238;224;305;155;150;386;378;5.0;3.0;0.0;0.0;0.0;0.0;0;1121;673;448;5;132;0.0
6029;Zondag 29 augustus 2010;439;231;208;308;158;150;17;17;0.0;0.0;0.0;0.0;0.0;0.0;0;486;209;277;3;103;0.0
6030;Maandag 30 augustus 2010;521;251;270;323;173;150;245;240;4.0;1.0;78.0;75.0;2.0;1.0;132;6327;3111;3216;1046;562;9.0
6031;Dinsdag 31 augustus 2010;528;258;270;383;187;196;158;157;1.0;0.0;37.0;37.0;0.0;0.0;124;6003;3216;2787;1120;791;11.0
6032;Totaal september 2010;16194;8206;7988;10633;5143;5490;10542;10358;81.0;103.0;804.0;759.0;22.0;23.0;2838;130144;72232;57912;21458;8684;2089.0
6033;Woensdag 1 september 2010;545;265;280;356;165;191;258;251;4.0;3.0;42.0;40.0;1.0;1.0;131;21165;11135;10030;1062;1236;24.0
6034;Donderdag 2 september 2010;523;258;265;372;187;185;258;256;0.0;2.0;21.0;21.0;0.0;0.0;131;6449;3403;3046;1037;332;315.0
6035;Vrijdag 3 september 2010;517;267;250;347;160;187;1279;1260;10.0;9.0;11.0;10.0;0.0;1.0;150;5528;2909;2619;818;330;32.0
6036;Zaterdag 4 september 2010;435;222;213;312;145;167;416;408;5.0;3.0;3.0;2.0;1.0;0.0;1;937;489;448;2;98;0.0
6037;Zondag 5 september 2010;417;197;220;322;149;173;12;11;1.0;0.0;0.0;0.0;0.0;0.0;0;522;234;288;1;92;0.0
6038;Maandag 6 september 2010;504;264;240;346;174;172;245;242;2.0;1.0;69.0;66.0;0.0;3.0;133;6654;3497;3157;1309;359;27.0
6039;Dinsdag 7 september 2010;547;294;253;341;160;181;165;161;1.0;3.0;44.0;42.0;2.0;0.0;129;5000;2652;2348;1217;279;26.0
6040;Woensdag 8 september 2010;550;286;264;371;181;190;892;868;10.0;14.0;37.0;33.0;3.0;1.0;140;4914;2700;2214;1021;255;29.0
6041;Donderdag 9 september 2010;596;302;294;334;160;174;383;376;6.0;1.0;27.0;24.0;0.0;3.0;138;5118;2796;2322;1081;285;29.0
6042;Vrijdag 10 september 2010;586;295;291;367;192;175;1605;1582;7.0;16.0;16.0;14.0;2.0;0.0;148;4611;2603;2008;682;273;32.0
6043;Zaterdag 11 september 2010;492;241;251;353;158;195;241;234;5.0;2.0;1.0;0.0;1.0;0.0;1;713;428;285;5;94;0.0
6044;Zondag 12 september 2010;405;214;191;319;153;166;6;6;0.0;0.0;0.0;0.0;0.0;0.0;0;366;202;164;0;58;1.0
6045;Maandag 13 september 2010;519;258;261;359;181;178;194;191;0.0;3.0;78.0;75.0;1.0;2.0;131;5138;2894;2244;1135;254;383.0
6046;Dinsdag 14 september 2010;537;279;258;364;180;184;157;157;0.0;0.0;42.0;40.0;1.0;1.0;130;3996;2213;1783;948;221;21.0
6047;Woensdag 15 september 2010;579;293;286;371;165;206;199;194;1.0;4.0;34.0;34.0;0.0;0.0;134;5993;3473;2520;860;386;33.0
6048;Donderdag 16 september 2010;570;296;274;362;174;188;231;222;3.0;6.0;16.0;15.0;0.0;1.0;145;4937;2796;2141;795;296;44.0
6049;Vrijdag 17 september 2010;595;306;289;358;167;191;1063;1048;5.0;10.0;17.0;15.0;2.0;0.0;116;4102;2338;1764;765;270;17.0
6050;Zaterdag 18 september 2010;453;235;218;374;195;179;346;338;4.0;4.0;2.0;2.0;0.0;0.0;0;839;549;290;6;81;1.0
6051;Zondag 19 september 2010;457;224;233;331;146;185;10;10;0.0;0.0;0.0;0.0;0.0;0.0;0;336;179;157;2;75;0.0
6052;Maandag 20 september 2010;592;301;291;360;184;176;254;249;0.0;5.0;66.0;62.0;1.0;3.0;112;5408;3123;2285;1082;405;562.0
6053;Dinsdag 21 september 2010;612;292;320;395;200;195;144;143;1.0;0.0;45.0;41.0;0.0;4.0;117;4248;2338;1910;806;220;24.0
6054;Woensdag 22 september 2010;625;294;331;386;205;181;160;157;2.0;1.0;33.0;32.0;0.0;1.0;133;4482;2459;2023;871;285;27.0
6055;Donderdag 23 september 2010;591;295;296;369;184;185;191;188;2.0;1.0;24.0;22.0;1.0;1.0;127;4293;2490;1803;851;279;30.0
6056;Vrijdag 24 september 2010;572;299;273;386;181;205;938;926;3.0;9.0;17.0;16.0;1.0;0.0;108;4004;2384;1620;1209;315;43.0
6057;Zaterdag 25 september 2010;518;268;250;367;182;185;252;249;3.0;0.0;0.0;0.0;0.0;0.0;0;1349;890;459;196;128;2.0
6058;Zondag 26 september 2010;436;211;225;330;149;181;11;11;0.0;0.0;0.0;0.0;0.0;0.0;0;354;222;132;4;68;0.0
6059;Maandag 27 september 2010;588;311;277;313;158;155;176;172;1.0;3.0;70.0;69.0;1.0;0.0;100;4665;2654;2011;826;385;300.0
6060;Dinsdag 28 september 2010;616;324;292;350;164;186;135;131;2.0;2.0;38.0;37.0;1.0;0.0;131;4101;2367;1734;853;356;38.0
6061;Woensdag 29 september 2010;602;311;291;372;175;197;128;125;2.0;1.0;31.0;28.0;2.0;1.0;112;4209;2348;1861;1239;365;29.0
6062;Donderdag 30 september 2010;615;304;311;346;169;177;193;192;1.0;0.0;20.0;19.0;1.0;0.0;140;5713;3467;2246;775;604;20.0
6063;Totaal oktober 2010;16038;8152;7886;11415;5629;5786;6475;6326;70.0;79.0;787.0;742.0;17.0;28.0;2702;117684;69315;48369;14274;7161;1372.0
6064;Vrijdag 1 oktober 2010;583;276;307;394;189;205;893;875;8.0;10.0;23.0;21.0;1.0;1.0;115;17636;10712;6924;765;940;483.0
6065;Zaterdag 2 oktober 2010;465;239;226;382;203;179;160;155;2.0;3.0;0.0;0.0;0.0;0.0;0;727;457;270;5;94;0.0
6066;Zondag 3 oktober 2010;445;215;230;340;171;169;8;7;1.0;0.0;0.0;0.0;0.0;0.0;0;418;206;212;0;100;0.0
6067;Maandag 4 oktober 2010;561;268;293;387;179;208;176;172;3.0;1.0;71.0;68.0;1.0;2.0;129;6508;3631;2877;816;338;42.0
6068;Dinsdag 5 oktober 2010;569;297;272;370;186;184;133;127;1.0;5.0;49.0;47.0;2.0;0.0;109;5105;2863;2242;937;281;23.0
6069;Woensdag 6 oktober 2010;583;319;264;392;203;189;127;124;2.0;1.0;32.0;30.0;1.0;1.0;139;4996;2834;2162;950;251;40.0
6070;Donderdag 7 oktober 2010;555;277;278;391;188;203;134;132;0.0;2.0;17.0;16.0;0.0;1.0;156;5056;2923;2133;739;231;24.0
6071;Vrijdag 8 oktober 2010;549;280;269;342;175;167;523;514;3.0;6.0;21.0;15.0;0.0;6.0;100;4334;2519;1815;671;277;164.0
6072;Zaterdag 9 oktober 2010;471;241;230;382;184;198;127;126;0.0;1.0;1.0;1.0;0.0;0.0;2;759;475;284;6;62;126.0
6073;Zondag 10 oktober 2010;444;218;226;332;162;170;255;246;5.0;4.0;0.0;0.0;0.0;0.0;1;638;381;257;4;75;2.0
6074;Maandag 11 oktober 2010;565;297;268;360;187;173;208;203;3.0;2.0;84.0;80.0;2.0;2.0;129;4824;2812;2012;803;282;28.0
6075;Dinsdag 12 oktober 2010;582;277;305;383;189;194;137;135;2.0;0.0;30.0;29.0;1.0;0.0;153;4052;2266;1786;704;229;39.0
6076;Woensdag 13 oktober 2010;542;279;263;359;195;164;110;109;1.0;0.0;29.0;27.0;0.0;2.0;126;3990;2268;1722;765;212;26.0
6077;Donderdag 14 oktober 2010;538;265;273;348;170;178;153;149;1.0;3.0;22.0;21.0;0.0;1.0;130;4620;2755;1865;807;254;30.0
6078;Vrijdag 15 oktober 2010;577;296;281;384;192;192;505;495;4.0;6.0;19.0;18.0;0.0;1.0;125;5811;3515;2296;573;322;23.0
6079;Zaterdag 16 oktober 2010;446;245;201;360;150;210;107;104;3.0;0.0;1.0;1.0;0.0;0.0;1;985;641;344;11;51;1.0
6080;Zondag 17 oktober 2010;421;218;203;348;159;189;7;7;0.0;0.0;0.0;0.0;0.0;0.0;0;327;172;155;4;38;0.0
6081;Maandag 18 oktober 2010;531;277;254;362;181;181;209;207;1.0;1.0;74.0;71.0;2.0;1.0;97;5125;3042;2083;647;259;38.0
6082;Dinsdag 19 oktober 2010;572;278;294;380;194;186;121;118;2.0;1.0;44.0;41.0;0.0;3.0;173;3897;2218;1679;609;255;23.0
6083;Woensdag 20 oktober 2010;575;301;274;397;183;214;815;792;11.0;12.0;39.0;34.0;3.0;2.0;115;4377;2562;1815;575;257;38.0
6084;Donderdag  21 oktober 2010;549;297;252;377;181;196;141;140;0.0;1.0;23.0;21.0;1.0;1.0;125;4118;2400;1718;601;227;28.0
6085;Vrijdag 22 oktober 2010;584;286;298;352;180;172;416;404;6.0;6.0;17.0;15.0;2.0;0.0;113;4209;2539;1670;489;254;15.0
6086;Zaterdag 23 oktober 2010;453;219;234;345;188;157;74;72;1.0;1.0;0.0;0.0;0.0;0.0;0;1058;743;315;2;47;2.0
6087;Zondag 24 oktober 2010;396;196;200;342;162;180;8;8;0.0;0.0;0.0;0.0;0.0;0.0;0;313;185;128;1;38;1.0
6088;Maandag 25 oktober 2010;552;284;268;345;164;181;183;176;4.0;3.0;90.0;88.0;0.0;2.0;135;5134;3047;2087;627;271;36.0
6089;Dinsdag 26 oktober 2010;488;264;224;370;189;181;127;124;1.0;2.0;43.0;42.0;0.0;1.0;142;3919;2292;1627;619;290;32.0
6090;Woensdag 27 oktober 2010;510;253;257;363;160;203;129;124;2.0;3.0;25.0;24.0;1.0;0.0;127;4028;2348;1680;519;272;31.0
6091;Donderdag 28 oktober 2010;558;286;272;381;190;191;122;119;2.0;1.0;11.0;11.0;0.0;0.0;121;4440;2659;1781;557;306;35.0
6092;Vrijdag 29 oktober 2010;543;273;270;413;196;217;282;279;0.0;3.0;22.0;21.0;0.0;1.0;136;4546;2700;1846;465;315;40.0
6093;Zaterdag 30 oktober 2010;415;228;187;366;189;177;79;78;0.0;1.0;0.0;0.0;0.0;0.0;3;1090;732;358;3;112;1.0
6094;Zondag 31 oktober 2010;416;203;213;368;190;178;6;5;1.0;0.0;0.0;0.0;0.0;0.0;0;644;418;226;0;221;1.0
6095;Totaal november 2010;15400;7789;7611;10936;5288;5648;3484;3418;30.0;36.0;932.0;887.0;23.0;22.0;2656;118128;71446;46682;11756;6853;2945.0
6096;Maandag 1 november 2010;511;286;225;370;182;188;216;211;4.0;1.0;92.0;88.0;3.0;1.0;107;17851;11101;6750;681;808;52.0
6097;Dinsdag 2 november 2010;593;294;299;347;162;185;96;95;0.0;1.0;51.0;50.0;1.0;0.0;119;5246;3035;2211;608;283;56.0
6098;Woensdag 3 november 2010;551;250;301;348;167;181;98;96;1.0;1.0;29.0;28.0;1.0;0.0;142;4931;2841;2090;542;264;30.0
6099;Donderdag 4 november 2010;549;288;261;358;176;182;79;78;1.0;0.0;22.0;20.0;1.0;1.0;150;5197;3015;2182;609;238;22.0
6100;Vrijdag 5 november 2010;548;277;271;386;173;213;205;201;1.0;3.0;18.0;18.0;0.0;0.0;119;4606;2712;1894;448;221;17.0
6101;Zaterdag 6 november 2010;460;227;233;401;198;203;48;48;0.0;0.0;1.0;1.0;0.0;0.0;0;742;504;238;4;74;0.0
6102;Zondag 7 november 2010;417;217;200;344;158;186;5;5;0.0;0.0;0.0;0.0;0.0;0.0;0;355;223;132;2;53;0.0
6103;Maandag  8 november 2010;528;273;255;343;164;179;153;146;3.0;4.0;70.0;65.0;4.0;1.0;119;5392;3173;2219;667;253;57.0
6104;Dinsdag 9 november 2010;604;294;310;364;188;176;115;112;1.0;2.0;41.0;39.0;1.0;1.0;127;3961;2359;1602;610;179;52.0
6105;Woensdag 10 november 2010;604;307;297;374;174;200;123;121;0.0;2.0;40.0;38.0;0.0;2.0;148;4416;2698;1718;577;259;49.0
6106;Donderdag 11 november 2010;562;290;272;361;175;186;132;129;2.0;1.0;19.0;18.0;1.0;0.0;129;4089;2347;1742;558;257;41.0
6107;Vrijdag 12 november 2010;551;297;254;376;187;189;425;421;2.0;2.0;26.0;24.0;2.0;0.0;115;3944;2402;1542;437;252;931.0
6108;Zaterdag 13 november 2010;490;253;237;380;171;209;28;27;0.0;1.0;0.0;0.0;0.0;0.0;1;742;499;243;11;62;1.0
6109;Zondag 14 november 2010;415;206;209;342;161;181;5;5;0.0;0.0;0.0;0.0;0.0;0.0;0;377;253;124;1;44;0.0
6110;Maandag 15 november 2010;519;246;273;353;181;172;170;165;4.0;1.0;77.0;73.0;1.0;3.0;101;6984;4367;2617;572;313;53.0
6111;Dinsdag 16 november 2010;563;287;276;375;186;189;99;97;2.0;0.0;42.0;40.0;1.0;1.0;112;3773;2249;1524;538;229;31.0
6112;Woensdag 17 november 2010;530;276;254;353;176;177;101;100;0.0;1.0;35.0;34.0;1.0;0.0;104;3790;2261;1529;477;221;38.0
6113;Donderdag 18 november 2010;528;244;284;370;181;189;87;86;0.0;1.0;23.0;21.0;1.0;1.0;132;4142;2493;1649;499;194;32.0
6114;Vrijdag 19 november 2010;519;261;258;372;173;199;209;202;3.0;4.0;12.0;10.0;0.0;2.0;128;3916;2377;1539;476;224;38.0
6115;Zaterdag 20 november 2010;457;249;208;331;167;164;52;50;0.0;2.0;0.0;0.0;0.0;0.0;0;1207;841;366;3;61;0.0
6116;Zondag 21 november 2010;370;190;180;360;163;197;3;3;0.0;0.0;0.0;0.0;0.0;0.0;0;349;206;143;1;52;0.0
6117;Maandag 22 november 2010;500;243;257;341;163;178;188;185;0.0;3.0;88.0;85.0;1.0;2.0;129;5144;3081;2063;591;247;29.0
6118;Dinsdag 23 november 2010;509;244;265;324;149;175;115;113;0.0;2.0;36.0;34.0;2.0;0.0;138;4048;2418;1630;511;253;1245.0
6119;Woensdag 24 november 2010;525;273;252;365;188;177;100;98;0.0;2.0;30.0;29.0;0.0;1.0;123;4022;2377;1645;486;227;10.0
6120;Donderdag 25 november 2010;560;293;267;364;174;190;104;103;0.0;1.0;23.0;23.0;0.0;0.0;113;4083;2569;1514;494;399;58.0
6121;Vrijdag 26 november 2010;563;286;277;384;182;202;239;235;3.0;1.0;21.0;21.0;0.0;0.0;76;3785;2368;1417;395;234;31.0
6122;Zaterdag 27 november 2010;450;229;221;388;191;197;41;41;0.0;0.0;0.0;0.0;0.0;0.0;1;1213;863;350;3;89;0.0
6123;Zondag 28 november 2010;386;182;204;374;190;184;5;5;0.0;0.0;0.0;0.0;0.0;0.0;0;386;220;166;0;61;2.0
6124;Maandag 29 november 2010;539;280;259;405;194;211;154;152;2.0;0.0;82.0;78.0;2.0;2.0;113;4667;2722;1945;450;321;30.0
6125;Dinsdag 30 november 2010;499;247;252;383;194;189;89;88;1.0;0.0;54.0;50.0;0.0;4.0;110;4770;2872;1898;505;481;40.0
6126;Totaal december 2010;15380;7958;7422;12531;6138;6393;3510;3439;38.0;33.0;901.0;858.0;27.0;16.0;2988;121298;74643;46655;9629;7657;2326.0
6127;Woensdag 1 december 2010;496;253;243;406;193;213;113;109;2.0;2.0;37.0;35.0;2.0;0.0;160;16842;10546;6296;516;563;31.0
6128;Donderdag 2 december 2010;503;277;226;407;210;197;80;74;4.0;2.0;17.0;15.0;2.0;0.0;124;5042;3022;2020;518;250;23.0
6129;Vrijdag 3 december 2010;532;287;245;385;187;198;143;141;1.0;1.0;14.0;13.0;1.0;0.0;133;4367;2654;1713;407;246;14.0
6130;Zaterdag 4 december 2010;434;220;214;363;173;190;29;29;0.0;0.0;0.0;0.0;0.0;0.0;1;728;485;243;3;67;0.0
6131;Zondag 5 december 2010;411;213;198;384;203;181;4;4;0.0;0.0;0.0;0.0;0.0;0.0;0;405;244;161;1;52;0.0
6132;Maandag 6 december 2010;530;240;290;408;208;200;167;165;1.0;1.0;96.0;92.0;1.0;3.0;116;5242;3167;2075;551;251;34.0
6133;Dinsdag 7 december 2010;526;251;275;414;195;219;115;109;4.0;2.0;41.0;37.0;3.0;1.0;144;4077;2483;1594;543;223;24.0
6134;Woensdag 8 december 2010;506;263;243;409;205;204;111;109;1.0;1.0;29.0;28.0;1.0;0.0;124;4365;2618;1747;554;246;33.0
6135;Donderdag 9 december 2010;552;290;262;424;214;210;97;95;1.0;1.0;25.0;24.0;1.0;0.0;122;4239;2630;1609;448;241;35.0
6136;Vrijdag 10 december 2010;528;282;246;418;219;199;358;351;4.0;3.0;16.0;15.0;0.0;1.0;112;4204;2654;1550;389;220;23.0
6137;Zaterdag 11 december 2010;427;213;214;397;198;199;64;62;1.0;1.0;0.0;0.0;0.0;0.0;0;982;681;301;2;64;0.0
6138;Zondag 12 december 2010;383;206;177;360;174;186;3;3;0.0;0.0;0.0;0.0;0.0;0.0;1;427;274;153;0;44;0.0
6139;Maandag 13 december 2010;532;293;239;391;193;198;164;162;1.0;1.0;65.0;62.0;3.0;0.0;114;4935;3004;1931;518;270;24.0
6140;Dinsdag 14 december 2010;563;278;285;453;230;223;119;117;1.0;1.0;42.0;37.0;4.0;1.0;120;4010;2501;1509;483;244;22.0
6141;Woensdag 15 december 2010;508;285;223;387;193;194;109;108;0.0;1.0;33.0;31.0;0.0;2.0;129;6428;4020;2408;400;325;89.0
6142;Donderdag 16 december 2010;528;285;243;440;224;216;104;101;1.0;2.0;33.0;32.0;0.0;1.0;114;4379;2687;1692;522;244;24.0
6143;Vrijdag 17 december 2010;534;289;245;431;203;228;268;265;2.0;1.0;14.0;14.0;0.0;0.0;100;3851;2414;1437;329;267;9.0
6144;Zaterdag 18 december 2010;452;236;216;409;194;215;81;80;1.0;0.0;1.0;1.0;0.0;0.0;1;1520;1040;480;5;110;0.0
6145;Zondag 19 december 2010;412;202;210;360;168;192;2;2;0.0;0.0;0.0;0.0;0.0;0.0;0;362;246;116;0;85;0.0
6146;Maandag 20 december 2010;504;261;243;392;192;200;198;190;4.0;4.0;122.0;117.0;3.0;2.0;139;6232;3744;2488;504;376;670.0
6147;Dinsdag 21 december 2010;535;265;270;374;165;209;188;186;1.0;1.0;46.0;45.0;0.0;1.0;146;4340;2543;1797;403;283;263.0
6148;Woensdag 22 december 2010;560;265;295;416;190;226;131;130;0.0;1.0;39.0;39.0;0.0;0.0;134;4116;2523;1593;388;258;19.0
6149;Donderdag 23 december 2010;519;269;250;436;223;213;129;129;0.0;0.0;26.0;23.0;2.0;1.0;134;4338;2678;1660;345;339;453.0
6150;Vrijdag 24 december 2010;517;241;276;451;209;242;83;81;1.0;1.0;12.0;11.0;0.0;1.0;95;2738;1647;1091;137;156;15.0
6151;Zaterdag 25 december 2010;388;215;173;381;178;203;4;4;0.0;0.0;0.0;0.0;0.0;0.0;0;207;119;88;0;49;0.0
6152;Zondag 26 december 2010;351;193;158;376;179;197;4;4;0.0;0.0;0.0;0.0;0.0;0.0;0;146;101;45;0;42;0.0
6153;Maandag 27 december 2010;517;269;248;391;201;190;164;161;3.0;0.0;79.0;75.0;3.0;1.0;113;4248;2590;1658;341;334;403.0
6154;Dinsdag 28 december 2010;569;289;280;416;209;207;157;152;1.0;4.0;53.0;52.0;1.0;0.0;184;4491;2764;1727;416;357;45.0
6155;Woensdag 29 december 2010;558;286;272;411;193;218;122;121;1.0;0.0;35.0;35.0;0.0;0.0;181;4677;2804;1873;327;323;29.0
6156;Donderdag 30 december 2010;525;278;247;420;201;219;114;112;1.0;1.0;20.0;20.0;0.0;0.0;160;5735;3493;2242;398;356;29.0
6157;Vrijdag 31 december 2010;480;264;216;421;214;207;85;83;1.0;1.0;6.0;5.0;0.0;1.0;87;3625;2267;1358;181;772;15.0
6158;Totaal op Zondag in 2010;21388;10852;10536;18536;8910;9626;717;702;11.0;4.0;2.0;2.0;0.0;0.0;12;32995;19614;13381;174;4341;21.0
6159;Totaal op Maandag in 2010;26749;13703;13046;19027;9327;9700;10518;10282;130.0;106.0;3899.0;3726.0;80.0;93.0;5988;323455;191877;131578;34650;18284;6144.0
6160;Totaal op Dinsdag in 2010;28193;14268;13925;19250;9409;9841;7265;7133;64.0;68.0;2108.0;2020.0;50.0;38.0;7326;250514;147471;103043;32361;14788;5059.0
6161;Totaal op Woensdag in 2010;28352;14526;13826;19816;9609;10207;9295;9104;88.0;103.0;1583.0;1508.0;37.0;38.0;7051;267103;156811;110292;30513;15872;1942.0
6162;Totaal op Donderdag in 2010;28056;14345;13711;19709;9570;10139;9083;8909;78.0;96.0;1113.0;1046.0;26.0;41.0;7096;278791;166564;112227;30331;16498;5714.0
6163;Totaal op Vrijdag in 2010;28551;14613;13938;20484;9940;10544;28845;28391;202.0;252.0;822.0;752.0;33.0;37.0;5716;250347;150478;99869;24993;16615;6287.0
6164;Totaal op Zaterdag in 2010;22865;11693;11172;19174;9178;9996;7704;7560;83.0;61.0;28.0;18.0;7.0;3.0;44;57790;38767;19023;684;4813;872.0
6165;Totaal 2011;180060;92353;87707;135741;65259;70482;71572;70217;601.0;754.0;9945.0;9464.0;235.0;246.0;33755;1459027;865306;593721;162962;106185;28612.0
6166;Totaal januari 2011;15106;7703;7403;12198;5866;6332;2664;2613;22.0;29.0;731.0;706.0;13.0;12.0;2953;124746;75094;49652;12324;8371;2596.0
6167;2011 zaterdag 1 januari;345;188;157;407;204;203;17;17;0.0;0.0;0.0;0.0;0.0;0.0;0;12513;7500;5013;74;889;0.0
6168;2011 zondag 2 januari;374;181;193;417;196;221;4;4;0.0;0.0;0.0;0.0;0.0;0.0;1;699;414;285;5;100;2.0
6169;2011 maandag 3 januari;524;272;252;409;190;219;95;95;0.0;0.0;33.0;33.0;0.0;0.0;78;6757;4010;2747;565;461;23.0
6170;2011 dinsdag 4 januari;540;280;260;450;237;213;75;73;0.0;2.0;49.0;49.0;0.0;0.0;163;5886;3408;2478;574;353;32.0
6171;2011 woensdag 5 januari;571;298;273;371;176;195;78;77;1.0;0.0;33.0;31.0;1.0;1.0;148;5860;3340;2520;603;310;42.0
6172;2011 donderdag 6 januari;530;272;258;436;199;237;83;83;0.0;0.0;13.0;10.0;1.0;2.0;166;5386;3097;2289;604;287;56.0
6173;2011 vrijdag 7 januari;529;250;279;446;222;224;118;116;1.0;1.0;13.0;12.0;1.0;0.0;127;5095;3080;2015;425;314;495.0
6174;2011 zaterdag 8 januari;419;218;201;429;215;214;40;38;1.0;1.0;0.0;0.0;0.0;0.0;2;983;659;324;7;71;0.0
6175;2011 zondag 9 januari;386;202;184;376;169;207;9;9;0.0;0.0;0.0;0.0;0.0;0.0;1;335;220;115;3;75;0.0
6176;2011 maandag 10 januari;492;244;248;379;179;200;188;187;1.0;0.0;80.0;80.0;0.0;0.0;145;5847;3529;2318;625;371;24.0
6177;2011 dinsdag 11 januari;519;276;243;408;201;207;230;224;3.0;3.0;58.0;57.0;0.0;1.0;175;4423;2639;1784;635;277;34.0
6178;2011 woensdag 12 januari;528;253;275;388;182;206;90;87;1.0;2.0;29.0;28.0;1.0;0.0;166;4332;2457;1875;591;234;33.0
6179;2011 donderdag 13 januari;517;282;235;435;185;250;75;73;1.0;1.0;12.0;12.0;0.0;0.0;159;4444;2747;1697;588;252;53.0
6180;2011 vrijdag 14 januari;504;253;251;406;204;202;161;159;0.0;2.0;16.0;13.0;3.0;0.0;152;4648;2858;1790;510;294;64.0
6181;2011 zaterdag 15 januari;381;200;181;413;194;219;42;39;2.0;1.0;0.0;0.0;0.0;0.0;0;2095;1464;631;15;126;0.0
6182;2011 zondag 16 januari;397;197;200;389;183;206;7;6;1.0;0.0;0.0;0.0;0.0;0.0;0;440;254;186;4;75;0.0
6183;2011 maandag 17 januari;504;264;240;380;183;197;138;136;0.0;2.0;55.0;53.0;1.0;1.0;110;5553;3311;2242;582;294;25.0
6184;2011 dinsdag 18 januari;553;306;247;378;195;183;99;98;0.0;1.0;34.0;34.0;0.0;0.0;166;4117;2477;1640;501;240;39.0
6185;2011 woensdag 19 januari;513;276;237;350;166;184;82;81;1.0;0.0;25.0;24.0;1.0;0.0;128;4328;2574;1754;534;203;36.0
6186;2011 donderdag 20 januari;538;260;278;391;184;207;77;73;1.0;3.0;19.0;18.0;1.0;0.0;148;4762;2934;1828;582;268;44.0
6187;2011 vrijdag 21 januari;549;270;279;379;172;207;172;167;2.0;3.0;19.0;19.0;0.0;0.0;124;4019;2421;1598;438;272;22.0
6188;2011 zaterdag 22 januari;463;225;238;370;168;202;40;40;0.0;0.0;0.0;0.0;0.0;0.0;1;986;662;324;6;70;0.0
6189;2011 zondag 23 januari;406;215;191;376;186;190;5;5;0.0;0.0;0.0;0.0;0.0;0.0;0;353;213;140;0;54;0.0
6190;2011 maandag 24 januari;491;250;241;368;173;195;134;131;2.0;1.0;63.0;62.0;0.0;1.0;103;5245;3234;2011;567;335;51.0
6191;2011 dinsdag 25 januari;524;260;264;373;188;185;90;87;1.0;2.0;40.0;38.0;0.0;2.0;149;4153;2542;1611;577;284;28.0
6192;2011 woensdag 26 januari;547;260;287;371;176;195;83;81;1.0;1.0;24.0;22.0;1.0;1.0;144;4141;2448;1693;892;257;949.0
6193;2011 donderdag 27 januari;550;282;268;375;172;203;80;79;0.0;1.0;22.0;22.0;0.0;0.0;129;4383;2684;1699;557;351;42.0
6194;2011 vrijdag 28 januari;521;264;257;386;201;185;156;154;0.0;2.0;17.0;15.0;1.0;1.0;154;4875;2998;1877;520;398;467.0
6195;2011 zaterdag 29 januari;448;236;212;375;181;194;35;35;0.0;0.0;0.0;0.0;0.0;0.0;0;1050;722;328;6;123;0.0
6196;2011 zondag 30 januari;407;204;203;371;185;186;10;10;0.0;0.0;0.0;0.0;0.0;0.0;0;482;319;163;2;97;0.0
6197;2011 maandag 31 januari;536;265;271;396;200;196;151;149;2.0;0.0;77.0;74.0;1.0;2.0;114;6556;3879;2677;732;636;35.0
6198;Totaal februari 2011;14112;7212;6900;10644;5215;5429;3055;3011;20.0;24.0;790.0;750.0;18.0;22.0;2770;117605;71039;46566;12608;6606;2600.0
6199;2011 dinsdag 1 februari;553;285;268;415;212;203;102;100;1.0;1.0;41.0;40.0;1.0;0.0;116;18519;11236;7283;708;731;33.0
6200;2011 woensdag 2 februari;548;269;279;370;192;178;95;95;0.0;0.0;33.0;30.0;1.0;2.0;176;5482;3141;2341;808;230;40.0
6201;2011 donderdag 3 februari;556;279;277;397;178;219;74;73;1.0;0.0;18.0;16.0;1.0;1.0;131;5593;3276;2317;682;257;35.0
6202;2011 vrijdag 4 februari;542;285;257;394;167;227;123;122;1.0;0.0;8.0;8.0;0.0;0.0;138;4765;2801;1964;620;255;45.0
6203;2011 zaterdag 5 februari;504;253;251;395;194;201;44;42;1.0;1.0;0.0;0.0;0.0;0.0;0;880;560;320;13;99;0.0
6204;2011 zondag 6 februari;442;228;214;361;184;177;2;2;0.0;0.0;0.0;0.0;0.0;0.0;0;424;269;155;1;48;0.0
6205;2011 maandag 7 februari;491;259;232;395;205;190;134;131;1.0;2.0;66.0;64.0;1.0;1.0;140;5542;3270;2272;829;293;44.0
6206;2011 dinsdag 8 februari;575;293;282;400;197;203;85;85;0.0;0.0;40.0;39.0;0.0;1.0;138;4456;2715;1741;571;263;39.0
6207;2011 woensdag 9 februari;516;276;240;399;179;220;70;68;1.0;1.0;32.0;30.0;2.0;0.0;134;4442;2629;1813;676;204;28.0
6208;2011 donderdag 10 februari;506;265;241;394;187;207;85;85;0.0;0.0;15.0;15.0;0.0;0.0;152;4801;2883;1918;624;312;382.0
6209;2011 vrijdag 11 februari;550;283;267;354;174;180;399;391;2.0;6.0;15.0;14.0;0.0;1.0;138;4162;2497;1665;484;252;16.0
6210;2011 zaterdag 12 februari;405;187;218;365;180;185;38;38;0.0;0.0;1.0;1.0;0.0;0.0;1;1050;720;330;6;66;0.0
6211;2011 zondag 13 februari;397;210;187;368;183;185;2;2;0.0;0.0;0.0;0.0;0.0;0.0;0;358;222;136;3;45;0.0
6212;2011 maandag 14 februari;523;283;240;386;201;185;442;432;6.0;4.0;105.0;102.0;3.0;0.0;114;5479;3372;2107;627;274;43.0
6213;2011 dinsdag 15 februari;528;273;255;375;187;188;92;90;1.0;1.0;34.0;32.0;0.0;2.0;147;5761;3716;2045;614;248;20.0
6214;2011 woensdag 16 februari;522;269;253;391;196;195;81;78;2.0;1.0;38.0;35.0;1.0;2.0;125;4320;2524;1796;588;207;26.0
6215;2011 donderdag 17 februari;565;275;290;368;174;194;82;82;0.0;0.0;22.0;22.0;0.0;0.0;136;4557;2693;1864;568;242;50.0
6216;2011 vrijdag 18 februari;535;267;268;393;190;203;164;163;0.0;1.0;14.0;13.0;0.0;1.0;147;4213;2612;1601;750;276;35.0
6217;2011 zaterdag 19 februari;448;241;207;396;193;203;39;39;0.0;0.0;0.0;0.0;0.0;0.0;0;1182;778;404;132;56;0.0
6218;2011 zondag 20 februari;418;209;209;312;161;151;6;6;0.0;0.0;0.0;0.0;0.0;0.0;0;601;384;217;2;69;0.0
6219;2011 maandag 21 februari;483;257;226;398;190;208;175;175;0.0;0.0;81.0;78.0;2.0;1.0;122;5410;3190;2220;633;302;85.0
6220;2011 dinsdag 22 februari;517;284;233;368;183;185;134;131;0.0;3.0;54.0;52.0;0.0;2.0;171;4056;2364;1692;601;279;49.0
6221;2011 woensdag 23 februari;552;260;292;387;196;191;114;112;1.0;1.0;35.0;31.0;2.0;2.0;141;4222;2495;1727;494;274;19.0
6222;2011 donderdag 24 februari;555;276;279;385;177;208;99;98;1.0;0.0;31.0;30.0;0.0;1.0;159;4483;2660;1823;556;316;49.0
6223;2011 vrijdag 25 februari;552;293;259;391;191;200;173;171;1.0;1.0;17.0;16.0;1.0;0.0;117;4422;2689;1733;428;313;24.0
6224;2011 zaterdag 26 februari;417;203;214;369;193;176;37;37;0.0;0.0;1.0;1.0;0.0;0.0;1;1270;860;410;8;86;1514.0
6225;2011 zondag 27 februari;397;193;204;353;169;184;5;5;0.0;0.0;1.0;1.0;0.0;0.0;0;421;290;131;0;72;0.0
6226;2011 maandag 28 februari;515;257;258;365;182;183;159;158;0.0;1.0;88.0;80.0;3.0;5.0;126;6734;4193;2541;582;537;24.0
6227;Totaal maart 2011;14768;7568;7200;12043;5809;6234;3224;3163;19.0;42.0;795.0;748.0;20.0;27.0;3134;125411;77687;47724;11899;7164;2473.0
6228;2011 dinsdag 1 maart;488;254;234;412;198;214;117;116;0.0;1.0;46.0;45.0;1.0;0.0;137;18212;11361;6851;590;673;37.0
6229;2011 woensdag 2 maart;504;250;254;373;191;182;70;70;0.0;0.0;19.0;19.0;0.0;0.0;150;5480;3175;2305;515;248;27.0
6230;2011 donderdag 3 maart;518;260;258;389;184;205;90;90;0.0;0.0;23.0;22.0;0.0;1.0;93;5730;3409;2321;531;233;39.0
6231;2011 vrijdag 4 maart;511;272;239;406;183;223;142;139;0.0;3.0;13.0;11.0;1.0;1.0;126;4842;2905;1937;520;239;443.0
6232;2011 zaterdag 5 maart;383;193;190;347;176;171;38;38;0.0;0.0;0.0;0.0;0.0;0.0;1;910;630;280;3;74;0.0
6233;2011 zondag 6 maart;369;182;187;394;210;184;8;6;0.0;2.0;0.0;0.0;0.0;0.0;0;355;227;128;3;40;1.0
6234;2011 maandag 7 maart;479;246;233;396;198;198;154;152;1.0;1.0;59.0;58.0;1.0;0.0;114;4789;2901;1888;527;268;26.0
6235;2011 dinsdag 8 maart;519;270;249;396;189;207;97;92;1.0;4.0;24.0;21.0;1.0;2.0;125;3991;2452;1539;474;208;32.0
6236;2011 woensdag 9 maart;528;262;266;400;196;204;91;88;1.0;2.0;37.0;37.0;0.0;0.0;153;4383;2676;1707;547;226;37.0
6237;2011 donderdag 10 maart;547;269;278;380;177;203;86;84;1.0;1.0;25.0;24.0;1.0;0.0;127;4772;2851;1921;518;271;43.0
6238;2011 vrijdag 11 maart;546;305;241;397;184;213;243;237;2.0;4.0;9.0;9.0;0.0;0.0;141;4136;2453;1683;462;239;44.0
6239;2011 zaterdag 12 maart;396;195;201;384;183;201;42;42;0.0;0.0;2.0;2.0;0.0;0.0;0;993;674;319;4;49;0.0
6240;2011 zondag 13 maart;383;190;193;361;177;184;2;2;0.0;0.0;0.0;0.0;0.0;0.0;0;304;195;109;3;43;0.0
6241;2011 maandag 14 maart;487;285;202;399;180;219;151;148;3.0;0.0;77.0;69.0;2.0;6.0;128;6058;4022;2036;577;305;25.0
6242;2011 dinsdag 15 maart;509;276;233;376;176;200;110;109;0.0;1.0;45.0;43.0;1.0;1.0;156;6382;4251;2131;612;266;16.0
6243;2011 woensdag 16 maart;508;251;257;405;197;208;104;102;1.0;1.0;28.0;27.0;0.0;1.0;169;4461;2788;1673;526;242;200.0
6244;2011 donderdag 17 maart;475;233;242;408;202;206;90;87;0.0;3.0;15.0;15.0;0.0;0.0;127;4070;2440;1630;535;190;21.0
6245;2011 vrijdag 18 maart;502;266;236;437;219;218;208;204;2.0;2.0;16.0;14.0;1.0;1.0;129;3956;2368;1588;399;275;22.0
6246;2011 zaterdag 19 maart;426;219;207;367;173;194;52;51;0.0;1.0;0.0;0.0;0.0;0.0;1;935;668;267;6;64;0.0
6247;2011 zondag 20 maart;374;191;183;335;144;191;3;3;0.0;0.0;0.0;0.0;0.0;0.0;0;444;293;151;0;65;0.0
6248;2011 maandag 21 maart;446;228;218;401;185;216;229;226;1.0;2.0;83.0;79.0;0.0;4.0;116;4716;2874;1842;545;281;27.0
6249;2011 dinsdag 22 maart;510;257;253;413;198;215;106;104;0.0;2.0;48.0;46.0;2.0;0.0;125;3673;2213;1460;511;208;30.0
6250;2011 woensdag 23 maart;494;249;245;394;197;197;103;101;1.0;1.0;34.0;31.0;2.0;1.0;124;3793;2314;1479;463;262;39.0
6251;2011 donderdag 24 maart;529;266;263;385;191;194;84;82;1.0;1.0;19.0;19.0;0.0;0.0;163;4090;2579;1511;463;291;660.0
6252;2011 vrijdag 25 maart;510;245;265;395;180;215;261;257;0.0;4.0;10.0;10.0;0.0;0.0;135;4044;2538;1506;417;277;25.0
6253;2011 zaterdag 26 maart;378;210;168;351;165;186;57;57;0.0;0.0;1.0;0.0;1.0;0.0;1;1188;808;380;9;84;0.0
6254;2011 zondag 27 maart;364;194;170;347;192;155;8;8;0.0;0.0;0.0;0.0;0.0;0.0;0;362;243;119;3;55;0.0
6255;2011 maandag 28 maart;500;250;250;418;180;238;159;154;2.0;3.0;77.0;69.0;4.0;4.0;123;4787;3003;1784;533;325;19.0
6256;2011 dinsdag 29 maart;552;264;288;413;194;219;121;118;1.0;2.0;34.0;32.0;1.0;1.0;188;3796;2203;1593;560;262;24.0
6257;2011 woensdag 30 maart;517;282;235;365;189;176;120;119;0.0;1.0;32.0;29.0;0.0;3.0;142;4348;2619;1729;492;367;592.0
6258;2011 donderdag 31 maart;516;254;262;399;201;198;78;77;1.0;0.0;19.0;17.0;1.0;1.0;140;5411;3554;1857;551;534;44.0
6259;Totaal april 2011;14277;7338;6939;11332;5493;5839;4959;4865;44.0;50.0;727.0;685.0;24.0;18.0;2597;109550;67249;42301;10016;7016;1764.0
6260;2011 vrijdag 1 april;506;252;254;396;190;206;397;384;5.0;8.0;20.0;18.0;1.0;1.0;131;18156;11468;6688;522;833;27.0
6261;2011 zaterdag 2 april;410;231;179;388;195;193;63;62;0.0;1.0;0.0;0.0;0.0;0.0;2;856;569;287;5;92;0.0
6262;2011 zondag 3 april;375;204;171;356;191;165;4;4;0.0;0.0;0.0;0.0;0.0;0.0;0;450;273;177;6;56;0.0
6263;2011 maandag 4 april;530;262;268;351;190;161;230;225;1.0;4.0;85.0;84.0;0.0;1.0;125;6327;3694;2633;688;348;30.0
6264;2011 dinsdag 5 april;538;277;261;357;176;181;114;111;3.0;0.0;35.0;34.0;1.0;0.0;141;4648;2694;1954;596;355;43.0
6265;2011 woensdag 6 april;466;257;209;359;171;188;86;82;2.0;2.0;36.0;34.0;0.0;2.0;168;4364;2525;1839;536;202;32.0
6266;2011 donderdag 7 april;490;274;216;357;168;189;136;133;1.0;2.0;17.0;16.0;1.0;0.0;158;4679;2832;1847;533;259;210.0
6267;2011 vrijdag 8 april;540;274;266;402;194;208;359;351;3.0;5.0;14.0;13.0;1.0;0.0;99;4294;2606;1688;393;234;34.0
6268;2011 zaterdag 9 april;400;209;191;374;174;200;73;72;0.0;1.0;0.0;0.0;0.0;0.0;0;855;595;260;6;41;0.0
6269;2011 zondag 10 april;372;188;184;392;204;188;9;9;0.0;0.0;0.0;0.0;0.0;0.0;1;416;261;155;0;45;0.0
6270;2011 maandag 11 april;501;255;246;396;192;204;228;226;2.0;0.0;77.0;74.0;2.0;1.0;145;4709;2840;1869;600;298;323.0
6271;2011 dinsdag 12 april;521;269;252;412;188;224;122;122;0.0;0.0;44.0;43.0;0.0;1.0;139;3705;2195;1510;467;240;55.0
6272;2011 woensdag 13 april;520;243;277;400;187;213;100;98;1.0;1.0;19.0;18.0;0.0;1.0;121;3836;2323;1513;531;240;46.0
6273;2011 donderdag 14 april;516;245;271;365;194;171;141;139;0.0;2.0;29.0;28.0;1.0;0.0;106;4219;2663;1556;573;258;42.0
6274;2011 vrijdag 15 april;551;277;274;376;191;185;534;525;3.0;6.0;23.0;21.0;0.0;2.0;116;5499;3437;2062;355;308;32.0
6275;2011 zaterdag 16 april;399;196;203;380;169;211;119;115;1.0;3.0;1.0;1.0;0.0;0.0;1;1061;744;317;11;50;2.0
6276;2011 zondag 17 april;373;184;189;321;159;162;7;7;0.0;0.0;0.0;0.0;0.0;0.0;0;358;216;142;3;42;0.0
6277;2011 maandag 18 april;495;276;219;378;184;194;230;226;4.0;0.0;89.0;81.0;7.0;1.0;133;4932;3026;1906;592;330;43.0
6278;2011 dinsdag 19 april;561;293;268;371;167;204;119;115;2.0;2.0;36.0;31.0;4.0;1.0;135;3768;2323;1445;510;273;23.0
6279;2011 woensdag 20 april;479;245;234;393;199;194;167;163;2.0;2.0;42.0;39.0;1.0;2.0;127;4028;2371;1657;470;271;23.0
6280;2011 donderdag 21 april;543;270;273;411;193;218;290;289;1.0;0.0;23.0;20.0;2.0;1.0;149;4309;2587;1722;540;310;698.0
6281;2011 vrijdag 22 april;519;271;248;373;181;192;168;162;2.0;4.0;11.0;10.0;0.0;1.0;23;1733;1179;554;106;117;3.0
6282;2011 zaterdag 23 april;391;208;183;402;188;214;98;97;1.0;0.0;0.0;0.0;0.0;0.0;1;1100;773;327;4;45;1.0
6283;2011 zondag 24 april;385;180;205;365;175;190;9;9;0.0;0.0;0.0;0.0;0.0;0.0;0;231;133;98;3;34;0.0
6284;2011 maandag 25 april;406;225;181;374;183;191;25;24;1.0;0.0;0.0;0.0;0.0;0.0;2;688;472;216;0;56;2.0
6285;2011 dinsdag 26 april;495;239;256;389;191;198;161;160;0.0;1.0;59.0;58.0;0.0;1.0;140;4997;2966;2031;515;374;26.0
6286;2011 woensdag 27 april;530;273;257;361;169;192;169;167;1.0;1.0;29.0;27.0;0.0;2.0;155;4257;2504;1753;492;327;27.0
6287;2011 donderdag 28 april;493;254;239;373;172;201;237;234;2.0;1.0;22.0;21.0;1.0;0.0;137;4994;3092;1902;546;358;18.0
6288;2011 vrijdag 29 april;543;285;258;422;198;224;530;520;6.0;4.0;16.0;14.0;2.0;0.0;140;5147;3233;1914;413;401;24.0
6289;2011 zaterdag 30 april;429;222;207;338;160;178;34;34;0.0;0.0;0.0;0.0;0.0;0.0;2;934;655;279;0;219;0.0
6290;Totaal mei 2011;15108;7752;7356;11287;5405;5882;8628;8502;56.0;70.0;915.0;862.0;30.0;23.0;2904;113721;70289;43432;10215;7546;2448.0
6291;2011 zondag 1 mei;416;209;207;334;154;180;11;11;0.0;0.0;0.0;0.0;0.0;0.0;0;8251;5328;2923;16;402;0.0
6292;2011 maandag 2 mei;483;258;225;371;185;186;344;333;4.0;7.0;81.0;80.0;0.0;1.0;133;7401;4462;2939;498;353;424.0
6293;2011 dinsdag 3 mei;511;240;271;364;175;189;188;185;1.0;2.0;48.0;44.0;1.0;3.0;157;5269;3153;2116;578;325;40.0
6294;2011 woensdag 4 mei;553;292;261;362;178;184;94;93;1.0;0.0;30.0;29.0;1.0;0.0;134;5000;2967;2033;481;274;31.0
6295;2011 donderdag 5 mei;440;240;200;348;171;177;60;60;0.0;0.0;0.0;0.0;0.0;0.0;5;1207;783;424;35;81;0.0
6296;2011 vrijdag 6 mei;558;300;258;360;167;193;767;760;3.0;4.0;22.0;20.0;1.0;1.0;47;3300;2081;1219;271;222;10.0
6297;2011 zaterdag 7 mei;451;246;205;364;168;196;207;205;1.0;1.0;0.0;0.0;0.0;0.0;0;797;574;223;1;58;0.0
6298;2011 zondag 8 mei;401;198;203;374;161;213;7;7;0.0;0.0;0.0;0.0;0.0;0.0;1;340;221;119;0;41;0.0
6299;2011 maandag 9 mei;464;236;228;371;178;193;213;208;3.0;2.0;66.0;64.0;0.0;2.0;191;6357;3791;2566;604;323;47.0
6300;2011 dinsdag 10 mei;517;267;250;412;205;207;157;155;0.0;2.0;45.0;43.0;2.0;0.0;205;4537;2700;1837;527;314;61.0
6301;2011 woensdag 11 mei;528;271;257;376;181;195;252;248;2.0;2.0;30.0;29.0;0.0;1.0;149;4522;2751;1771;496;239;52.0
6302;2011 donderdag 12 mei;506;268;238;390;183;207;247;245;2.0;0.0;24.0;22.0;2.0;0.0;143;4726;2862;1864;516;253;32.0
6303;2011 vrijdag 13 mei;487;228;259;374;189;185;611;604;3.0;4.0;19.0;15.0;3.0;1.0;126;3999;2434;1565;393;497;449.0
6304;2011 zaterdag 14 mei;446;250;196;345;157;188;228;225;1.0;2.0;1.0;0.0;0.0;1.0;1;871;592;279;4;75;0.0
6305;2011 zondag 15 mei;406;199;207;335;168;167;11;11;0.0;0.0;0.0;0.0;0.0;0.0;0;1008;681;327;2;100;1.0
6306;2011 maandag 16 mei;497;237;260;381;177;204;251;247;2.0;2.0;76.0;72.0;4.0;0.0;117;5647;3533;2114;513;274;40.0
6307;2011 dinsdag 17 mei;513;249;264;386;180;206;145;141;0.0;4.0;38.0;36.0;1.0;1.0;113;4044;2496;1548;496;254;37.0
6308;2011 woensdag 18 mei;581;301;280;370;175;195;173;172;1.0;0.0;44.0;38.0;4.0;2.0;152;4228;2607;1621;558;269;631.0
6309;2011 donderdag 19 mei;466;239;227;359;170;189;196;193;0.0;3.0;29.0;27.0;0.0;2.0;157;4398;2657;1741;451;260;29.0
6310;2011 vrijdag 20 mei;510;253;257;373;168;205;1284;1271;6.0;7.0;22.0;21.0;1.0;0.0;111;4180;2597;1583;374;340;23.0
6311;2011 zaterdag 21 mei;450;230;220;341;158;183;278;275;0.0;3.0;1.0;0.0;1.0;0.0;0;893;640;253;7;56;0.0
6312;2011 zondag 22 mei;412;216;196;341;177;164;11;9;1.0;1.0;0.0;0.0;0.0;0.0;0;324;221;103;2;23;0.0
6313;2011 maandag 23 mei;501;248;253;361;166;195;251;248;1.0;2.0;81.0;79.0;2.0;0.0;129;4706;2886;1820;506;265;30.0
6314;2011 dinsdag 24 mei;519;288;231;343;158;185;145;142;2.0;1.0;44.0;44.0;0.0;0.0;130;3678;2237;1441;464;250;19.0
6315;2011 woensdag 25 mei;549;290;259;385;191;194;219;213;2.0;4.0;32.0;28.0;1.0;3.0;145;3983;2477;1506;456;265;37.0
6316;2011 donderdag 26 mei;526;267;259;384;181;203;294;290;2.0;2.0;17.0;16.0;0.0;1.0;143;4125;2448;1677;477;326;376.0
6317;2011 vrijdag 27 mei;524;288;236;371;190;181;1205;1187;7.0;11.0;22.0;19.0;2.0;1.0;140;4015;2499;1516;357;288;27.0
6318;2011 zaterdag 28 mei;407;196;211;372;191;181;321;316;3.0;2.0;0.0;0.0;0.0;0.0;1;1214;894;320;5;91;0.0
6319;2011 zondag 29 mei;394;191;203;324;150;174;10;10;0.0;0.0;0.0;0.0;0.0;0.0;0;419;272;147;4;75;2.0
6320;2011 maandag 30 mei;539;274;265;368;185;183;266;259;5.0;2.0;89.0;85.0;3.0;1.0;129;5167;3194;1973;571;407;30.0
6321;2011 dinsdag 31 mei;553;283;270;348;168;180;182;179;3.0;0.0;54.0;51.0;1.0;2.0;145;5115;3251;1864;552;546;20.0
6322;Totaal juni 2011;15362;7896;7466;10609;5094;5515;9872;9709;65.0;98.0;692.0;662.0;14.0;16.0;2628;110934;68124;42810;11005;9377;2111.0
6323;2011 woensdag 1 juni;576;277;299;369;179;190;825;806;4.0;15.0;44.0;42.0;1.0;1.0;158;17746;11201;6545;606;810;514.0
6324;2011 donderdag 2 juni;475;230;245;359;176;183;28;27;0.0;1.0;0.0;0.0;0.0;0.0;0;543;344;199;2;52;0.0
6325;2011 vrijdag 3 juni;497;267;230;373;179;194;755;750;4.0;1.0;10.0;9.0;0.0;1.0;24;1707;1114;593;156;132;32.0
6326;2011 zaterdag 4 juni;421;211;210;348;159;189;251;248;1.0;2.0;1.0;1.0;0.0;0.0;0;586;406;180;4;83;0.0
6327;2011 zondag 5 juni;445;243;202;311;146;165;18;18;0.0;0.0;0.0;0.0;0.0;0.0;0;451;282;169;0;62;1.0
6328;2011 maandag 6 juni;508;272;236;381;182;199;341;331;6.0;4.0;73.0;73.0;0.0;0.0;113;6554;3809;2745;677;379;42.0
6329;2011 dinsdag 7 juni;583;302;281;353;181;172;174;172;0.0;2.0;33.0;32.0;0.0;1.0;142;4861;2881;1980;559;291;44.0
6330;2011 woensdag 8 juni;538;283;255;351;187;164;170;168;0.0;2.0;24.0;24.0;0.0;0.0;111;4586;2792;1794;563;261;53.0
6331;2011 donderdag 9 juni;551;281;270;374;171;203;269;263;3.0;3.0;25.0;24.0;1.0;0.0;135;4622;2785;1837;556;256;23.0
6332;2011 vrijdag 10 juni;557;291;266;366;170;196;1186;1168;8.0;10.0;10.0;10.0;0.0;0.0;129;4535;2916;1619;491;309;31.0
6333;2011 zaterdag 11 juni;431;213;218;319;154;165;339;333;5.0;1.0;2.0;1.0;1.0;0.0;0;739;504;235;5;61;0.0
6334;2011 zondag 12 juni;401;205;196;333;165;168;15;15;0.0;0.0;0.0;0.0;0.0;0.0;0;295;191;104;3;66;0.0
6335;2011 maandag 13 juni;445;225;220;333;165;168;17;17;0.0;0.0;0.0;0.0;0.0;0.0;1;557;361;196;1;83;0.0
6336;2011 dinsdag 14 juni;523;256;267;375;169;206;210;207;0.0;3.0;48.0;43.0;2.0;3.0;99;4670;2761;1909;641;389;35.0
6337;2011 woensdag 15 juni;564;312;252;374;177;197;197;192;3.0;2.0;35.0;33.0;1.0;1.0;118;5963;3768;2195;772;340;15.0
6338;2011 donderdag 16 juni;558;281;277;332;154;178;278;276;1.0;1.0;33.0;26.0;4.0;3.0;158;4854;2966;1888;506;359;814.0
6339;2011 vrijdag 17 juni;554;278;276;380;182;198;1077;1064;4.0;9.0;14.0;14.0;0.0;0.0;114;3965;2392;1573;419;315;10.0
6340;2011 zaterdag 18 juni;469;247;222;349;184;165;279;275;2.0;2.0;0.0;0.0;0.0;0.0;1;846;612;234;3;94;0.0
6341;2011 zondag 19 juni;444;237;207;346;165;181;8;7;0.0;1.0;0.0;0.0;0.0;0.0;0;316;194;122;6;72;1.0
6342;2011 maandag 20 juni;505;259;246;348;154;194;283;277;2.0;4.0;86.0;84.0;0.0;2.0;156;5061;3014;2047;551;442;21.0
6343;2011 dinsdag 21 juni;557;301;256;347;162;185;239;234;3.0;2.0;44.0;44.0;0.0;0.0;167;3982;2381;1601;536;378;282.0
6344;2011 woensdag 22 juni;547;284;263;350;167;183;219;214;0.0;5.0;25.0;23.0;1.0;1.0;139;4085;2454;1631;544;361;22.0
6345;2011 donderdag 23 juni;555;270;285;326;164;162;235;226;1.0;8.0;16.0;14.0;1.0;1.0;171;4201;2639;1562;541;422;45.0
6346;2011 vrijdag 24 juni;608;300;308;333;147;186;1232;1215;9.0;8.0;15.0;14.0;1.0;0.0;119;4106;2584;1522;485;427;23.0
6347;2011 zaterdag 25 juni;481;258;223;361;182;179;352;349;0.0;3.0;1.0;1.0;0.0;0.0;2;1286;878;408;7;128;0.0
6348;2011 zondag 26 juni;410;197;213;348;165;183;13;13;0.0;0.0;0.0;0.0;0.0;0.0;0;386;235;151;2;111;0.0
6349;2011 maandag 27 juni;548;288;260;336;150;186;236;233;2.0;1.0;73.0;73.0;0.0;0.0;150;4945;2971;1974;671;537;20.0
6350;2011 dinsdag 28 juni;562;289;273;413;215;198;159;157;1.0;1.0;34.0;34.0;0.0;0.0;144;3969;2343;1626;563;447;24.0
6351;2011 woensdag 29 juni;521;262;259;367;178;189;150;142;4.0;4.0;28.0;26.0;0.0;2.0;149;4055;2360;1695;508;506;31.0
6352;2011 donderdag 30 juni;528;277;251;354;165;189;317;312;2.0;3.0;18.0;17.0;1.0;0.0;128;6462;3986;2476;627;1204;28.0
6353;Totaal juli 2011;15769;8080;7689;10991;5336;5655;7853;7704;68.0;81.0;795.0;752.0;22.0;21.0;2747;127257;73727;53530;13866;12483;1499.0
6354;2011 vrijdag 1 juli;562;275;287;384;178;206;1278;1260;10.0;8.0;25.0;21.0;1.0;3.0;122;19384;11309;8075;662;1341;18.0
6355;2011 zaterdag 2 juli;432;227;205;372;179;193;294;289;2.0;3.0;2.0;2.0;0.0;0.0;2;952;579;373;4;188;0.0
6356;2011 zondag 3 juli;424;218;206;309;152;157;12;11;1.0;0.0;0.0;0.0;0.0;0.0;0;467;247;220;5;131;0.0
6357;2011 maandag 4 juli;528;275;253;346;185;161;279;273;1.0;5.0;80.0;77.0;1.0;2.0;114;7122;3902;3220;1117;492;34.0
6358;2011 dinsdag 5 juli;556;276;280;380;182;198;145;142;3.0;0.0;40.0;40.0;0.0;0.0;147;5609;3109;2500;768;514;39.0
6359;2011 woensdag 6 juli;518;271;247;392;197;195;184;179;2.0;3.0;35.0;33.0;1.0;1.0;140;5489;3171;2318;637;395;359.0
6360;2011 donderdag 7 juli;562;260;302;376;182;194;346;334;6.0;6.0;28.0;27.0;1.0;0.0;144;5550;3139;2411;619;399;21.0
6361;2011 vrijdag 8 juli;558;302;256;431;219;212;835;827;6.0;2.0;16.0;14.0;2.0;0.0;131;4882;2913;1969;516;460;651.0
6362;2011 zaterdag 9 juli;430;230;200;358;172;186;241;237;2.0;2.0;2.0;2.0;0.0;0.0;1;993;658;335;5;131;1.0
6363;2011 zondag 10 juli;428;224;204;342;179;163;13;12;1.0;0.0;0.0;0.0;0.0;0.0;4;580;343;237;3;150;0.0
6364;2011 maandag 11 juli;556;276;280;364;179;185;288;284;1.0;3.0;73.0;70.0;3.0;0.0;137;5711;3286;2425;771;572;26.0
6365;2011 dinsdag 12 juli;547;267;280;351;156;195;158;155;2.0;1.0;37.0;35.0;1.0;1.0;136;4424;2533;1891;797;563;22.0
6366;2011 woensdag 13 juli;545;278;267;377;168;209;137;130;2.0;5.0;30.0;27.0;2.0;1.0;153;4333;2428;1905;618;411;24.0
6367;2011 donderdag 14 juli;581;285;296;382;176;206;215;215;0.0;0.0;18.0;17.0;1.0;0.0;128;4530;2638;1892;556;436;37.0
6368;2011 vrijdag 15 juli;573;290;283;365;189;176;686;663;11.0;12.0;19.0;17.0;1.0;1.0;109;6264;3786;2478;513;652;32.0
6369;2011 zaterdag 16 juli;435;219;216;343;162;181;179;176;2.0;1.0;0.0;0.0;0.0;0.0;0;1106;702;404;11;151;0.0
6370;2011 zondag 17 juli;425;217;208;330;163;167;11;11;0.0;0.0;0.0;0.0;0.0;0.0;0;387;228;159;5;103;0.0
6371;2011 maandag 18 juli;515;264;251;372;195;177;240;232;3.0;5.0;71.0;68.0;2.0;1.0;130;5577;3293;2284;678;473;8.0
6372;2011 dinsdag 19 juli;548;282;266;310;145;165;146;144;1.0;1.0;46.0;44.0;1.0;1.0;108;4205;2426;1779;721;394;46.0
6373;2011 woensdag 20 juli;541;266;275;341;162;179;164;160;1.0;3.0;34.0;34.0;0.0;0.0;105;4610;2591;2019;671;426;20.0
6374;2011 donderdag 21 juli;540;284;256;334;154;180;155;152;0.0;3.0;18.0;18.0;0.0;0.0;135;4414;2584;1830;640;373;35.0
6375;2011 vrijdag 22 juli;553;271;282;320;146;174;520;512;1.0;7.0;18.0;17.0;0.0;1.0;129;4183;2445;1738;514;424;21.0
6376;2011 zaterdag 23 juli;385;211;174;351;167;184;144;143;0.0;1.0;1.0;1.0;0.0;0.0;2;1087;679;408;8;102;0.0
6377;2011 zondag 24 juli;398;210;188;331;152;179;16;16;0.0;0.0;0.0;0.0;0.0;0.0;0;316;197;119;0;61;0.0
6378;2011 maandag 25 juli;527;277;250;345;182;163;240;231;4.0;5.0;94.0;89.0;1.0;4.0;129;5510;3122;2388;601;457;11.0
6379;2011 dinsdag 26 juli;553;262;291;335;159;176;148;146;1.0;1.0;45.0;42.0;1.0;2.0;164;3971;2285;1686;579;542;24.0
6380;2011 woensdag 27 juli;572;309;263;338;162;176;181;177;2.0;2.0;33.0;32.0;0.0;1.0;128;4378;2450;1928;626;457;31.0
6381;2011 donderdag 28 juli;533;292;241;378;188;190;155;154;0.0;1.0;20.0;19.0;1.0;0.0;137;4630;2772;1858;619;485;17.0
6382;2011 vrijdag 29 juli;586;305;281;369;177;192;346;343;2.0;1.0;10.0;6.0;2.0;2.0;110;4788;2720;2068;592;620;21.0
6383;2011 zaterdag 30 juli;454;241;213;337;161;176;85;84;1.0;0.0;0.0;0.0;0.0;0.0;2;965;654;311;9;202;1.0
6384;2011 zondag 31 juli;404;216;188;328;168;160;12;12;0.0;0.0;0.0;0.0;0.0;0.0;0;840;538;302;1;378;0.0
6385;Totaal augustus 2011;16090;8299;7791;10681;5198;5483;6907;6753;71.0;83.0;911.0;869.0;18.0;24.0;3000;138827;74697;64130;22133;12205;3182.0
6386;2011 maandag 1 augustus;531;279;252;352;182;170;221;216;2.0;3.0;82.0;82.0;0.0;0.0;98;21690;11914;9776;1005;1308;26.0
6387;2011 dinsdag 2 augustus;545;292;253;358;162;196;147;143;2.0;2.0;34.0;32.0;0.0;2.0;126;5588;2931;2657;977;417;25.0
6388;2011 woensdag 3 augustus;568;310;258;344;161;183;145;141;2.0;2.0;30.0;28.0;1.0;1.0;145;5336;2857;2479;706;311;15.0
6389;2011 donderdag 4 augustus;537;278;259;358;174;184;121;118;2.0;1.0;16.0;16.0;0.0;0.0;122;5284;2795;2489;755;451;39.0
6390;2011 vrijdag 5 augustus;599;312;287;392;191;201;335;327;3.0;5.0;9.0;9.0;0.0;0.0;103;4742;2650;2092;616;397;25.0
6391;2011 zaterdag 6 augustus;445;219;226;357;166;191;112;112;0.0;0.0;0.0;0.0;0.0;0.0;2;726;419;307;8;85;1.0
6392;2011 zondag 7 augustus;444;229;215;325;162;163;6;6;0.0;0.0;0.0;0.0;0.0;0.0;1;363;196;167;6;102;0.0
6393;2011 maandag 8 augustus;537;283;254;323;158;165;271;266;1.0;4.0;86.0;83.0;1.0;2.0;119;5666;3100;2566;829;480;775.0
6394;2011 dinsdag 9 augustus;569;282;287;332;157;175;146;145;1.0;0.0;38.0;38.0;0.0;0.0;109;4403;2459;1944;725;341;1035.0
6395;2011 woensdag 10 augustus;540;293;247;342;167;175;145;143;0.0;2.0;23.0;23.0;0.0;0.0;159;4572;2424;2148;650;385;34.0
6396;2011 donderdag 11 augustus;533;249;284;350;170;180;190;183;3.0;4.0;28.0;26.0;1.0;1.0;136;4480;2526;1954;844;380;43.0
6397;2011 vrijdag 12 augustus;555;290;265;362;168;194;486;480;3.0;3.0;12.0;12.0;0.0;0.0;110;4356;2401;1955;579;390;14.0
6398;2011 zaterdag 13 augustus;461;231;230;339;146;193;102;98;2.0;2.0;0.0;0.0;0.0;0.0;0;887;495;392;11;83;1.0
6399;2011 zondag 14 augustus;444;217;227;307;160;147;8;8;0.0;0.0;0.0;0.0;0.0;0.0;2;493;218;275;4;91;0.0
6400;2011 maandag 15 augustus;570;281;289;320;152;168;223;217;4.0;2.0;82.0;78.0;1.0;3.0;144;7791;4311;3480;855;665;23.0
6401;2011 dinsdag 16 augustus;537;300;237;346;170;176;171;168;2.0;1.0;33.0;31.0;2.0;0.0;151;4703;2456;2247;909;379;14.0
6402;2011 woensdag 17 augustus;568;294;274;344;171;173;150;146;3.0;1.0;27.0;25.0;1.0;1.0;119;4652;2402;2250;784;373;34.0
6403;2011 donderdag 18 augustus;527;280;247;342;166;176;202;199;1.0;2.0;28.0;25.0;2.0;1.0;144;4772;2609;2163;895;381;11.0
6404;2011 vrijdag 19 augustus;503;246;257;358;178;180;684;662;11.0;11.0;10.0;8.0;2.0;0.0;111;4179;2259;1920;981;454;18.0
6405;2011 zaterdag 20 augustus;433;220;213;354;193;161;237;232;2.0;3.0;2.0;1.0;0.0;1.0;2;1165;665;500;10;128;0.0
6406;2011 zondag 21 augustus;384;202;182;348;175;173;7;7;0.0;0.0;0.0;0.0;0.0;0.0;0;559;244;315;4;94;0.0
6407;2011 maandag 22 augustus;526;282;244;363;193;170;228;221;1.0;6.0;69.0;68.0;1.0;0.0;106;6136;3251;2885;2155;464;32.0
6408;2011 dinsdag 23 augustus;538;276;262;372;175;197;166;163;0.0;3.0;52.0;51.0;0.0;1.0;157;4207;2298;1909;1073;375;24.0
6409;2011 woensdag 24 augustus;559;291;268;336;174;162;200;196;2.0;2.0;29.0;26.0;2.0;1.0;155;4360;2334;2026;845;383;19.0
6410;2011 donderdag 25 augustus;563;272;291;353;175;178;258;258;0.0;0.0;31.0;29.0;1.0;1.0;137;4974;2619;2355;908;547;887.0
6411;2011 vrijdag 26 augustus;554;288;266;358;162;196;1025;1004;14.0;7.0;29.0;27.0;0.0;2.0;118;4594;2465;2129;862;445;16.0
6412;2011 zaterdag 27 augustus;444;238;206;307;149;158;336;329;2.0;5.0;1.0;1.0;0.0;0.0;0;1112;633;479;10;150;1.0
6413;2011 zondag 28 augustus;415;211;204;291;154;137;16;15;1.0;0.0;0.0;0.0;0.0;0.0;0;637;226;411;5;129;0.0
6414;2011 maandag 29 augustus;540;281;259;338;161;177;257;248;4.0;5.0;78.0;73.0;1.0;4.0;103;5707;2880;2827;1309;554;22.0
6415;2011 dinsdag 30 augustus;539;263;276;320;144;176;155;150;1.0;4.0;45.0;44.0;0.0;1.0;163;4916;2544;2372;1509;528;23.0
6416;2011 woensdag 31 augustus;582;310;272;390;182;208;157;152;2.0;3.0;37.0;33.0;2.0;2.0;158;5777;3116;2661;1304;935;25.0
6417;Totaal september 2011;15661;8106;7555;10629;5067;5562;9600;9400;83.0;117.0;776.0;732.0;24.0;20.0;2757;130207;71055;59152;23477;10455;1845.0
6418;2011 donderdag 1 september;554;293;261;348;179;169;342;334;2.0;6.0;28.0;28.0;0.0;0.0;127;22048;11306;10742;1567;1311;265.0
6419;2011 vrijdag 2 september;553;294;259;349;162;187;1283;1263;7.0;13.0;11.0;10.0;1.0;0.0;102;5830;3094;2736;908;444;47.0
6420;2011 zaterdag 3 september;446;253;193;377;179;198;336;329;5.0;2.0;2.0;2.0;0.0;0.0;2;866;414;452;18;118;0.0
6421;2011 zondag 4 september;440;227;213;336;155;181;11;10;0.0;1.0;0.0;0.0;0.0;0.0;0;624;243;381;7;115;0.0
6422;2011 maandag 5 september;518;274;244;377;193;184;268;260;3.0;5.0;69.0;62.0;3.0;4.0;87;6967;3626;3341;1325;554;20.0
6423;2011 dinsdag 6 september;555;300;255;355;187;168;185;180;2.0;3.0;39.0;35.0;4.0;0.0;136;5020;2647;2373;1252;389;29.0
6424;2011 woensdag 7 september;577;300;277;345;183;162;239;234;0.0;5.0;29.0;27.0;1.0;1.0;147;5044;2611;2433;1311;326;333.0
6425;2011 donderdag 8 september;545;287;258;353;174;179;255;251;3.0;1.0;26.0;26.0;0.0;0.0;132;4913;2598;2315;1107;365;19.0
6426;2011 vrijdag 9 september;522;269;253;382;182;200;1382;1356;8.0;18.0;20.0;16.0;2.0;2.0;116;4250;2383;1867;1128;359;36.0
6427;2011 zaterdag 10 september;471;249;222;379;189;190;326;320;3.0;3.0;3.0;3.0;0.0;0.0;1;1064;628;436;16;191;0.0
6428;2011 zondag 11 september;410;214;196;327;169;158;10;10;0.0;0.0;0.0;0.0;0.0;0.0;0;398;184;214;5;90;0.0
6429;2011 maandag 12 september;565;294;271;333;155;178;253;241;5.0;7.0;68.0;65.0;2.0;1.0;119;5077;2733;2344;1038;415;15.0
6430;2011 dinsdag 13 september;522;275;247;356;174;182;128;125;3.0;0.0;34.0;34.0;0.0;0.0;148;4197;2265;1932;1251;286;35.0
6431;2011 woensdag 14 september;587;297;290;326;149;177;175;170;1.0;4.0;37.0;37.0;0.0;0.0;141;4207;2292;1915;949;345;353.0
6432;2011 donderdag 15 september;562;272;290;358;161;197;202;197;3.0;2.0;24.0;20.0;1.0;3.0;131;6045;3454;2591;1054;418;26.0
6433;2011 vrijdag 16 september;572;299;273;361;168;193;960;938;11.0;11.0;14.0;12.0;1.0;1.0;133;4334;2393;1941;1139;350;15.0
6434;2011 zaterdag 17 september;457;236;221;341;167;174;244;240;1.0;3.0;1.0;1.0;0.0;0.0;1;863;516;347;0;96;1.0
6435;2011 zondag 18 september;400;205;195;305;136;169;5;5;0.0;0.0;0.0;0.0;0.0;0.0;1;430;204;226;1;75;0.0
6436;2011 maandag 19 september;516;265;251;335;144;191;232;226;4.0;2.0;88.0;85.0;0.0;3.0;121;5101;2790;2311;903;371;14.0
6437;2011 dinsdag 20 september;596;310;286;336;153;183;140;137;1.0;2.0;44.0;40.0;3.0;1.0;147;4351;2440;1911;826;312;39.0
6438;2011 woensdag 21 september;520;262;258;369;170;199;156;152;2.0;2.0;30.0;30.0;0.0;0.0;102;4165;2197;1968;810;282;46.0
6439;2011 donderdag 22 september;541;263;278;378;179;199;184;181;1.0;2.0;17.0;16.0;0.0;1.0;136;4513;2478;2035;902;333;416.0
6440;2011 vrijdag 23 september;548;297;251;375;173;202;793;781;5.0;7.0;13.0;12.0;1.0;0.0;114;4132;2446;1686;1152;313;16.0
6441;2011 zaterdag 24 september;476;243;233;325;159;166;201;198;2.0;1.0;0.0;0.0;0.0;0.0;0;1136;760;376;300;122;0.0
6442;2011 zondag 25 september;398;207;191;328;166;162;12;12;0.0;0.0;0.0;0.0;0.0;0.0;0;519;292;227;4;91;2.0
6443;2011 maandag 26 september;511;267;244;364;170;194;206;202;2.0;2.0;87.0;85.0;0.0;2.0;127;4863;2669;2194;765;523;24.0
6444;2011 dinsdag 27 september;542;279;263;397;175;222;126;119;4.0;3.0;32.0;30.0;2.0;0.0;145;4076;2312;1764;1198;390;19.0
6445;2011 woensdag 28 september;576;281;295;372;163;209;135;131;1.0;3.0;23.0;21.0;1.0;1.0;115;4268;2481;1787;808;388;21.0
6446;2011 donderdag 29 september;563;291;272;350;179;171;168;166;0.0;2.0;27.0;27.0;0.0;0.0;131;4747;2817;1930;1100;383;24.0
6447;2011 vrijdag 30 september;618;303;315;392;174;218;643;632;4.0;7.0;10.0;8.0;2.0;0.0;95;6159;3782;2377;633;700;30.0
6448;Totaal oktober 2011;15087;7648;7439;11271;5353;5918;4677;4583;38.0;56.0;855.0;824.0;11.0;20.0;2407;117675;69352;48323;13410;8521;2292.0
6449;2011 zaterdag 1 oktober;456;232;224;364;177;187;163;161;1.0;1.0;0.0;0.0;0.0;0.0;0;10771;6453;4318;38;659;1.0
6450;2011 zondag 2 oktober;388;200;188;350;160;190;4;4;0.0;0.0;0.0;0.0;0.0;0.0;0;459;217;242;3;95;1.0
6451;2011 maandag 3 oktober;501;262;239;321;146;175;194;191;2.0;1.0;88.0;82.0;3.0;3.0;103;6947;4012;2935;698;448;44.0
6452;2011 dinsdag 4 oktober;529;256;273;363;147;216;113;110;2.0;1.0;36.0;35.0;0.0;1.0;113;5364;3018;2346;741;326;35.0
6453;2011 woensdag 5 oktober;536;282;254;373;183;190;142;137;1.0;4.0;26.0;24.0;0.0;2.0;116;5266;2963;2303;807;361;41.0
6454;2011 donderdag 6 oktober;579;291;288;369;167;202;123;118;1.0;4.0;17.0;16.0;0.0;1.0;104;5051;2842;2209;701;285;154.0
6455;2011 vrijdag 7 oktober;554;295;259;334;159;175;478;468;4.0;6.0;15.0;13.0;1.0;1.0;105;4389;2603;1786;569;293;45.0
6456;2011 zaterdag 8 oktober;407;213;194;364;173;191;93;93;0.0;0.0;0.0;0.0;0.0;0.0;1;809;523;286;8;67;0.0
6457;2011 zondag 9 oktober;396;210;186;344;152;192;17;17;0.0;0.0;0.0;0.0;0.0;0.0;0;323;156;167;1;53;0.0
6458;2011 maandag 10 oktober;509;245;264;382;183;199;269;260;5.0;4.0;92.0;87.0;2.0;3.0;126;5429;3089;2340;706;435;19.0
6459;2011 dinsdag 11 oktober;574;288;286;376;183;193;153;148;1.0;4.0;48.0;48.0;0.0;0.0;116;4166;2449;1717;863;249;1007.0
6460;2011 woensdag 12 oktober;554;286;268;363;175;188;137;133;1.0;3.0;19.0;19.0;0.0;0.0;103;4235;2421;1814;669;280;38.0
6461;2011 donderdag 13 oktober;507;234;273;360;179;181;106;103;2.0;1.0;18.0;18.0;0.0;0.0;141;4323;2516;1807;626;283;34.0
6462;2011 vrijdag 14 oktober;530;285;245;334;166;168;473;466;2.0;5.0;9.0;8.0;1.0;0.0;111;4542;2807;1735;503;350;39.0
6463;2011 zaterdag 15 oktober;397;210;187;377;191;186;93;90;1.0;2.0;0.0;0.0;0.0;0.0;1;1834;1212;622;13;158;1.0
6464;2011 zondag 16 oktober;396;198;198;343;165;178;5;5;0.0;0.0;0.0;0.0;0.0;0.0;2;456;267;189;2;41;1.0
6465;2011 maandag 17 oktober;558;268;290;367;160;207;191;187;3.0;1.0;95.0;91.0;1.0;3.0;110;5258;3079;2179;771;338;10.0
6466;2011 dinsdag 18 oktober;519;263;256;375;177;198;142;138;1.0;3.0;49.0;49.0;0.0;0.0;116;4121;2431;1690;581;313;19.0
6467;2011 woensdag 19 oktober;509;245;264;374;164;210;114;113;0.0;1.0;35.0;35.0;0.0;0.0;117;4256;2443;1813;660;240;26.0
6468;2011 donderdag 20 oktober;476;254;222;360;180;180;155;153;1.0;1.0;22.0;22.0;0.0;0.0;117;4552;2758;1794;632;283;43.0
6469;2011 vrijdag 21 oktober;552;283;269;388;210;178;364;359;2.0;3.0;16.0;15.0;0.0;1.0;106;4322;2625;1697;464;275;28.0
6470;2011 zaterdag 22 oktober;421;201;220;345;163;182;64;64;0.0;0.0;0.0;0.0;0.0;0.0;0;1038;695;343;13;42;0.0
6471;2011 zondag 23 oktober;363;196;167;337;162;175;2;2;0.0;0.0;0.0;0.0;0.0;0.0;0;299;173;126;0;61;0.0
6472;2011 maandag 24 oktober;489;241;248;387;174;213;206;203;1.0;2.0;83.0;81.0;0.0;2.0;102;5066;2968;2098;587;371;505.0
6473;2011 dinsdag 25 oktober;507;263;244;385;206;179;114;114;0.0;0.0;44.0;43.0;0.0;1.0;135;4081;2361;1720;549;327;22.0
6474;2011 woensdag 26 oktober;553;298;255;382;180;202;103;101;1.0;1.0;39.0;37.0;1.0;1.0;105;4341;2722;1619;544;328;53.0
6475;2011 donderdag 27 oktober;484;237;247;374;180;194;110;110;0.0;0.0;15.0;15.0;0.0;0.0;122;4312;2591;1721;571;363;32.0
6476;2011 vrijdag 28 oktober;552;266;286;405;191;214;298;292;3.0;3.0;22.0;22.0;0.0;0.0;123;4286;2594;1692;464;370;54.0
6477;2011 zaterdag 29 oktober;417;216;201;351;175;176;59;56;1.0;2.0;0.0;0.0;0.0;0.0;0;954;630;324;12;84;0.0
6478;2011 zondag 30 oktober;385;187;198;374;162;212;1;1;0.0;0.0;0.0;0.0;0.0;0.0;0;500;284;216;2;119;1.0
6479;2011 maandag 31 oktober;489;243;246;350;163;187;191;186;2.0;3.0;67.0;64.0;2.0;1.0;112;5925;3450;2475;612;624;39.0
6480;Totaal november 2011;14190;7316;6874;11460;5484;5976;4878;4745;76.0;57.0;995.0;948.0;25.0;22.0;2808;119723;71238;48485;12127;7372;3168.0
6481;2011 dinsdag 1 november;540;267;273;377;185;192;173;165;4.0;4.0;53.0;50.0;2.0;1.0;133;17159;10283;6876;630;744;17.0
6482;2011 woensdag 2 november;497;267;230;369;182;187;103;100;0.0;3.0;37.0;37.0;0.0;0.0;131;5109;2788;2321;575;284;52.0
6483;2011 donderdag 3 november;478;240;238;391;194;197;70;69;0.0;1.0;21.0;21.0;0.0;0.0;119;5435;3072;2363;595;318;37.0
6484;2011 vrijdag 4 november;521;265;256;388;186;202;210;202;4.0;4.0;20.0;20.0;0.0;0.0;113;4708;2707;2001;482;230;32.0
6485;2011 zaterdag 5 november;402;215;187;395;188;207;54;52;2.0;0.0;0.0;0.0;0.0;0.0;1;850;527;323;8;89;0.0
6486;2011 zondag 6 november;404;203;201;380;183;197;2;2;0.0;0.0;0.0;0.0;0.0;0.0;0;395;225;170;1;51;0.0
6487;2011 maandag 7 november;482;236;246;387;195;192;172;170;2.0;0.0;74.0;70.0;4.0;0.0;109;5349;3097;2252;747;295;744.0
6488;2011 dinsdag 8 november;506;263;243;357;163;194;101;98;2.0;1.0;38.0;38.0;0.0;0.0;128;4365;2597;1768;537;251;16.0
6489;2011 woensdag 9 november;472;246;226;342;160;182;91;89;1.0;1.0;25.0;25.0;0.0;0.0;140;4226;2426;1800;514;234;28.0
6490;2011 donderdag 10 november;508;254;254;350;147;203;109;108;0.0;1.0;11.0;11.0;0.0;0.0;120;4416;2620;1796;556;237;22.0
6491;2011 vrijdag 11 november;549;291;258;377;182;195;1817;1763;30.0;24.0;51.0;44.0;2.0;5.0;132;4413;2726;1687;415;287;39.0
6492;2011 zaterdag 12 november;408;226;182;376;170;206;39;37;2.0;0.0;0.0;0.0;0.0;0.0;0;986;652;334;2;65;0.0
6493;2011 zondag 13 november;352;172;180;375;190;185;2;2;0.0;0.0;0.0;0.0;0.0;0.0;0;320;188;132;1;38;0.0
6494;2011 maandag 14 november;475;241;234;379;192;187;194;192;0.0;2.0;99.0;97.0;1.0;1.0;112;4967;2871;2096;590;339;30.0
6495;2011 dinsdag 15 november;503;267;236;394;192;202;88;84;2.0;2.0;61.0;61.0;0.0;0.0;128;5333;3220;2113;640;265;43.0
6496;2011 woensdag 16 november;535;275;260;388;191;197;95;94;0.0;1.0;39.0;35.0;1.0;3.0;128;4233;2483;1750;519;289;30.0
6497;2011 donderdag 17 november;473;235;238;334;172;162;95;93;2.0;0.0;26.0;23.0;1.0;2.0;116;4462;2633;1829;560;246;47.0
6498;2011 vrijdag 18 november;536;277;259;427;195;232;231;228;3.0;0.0;20.0;18.0;1.0;1.0;106;4177;2524;1653;425;227;899.0
6499;2011 zaterdag 19 november;402;216;186;394;185;209;41;40;0.0;1.0;0.0;0.0;0.0;0.0;2;932;687;245;11;55;0.0
6500;2011 zondag 20 november;409;232;177;373;165;208;16;15;1.0;0.0;0.0;0.0;0.0;0.0;0;552;344;208;0;53;3.0
6501;2011 maandag 21 november;463;242;221;369;174;195;188;184;0.0;4.0;98.0;93.0;4.0;1.0;123;4837;2870;1967;764;364;42.0
6502;2011 dinsdag 22 november;476;231;245;402;190;212;135;130;4.0;1.0;54.0;52.0;1.0;1.0;136;3981;2257;1724;579;248;23.0
6503;2011 woensdag 23 november;515;244;271;392;194;198;99;95;3.0;1.0;34.0;33.0;0.0;1.0;145;3909;2331;1578;519;253;43.0
6504;2011 donderdag 24 november;486;249;237;434;209;225;100;99;0.0;1.0;19.0;18.0;0.0;1.0;107;4247;2512;1735;488;256;24.0
6505;2011 vrijdag 25 november;495;243;252;385;190;195;249;243;5.0;1.0;17.0;13.0;2.0;2.0;116;4295;2644;1651;365;262;55.0
6506;2011 zaterdag 26 november;442;238;204;390;187;203;32;31;1.0;0.0;1.0;1.0;0.0;0.0;0;1188;838;350;7;80;5.0
6507;2011 zondag 27 november;359;188;171;364;185;179;7;7;0.0;0.0;0.0;0.0;0.0;0.0;0;343;208;135;4;52;0.0
6508;2011 maandag 28 november;464;252;212;367;161;206;171;165;5.0;1.0;97.0;92.0;4.0;1.0;152;5089;2992;2097;568;437;862.0
6509;2011 dinsdag 29 november;513;278;235;421;198;223;95;92;2.0;1.0;58.0;55.0;1.0;2.0;171;3983;2478;1505;516;314;46.0
6510;2011 woensdag 30 november;525;263;262;383;179;204;99;96;1.0;2.0;42.0;41.0;1.0;0.0;140;5464;3438;2026;509;509;29.0
6511;Totaal december 2011;14359;7351;7008;12516;5881;6635;3210;3131;35.0;44.0;955.0;919.0;15.0;21.0;2637;123047;75544;47503;9528;8807;2294.0
6512;2011 donderdag 1 december;539;260;279;406;207;199;98;92;3.0;3.0;32.0;31.0;1.0;0.0;126;17266;10608;6658;619;746;65.0
6513;2011 vrijdag 2 december;524;253;271;428;214;214;165;157;4.0;4.0;19.0;18.0;1.0;0.0;108;5130;3133;1997;446;283;25.0
6514;2011 zaterdag 3 december;368;194;174;396;175;221;22;22;0.0;0.0;0.0;0.0;0.0;0.0;1;771;499;272;7;77;0.0
6515;2011 zondag 4 december;374;185;189;377;176;201;3;2;1.0;0.0;0.0;0.0;0.0;0.0;1;386;220;166;3;49;0.0
6516;2011 maandag 5 december;409;213;196;388;191;197;173;166;4.0;3.0;93.0;90.0;0.0;3.0;127;5785;3487;2298;563;362;702.0
6517;2011 dinsdag 6 december;476;255;221;428;203;225;109;103;2.0;4.0;58.0;57.0;1.0;0.0;119;4967;2912;2055;517;281;39.0
6518;2011 woensdag 7 december;546;301;245;396;189;207;96;94;0.0;2.0;41.0;39.0;0.0;2.0;120;4646;2760;1886;490;264;30.0
6519;2011 donderdag 8 december;506;270;236;409;191;218;79;79;0.0;0.0;33.0;32.0;1.0;0.0;112;4574;2809;1765;483;248;56.0
6520;2011 vrijdag 9 december;517;262;255;403;199;204;206;204;1.0;1.0;16.0;14.0;1.0;1.0;123;4079;2502;1577;411;261;23.0
6521;2011 zaterdag 10 december;436;238;198;374;182;192;50;49;0.0;1.0;1.0;1.0;0.0;0.0;1;1401;1017;384;5;87;0.0
6522;2011 zondag 11 december;370;186;184;384;193;191;1;1;0.0;0.0;0.0;0.0;0.0;0.0;0;392;231;161;1;47;0.0
6523;2011 maandag 12 december;500;249;251;394;184;210;248;245;3.0;0.0;113.0;106.0;3.0;4.0;106;5010;3134;1876;532;349;31.0
6524;2011 dinsdag 13 december;516;242;274;411;181;230;132;128;3.0;1.0;52.0;48.0;1.0;3.0;127;3972;2353;1619;471;264;340.0
6525;2011 woensdag 14 december;519;273;246;441;206;235;110;109;1.0;0.0;32.0;31.0;1.0;0.0;123;4447;2669;1778;451;340;42.0
6526;2011 donderdag 15 december;513;244;269;428;188;240;90;89;0.0;1.0;23.0;22.0;0.0;1.0;116;6760;4380;2380;429;349;65.0
6527;2011 vrijdag 16 december;508;272;236;437;217;220;227;222;1.0;4.0;12.0;11.0;0.0;1.0;94;4664;2906;1758;414;355;14.0
6528;2011 zaterdag 17 december;412;209;203;420;191;229;67;65;0.0;2.0;2.0;2.0;0.0;0.0;0;1339;975;364;3;95;0.0
6529;2011 zondag 18 december;359;193;166;383;177;206;4;4;0.0;0.0;0.0;0.0;0.0;0.0;0;423;257;166;2;86;0.0
6530;2011 maandag 19 december;456;230;226;420;198;222;198;197;0.0;1.0;115.0;112.0;2.0;1.0;166;5731;3531;2200;537;393;21.0
6531;2011 dinsdag 20 december;508;258;250;426;184;242;139;136;1.0;2.0;65.0;65.0;0.0;0.0;123;4686;2905;1781;457;368;719.0
6532;2011 woensdag 21 december;555;273;282;376;180;196;164;162;0.0;2.0;57.0;54.0;1.0;2.0;136;4374;2675;1699;475;328;23.0
6533;2011 donderdag 22 december;517;273;244;425;197;228;117;111;4.0;2.0;30.0;29.0;0.0;1.0;140;4680;2838;1842;499;389;25.0
6534;2011 vrijdag 23 december;514;264;250;407;178;229;183;179;2.0;2.0;18.0;16.0;0.0;2.0;128;4637;2814;1823;350;380;19.0
6535;2011 zaterdag 24 december;405;223;182;381;189;192;18;17;0.0;1.0;0.0;0.0;0.0;0.0;0;603;379;224;1;74;1.0
6536;2011 zondag 25 december;325;156;169;370;163;207;3;3;0.0;0.0;0.0;0.0;0.0;0.0;0;215;143;72;0;40;0.0
6537;2011 maandag 26 december;303;164;139;363;174;189;8;8;0.0;0.0;0.0;0.0;0.0;0.0;1;289;167;122;1;76;0.0
6538;2011 dinsdag 27 december;460;233;227;340;173;167;132;129;0.0;3.0;65.0;63.0;2.0;0.0;114;4805;2920;1885;364;390;19.0
6539;2011 woensdag 28 december;486;253;233;441;202;239;130;124;3.0;3.0;42.0;42.0;0.0;0.0;142;5196;3149;2047;360;368;4.0
6540;2011 donderdag 29 december;532;260;272;419;193;226;102;101;0.0;1.0;23.0;23.0;0.0;0.0;165;5304;3155;2149;353;412;15.0
6541;2011 vrijdag 30 december;513;269;244;413;194;219;111;108;2.0;1.0;13.0;13.0;0.0;0.0;118;5303;3265;2038;280;469;14.0
6542;2011 zaterdag 31 december;393;196;197;432;192;240;25;25;0.0;0.0;0.0;0.0;0.0;0.0;0;1212;751;461;4;577;2.0
6543;Totaal op zondag in 2011;20642;10550;10092;18201;8843;9358;410;398;7.0;5.0;1.0;1.0;0.0;0.0;15;30499;18324;12175;146;4362;16.0
6544;Totaal op maandag in 2011;25931;13359;12572;19245;9281;9964;10833;10599;114.0;120.0;3961.0;3800.0;78.0;83.0;6040;295124;172465;122659;35423;20936;5582.0
6545;Totaal op dinsdag in 2011;27614;14159;13455;19650;9411;10239;7160;6999;70.0;91.0;2309.0;2225.0;41.0;43.0;7309;275321;162847;112474;34562;18498;4841.0
6546;Totaal op woensdag in 2011;27855;14313;13542;19417;9366;10051;7653;7475;66.0;112.0;1682.0;1592.0;38.0;52.0;7139;251138;146902;104236;32553;17124;5335.0
6547;Totaal op donderdag in 2011;27288;13776;13512;19593;9334;10259;7958;7820;56.0;82.0;1105.0;1048.0;30.0;27.0;6765;272103;160120;111983;31940;18879;6292.0
6548;Totaal op vrijdag in 2011;28026;14383;13643;20007;9581;10426;28693;28180;233.0;280.0;849.0;766.0;44.0;39.0;6033;258835;155656;103179;27091;19218;4673.0
6549;Totaal op zaterdag in 2011;22533;11729;10804;19548;9385;10163;6820;6708;51.0;61.0;30.0;25.0;3.0;2.0;41;75683;48781;26902;893;6906;1533.0
6550;Overig 2011;171;84;87;80;58;22;2045;2038;4.0;3.0;8.0;7.0;1.0;0.0;413;324;211;113;354;262;340.0
6551;2012 zondag 1 januari;325;158;167;411;188;223;6;6;0.0;0.0;0.0;0.0;0.0;0.0;0;12321;7115;5206;71;907;0.0
6552;2012 maandag 2 januari;446;235;211;419;199;220;108;107;0.0;1.0;40.0;36.0;2.0;2.0;90;7670;4519;3151;552;523;24.0
6553;2012 dinsdag 3 januari;497;249;248;436;212;224;97;95;1.0;1.0;36.0;33.0;1.0;2.0;128;5857;3401;2456;584;399;21.0
6554;2012 woensdag 4 januari;511;247;264;412;207;205;90;88;1.0;1.0;28.0;25.0;0.0;3.0;153;6035;3490;2545;584;302;16.0
6555;2012 donderdag 5 januari;519;278;241;397;182;215;90;90;0.0;0.0;21.0;21.0;0.0;0.0;115;6101;3519;2582;632;387;36.0
6556;2012 vrijdag 6 januari;548;284;264;457;219;238;107;107;0.0;0.0;11.0;9.0;1.0;1.0;106;5461;3209;2252;479;314;39.0
6557;2012 zaterdag 7 januari;376;213;163;417;220;197;24;23;0.0;1.0;0.0;0.0;0.0;0.0;0;945;607;338;6;85;0.0
6558;2012 zondag 8 januari;377;208;169;392;180;212;11;11;0.0;0.0;0.0;0.0;0.0;0.0;0;474;272;202;3;80;0.0
6559;2012 maandag 9 januari;485;246;239;389;187;202;167;166;1.0;0.0;91.0;89.0;1.0;1.0;115;6009;3577;2432;593;332;28.0
6560;2012 dinsdag 10 januari;482;246;236;416;201;215;104;101;0.0;3.0;37.0;36.0;0.0;1.0;148;5091;2948;2143;597;374;41.0
6561;2012 woensdag 11 januari;512;248;264;425;223;202;78;77;0.0;1.0;27.0;25.0;1.0;1.0;142;4475;2495;1980;580;285;26.0
6562;2012 donderdag 12 januari;506;252;254;408;200;208;134;130;3.0;1.0;32.0;31.0;0.0;1.0;131;4853;2852;2001;536;320;30.0
6563;2012 vrijdag 13 januari;509;270;239;387;192;195;89;88;0.0;1.0;6.0;6.0;0.0;0.0;139;4232;2681;1551;451;266;28.0
6564;2012 zaterdag 14 januari;390;185;205;387;181;206;36;36;0.0;0.0;0.0;0.0;0.0;0.0;0;995;642;353;4;97;0.0
6565;2012 zondag 15 januari;396;203;193;360;165;195;9;9;0.0;0.0;0.0;0.0;0.0;0.0;2;1249;818;431;1;123;0.0
6566;2012 maandag 16 januari;496;258;238;372;177;195;153;151;0.0;2.0;76.0;73.0;2.0;1.0;131;6217;3690;2527;599;370;48.0
6567;2012 dinsdag 17 januari;535;279;256;425;210;215;76;76;0.0;0.0;31.0;30.0;0.0;1.0;125;4273;2580;1693;492;311;67.0
6568;2012 woensdag 18 januari;480;254;226;409;202;207;77;76;0.0;1.0;24.0;23.0;0.0;1.0;137;4335;2574;1761;579;278;32.0
6569;2012 donderdag 19 januari;516;270;246;398;172;226;72;71;1.0;0.0;9.0;9.0;0.0;0.0;114;4575;2802;1773;483;328;17.0
6570;2012 vrijdag 20 januari;495;250;245;400;181;219;208;206;2.0;0.0;16.0;16.0;0.0;0.0;113;4464;2731;1733;441;324;15.0
6571;2012 zaterdag 21 januari;416;232;184;403;189;214;46;45;0.0;1.0;0.0;0.0;0.0;0.0;1;1032;754;278;4;88;0.0
6572;2012 zondag 22 januari;435;208;227;378;191;187;6;6;0.0;0.0;0.0;0.0;0.0;0.0;1;364;230;134;2;56;1.0
6573;2012 maandag 23 januari;495;245;250;401;187;214;159;155;1.0;3.0;69.0;64.0;3.0;2.0;90;5107;3002;2105;675;339;30.0
6574;2012 dinsdag 24 januari;538;268;270;376;178;198;86;85;1.0;0.0;39.0;39.0;0.0;0.0;111;4300;2615;1685;508;298;41.0
6575;2012 woensdag 25 januari;531;262;269;403;162;241;87;85;1.0;1.0;19.0;18.0;0.0;1.0;140;4421;2598;1823;521;334;49.0
6576;2012 donderdag 26 januari;524;286;238;439;215;224;72;72;0.0;0.0;22.0;21.0;1.0;0.0;145;4635;2829;1806;539;411;54.0
6577;2012 vrijdag 27 januari;500;252;248;414;205;209;137;136;1.0;0.0;14.0;12.0;1.0;1.0;143;4381;2663;1718;447;468;41.0
6578;2012 zaterdag 28 januari;407;185;222;395;174;221;39;39;0.0;0.0;0.0;0.0;0.0;0.0;0;1336;843;493;2;141;2.0
6579;2012 zondag 29 januari;389;189;200;360;165;195;6;6;0.0;0.0;0.0;0.0;0.0;0.0;0;468;211;257;3;107;0.0
6580;2012 maandag 30 januari;451;236;215;391;182;209;151;149;2.0;0.0;70.0;69.0;0.0;1.0;109;5432;3095;2337;553;510;65.0
6581;2012 dinsdag 31 januari;465;215;250;411;196;215;89;88;0.0;1.0;33.0;32.0;1.0;0.0;147;5533;3418;2115;646;733;47.0
6582;Totaal januari 2012;14552;7411;7141;12488;5942;6546;2614;2580;15.0;19.0;751.0;717.0;14.0;20.0;2776;132641;78780;53861;12167;9890;798.0
6583;2012 woensdag 1 februari;494;236;258;393;198;195;127;124;0.0;3.0;31.0;30.0;1.0;0.0;136;18900;11073;7827;960;851;40.0
6584;2012 donderdag 2 februari;529;266;263;372;173;199;126;124;1.0;1.0;30.0;27.0;2.0;1.0;133;5888;3419;2469;721;334;32.0
6585;2012 vrijdag 3 februari;517;270;247;453;218;235;120;117;1.0;2.0;9.0;9.0;0.0;0.0;116;4631;2691;1940;615;323;34.0
6586;2012 zaterdag 4 februari;378;200;178;408;199;209;42;41;1.0;0.0;0.0;0.0;0.0;0.0;1;864;532;332;2;117;1.0
6587;2012 zondag 5 februari;361;186;175;387;197;190;5;5;0.0;0.0;0.0;0.0;0.0;0.0;0;559;329;230;1;97;0.0
6588;2012 maandag 6 februari;499;261;238;434;210;224;147;146;0.0;1.0;76.0;74.0;1.0;1.0;123;5604;3236;2368;918;348;25.0
6589;2012 dinsdag 7 februari;516;263;253;438;218;220;88;84;4.0;0.0;38.0;37.0;1.0;0.0;147;4480;2506;1974;773;247;1859.0
6590;2012 woensdag 8 februari;493;235;258;443;212;231;73;72;0.0;1.0;27.0;25.0;1.0;1.0;136;4395;2500;1895;733;264;1467.0
6591;2012 donderdag 9 februari;498;254;244;441;221;220;62;61;0.0;1.0;15.0;15.0;0.0;0.0;148;4580;2651;1929;643;237;40.0
6592;2012 vrijdag 10 februari;534;276;258;430;213;217;169;169;0.0;0.0;12.0;11.0;1.0;0.0;99;4244;2584;1660;500;349;28.0
6593;2012 zaterdag 11 februari;439;228;211;408;193;215;27;27;0.0;0.0;0.0;0.0;0.0;0.0;1;866;565;301;2;56;0.0
6594;2012 zondag 12 februari;408;218;190;440;209;231;4;4;0.0;0.0;0.0;0.0;0.0;0.0;0;450;245;205;3;49;2.0
6595;2012 maandag 13 februari;458;242;216;445;217;228;135;134;0.0;1.0;58.0;57.0;1.0;0.0;106;4767;2764;2003;662;335;56.0
6596;2012 dinsdag 14 februari;491;257;234;423;175;248;285;282;0.0;3.0;72.0;72.0;0.0;0.0;124;4384;2654;1730;508;256;43.0
6597;2012 woensdag 15 februari;528;269;259;441;200;241;80;77;2.0;1.0;29.0;28.0;1.0;0.0;152;5523;3359;2164;556;295;56.0
6598;2012 donderdag 16 februari;518;266;252;408;208;200;73;71;2.0;0.0;17.0;17.0;0.0;0.0;116;4652;2753;1899;666;246;42.0
6599;2012 vrijdag 17 februari;516;255;261;487;224;263;111;107;2.0;2.0;9.0;9.0;0.0;0.0;107;4120;2517;1603;787;243;13.0
6600;2012 zaterdag 18 februari;422;210;212;453;224;229;32;32;0.0;0.0;0.0;0.0;0.0;0.0;1;966;614;352;1;68;0.0
6601;2012 zondag 19 februari;354;185;169;432;219;213;5;5;0.0;0.0;0.0;0.0;0.0;0.0;0;325;207;118;0;36;0.0
6602;2012 maandag 20 februari;482;245;237;422;194;228;161;159;1.0;1.0;77.0;75.0;0.0;2.0;94;4332;2641;1691;524;321;40.0
6603;2012 dinsdag 21 februari;542;285;257;427;198;229;141;138;2.0;1.0;53.0;51.0;0.0;2.0;129;3723;2094;1629;517;277;35.0
6604;2012 woensdag 22 februari;515;247;268;449;202;247;115;112;2.0;1.0;33.0;31.0;1.0;1.0;116;4270;2504;1766;433;312;662.0
6605;2012 donderdag 23 februari;511;255;256;471;249;222;74;74;0.0;0.0;9.0;9.0;0.0;0.0;118;4450;2552;1898;497;336;36.0
6606;2012 vrijdag 24 februari;506;249;257;437;204;233;151;149;1.0;1.0;14.0;12.0;1.0;1.0;114;4329;2617;1712;378;300;26.0
6607;2012 zaterdag 25 februari;423;223;200;392;180;212;38;38;0.0;0.0;0.0;0.0;0.0;0.0;1;1521;1070;451;5;98;1610.0
6608;2012 zondag 26 februari;375;195;180;437;210;227;8;8;0.0;0.0;0.0;0.0;0.0;0.0;1;441;281;160;1;45;1.0
6609;2012 maandag 27 februari;501;263;238;431;184;247;156;150;2.0;4.0;79.0;73.0;1.0;5.0;135;5290;3084;2206;666;388;22.0
6610;2012 dinsdag 28 februari;512;254;258;439;189;250;105;102;1.0;2.0;49.0;48.0;1.0;0.0;149;4671;2861;1810;527;457;25.0
6611;2012 woensdag 29 februari;475;252;223;470;220;250;174;169;3.0;2.0;43.0;43.0;0.0;0.0;139;5675;3367;2308;528;536;39.0
6612;Totaal februari 2012;13795;7045;6750;12511;5958;6553;2834;2781;25.0;28.0;780.0;753.0;13.0;14.0;2642;118900;70270;48630;13127;7821;6234.0
6613;2012 donderdag 1 maart;501;262;239;464;239;225;103;99;3.0;1.0;20.0;19.0;1.0;0.0;120;19526;11785;7741;652;832;38.0
6614;2012 vrijdag 2 maart;538;272;266;432;207;225;164;158;5.0;1.0;14.0;14.0;0.0;0.0;118;5351;3206;2145;546;296;27.0
6615;2012 zaterdag 3 maart;412;236;176;414;195;219;38;37;0.0;1.0;0.0;0.0;0.0;0.0;2;1008;654;354;8;77;0.0
6616;2012 zondag 4 maart;377;193;184;411;176;235;7;6;0.0;1.0;0.0;0.0;0.0;0.0;1;471;272;199;1;63;0.0
6617;2012 maandag 5 maart;528;272;256;396;199;197;151;148;3.0;0.0;84.0;82.0;0.0;2.0;119;6118;3613;2505;723;357;37.0
6618;2012 dinsdag 6 maart;557;293;264;454;215;239;107;103;2.0;2.0;42.0;42.0;0.0;0.0;125;5132;2990;2142;507;312;617.0
6619;2012 woensdag 7 maart;519;267;252;442;208;234;82;81;0.0;1.0;23.0;22.0;0.0;1.0;124;4770;2796;1974;568;201;36.0
6620;2012 donderdag 8 maart;536;283;253;432;197;235;81;80;1.0;0.0;19.0;18.0;0.0;1.0;155;4674;2743;1931;522;234;46.0
6621;2012 vrijdag 9 maart;499;247;252;433;211;222;201;195;0.0;6.0;12.0;10.0;1.0;1.0;94;4042;2409;1633;465;267;17.0
6622;2012 zaterdag 10 maart;391;195;196;411;187;224;43;43;0.0;0.0;1.0;1.0;0.0;0.0;0;1066;724;342;3;94;0.0
6623;2012 zondag 11 maart;356;177;179;382;174;208;7;7;0.0;0.0;0.0;0.0;0.0;0.0;0;338;206;132;1;41;0.0
6624;2012 maandag 12 maart;498;276;222;413;203;210;199;195;2.0;2.0;75.0;70.0;2.0;3.0;143;5073;3131;1942;674;251;34.0
6625;2012 dinsdag 13 maart;481;247;234;411;189;222;86;84;2.0;0.0;43.0;40.0;3.0;0.0;149;4068;2450;1618;505;256;27.0
6626;2012 woensdag 14 maart;512;276;236;434;189;245;89;87;2.0;0.0;21.0;20.0;0.0;1.0;123;4021;2405;1616;538;209;33.0
6627;2012 donderdag 15 maart;489;277;212;430;228;202;93;91;1.0;1.0;15.0;15.0;0.0;0.0;130;5794;3555;2239;487;306;884.0
6628;2012 vrijdag 16 maart;512;265;247;472;222;250;192;189;2.0;1.0;10.0;7.0;2.0;1.0;101;4368;2686;1682;419;297;12.0
6629;2012 zaterdag 17 maart;410;213;197;372;181;191;39;37;1.0;1.0;0.0;0.0;0.0;0.0;0;1013;713;300;1;79;0.0
6630;2012 zondag 18 maart;343;168;175;359;179;180;8;8;0.0;0.0;0.0;0.0;0.0;0.0;0;373;220;153;2;57;0.0
6631;2012 maandag 19 maart;443;235;208;416;206;210;159;159;0.0;0.0;65.0;63.0;2.0;0.0;113;4838;2875;1963;491;302;21.0
6632;2012 dinsdag 20 maart;518;270;248;417;198;219;119;119;0.0;0.0;36.0;36.0;0.0;0.0;130;4120;2574;1546;476;303;29.0
6633;2012 woensdag 21 maart;538;271;267;403;189;214;166;163;1.0;2.0;37.0;36.0;1.0;0.0;128;3753;2213;1540;433;243;24.0
6634;2012 donderdag 22 maart;493;261;232;414;188;226;88;87;0.0;1.0;23.0;22.0;0.0;1.0;136;4063;2449;1614;467;277;39.0
6635;2012 vrijdag 23 maart;555;285;270;405;186;219;225;224;0.0;1.0;9.0;9.0;0.0;0.0;104;3906;2441;1465;363;292;516.0
6636;2012 zaterdag 24 maart;395;206;189;395;197;198;43;42;1.0;0.0;0.0;0.0;0.0;0.0;0;1218;837;381;3;83;1.0
6637;2012 zondag 25 maart;336;173;163;367;162;205;6;6;0.0;0.0;0.0;0.0;0.0;0.0;0;480;313;167;0;48;0.0
6638;2012 maandag 26 maart;488;255;233;403;195;208;195;189;3.0;3.0;69.0;66.0;2.0;1.0;128;4569;2695;1874;475;326;29.0
6639;2012 dinsdag 27 maart;499;264;235;401;195;206;99;98;0.0;1.0;37.0;36.0;0.0;1.0;121;3924;2422;1502;450;314;837.0
6640;2012 woensdag 28 maart;527;262;265;411;198;213;116;114;2.0;0.0;25.0;25.0;0.0;0.0;157;3955;2396;1559;470;351;24.0
6641;2012 donderdag 29 maart;466;247;219;414;200;214;91;89;1.0;1.0;21.0;20.0;1.0;0.0;134;4362;2625;1737;465;366;41.0
6642;2012 vrijdag 30 maart;504;272;232;396;190;206;304;298;5.0;1.0;9.0;8.0;1.0;0.0;94;5522;3504;2018;463;406;19.0
6643;2012 zaterdag 31 maart;448;229;219;393;179;214;59;59;0.0;0.0;1.0;1.0;0.0;0.0;0;1680;1149;531;5;279;0.0
6644;Totaal maart 2012;14669;7649;7020;12797;6082;6715;3360;3295;37.0;28.0;711.0;682.0;16.0;13.0;2749;123596;75051;48545;11183;7819;3388.0
6645;2012 zondag 1 april;398;215;183;374;201;173;11;8;2.0;1.0;0.0;0.0;0.0;0.0;0;10473;6485;3988;30;547;0.0
6646;2012 maandag 2 april;520;264;256;373;170;203;218;213;4.0;1.0;78.0;76.0;1.0;1.0;102;7677;4624;3053;725;421;15.0
6647;2012 dinsdag 3 april;502;287;215;433;228;205;107;105;0.0;2.0;31.0;31.0;0.0;0.0;120;5454;3304;2150;526;415;70.0
6648;2012 woensdag 4 april;548;291;257;398;176;222;129;125;2.0;2.0;36.0;32.0;1.0;3.0;140;4769;2722;2047;521;325;41.0
6649;2012 donderdag 5 april;517;266;251;433;220;213;168;163;2.0;3.0;26.0;26.0;0.0;0.0;134;5560;3305;2255;531;342;986.0
6650;2012 vrijdag 6 april;552;278;274;426;221;205;109;108;0.0;1.0;6.0;6.0;0.0;0.0;24;1898;1228;670;135;116;5.0
6651;2012 zaterdag 7 april;414;213;201;377;176;201;67;65;2.0;0.0;0.0;0.0;0.0;0.0;1;804;593;211;2;62;0.0
6652;2012 zondag 8 april;390;197;193;364;183;181;10;10;0.0;0.0;0.0;0.0;0.0;0.0;1;261;159;102;0;56;0.0
6653;2012 maandag 9 april;376;187;189;389;205;184;12;12;0.0;0.0;0.0;0.0;0.0;0.0;1;654;411;243;0;45;0.0
6654;2012 dinsdag 10 april;467;235;232;347;156;191;148;141;4.0;3.0;41.0;38.0;1.0;2.0;123;5896;3558;2338;569;376;13.0
6655;2012 woensdag 11 april;563;279;284;398;188;210;116;115;1.0;0.0;23.0;22.0;0.0;1.0;167;4656;2817;1839;568;298;27.0
6656;2012 donderdag 12 april;548;271;277;415;186;229;206;204;1.0;1.0;23.0;23.0;0.0;0.0;119;4848;3035;1813;546;297;50.0
6657;2012 vrijdag 13 april;472;249;223;425;217;208;329;319;1.0;9.0;15.0;13.0;2.0;0.0;118;4095;2498;1597;465;228;44.0
6658;2012 zaterdag 14 april;403;196;207;387;186;201;153;149;2.0;2.0;0.0;0.0;0.0;0.0;1;1033;697;336;2;67;0.0
6659;2012 zondag 15 april;373;196;177;396;202;194;11;11;0.0;0.0;0.0;0.0;0.0;0.0;0;1113;737;376;4;112;0.0
6660;2012 maandag 16 april;458;236;222;390;199;191;226;221;2.0;3.0;89.0;85.0;2.0;2.0;127;5764;3548;2216;645;396;406.0
6661;2012 dinsdag 17 april;528;287;241;387;181;206;134;130;2.0;2.0;34.0;31.0;1.0;2.0;144;4185;2532;1653;500;281;17.0
6662;2012 woensdag 18 april;524;275;249;418;186;232;141;138;2.0;1.0;27.0;27.0;0.0;0.0;114;3993;2427;1566;484;241;21.0
6663;2012 donderdag 19 april;551;285;266;419;203;216;166;163;1.0;2.0;19.0;18.0;1.0;0.0;177;3892;2278;1614;510;240;41.0
6664;2012 vrijdag 20 april;536;264;272;419;198;221;818;813;3.0;2.0;13.0;11.0;2.0;0.0;122;4266;2617;1649;386;298;19.0
6665;2012 zaterdag 21 april;392;215;177;401;187;214;198;197;1.0;0.0;2.0;2.0;0.0;0.0;0;1012;701;311;1;69;0.0
6666;2012 zondag 22 april;413;211;202;351;175;176;10;10;0.0;0.0;1.0;1.0;0.0;0.0;0;426;260;166;0;38;0.0
6667;2012 maandag 23 april;493;280;213;368;186;182;263;257;3.0;3.0;88.0;83.0;3.0;2.0;119;4585;2696;1889;493;333;41.0
6668;2012 dinsdag 24 april;572;277;295;407;191;216;157;154;3.0;0.0;36.0;33.0;2.0;1.0;138;4119;2509;1610;455;243;27.0
6669;2012 woensdag 25 april;520;272;248;424;201;223;172;168;1.0;3.0;26.0;24.0;2.0;0.0;143;4195;2579;1616;433;371;42.0
6670;2012 donderdag 26 april;511;273;238;433;186;247;245;244;0.0;1.0;16.0;16.0;0.0;0.0;135;4256;2599;1657;506;289;1071.0
6671;2012 vrijdag 27 april;551;256;295;394;172;222;795;785;4.0;6.0;14.0;12.0;0.0;2.0;116;4914;3183;1731;428;361;24.0
6672;2012 zaterdag 28 april;393;213;180;375;196;179;228;226;1.0;1.0;1.0;0.0;0.0;1.0;4;1373;903;470;4;115;0.0
6673;2012 zondag 29 april;397;195;202;371;170;201;9;9;0.0;0.0;0.0;0.0;0.0;0.0;0;322;186;136;0;77;0.0
6674;2012 maandag 30 april;356;185;171;381;178;203;18;18;0.0;0.0;0.0;0.0;0.0;0.0;3;1048;729;319;2;246;0.0
6675;Totaal april 2012;14238;7348;6890;11873;5724;6149;5374;5281;44.0;49.0;645.0;610.0;18.0;17.0;2393;107541;65920;41621;9471;7305;2960.0
6676;2012 dinsdag 1 mei;498;258;240;372;182;190;206;201;3.0;2.0;41.0;39.0;0.0;2.0;105;16698;10510;6188;506;780;17.0
6677;2012 woensdag 2 mei;544;267;277;385;183;202;175;169;2.0;4.0;38.0;36.0;1.0;1.0;136;5581;3208;2373;489;260;892.0
6678;2012 donderdag 3 mei;546;299;247;414;185;229;197;196;0.0;1.0;31.0;30.0;0.0;1.0;142;5612;3377;2235;520;274;50.0
6679;2012 vrijdag 4 mei;507;262;245;360;184;176;124;119;1.0;4.0;2.0;2.0;0.0;0.0;128;4715;2873;1842;457;278;5.0
6680;2012 zaterdag 5 mei;449;226;223;367;177;190;99;99;0.0;0.0;0.0;0.0;0.0;0.0;2;835;536;299;2;80;0.0
6681;2012 zondag 6 mei;372;201;171;330;152;178;7;7;0.0;0.0;0.0;0.0;0.0;0.0;0;488;299;189;2;93;0.0
6682;2012 maandag 7 mei;544;270;274;363;182;181;272;268;3.0;1.0;98.0;96.0;1.0;1.0;111;5382;3208;2174;525;291;28.0
6683;2012 dinsdag 8 mei;513;251;262;409;201;208;155;152;0.0;3.0;48.0;44.0;1.0;3.0;164;4448;2711;1737;623;227;32.0
6684;2012 woensdag 9 mei;549;282;267;400;183;217;162;156;1.0;5.0;23.0;21.0;2.0;0.0;132;3907;2316;1591;480;208;30.0
6685;2012 donderdag 10 mei;513;273;240;398;206;192;262;253;2.0;7.0;20.0;20.0;0.0;0.0;132;4522;2807;1715;516;326;35.0
6686;2012 vrijdag 11 mei;505;275;230;388;181;207;973;966;3.0;4.0;25.0;22.0;0.0;3.0;130;3737;2297;1440;405;228;50.0
6687;2012 zaterdag 12 mei;399;198;201;351;165;186;371;368;2.0;1.0;1.0;0.0;1.0;0.0;1;937;690;247;6;62;0.0
6688;2012 zondag 13 mei;360;192;168;344;166;178;11;11;0.0;0.0;0.0;0.0;0.0;0.0;0;381;224;157;0;46;0.0
6689;2012 maandag 14 mei;512;274;238;363;171;192;292;290;1.0;1.0;86.0;79.0;3.0;4.0;125;4698;2879;1819;452;328;22.0
6690;2012 dinsdag 15 mei;508;268;240;369;164;205;203;197;1.0;5.0;44.0;39.0;1.0;4.0;146;5552;3547;2005;489;321;37.0
6691;2012 woensdag 16 mei;513;266;247;357;176;181;728;713;5.0;10.0;36.0;33.0;0.0;3.0;130;4825;2952;1873;562;266;25.0
6692;2012 donderdag 17 mei;450;249;201;354;184;170;36;35;0.0;1.0;0.0;0.0;0.0;0.0;2;537;358;179;2;62;0.0
6693;2012 vrijdag 18 mei;491;248;243;386;184;202;781;765;5.0;11.0;8.0;6.0;0.0;2.0;24;1890;1238;652;148;129;3.0
6694;2012 zaterdag 19 mei;429;210;219;356;187;169;228;225;2.0;1.0;1.0;1.0;0.0;0.0;0;580;419;161;2;39;0.0
6695;2012 zondag 20 mei;389;204;185;352;172;180;8;8;0.0;0.0;0.0;0.0;0.0;0.0;0;558;385;173;2;64;0.0
6696;2012 maandag 21 mei;504;262;242;379;186;193;291;279;7.0;5.0;112.0;105.0;5.0;2.0;97;5455;3230;2225;602;356;26.0
6697;2012 dinsdag 22 mei;533;255;278;403;190;213;171;169;1.0;1.0;42.0;41.0;0.0;1.0;148;4041;2416;1625;503;242;32.0
6698;2012 woensdag 23 mei;576;287;289;420;199;221;194;190;1.0;3.0;37.0;34.0;2.0;1.0;159;3899;2308;1591;417;215;34.0
6699;2012 donderdag 24 mei;561;286;275;429;214;215;288;285;0.0;3.0;28.0;26.0;1.0;1.0;122;4075;2495;1580;464;219;1507.0
6700;2012 vrijdag 25 mei;512;246;266;394;191;203;1298;1272;6.0;20.0;26.0;25.0;0.0;1.0;108;4239;2694;1545;357;327;15.0
6701;2012 zaterdag 26 mei;423;225;198;352;175;177;250;246;2.0;2.0;1.0;1.0;0.0;0.0;0;1088;738;350;2;56;0.0
6702;2012 zondag 27 mei;386;210;176;349;158;191;14;14;0.0;0.0;0.0;0.0;0.0;0.0;0;247;169;78;0;71;0.0
6703;2012 maandag 28 mei;402;226;176;347;159;188;18;18;0.0;0.0;0.0;0.0;0.0;0.0;2;721;480;241;3;101;0.0
6704;2012 dinsdag 29 mei;490;249;241;361;178;183;181;178;2.0;1.0;49.0;48.0;1.0;0.0;113;4729;2851;1878;558;356;21.0
6705;2012 woensdag 30 mei;569;295;274;369;187;182;194;189;0.0;5.0;25.0;24.0;0.0;1.0;114;4600;2739;1861;488;381;32.0
6706;2012 donderdag 31 mei;527;267;260;380;181;199;223;219;1.0;3.0;26.0;26.0;0.0;0.0;134;5394;3429;1965;484;613;28.0
6707;Totaal mei 2012;15074;7781;7293;11601;5603;5998;8412;8257;51.0;104.0;848.0;798.0;19.0;31.0;2607;114371;70383;43988;10066;7299;2921.0
6708;2012 vrijdag 1 juni;527;262;265;396;198;198;1401;1379;8.0;14.0;24.0;22.0;2.0;0.0;120;17755;11157;6598;484;716;14.0
6709;2012 zaterdag 2 juni;409;214;195;363;168;195;412;405;2.0;5.0;1.0;1.0;0.0;0.0;1;904;588;316;2;87;0.0
6710;2012 zondag 3 juni;409;210;199;342;154;188;17;16;1.0;0.0;0.0;0.0;0.0;0.0;0;549;311;238;0;78;4.0
6711;2012 maandag 4 juni;491;268;223;355;182;173;275;266;1.0;8.0;109.0;105.0;0.0;4.0;122;6099;3567;2532;617;338;417.0
6712;2012 dinsdag 5 juni;514;256;258;336;164;172;149;146;0.0;3.0;47.0;47.0;0.0;0.0;163;5178;2996;2182;531;301;488.0
6713;2012 woensdag 6 juni;557;282;275;424;203;221;450;437;6.0;7.0;15.0;12.0;1.0;2.0;130;4720;2773;1947;503;275;19.0
6714;2012 donderdag 7 juni;507;270;237;374;179;195;202;200;1.0;1.0;27.0;26.0;1.0;0.0;128;4888;2957;1931;478;285;28.0
6715;2012 vrijdag 8 juni;529;282;247;389;168;221;1005;991;9.0;5.0;15.0;12.0;3.0;0.0;145;4343;2646;1697;402;270;7.0
6716;2012 zaterdag 9 juni;434;192;242;343;158;185;238;229;4.0;5.0;2.0;2.0;0.0;0.0;2;875;590;285;4;57;1.0
6717;2012 zondag 10 juni;364;204;160;363;168;195;19;19;0.0;0.0;0.0;0.0;0.0;0.0;0;607;407;200;0;63;0.0
6718;2012 maandag 11 juni;489;242;247;379;189;190;244;237;1.0;6.0;83.0;80.0;0.0;3.0;107;5054;3032;2022;494;351;39.0
6719;2012 dinsdag 12 juni;542;270;272;394;182;212;294;286;5.0;3.0;38.0;38.0;0.0;0.0;164;4203;2497;1706;464;301;355.0
6720;2012 woensdag 13 juni;539;255;284;367;181;186;120;116;3.0;1.0;27.0;24.0;3.0;0.0;147;4075;2495;1580;542;287;33.0
6721;2012 donderdag 14 juni;492;260;232;344;160;184;227;223;1.0;3.0;13.0;12.0;0.0;1.0;147;4406;2559;1847;440;372;39.0
6722;2012 vrijdag 15 juni;502;258;244;374;171;203;967;950;8.0;9.0;12.0;12.0;0.0;0.0;134;6423;4139;2284;372;414;9.0
6723;2012 zaterdag 16 juni;429;221;208;374;184;190;281;276;1.0;4.0;0.0;0.0;0.0;0.0;0;1375;934;441;1;99;1.0
6724;2012 zondag 17 juni;380;190;190;325;163;162;7;7;0.0;0.0;0.0;0.0;0.0;0.0;0;400;254;146;3;55;0.0
6725;2012 maandag 18 juni;513;265;248;329;165;164;250;242;3.0;5.0;74.0;73.0;1.0;0.0;132;5303;3223;2080;571;321;155.0
6726;2012 dinsdag 19 juni;491;277;214;369;191;178;145;143;1.0;1.0;32.0;31.0;0.0;1.0;158;4171;2564;1607;546;309;13.0
6727;2012 woensdag 20 juni;509;262;247;398;188;210;198;197;0.0;1.0;27.0;27.0;0.0;0.0;127;4834;2962;1872;539;330;27.0
6728;2012 donderdag 21 juni;560;289;271;377;173;204;351;340;4.0;7.0;26.0;26.0;0.0;0.0;121;4556;2722;1834;472;396;39.0
6729;2012 vrijdag 22 juni;525;285;240;385;190;195;971;955;5.0;11.0;14.0;14.0;0.0;0.0;118;4667;2894;1773;410;403;21.0
6730;2012 zaterdag 23 juni;418;210;208;375;183;192;238;233;3.0;2.0;1.0;1.0;0.0;0.0;0;1488;985;503;3;101;0.0
6731;2012 zondag 24 juni;398;198;200;340;159;181;17;17;0.0;0.0;0.0;0.0;0.0;0.0;0;498;312;186;0;82;0.0
6732;2012 maandag 25 juni;475;246;229;355;187;168;275;269;3.0;3.0;73.0;71.0;2.0;0.0;115;6521;3980;2541;574;536;24.0
6733;2012 dinsdag 26 juni;547;255;292;351;153;198;165;162;1.0;2.0;49.0;46.0;2.0;1.0;145;4711;2845;1866;506;487;1238.0
6734;2012 woensdag 27 juni;554;269;285;370;173;197;147;143;3.0;1.0;29.0;29.0;0.0;0.0;148;5199;3242;1957;565;464;20.0
6735;2012 donderdag 28 juni;550;281;269;379;185;194;231;225;3.0;3.0;21.0;17.0;2.0;2.0;122;5543;3373;2170;585;606;21.0
6736;2012 vrijdag 29 juni;528;272;256;399;192;207;936;918;7.0;11.0;17.0;17.0;0.0;0.0;146;6612;4128;2484;550;689;37.0
6737;2012 zaterdag 30 juni;384;197;187;389;209;180;289;284;2.0;3.0;2.0;2.0;0.0;0.0;1;2233;1472;761;3;662;0.0
6738;Totaal juni 2012;14566;7442;7124;11058;5320;5738;10521;10311;86.0;124.0;778.0;747.0;17.0;14.0;2843;128190;78604;49586;10661;9735;3049.0
6739;2012 zondag 1 juli;435;209;226;316;149;167;11;10;1.0;0.0;0.0;0.0;0.0;0.0;1;12294;6910;5384;48;814;0.0
6740;2012 maandag 2 juli;466;214;252;356;161;195;257;248;4.0;5.0;66.0;62.0;2.0;2.0;126;8125;4419;3706;888;641;473.0
6741;2012 dinsdag 3 juli;519;285;234;365;168;197;146;141;0.0;5.0;29.0;27.0;1.0;1.0;140;6201;3509;2692;678;447;24.0
6742;2012 woensdag 4 juli;538;282;256;401;192;209;184;181;1.0;2.0;27.0;26.0;1.0;0.0;152;5633;3193;2440;611;443;29.0
6743;2012 donderdag 5 juli;549;264;285;409;187;222;268;263;2.0;3.0;22.0;20.0;0.0;2.0;153;5913;3465;2448;644;658;24.0
6744;2012 vrijdag 6 juli;504;264;240;389;187;202;831;822;5.0;4.0;15.0;12.0;3.0;0.0;113;5042;2875;2167;539;594;16.0
6745;2012 zaterdag 7 juli;424;218;206;351;175;176;318;313;1.0;4.0;2.0;1.0;1.0;0.0;3;1080;671;409;4;165;0.0
6746;2012 zondag 8 juli;423;220;203;367;168;199;11;10;0.0;1.0;0.0;0.0;0.0;0.0;0;542;325;217;0;113;0.0
6747;2012 maandag 9 juli;473;240;233;334;164;170;230;221;6.0;3.0;87.0;84.0;2.0;1.0;113;5934;3315;2619;680;451;33.0
6748;2012 dinsdag 10 juli;567;303;264;377;189;188;151;146;2.0;3.0;41.0;40.0;0.0;1.0;112;5397;3073;2324;589;414;25.0
6749;2012 woensdag 11 juli;510;259;251;355;170;185;145;142;1.0;2.0;19.0;17.0;1.0;1.0;148;4628;2624;2004;532;429;25.0
6750;2012 donderdag 12 juli;515;244;271;372;170;202;252;250;0.0;2.0;22.0;21.0;0.0;1.0;132;4996;2938;2058;535;526;447.0
6751;2012 vrijdag 13 juli;538;266;272;369;186;183;393;384;3.0;6.0;11.0;10.0;1.0;0.0;138;4346;2528;1818;512;438;37.0
6752;2012 zaterdag 14 juli;408;197;211;338;173;165;200;198;1.0;1.0;0.0;0.0;0.0;0.0;1;1294;838;456;8;151;1.0
6753;2012 zondag 15 juli;407;200;207;304;135;169;19;19;0.0;0.0;0.0;0.0;0.0;0.0;0;1390;746;644;6;254;1.0
6754;2012 maandag 16 juli;474;238;236;342;162;180;255;250;3.0;2.0;64.0;62.0;1.0;1.0;141;6062;3440;2622;622;533;33.0
6755;2012 dinsdag 17 juli;517;255;262;327;155;172;145;142;3.0;0.0;41.0;39.0;1.0;1.0;165;4563;2594;1969;612;408;12.0
6756;2012 woensdag 18 juli;512;260;252;366;182;184;143;141;0.0;2.0;20.0;19.0;1.0;0.0;149;4630;2634;1996;560;360;9.0
6757;2012 donderdag 19 juli;502;267;235;354;194;160;138;137;0.0;1.0;16.0;15.0;0.0;1.0;135;4518;2589;1929;565;369;25.0
6758;2012 vrijdag 20 juli;555;287;268;357;165;192;514;506;5.0;3.0;15.0;14.0;1.0;0.0;131;4509;2647;1862;442;380;10.0
6759;2012 zaterdag 21 juli;401;209;192;333;182;151;119;116;0.0;3.0;1.0;1.0;0.0;0.0;3;1080;632;448;10;105;0.0
6760;2012 zondag 22 juli;410;218;192;342;148;194;9;9;0.0;0.0;1.0;0.0;1.0;0.0;0;407;237;170;0;87;1.0
6761;2012 maandag 23 juli;485;261;224;355;173;182;226;221;2.0;3.0;59.0;53.0;3.0;3.0;124;4974;2858;2116;691;403;17.0
6762;2012 dinsdag 24 juli;557;293;264;328;157;171;137;136;0.0;1.0;35.0;33.0;0.0;2.0;140;4048;2306;1742;593;429;33.0
6763;2012 woensdag 25 juli;572;312;260;395;183;212;120;118;0.0;2.0;22.0;20.0;0.0;2.0;148;4005;2287;1718;565;436;31.0
6764;2012 donderdag 26 juli;506;267;239;371;188;183;113;110;1.0;2.0;15.0;14.0;0.0;1.0;122;3960;2262;1698;620;426;13.0
6765;2012 vrijdag 27 juli;554;287;267;393;195;198;369;363;2.0;4.0;9.0;8.0;1.0;0.0;112;4041;2314;1727;526;464;12.0
6766;2012 zaterdag 28 juli;456;227;229;367;190;177;103;103;0.0;0.0;0.0;0.0;0.0;0.0;1;1096;705;391;6;175;0.0
6767;2012 zondag 29 juli;401;225;176;348;165;183;11;11;0.0;0.0;0.0;0.0;0.0;0.0;0;462;251;211;1;110;0.0
6768;2012 maandag 30 juli;501;227;274;317;144;173;228;222;2.0;4.0;78.0;76.0;1.0;1.0;132;5181;2824;2357;724;679;13.0
6769;2012 dinsdag 31 juli;530;255;275;351;156;195;113;113;0.0;0.0;39.0;36.0;3.0;0.0;118;5426;3188;2238;742;853;16.0
6770;Totaal juli 2012;15209;7753;7456;11049;5313;5736;6159;6046;45.0;68.0;756.0;710.0;25.0;21.0;2953;131777;75197;56580;13553;12755;1360.0
6771;2012 woensdag 1 augustus;584;311;273;356;174;182;133;131;0.0;2.0;30.0;29.0;0.0;1.0;147;20723;10548;10175;777;1264;37.0
6772;2012 donderdag 2 augustus;520;272;248;348;162;186;100;95;4.0;1.0;16.0;15.0;1.0;0.0;120;5586;2971;2615;777;418;27.0
6773;2012 vrijdag 3 augustus;542;259;283;330;153;177;307;301;2.0;4.0;4.0;4.0;0.0;0.0;137;4591;2436;2155;555;332;20.0
6774;2012 zaterdag 4 augustus;434;230;204;326;155;171;172;170;1.0;1.0;0.0;0.0;0.0;0.0;0;857;494;363;2;101;0.0
6775;2012 zondag 5 augustus;395;206;189;340;168;172;10;10;0.0;0.0;0.0;0.0;0.0;0.0;0;617;303;314;2;95;0.0
6776;2012 maandag 6 augustus;500;254;246;336;155;181;231;224;3.0;4.0;64.0;61.0;1.0;2.0;140;5600;3000;2600;843;376;34.0
6777;2012 dinsdag 7 augustus;534;286;248;336;161;175;126;125;0.0;1.0;35.0;34.0;1.0;0.0;157;4611;2520;2091;699;358;10.0
6778;2012 woensdag 8 augustus;568;282;286;367;187;180;188;181;2.0;5.0;29.0;27.0;1.0;1.0;127;4491;2428;2063;660;333;37.0
6779;2012 donderdag 9 augustus;524;299;225;341;166;175;109;107;1.0;1.0;21.0;20.0;1.0;0.0;141;4287;2376;1911;697;306;16.0
6780;2012 vrijdag 10 augustus;545;276;269;329;164;165;420;412;2.0;6.0;3.0;1.0;1.0;1.0;117;4395;2443;1952;649;441;18.0
6781;2012 zaterdag 11 augustus;428;218;210;324;148;176;122;121;1.0;0.0;0.0;0.0;0.0;0.0;0;798;419;379;1;103;632.0
6782;2012 zondag 12 augustus;406;212;194;325;154;171;9;9;0.0;0.0;0.0;0.0;0.0;0.0;0;520;243;277;3;105;0.0
6783;2012 maandag 13 augustus;496;247;249;342;179;163;190;188;1.0;1.0;67.0;66.0;1.0;0.0;119;5209;2799;2410;731;448;17.0
6784;2012 dinsdag 14 augustus;545;271;274;373;178;195;174;172;1.0;1.0;38.0;37.0;0.0;1.0;123;4421;2388;2033;770;458;36.0
6785;2012 woensdag 15 augustus;553;280;273;369;186;183;134;129;2.0;3.0;26.0;25.0;1.0;0.0;169;6115;3152;2963;925;494;34.0
6786;2012 donderdag 16 augustus;530;277;253;362;176;186;171;168;3.0;0.0;16.0;16.0;0.0;0.0;145;4951;2657;2294;842;325;20.0
6787;2012 vrijdag 17 augustus;531;269;262;357;143;214;505;497;1.0;7.0;10.0;8.0;1.0;1.0;95;4368;2347;2021;913;364;9.0
6788;2012 zaterdag 18 augustus;457;220;237;355;166;189;174;172;2.0;0.0;0.0;0.0;0.0;0.0;1;982;518;464;1;97;0.0
6789;2012 zondag 19 augustus;421;237;184;390;171;219;4;3;0.0;1.0;0.0;0.0;0.0;0.0;0;571;230;341;3;91;0.0
6790;2012 maandag 20 augustus;553;290;263;347;159;188;252;246;4.0;2.0;79.0;79.0;0.0;0.0;154;6002;2886;3116;1396;405;1363.0
6791;2012 dinsdag 21 augustus;536;268;268;383;193;190;154;151;1.0;2.0;44.0;41.0;1.0;2.0;159;4421;2314;2107;1726;391;14.0
6792;2012 woensdag 22 augustus;550;273;277;393;201;192;158;154;1.0;3.0;21.0;18.0;1.0;2.0;136;4411;2259;2152;861;355;20.0
6793;2012 donderdag 23 augustus;523;265;258;361;164;197;189;184;2.0;3.0;16.0;16.0;0.0;0.0;139;4660;2464;2196;835;380;11.0
6794;2012 vrijdag 24 augustus;521;277;244;364;174;190;846;833;2.0;11.0;12.0;12.0;0.0;0.0;116;4678;2588;2090;709;437;800.0
6795;2012 zaterdag 25 augustus;470;236;234;366;180;186;250;248;1.0;1.0;0.0;0.0;0.0;0.0;1;1450;758;692;4;163;0.0
6796;2012 zondag 26 augustus;407;197;210;319;160;159;9;8;0.0;1.0;0.0;0.0;0.0;0.0;0;690;268;422;6;79;0.0
6797;2012 maandag 27 augustus;461;218;243;355;174;181;247;243;2.0;2.0;69.0;65.0;3.0;1.0;121;5998;2851;3147;1223;531;17.0
6798;2012 dinsdag 28 augustus;514;278;236;364;184;180;208;203;2.0;3.0;40.0;36.0;1.0;3.0;158;4968;2567;2401;1288;429;18.0
6799;2012 woensdag 29 augustus;545;250;295;308;151;157;175;173;1.0;1.0;34.0;32.0;2.0;0.0;144;4751;2473;2278;1160;462;27.0
6800;2012 donderdag 30 augustus;553;286;267;364;192;172;246;240;4.0;2.0;26.0;24.0;0.0;2.0;126;5618;3023;2595;1625;581;21.0
6801;2012 vrijdag 31 augustus;539;262;277;317;159;158;1122;1108;4.0;10.0;13.0;13.0;0.0;0.0;129;6574;3704;2870;1002;1027;7.0
6802;Totaal augustus 2012;15685;8006;7679;10847;5237;5610;7135;7006;50.0;79.0;713.0;679.0;17.0;17.0;3121;137914;72427;65487;21685;11749;3245.0
6803;2012 zaterdag 1 september;392;200;192;337;153;184;404;398;5.0;1.0;2.0;2.0;0.0;0.0;0;15627;7280;8347;88;1018;1.0
6804;2012 zondag 2 september;413;216;197;323;149;174;16;15;1.0;0.0;0.0;0.0;0.0;0.0;0;1002;374;628;0;146;0.0
6805;2012 maandag 3 september;509;272;237;346;163;183;269;264;2.0;3.0;64.0;59.0;3.0;2.0;115;8070;4121;3949;1331;731;18.0
6806;2012 dinsdag 4 september;556;286;270;334;152;182;165;160;1.0;4.0;29.0;29.0;0.0;0.0;143;5911;3077;2834;1851;376;644.0
6807;2012 woensdag 5 september;521;260;261;346;177;169;188;184;2.0;2.0;27.0;23.0;2.0;2.0;145;5696;2946;2750;1455;372;19.0
6808;2012 donderdag 6 september;521;260;261;382;178;204;375;370;3.0;2.0;20.0;19.0;0.0;1.0;144;5407;2865;2542;1186;335;41.0
6809;2012 vrijdag 7 september;536;275;261;381;170;211;1197;1177;8.0;12.0;9.0;9.0;0.0;0.0;138;4439;2451;1988;923;352;13.0
6810;2012 zaterdag 8 september;438;226;212;370;203;167;301;300;1.0;0.0;0.0;0.0;0.0;0.0;1;868;464;404;170;128;2.0
6811;2012 zondag 9 september;387;207;180;380;176;204;16;16;0.0;0.0;0.0;0.0;0.0;0.0;1;602;298;304;0;100;0.0
6812;2012 maandag 10 september;554;290;264;373;171;202;243;236;3.0;4.0;76.0;73.0;3.0;0.0;142;5454;2917;2537;1503;445;13.0
6813;2012 dinsdag 11 september;534;299;235;346;175;171;126;122;1.0;3.0;28.0;27.0;1.0;0.0;137;4440;2395;2045;1005;300;24.0
6814;2012 woensdag 12 september;555;266;289;348;177;171;207;204;1.0;2.0;11.0;11.0;0.0;0.0;139;4268;2345;1923;741;299;9.0
6815;2012 donderdag 13 september;566;285;281;381;175;206;162;159;0.0;3.0;11.0;10.0;1.0;0.0;118;4592;2549;2043;797;349;366.0
6816;2012 vrijdag 14 september;595;292;303;389;205;184;1070;1050;6.0;14.0;12.0;10.0;1.0;1.0;115;4494;2618;1876;956;374;9.0
6817;2012 zaterdag 15 september;414;213;201;301;152;149;312;307;3.0;2.0;1.0;0.0;1.0;0.0;2;1850;1111;739;8;220;0.0
6818;2012 zondag 16 september;438;212;226;335;163;172;6;6;0.0;0.0;0.0;0.0;0.0;0.0;0;661;340;321;4;79;0.0
6819;2012 maandag 17 september;520;269;251;357;166;191;213;210;2.0;1.0;76.0;74.0;1.0;1.0;110;5473;2988;2485;921;419;19.0
6820;2012 dinsdag 18 september;589;292;297;341;148;193;167;163;2.0;2.0;26.0;24.0;1.0;1.0;139;4306;2439;1867;1368;308;33.0
6821;2012 woensdag 19 september;566;291;275;328;166;162;173;172;1.0;0.0;32.0;31.0;0.0;1.0;150;4053;2249;1804;801;251;26.0
6822;2012 donderdag 20 september;559;279;280;344;184;160;252;246;2.0;4.0;14.0;12.0;1.0;1.0;113;4518;2636;1882;851;393;14.0
6823;2012 vrijdag 21 september;567;287;280;348;166;182;1035;1010;12.0;13.0;16.0;14.0;2.0;0.0;129;3978;2270;1708;1161;356;467.0
6824;2012 zaterdag 22 september;436;223;213;354;177;177;263;257;4.0;2.0;1.0;0.0;0.0;1.0;0;1050;660;390;180;114;0.0
6825;2012 zondag 23 september;435;217;218;317;165;152;6;6;0.0;0.0;0.0;0.0;0.0;0.0;0;485;234;251;2;88;0.0
6826;2012 maandag 24 september;550;278;272;329;161;168;244;235;3.0;6.0;80.0;77.0;2.0;1.0;108;5478;3344;2134;1132;431;18.0
6827;2012 dinsdag 25 september;542;271;271;372;186;186;157;152;3.0;2.0;33.0;33.0;0.0;0.0;135;4264;2429;1835;1243;400;36.0
6828;2012 woensdag 26 september;528;280;248;387;199;188;145;144;0.0;1.0;19.0;18.0;1.0;0.0;140;4194;2312;1882;918;412;27.0
6829;2012 donderdag 27 september;536;270;266;421;217;204;178;176;1.0;1.0;15.0;15.0;0.0;0.0;102;4391;2570;1821;921;443;23.0
6830;2012 vrijdag 28 september;522;274;248;372;178;194;706;697;3.0;6.0;15.0;14.0;1.0;0.0;93;4773;2836;1937;644;494;12.0
6831;2012 zaterdag 29 september;433;206;227;392;210;182;179;176;2.0;1.0;1.0;1.0;0.0;0.0;1;1008;609;399;8;170;0.0
6832;2012 zondag 30 september;405;216;189;366;199;167;6;6;0.0;0.0;0.0;0.0;0.0;0.0;1;1097;642;455;1;317;0.0
6833;Totaal september 2012;15117;7712;7405;10700;5261;5439;8781;8618;72.0;91.0;618.0;585.0;21.0;12.0;2561;122449;66369;56080;22169;10220;1834.0
6834;2012 maandag 1 oktober;495;244;251;355;176;179;226;220;1.0;5.0;72.0;70.0;0.0;2.0;103;18201;10338;7863;805;1177;11.0
6835;2012 dinsdag 2 oktober;527;258;269;364;182;182;130;127;2.0;1.0;48.0;42.0;2.0;4.0;152;5406;3078;2328;953;390;15.0
6836;2012 woensdag 3 oktober;514;274;240;375;177;198;91;90;0.0;1.0;28.0;27.0;0.0;1.0;109;4936;2708;2228;721;410;22.0
6837;2012 donderdag 4 oktober;476;248;228;352;175;177;118;114;3.0;1.0;18.0;16.0;0.0;2.0;119;5143;2977;2166;748;307;30.0
6838;2012 vrijdag 5 oktober;538;283;255;371;165;206;466;455;8.0;3.0;15.0;14.0;0.0;1.0;114;4523;2602;1921;611;310;37.0
6839;2012 zaterdag 6 oktober;431;235;196;377;181;196;104;100;3.0;1.0;1.0;1.0;0.0;0.0;0;793;493;300;7;93;0.0
6840;2012 zondag 7 oktober;405;222;183;329;167;162;5;5;0.0;0.0;0.0;0.0;0.0;0.0;0;456;224;232;1;65;0.0
6841;2012 maandag 8 oktober;495;263;232;357;177;180;204;199;2.0;3.0;73.0;69.0;2.0;2.0;96;5181;2881;2300;661;374;28.0
6842;2012 dinsdag 9 oktober;509;250;259;385;178;207;108;106;0.0;2.0;49.0;45.0;2.0;2.0;166;4301;2533;1768;704;303;35.0
6843;2012 woensdag 10 oktober;543;252;291;382;185;197;151;147;1.0;3.0;34.0;34.0;0.0;0.0;118;4378;2584;1794;770;252;22.0
6844;2012 donderdag 11 oktober;524;248;276;388;180;208;146;144;1.0;1.0;15.0;14.0;0.0;1.0;103;4314;2492;1822;688;272;23.0
6845;2012 vrijdag 12 oktober;535;252;283;411;202;209;771;761;4.0;6.0;17.0;15.0;1.0;1.0;130;3929;2367;1562;511;287;1297.0
6846;2012 zaterdag 13 oktober;399;221;178;378;198;180;78;78;0.0;0.0;0.0;0.0;0.0;0.0;0;863;540;323;3;75;1.0
6847;2012 zondag 14 oktober;412;201;211;380;192;188;7;7;0.0;0.0;0.0;0.0;0.0;0.0;0;512;283;229;1;64;0.0
6848;2012 maandag 15 oktober;483;245;238;405;183;222;207;206;0.0;1.0;92.0;89.0;2.0;1.0;97;6565;3784;2781;888;435;14.0
6849;2012 dinsdag 16 oktober;535;285;250;400;213;187;116;115;0.0;1.0;36.0;35.0;1.0;0.0;137;4309;2488;1821;582;291;49.0
6850;2012 woensdag 17 oktober;497;244;253;392;189;203;114;111;1.0;2.0;23.0;23.0;0.0;0.0;126;3983;2345;1638;605;247;31.0
6851;2012 donderdag 18 oktober;536;294;242;377;169;208;128;125;2.0;1.0;24.0;22.0;0.0;2.0;139;4462;2604;1858;601;285;31.0
6852;2012 vrijdag 19 oktober;527;269;258;400;204;196;319;313;1.0;5.0;15.0;15.0;0.0;0.0;99;3863;2235;1628;489;269;350.0
6853;2012 zaterdag 20 oktober;415;193;222;345;153;192;86;86;0.0;0.0;1.0;1.0;0.0;0.0;0;1244;830;414;2;90;2.0
6854;2012 zondag 21 oktober;355;171;184;344;164;180;7;7;0.0;0.0;0.0;0.0;0.0;0.0;0;443;258;185;0;52;1.0
6855;2012 maandag 22 oktober;528;254;274;363;176;187;187;186;1.0;0.0;79.0;78.0;1.0;0.0;99;4687;2658;2029;604;284;30.0
6856;2012 dinsdag 23 oktober;503;259;244;361;176;185;125;124;1.0;0.0;49.0;46.0;2.0;1.0;121;3849;2273;1576;542;269;15.0
6857;2012 woensdag 24 oktober;534;274;260;358;185;173;98;98;0.0;0.0;33.0;31.0;1.0;1.0;123;3710;2118;1592;533;286;23.0
6858;2012 donderdag 25 oktober;491;246;245;344;172;172;96;94;1.0;1.0;24.0;24.0;0.0;0.0;126;4228;2470;1758;601;393;22.0
6859;2012 vrijdag 26 oktober;503;249;254;378;162;216;287;283;3.0;1.0;17.0;17.0;0.0;0.0;119;3911;2345;1566;421;301;10.0
6860;2012 zaterdag 27 oktober;415;195;220;368;183;185;55;53;1.0;1.0;2.0;2.0;0.0;0.0;0;1045;691;354;1;71;2.0
6861;2012 zondag 28 oktober;413;220;193;349;162;187;5;5;0.0;0.0;0.0;0.0;0.0;0.0;0;545;311;234;1;78;0.0
6862;2012 maandag 29 oktober;495;256;239;373;197;176;141;141;0.0;0.0;85.0;85.0;0.0;0.0;91;4634;2724;1910;495;403;20.0
6863;2012 dinsdag 30 oktober;545;288;257;380;183;197;124;120;1.0;3.0;39.0;38.0;0.0;1.0;145;4054;2388;1666;527;357;24.0
6864;2012 woensdag 31 oktober;521;240;281;364;178;186;95;91;2.0;2.0;30.0;29.0;0.0;1.0;140;5094;3127;1967;582;455;53.0
6865;Totaal oktober 2012;15099;7633;7466;11505;5584;5921;4795;4711;39.0;45.0;919.0;882.0;14.0;23.0;2772;123562;71749;51813;14658;8945;2198.0
6866;2012 donderdag 1 november;568;299;269;410;212;198;115;114;1.0;0.0;23.0;18.0;3.0;2.0;112;17902;10769;7133;614;828;29.0
6867;2012 vrijdag 2 november;522;270;252;366;175;191;212;211;0.0;1.0;17.0;15.0;1.0;1.0;128;4879;2928;1951;516;338;22.0
6868;2012 zaterdag 3 november;399;205;194;389;184;205;37;37;0.0;0.0;0.0;0.0;0.0;0.0;1;874;521;353;2;85;0.0
6869;2012 zondag 4 november;369;189;180;363;177;186;1;1;0.0;0.0;0.0;0.0;0.0;0.0;1;532;326;206;0;64;0.0
6870;2012 maandag 5 november;466;244;222;427;206;221;190;186;2.0;2.0;90.0;83.0;3.0;4.0;124;5703;3320;2383;562;337;19.0
6871;2012 dinsdag 6 november;526;276;250;389;181;208;94;92;0.0;2.0;41.0;39.0;2.0;0.0;126;4624;2740;1884;525;303;907.0
6872;2012 woensdag 7 november;532;255;277;375;178;197;85;85;0.0;0.0;31.0;31.0;0.0;0.0;158;4167;2362;1805;452;255;22.0
6873;2012 donderdag 8 november;529;270;259;377;188;189;64;63;1.0;0.0;24.0;24.0;0.0;0.0;130;4375;2572;1803;502;274;19.0
6874;2012 vrijdag 9 november;530;285;245;391;184;207;191;185;2.0;4.0;14.0;14.0;0.0;0.0;125;3997;2465;1532;533;231;424.0
6875;2012 zaterdag 10 november;398;200;198;371;178;193;281;275;2.0;4.0;3.0;3.0;0.0;0.0;2;1168;781;387;2;69;0.0
6876;2012 zondag 11 november;390;214;176;358;171;187;3;3;0.0;0.0;0.0;0.0;0.0;0.0;0;446;248;198;0;66;0.0
6877;2012 maandag 12 november;483;241;242;378;197;181;232;230;0.0;2.0;90.0;87.0;2.0;1.0;131;4926;2898;2028;666;312;31.0
6878;2012 dinsdag 13 november;507;270;237;372;192;180;98;97;0.0;1.0;34.0;34.0;0.0;0.0;150;4027;2445;1582;493;274;17.0
6879;2012 woensdag 14 november;496;253;243;399;195;204;81;81;0.0;0.0;17.0;16.0;0.0;1.0;143;3800;2211;1589;536;233;29.0
6880;2012 donderdag 15 november;498;236;262;425;202;223;84;82;1.0;1.0;21.0;20.0;0.0;1.0;134;5689;3472;2217;476;324;24.0
6881;2012 vrijdag 16 november;527;269;258;437;200;237;186;186;0.0;0.0;17.0;15.0;2.0;0.0;147;4351;2606;1745;448;255;12.0
6882;2012 zaterdag 17 november;406;212;194;357;187;170;46;46;0.0;0.0;0.0;0.0;0.0;0.0;0;962;642;320;1;72;0.0
6883;2012 zondag 18 november;362;189;173;356;161;195;0;0;0.0;0.0;0.0;0.0;0.0;0.0;0;452;265;187;0;49;0.0
6884;2012 maandag 19 november;458;230;228;405;194;211;168;167;1.0;0.0;93.0;89.0;4.0;0.0;105;4576;2689;1887;571;289;15.0
6885;2012 dinsdag 20 november;514;271;243;347;170;177;126;122;2.0;2.0;45.0;45.0;0.0;0.0;139;4155;2459;1696;485;345;42.0
6886;2012 woensdag 21 november;472;236;236;390;195;195;120;118;1.0;1.0;42.0;39.0;2.0;1.0;123;3853;2281;1572;520;236;38.0
6887;2012 donderdag 22 november;489;252;237;381;204;177;115;115;0.0;0.0;22.0;21.0;0.0;1.0;154;4008;2463;1545;479;258;20.0
6888;2012 vrijdag 23 november;496;230;266;407;211;196;179;177;1.0;1.0;10.0;10.0;0.0;0.0;133;3908;2412;1496;383;219;17.0
6889;2012 zaterdag 24 november;393;208;185;419;194;225;36;36;0.0;0.0;1.0;1.0;0.0;0.0;0;1266;831;435;0;80;0.0
6890;2012 zondag 25 november;350;168;182;372;170;202;2;2;0.0;0.0;0.0;0.0;0.0;0.0;0;545;333;212;2;65;0.0
6891;2012 maandag 26 november;486;261;225;390;194;196;177;170;4.0;3.0;84.0;83.0;1.0;0.0;133;4738;2882;1856;546;344;35.0
6892;2012 dinsdag 27 november;503;270;233;378;205;173;100;98;1.0;1.0;44.0;41.0;0.0;3.0;148;3986;2347;1639;489;329;29.0
6893;2012 woensdag 28 november;500;269;231;396;188;208;95;93;2.0;0.0;28.0;28.0;0.0;0.0;125;3994;2371;1623;470;320;34.0
6894;2012 donderdag 29 november;511;258;253;419;211;208;70;67;0.0;3.0;22.0;22.0;0.0;0.0;127;4548;2742;1806;478;339;20.0
6895;2012 vrijdag 30 november;515;276;239;405;197;208;171;168;0.0;3.0;22.0;17.0;3.0;2.0;117;6310;4024;2286;435;548;17.0
6896;Totaal november 2012;14195;7306;6889;11649;5701;5948;3359;3307;21.0;31.0;835.0;795.0;23.0;17.0;2916;118761;71405;47356;11186;7741;1822.0
6897;2012 zaterdag 1 december;415;235;180;398;180;218;65;65;0.0;0.0;0.0;0.0;0.0;0.0;0;11781;7191;4590;29;489;0.0
6898;2012 zondag 2 december;347;190;157;342;172;170;3;3;0.0;0.0;0.0;0.0;0.0;0.0;0;600;353;247;0;58;1.0
6899;2012 maandag 3 december;469;258;211;396;200;196;181;178;1.0;2.0;75.0;73.0;1.0;1.0;150;6668;3880;2788;522;384;16.0
6900;2012 dinsdag 4 december;448;228;220;426;213;213;98;97;0.0;1.0;46.0;44.0;0.0;2.0;154;5191;3112;2079;522;324;31.0
6901;2012 woensdag 5 december;402;202;200;417;203;214;91;87;2.0;2.0;27.0;25.0;1.0;1.0;147;4464;2661;1803;501;276;36.0
6902;2012 donderdag 6 december;492;254;238;391;204;187;81;78;1.0;2.0;30.0;30.0;0.0;0.0;137;4631;2688;1943;502;248;23.0
6903;2012 vrijdag 7 december;551;293;258;398;188;210;149;146;1.0;2.0;15.0;14.0;0.0;1.0;133;4290;2740;1550;381;274;20.0
6904;2012 zaterdag 8 december;351;189;162;360;194;166;37;37;0.0;0.0;1.0;1.0;0.0;0.0;0;1193;812;381;0;85;0.0
6905;2012 zondag 9 december;376;178;198;379;192;187;0;0;0.0;0.0;0.0;0.0;0.0;0.0;0;482;274;208;0;50;2.0
6906;2012 maandag 10 december;440;236;204;365;169;196;249;243;3.0;3.0;106.0;101.0;2.0;3.0;125;5585;3327;2258;527;400;23.0
6907;2012 dinsdag 11 december;451;236;215;416;186;230;134;132;1.0;1.0;40.0;38.0;1.0;1.0;111;4067;2476;1591;557;312;26.0
6908;2012 woensdag 12 december;569;286;283;397;180;217;1657;1612;18.0;27.0;69.0;68.0;1.0;0.0;121;4839;2993;1846;452;263;21.0
6909;2012 donderdag 13 december;518;263;255;415;197;218;70;68;1.0;1.0;26.0;26.0;0.0;0.0;123;4348;2683;1665;411;256;23.0
6910;2012 vrijdag 14 december;463;254;209;468;232;236;282;278;0.0;4.0;25.0;25.0;0.0;0.0;158;5316;3397;1919;329;325;11.0
6911;2012 zaterdag 15 december;378;171;207;421;201;220;51;48;2.0;1.0;0.0;0.0;0.0;0.0;0;2844;1970;874;4;133;2.0
6912;2012 zondag 16 december;362;177;185;425;220;205;1;1;0.0;0.0;0.0;0.0;0.0;0.0;0;657;403;254;3;75;0.0
6913;2012 maandag 17 december;416;203;213;440;218;222;246;242;2.0;2.0;106.0;102.0;2.0;2.0;159;6422;3927;2495;518;453;70.0
6914;2012 dinsdag 18 december;488;257;231;375;193;182;141;136;3.0;2.0;65.0;63.0;0.0;2.0;148;4542;2754;1788;492;320;14.0
6915;2012 woensdag 19 december;480;248;232;423;192;231;117;112;3.0;2.0;47.0;46.0;0.0;1.0;151;4650;2761;1889;501;365;15.0
6916;2012 donderdag 20 december;520;257;263;393;188;205;418;400;8.0;10.0;46.0;42.0;2.0;2.0;117;5650;3408;2242;479;464;15.0
6917;2012 vrijdag 21 december;546;287;259;407;196;211;381;374;4.0;3.0;31.0;27.0;3.0;1.0;144;6088;3886;2202;405;483;265.0
6918;2012 zaterdag 22 december;375;199;176;405;209;196;74;74;0.0;0.0;1.0;1.0;0.0;0.0;2;1671;1098;573;3;180;0.0
6919;2012 zondag 23 december;351;179;172;413;179;234;5;5;0.0;0.0;0.0;0.0;0.0;0.0;2;512;286;226;0;111;0.0
6920;2012 maandag 24 december;477;243;234;445;194;251;106;103;1.0;2.0;36.0;35.0;1.0;0.0;43;2822;1727;1095;131;217;6.0
6921;2012 dinsdag 25 december;328;160;168;413;195;218;2;2;0.0;0.0;0.0;0.0;0.0;0.0;0;274;157;117;3;57;0.0
6922;2012 woensdag 26 december;333;171;162;408;202;206;7;7;0.0;0.0;0.0;0.0;0.0;0.0;1;313;190;123;0;64;0.0
6923;2012 donderdag 27 december;464;240;224;426;208;218;112;110;1.0;1.0;28.0;26.0;1.0;1.0;151;6605;3932;2673;395;516;9.0
6924;2012 vrijdag 28 december;597;322;275;446;223;223;161;160;0.0;1.0;22.0;21.0;0.0;1.0;139;6600;4014;2586;355;568;25.0
6925;2012 zaterdag 29 december;435;207;228;438;212;226;32;31;1.0;0.0;0.0;0.0;0.0;0.0;0;1053;672;381;1;136;0.0
6926;2012 zondag 30 december;393;194;199;420;211;209;5;5;0.0;0.0;0.0;0.0;0.0;0.0;1;730;479;251;3;135;0.0
6927;2012 maandag 31 december;394;213;181;397;183;214;110;107;1.0;2.0;21.0;20.0;1.0;0.0;60;3567;2215;1352;111;761;3.0
6928;Totaal december 2012;13629;7030;6599;12663;6134;6529;5066;4941;54.0;71.0;863.0;828.0;16.0;19.0;2477;118455;72466;45989;8137;8782;657.0
6929;Totaal 2012;175959;90180;85779;140813;67907;72906;70315;69030;544.0;741.0;9224.0;8789.0;217.0;218.0;33273;1478861;869002;609859;158374;110356;30955.0
6930;Totaal op zondag in 2012;20529;10568;9961;19319;9246;10073;426;416;5.0;5.0;2.0;1.0;1.0;0.0;13;62888;36351;26537;217;6501;14.0
6931;Totaal op maandag in 2012;25530;13163;12367;20088;9695;10393;10404;10184;99.0;121.0;3850.0;3699.0;80.0;71.0;5820;291822;168541;123281;34100;21428;4021.0
6932;Totaal op dinsdag in 2012;26762;13765;12997;20015;9604;10411;7062;6913;63.0;86.0;2072.0;1984.0;36.0;52.0;7087;248703;146402;102301;33904;18621;8178.0
6933;Totaal op woensdag in 2012;27195;13718;13477;20458;9826;10632;9175;8967;83.0;125.0;1462.0;1389.0;34.0;39.0;7049;263560;151472;112088;31283;17954;4423.0
6934;Totaal op donderdag in 2012;26959;13926;13033;20545;9997;10548;8131;7968;73.0;90.0;1082.0;1032.0;20.0;30.0;6672;275542;162465;113077;31233;19208;6566.0
6935;Totaal op vrijdag in 2012;27369;13998;13371;20718;9923;10795;25755;25340;158.0;257.0;717.0;654.0;39.0;24.0;6130;250798;151609;99189;26701;19063;5005.0
6936;Totaal op zaterdag in 2012;21484;10978;10506;19598;9568;10030;7457;7346;58.0;53.0;32.0;27.0;3.0;2.0;39;84844;51781;33063;625;7286;2259.0
6937;Overig 2012;131;64;67;72;48;24;1905;1896;5.0;4.0;7.0;3.0;4.0;0.0;463;704;381;323;311;295;489.0
6938;2013 dinsdag 1 januari;377;198;179;414;198;216;3;3;0.0;0.0;0.0;0.0;0.0;0.0;2;12816;7151;5665;77;871;0.0
6939;2013 woensdag 2 januari;495;261;234;460;220;240;74;73;0.0;1.0;20.0;19.0;1.0;0.0;103;8099;4461;3638;605;531;15.0
6940;2013 donderdag 3 januari;547;295;252;417;190;227;104;102;0.0;2.0;18.0;17.0;0.0;1.0;184;7171;4229;2942;594;459;1189.0
6941;2013 vrijdag 4 januari;585;309;276;443;187;256;103;101;1.0;1.0;12.0;12.0;0.0;0.0;147;5948;3370;2578;516;350;910.0
6942;2013 zaterdag 5 januari;399;213;186;406;199;207;19;19;0.0;0.0;1.0;0.0;1.0;0.0;0;1092;673;419;1;111;1.0
6943;2013 zondag 6 januari;382;200;182;409;192;217;10;10;0.0;0.0;0.0;0.0;0.0;0.0;2;654;388;266;1;93;0.0
6944;2013 maandag 7 januari;466;240;226;441;242;199;184;178;1.0;5.0;87.0;83.0;2.0;2.0;138;6683;3851;2832;588;415;28.0
6945;2013 dinsdag 8 januari;504;264;240;448;205;243;100;97;3.0;0.0;56.0;54.0;0.0;2.0;152;5322;3150;2172;621;289;19.0
6946;2013 woensdag 9 januari;493;268;225;440;225;215;80;78;0.0;2.0;31.0;31.0;0.0;0.0;119;4302;2463;1839;604;259;33.0
6947;2013 donderdag 10 januari;536;285;251;489;238;251;68;66;2.0;0.0;14.0;14.0;0.0;0.0;111;5498;3270;2228;588;355;26.0
6948;2013 vrijdag 11 januari;534;301;233;445;234;211;95;95;0.0;0.0;10.0;8.0;1.0;1.0;114;4241;2491;1750;499;254;20.0
6949;2013 zaterdag 12 januari;409;219;190;368;172;196;37;37;0.0;0.0;0.0;0.0;0.0;0.0;1;1158;752;406;8;121;0.0
6950;2013 zondag 13 januari;362;193;169;404;187;217;6;6;0.0;0.0;0.0;0.0;0.0;0.0;0;483;294;189;1;67;0.0
6951;2013 maandag 14 januari;494;241;253;443;217;226;162;162;0.0;0.0;88.0;87.0;1.0;0.0;124;5321;3162;2159;580;385;34.0
6952;2013 dinsdag 15 januari;455;228;227;433;201;232;100;100;0.0;0.0;39.0;37.0;1.0;1.0;121;5410;3242;2168;552;394;43.0
6953;2013 woensdag 16 januari;488;252;236;389;193;196;91;90;1.0;0.0;30.0;30.0;0.0;0.0;103;4540;2771;1769;531;299;27.0
6954;2013 donderdag 17 januari;488;253;235;441;205;236;66;66;0.0;0.0;16.0;15.0;0.0;1.0;121;4488;2712;1776;547;306;54.0
6955;2013 vrijdag 18 januari;506;271;235;446;226;220;124;121;2.0;1.0;13.0;13.0;0.0;0.0;105;3988;2477;1511;481;347;540.0
6956;2013 zaterdag 19 januari;399;211;188;445;214;231;39;38;1.0;0.0;0.0;0.0;0.0;0.0;1;982;663;319;2;66;1.0
6957;2013 zondag 20 januari;371;191;180;413;201;212;6;6;0.0;0.0;0.0;0.0;0.0;0.0;0;760;442;318;1;108;0.0
6958;2013 maandag 21 januari;462;217;245;390;198;192;165;165;0.0;0.0;79.0;78.0;1.0;0.0;123;5077;3054;2023;509;323;27.0
6959;2013 dinsdag 22 januari;500;259;241;436;220;216;105;103;1.0;1.0;41.0;39.0;0.0;2.0;114;4003;2403;1600;511;342;26.0
6960;2013 woensdag 23 januari;505;259;246;445;209;236;83;81;1.0;1.0;25.0;23.0;0.0;2.0;170;4004;2375;1629;490;276;19.0
6961;2013 donderdag 24 januari;471;240;231;455;231;224;50;50;0.0;0.0;16.0;16.0;0.0;0.0;151;4209;2552;1657;630;320;27.0
6962;2013 vrijdag 25 januari;523;270;253;469;228;241;121;119;0.0;2.0;17.0;17.0;0.0;0.0;96;4196;2591;1605;406;409;31.0
6963;2013 zaterdag 26 januari;401;209;192;439;218;221;30;30;0.0;0.0;2.0;2.0;0.0;0.0;0;1359;925;434;5;155;0.0
6964;2013 zondag 27 januari;348;180;168;448;203;245;4;4;0.0;0.0;0.0;0.0;0.0;0.0;0;585;336;249;3;118;0.0
6965;2013 maandag 28 januari;454;241;213;482;241;241;174;170;3.0;1.0;87.0;86.0;0.0;1.0;129;5184;3073;2111;716;502;487.0
6966;2013 dinsdag 29 januari;545;279;266;431;208;223;93;91;0.0;2.0;38.0;37.0;1.0;0.0;158;4179;2544;1635;530;388;12.0
6967;2013 woensdag 30 januari;507;256;251;470;218;252;72;71;0.0;1.0;29.0;28.0;1.0;0.0;130;4336;2574;1762;941;465;38.0
6968;2013 donderdag 31 januari;520;281;239;450;218;232;86;86;0.0;0.0;18.0;18.0;0.0;0.0;136;5940;3561;2379;635;717;28.0
6969;2013 vrijdag 1 februari;542;265;277;467;239;228;157;154;2.0;1.0;11.0;8.0;1.0;2.0;124;19286;10991;8295;810;944;35.0
6970;2013 zaterdag 2 februari;401;196;205;449;213;236;39;38;1.0;0.0;0.0;0.0;0.0;0.0;0;1148;674;474;3;157;1.0
6971;2013 zondag 3 februari;379;203;176;441;203;238;11;11;0.0;0.0;0.0;0.0;0.0;0.0;0;764;410;354;0;120;0.0
6972;2013 maandag 4 februari;451;243;208;447;210;237;154;152;0.0;2.0;74.0;71.0;2.0;1.0;123;6738;3878;2860;711;530;20.0
6973;2013 dinsdag 5 februari;516;262;254;462;214;248;95;91;0.0;4.0;42.0;40.0;2.0;0.0;150;5269;2995;2274;730;322;30.0
6974;2013 woensdag 6 februari;519;271;248;444;214;230;93;93;0.0;0.0;26.0;24.0;1.0;1.0;159;4764;2727;2037;693;285;30.0
6975;2013 donderdag 7 februari;461;251;210;457;210;247;54;54;0.0;0.0;16.0;15.0;0.0;1.0;145;5042;2985;2057;822;310;16.0
6976;2013 vrijdag 8 februari;499;243;256;485;236;249;100;95;1.0;4.0;18.0;17.0;0.0;1.0;125;4206;2541;1665;527;261;28.0
6977;2013 zaterdag 9 februari;371;197;174;423;205;218;31;31;0.0;0.0;0.0;0.0;0.0;0.0;0;955;630;325;74;86;0.0
6978;2013 zondag 10 februari;351;204;147;423;209;214;4;4;0.0;0.0;0.0;0.0;0.0;0.0;1;602;349;253;3;82;0.0
6979;2013 maandag 11 februari;458;241;217;405;223;182;153;149;2.0;2.0;73.0;71.0;2.0;0.0;115;4500;2667;1833;527;304;658.0
6980;2013 dinsdag 12 februari;470;250;220;436;190;246;79;79;0.0;0.0;40.0;39.0;1.0;0.0;144;3746;2251;1495;513;243;19.0
6981;2013 woensdag 13 februari;464;233;231;412;181;231;107;105;0.0;2.0;27.0;27.0;0.0;0.0;125;4142;2512;1630;628;304;22.0
6982;2013 donderdag 14 februari;502;266;236;476;230;246;210;205;1.0;4.0;27.0;26.0;1.0;0.0;127;4306;2601;1705;515;287;18.0
6983;2013 vrijdag 15 februari;476;240;236;439;222;217;132;130;1.0;1.0;16.0;16.0;0.0;0.0;134;5741;3620;2121;570;346;25.0
6984;2013 zaterdag 16 februari;390;199;191;449;220;229;36;35;1.0;0.0;0.0;0.0;0.0;0.0;0;1277;812;465;5;78;1.0
6985;2013 zondag 17 februari;367;191;176;416;207;209;6;6;0.0;0.0;0.0;0.0;0.0;0.0;1;567;327;240;0;58;0.0
6986;2013 maandag 18 februari;432;224;208;427;195;232;171;168;3.0;0.0;81.0;72.0;6.0;3.0;129;5344;3114;2230;661;360;28.0
6987;2013 dinsdag 19 februari;524;259;265;468;210;258;105;102;1.0;2.0;52.0;50.0;0.0;2.0;162;4102;2349;1753;775;242;49.0
6988;2013 woensdag 20 februari;542;284;258;455;218;237;85;82;2.0;1.0;36.0;35.0;0.0;1.0;148;4323;2599;1724;687;390;45.0
6989;2013 donderdag 21 februari;464;236;228;491;250;241;71;71;0.0;0.0;15.0;15.0;0.0;0.0;149;4330;2532;1798;490;373;36.0
6990;2013 vrijdag 22 februari;481;256;225;471;224;247;149;146;2.0;1.0;13.0;12.0;1.0;0.0;123;4305;2611;1694;680;302;9.0
6991;2013 zaterdag 23 februari;402;189;213;455;215;240;36;35;0.0;1.0;1.0;0.0;0.0;1.0;0;1409;928;481;2;100;3.0
6992;2013 zondag 24 februari;329;165;164;444;229;215;8;8;0.0;0.0;0.0;0.0;0.0;0.0;1;578;352;226;0;63;0.0
6993;2013 maandag 25 februari;465;214;251;447;206;241;184;182;1.0;1.0;93.0;91.0;0.0;2.0;140;5240;3014;2226;594;393;696.0
6994;2013 dinsdag 26 februari;474;247;227;437;212;225;108;107;0.0;1.0;37.0;36.0;0.0;1.0;161;4439;2697;1742;553;327;37.0
6995;2013 woensdag 27 februari;498;265;233;457;231;226;79;77;2.0;0.0;34.0;33.0;0.0;1.0;188;4485;2744;1741;479;363;17.0
6996;2013 donderdag 28 februari;511;281;230;454;203;251;78;74;3.0;1.0;24.0;23.0;1.0;0.0;154;6301;3845;2456;562;633;19.0
6997;2013 vrijdag 1 maart;519;254;265;474;218;256;408;397;5.0;6.0;22.0;21.0;0.0;1.0;145;19092;11501;7591;511;827;14.0
6998;2013 zaterdag 2 maart;390;201;189;499;221;278;38;38;0.0;0.0;0.0;0.0;0.0;0.0;2;1098;685;413;0;105;1.0
6999;2013 zondag 3 maart;352;194;158;402;196;206;10;10;0.0;0.0;0.0;0.0;0.0;0.0;0;744;445;299;1;70;1.0
7000;2013 maandag 4 maart;442;226;216;480;222;258;171;167;3.0;1.0;76.0;73.0;1.0;2.0;124;6429;3725;2704;712;319;858.0
7001;2013 dinsdag 5 maart;493;266;227;507;226;281;110;108;1.0;1.0;40.0;39.0;0.0;1.0;143;5266;3107;2159;609;294;44.0
7002;2013 woensdag 6 maart;530;280;250;462;225;237;79;78;1.0;0.0;29.0;29.0;0.0;0.0;170;4803;2809;1994;564;347;20.0
7003;2013 donderdag 7 maart;484;247;237;478;228;250;81;80;0.0;1.0;18.0;18.0;0.0;0.0;121;4927;3044;1883;569;268;55.0
7004;2013 vrijdag 8 maart;516;277;239;497;241;256;155;152;2.0;1.0;14.0;14.0;0.0;0.0;142;4225;2540;1685;470;243;17.0
7005;2013 zaterdag 9 maart;388;192;196;452;210;242;32;30;0.0;2.0;0.0;0.0;0.0;0.0;0;888;563;325;9;55;0.0
7006;2013 zondag 10 maart;375;184;191;417;191;226;5;5;0.0;0.0;0.0;0.0;0.0;0.0;0;654;399;255;7;52;0.0
7007;2013 maandag 11 maart;451;239;212;431;210;221;185;183;1.0;1.0;75.0;72.0;1.0;2.0;147;5168;3016;2152;583;291;25.0
7008;2013 dinsdag 12 maart;489;238;251;397;191;206;114;113;1.0;0.0;48.0;46.0;1.0;1.0;175;4110;2424;1686;632;269;24.0
7009;2013 woensdag 13 maart;491;263;228;416;200;216;196;192;2.0;2.0;31.0;30.0;1.0;0.0;150;3869;2373;1496;538;233;27.0
7010;2013 donderdag 14 maart;522;266;256;464;218;246;70;69;0.0;1.0;13.0;13.0;0.0;0.0;100;4135;2479;1656;522;257;24.0
7011;2013 vrijdag 15 maart;484;235;249;492;245;247;209;208;1.0;0.0;11.0;10.0;1.0;0.0;124;5773;3567;2206;418;304;30.0
7012;2013 zaterdag 16 maart;377;195;182;433;194;239;41;41;0.0;0.0;0.0;0.0;0.0;0.0;1;1220;841;379;15;61;0.0
7013;2013 zondag 17 maart;378;199;179;406;172;234;8;8;0.0;0.0;0.0;0.0;0.0;0.0;1;561;308;253;1;78;0.0
7014;2013 maandag 18 maart;505;277;228;453;215;238;193;188;3.0;2.0;82.0;81.0;1.0;0.0;159;5148;2996;2152;585;347;22.0
7015;2013 dinsdag 19 maart;503;243;260;422;203;219;111;110;0.0;1.0;41.0;39.0;1.0;1.0;132;4053;2413;1640;496;241;16.0
7016;2013 woensdag 20 maart;457;229;228;426;198;228;114;112;1.0;1.0;29.0;27.0;1.0;1.0;162;4068;2535;1533;559;318;46.0
7017;2013 donderdag 21 maart;483;257;226;448;216;232;144;143;0.0;1.0;12.0;11.0;1.0;0.0;154;4114;2411;1703;466;299;22.0
7018;2013 vrijdag 22 maart;505;248;257;443;226;217;240;236;0.0;4.0;14.0;12.0;1.0;1.0;123;3867;2429;1438;398;282;14.0
7019;2013 zaterdag 23 maart;386;210;176;403;189;214;61;60;0.0;1.0;1.0;1.0;0.0;0.0;1;1329;936;393;4;104;0.0
7020;2013 zondag 24 maart;350;185;165;442;206;236;9;9;0.0;0.0;0.0;0.0;0.0;0.0;1;519;322;197;1;74;1.0
7021;2013 maandag 25 maart;466;257;209;442;216;226;230;226;2.0;2.0;78.0;75.0;0.0;3.0;121;5059;3109;1950;619;356;35.0
7022;2013 dinsdag 26 maart;511;255;256;444;237;207;113;113;0.0;0.0;33.0;30.0;2.0;1.0;130;4035;2480;1555;551;320;42.0
7023;2013 woensdag 27 maart;480;241;239;424;201;223;123;121;2.0;0.0;19.0;19.0;0.0;0.0;161;4194;2592;1602;488;373;16.0
7024;2013 donderdag 28 maart;509;247;262;460;219;241;125;124;0.0;1.0;13.0;13.0;0.0;0.0;159;5744;3440;2304;540;441;28.0
7025;2013 vrijdag 29 maart;491;244;247;470;218;252;66;63;1.0;2.0;10.0;9.0;1.0;0.0;44;2719;1754;965;186;257;0.0
7026;2013 zaterdag 30 maart;411;208;203;435;206;229;67;66;1.0;0.0;0.0;0.0;0.0;0.0;0;1267;826;441;4;144;1.0
7027;2013 zondag 31 maart;329;156;173;389;178;211;8;8;0.0;0.0;0.0;0.0;0.0;0.0;1;874;578;296;1;266;0.0
7028;2013 maandag 1 april;374;201;173;409;185;224;10;10;0.0;0.0;0.0;0.0;0.0;0.0;2;11255;6816;4439;38;601;0.0
7029;2013 dinsdag 2 april;459;254;205;419;202;217;157;154;2.0;1.0;56.0;51.0;3.0;2.0;145;7542;4349;3193;622;498;10.0
7030;2013 woensdag 3 april;509;260;249;436;196;240;119;119;0.0;0.0;27.0;26.0;0.0;1.0;112;5531;3150;2381;680;323;948.0
7031;2013 donderdag 4 april;577;306;271;437;208;229;122;120;0.0;2.0;13.0;12.0;0.0;1.0;112;5406;3102;2304;559;336;33.0
7032;2013 vrijdag 5 april;540;288;252;460;226;234;280;274;3.0;3.0;9.0;8.0;0.0;1.0;121;4384;2613;1771;536;270;20.0
7033;2013 zaterdag 6 april;408;192;216;421;213;208;62;60;2.0;0.0;0.0;0.0;0.0;0.0;2;882;608;274;1;71;0.0
7034;2013 zondag 7 april;343;174;169;389;191;198;3;3;0.0;0.0;0.0;0.0;0.0;0.0;0;483;302;181;0;71;0.0
7035;2013 maandag 8 april;464;221;243;425;193;232;241;230;5.0;6.0;90.0;89.0;0.0;1.0;131;5114;3079;2035;575;338;14.0
7036;2013 dinsdag 9 april;475;250;225;481;221;260;105;103;1.0;1.0;48.0;47.0;0.0;1.0;144;4150;2449;1701;561;271;31.0
7037;2013 woensdag 10 april;504;244;260;452;222;230;111;107;4.0;0.0;28.0;27.0;0.0;1.0;139;3964;2392;1572;541;278;28.0
7038;2013 donderdag 11 april;496;241;255;449;222;227;99;98;1.0;0.0;20.0;18.0;2.0;0.0;125;4098;2439;1659;518;235;32.0
7039;2013 vrijdag 12 april;480;233;247;446;194;252;344;335;2.0;7.0;8.0;6.0;0.0;2.0;146;3887;2411;1476;444;336;11.0
7040;2013 zaterdag 13 april;406;216;190;387;192;195;82;82;0.0;0.0;0.0;0.0;0.0;0.0;0;898;580;318;1;66;0.0
7041;2013 zondag 14 april;344;180;164;419;207;212;4;4;0.0;0.0;0.0;0.0;0.0;0.0;0;483;300;183;0;54;0.0
7042;2013 maandag 15 april;487;255;232;428;223;205;204;200;2.0;2.0;103.0;95.0;6.0;2.0;121;6041;3726;2315;582;361;36.0
7043;2013 dinsdag 16 april;474;239;235;373;186;187;116;115;0.0;1.0;55.0;55.0;0.0;0.0;154;4239;2556;1683;531;332;20.0
7044;2013 woensdag 17 april;457;214;243;408;183;225;118;118;0.0;0.0;27.0;25.0;2.0;0.0;138;3808;2314;1494;517;235;654.0
7045;2013 donderdag 18 april;502;238;264;442;212;230;111;110;0.0;1.0;15.0;15.0;0.0;0.0;102;4299;2637;1662;579;249;22.0
7046;2013 vrijdag 19 april;476;239;237;415;202;213;434;431;1.0;2.0;13.0;13.0;0.0;0.0;87;3519;2143;1376;415;286;17.0
7047;2013 zaterdag 20 april;407;189;218;394;213;181;124;119;5.0;0.0;0.0;0.0;0.0;0.0;1;1239;835;404;0;72;0.0
7048;2013 zondag 21 april;377;211;166;398;174;224;5;5;0.0;0.0;0.0;0.0;0.0;0.0;1;432;272;160;0;63;0.0
7049;2013 maandag 22 april;489;245;244;451;229;222;269;263;3.0;3.0;90.0;84.0;3.0;3.0;115;4565;2769;1796;464;364;19.0
7050;2013 dinsdag 23 april;476;248;228;388;179;209;132;127;1.0;4.0;46.0;43.0;1.0;2.0;143;3553;2132;1421;499;285;36.0
7051;2013 woensdag 24 april;499;259;240;392;185;207;149;144;0.0;5.0;30.0;28.0;0.0;2.0;141;3429;2070;1359;525;256;312.0
7052;2013 donderdag 25 april;496;249;247;400;180;220;193;190;1.0;2.0;19.0;15.0;1.0;3.0;147;4205;2584;1621;462;302;19.0
7053;2013 vrijdag 26 april;512;260;252;374;169;205;692;679;4.0;9.0;15.0;14.0;0.0;1.0;115;4313;2702;1611;425;356;13.0
7054;2013 zaterdag 27 april;406;189;217;385;191;194;173;169;2.0;2.0;0.0;0.0;0.0;0.0;5;1239;830;409;1;88;0.0
7055;2013 zondag 28 april;388;194;194;337;156;181;11;11;0.0;0.0;0.0;0.0;0.0;0.0;0;526;321;205;2;82;0.0
7056;2013 maandag 29 april;496;245;251;360;159;201;199;193;3.0;3.0;24.0;23.0;0.0;1.0;86;3551;2160;1391;334;333;8.0
7057;2013 dinsdag 30 april;372;203;169;373;201;172;21;21;0.0;0.0;0.0;0.0;0.0;0.0;1;861;537;324;1;252;0.0
7058;2013 woensdag 1 mei;470;238;232;367;159;208;153;145;5.0;3.0;21.0;20.0;1.0;0.0;132;16118;9704;6414;546;791;12.0
7059;2013 donderdag 2 mei;493;258;235;385;201;184;154;153;0.0;1.0;16.0;15.0;0.0;1.0;141;6045;3626;2419;592;412;21.0
7060;2013 vrijdag 3 mei;519;245;274;364;155;209;526;519;3.0;4.0;19.0;18.0;1.0;0.0;125;4711;2816;1895;464;331;14.0
7061;2013 zaterdag 4 mei;405;207;198;342;166;176;59;58;0.0;1.0;0.0;0.0;0.0;0.0;0;789;523;266;1;75;0.0
7062;2013 zondag 5 mei;396;199;197;367;174;193;15;15;0.0;0.0;0.0;0.0;0.0;0.0;0;531;298;233;2;71;0.0
7063;2013 maandag 6 mei;502;269;233;384;185;199;277;273;1.0;3.0;102.0;97.0;2.0;3.0;117;5074;2954;2120;522;298;25.0
7064;2013 dinsdag 7 mei;518;238;280;383;181;202;204;199;1.0;4.0;44.0;42.0;1.0;1.0;156;4410;2548;1862;519;279;9.0
7065;2013 woensdag 8 mei;521;264;257;426;183;243;519;509;2.0;8.0;28.0;28.0;0.0;0.0;135;4415;2628;1787;520;283;15.0
7066;2013 donderdag 9 mei;382;206;176;362;155;207;24;24;0.0;0.0;0.0;0.0;0.0;0.0;0;613;376;237;1;76;3.0
7067;2013 vrijdag 10 mei;479;252;227;412;194;218;556;549;2.0;5.0;11.0;10.0;1.0;0.0;37;2177;1376;801;168;145;10.0
7068;2013 zaterdag 11 mei;407;210;197;351;168;183;176;175;0.0;1.0;0.0;0.0;0.0;0.0;3;634;422;212;3;45;0.0
7069;2013 zondag 12 mei;361;165;196;334;134;200;12;11;1.0;0.0;0.0;0.0;0.0;0.0;0;446;268;178;2;38;0.0
7070;2013 maandag 13 mei;454;219;235;370;188;182;290;287;1.0;2.0;81.0;74.0;5.0;2.0;121;5299;3182;2117;680;319;13.0
7071;2013 dinsdag 14 mei;489;249;240;360;184;176;174;172;1.0;1.0;43.0;43.0;0.0;0.0;147;4108;2457;1651;539;261;26.0
7072;2013 woensdag 15 mei;426;242;184;366;170;196;171;166;2.0;3.0;30.0;29.0;1.0;0.0;125;5405;3367;2038;564;316;37.0
7073;2013 donderdag 16 mei;543;278;265;389;187;202;210;207;2.0;1.0;22.0;22.0;0.0;0.0;111;4309;2609;1700;531;262;30.0
7074;2013 vrijdag 17 mei;521;276;245;357;175;182;756;743;4.0;9.0;12.0;11.0;0.0;1.0;118;4104;2513;1591;402;245;13.0
7075;2013 zaterdag 18 mei;385;211;174;376;179;197;204;202;1.0;1.0;1.0;1.0;0.0;0.0;0;872;596;276;2;64;0.0
7076;2013 zondag 19 mei;399;185;214;353;178;175;12;10;1.0;1.0;0.0;0.0;0.0;0.0;1;294;168;126;0;46;0.0
7077;2013 maandag 20 mei;354;178;176;332;159;173;18;16;0.0;2.0;0.0;0.0;0.0;0.0;1;997;678;319;3;92;0.0
7078;2013 dinsdag 21 mei;465;225;240;369;170;199;185;176;3.0;6.0;48.0;47.0;1.0;0.0;121;4406;2675;1731;604;350;24.0
7079;2013 woensdag 22 mei;504;262;242;384;187;197;156;155;1.0;0.0;32.0;30.0;1.0;1.0;132;4056;2474;1582;579;306;47.0
7080;2013 donderdag 23 mei;493;248;245;375;180;195;189;188;0.0;1.0;19.0;17.0;2.0;0.0;131;4108;2513;1595;517;304;32.0
7081;2013 vrijdag 24 mei;492;254;238;375;169;206;917;904;7.0;6.0;12.0;12.0;0.0;0.0;137;3611;2184;1427;376;288;842.0
7082;2013 zaterdag 25 mei;379;216;163;317;141;176;283;279;2.0;2.0;1.0;1.0;0.0;0.0;0;1191;816;375;6;129;0.0
7083;2013 zondag 26 mei;416;211;205;347;179;168;13;13;0.0;0.0;0.0;0.0;0.0;0.0;1;469;289;180;1;58;0.0
7084;2013 maandag 27 mei;471;249;222;359;185;174;298;289;4.0;5.0;71.0;69.0;2.0;0.0;123;4568;2801;1767;610;360;18.0
7085;2013 dinsdag 28 mei;502;252;250;403;198;205;174;168;3.0;3.0;53.0;49.0;3.0;1.0;162;3747;2268;1479;547;298;25.0
7086;2013 woensdag 29 mei;503;274;229;383;194;189;139;138;1.0;0.0;26.0;26.0;0.0;0.0;123;3854;2331;1523;553;324;17.0
7087;2013 donderdag 30 mei;463;233;230;365;177;188;226;224;0.0;2.0;14.0;12.0;2.0;0.0;157;4414;2726;1688;522;429;34.0
7088;2013 vrijdag 31 mei;465;228;237;383;183;200;1120;1102;1.0;17.0;22.0;21.0;0.0;1.0;121;5587;3458;2129;482;619;15.0
7089;2013 zaterdag 1 juni;412;202;210;348;164;184;295;288;4.0;3.0;0.0;0.0;0.0;0.0;1;11262;6877;4385;42;557;0.0
7090;2013 zondag 2 juni;358;193;165;360;182;178;11;11;0.0;0.0;0.0;0.0;0.0;0.0;1;582;335;247;1;85;0.0
7091;2013 maandag 3 juni;446;235;211;354;168;186;262;257;1.0;4.0;82.0;78.0;1.0;3.0;97;6042;3563;2479;607;358;23.0
7092;2013 dinsdag 4 juni;507;253;254;355;163;192;168;164;2.0;2.0;40.0;37.0;1.0;2.0;144;4983;2959;2024;576;275;23.0
7093;2013 woensdag 5 juni;521;280;241;363;176;187;153;151;1.0;1.0;29.0;28.0;0.0;1.0;132;4348;2537;1811;536;338;23.0
7094;2013 donderdag 6 juni;513;282;231;394;188;206;221;214;6.0;1.0;15.0;13.0;2.0;0.0;112;4472;2700;1772;606;265;21.0
7095;2013 vrijdag 7 juni;522;260;262;400;213;187;1063;1047;8.0;8.0;14.0;12.0;1.0;1.0;142;3701;2137;1564;437;250;20.0
7096;2013 zaterdag 8 juni;422;209;213;382;188;194;257;252;3.0;2.0;2.0;2.0;0.0;0.0;0;899;606;293;3;111;0.0
7097;2013 zondag 9 juni;358;186;172;329;148;181;9;9;0.0;0.0;0.0;0.0;0.0;0.0;0;408;232;176;7;52;0.0
7098;2013 maandag 10 juni;517;263;254;377;177;200;287;283;2.0;2.0;89.0;87.0;1.0;1.0;124;4757;2874;1883;570;283;15.0
7099;2013 dinsdag 11 juni;467;242;225;355;181;174;141;133;4.0;4.0;45.0;43.0;0.0;2.0;138;3846;2315;1531;575;271;25.0
7100;2013 woensdag 12 juni;512;265;247;396;193;203;160;152;1.0;7.0;27.0;25.0;2.0;0.0;122;3749;2271;1478;515;258;380.0
7101;2013 donderdag 13 juni;503;269;234;391;195;196;239;236;1.0;2.0;14.0;14.0;0.0;0.0;107;3861;2319;1542;509;297;25.0
7102;2013 vrijdag 14 juni;512;265;247;335;151;184;892;880;3.0;9.0;18.0;18.0;0.0;0.0;113;4094;2522;1572;445;323;9.0
7103;2013 zaterdag 15 juni;421;218;203;326;152;174;262;260;1.0;1.0;0.0;0.0;0.0;0.0;1;1856;1182;674;9;151;0.0
7104;2013 zondag 16 juni;374;187;187;318;150;168;15;14;1.0;0.0;0.0;0.0;0.0;0.0;1;569;351;218;0;91;142.0
7105;2013 maandag 17 juni;492;264;228;362;192;170;237;231;1.0;5.0;83.0;82.0;1.0;0.0;98;4906;2881;2025;606;368;37.0
7106;2013 dinsdag 18 juni;489;235;254;366;180;186;178;175;1.0;2.0;41.0;39.0;1.0;1.0;124;3779;2240;1539;538;277;24.0
7107;2013 woensdag 19 juni;530;274;256;374;175;199;145;143;2.0;0.0;27.0;25.0;1.0;1.0;165;3531;2042;1489;524;312;9.0
7108;2013 donderdag 20 juni;502;241;261;380;197;183;226;223;0.0;3.0;19.0;18.0;0.0;1.0;141;4048;2510;1538;536;354;28.0
7109;2013 vrijdag 21 juni;513;275;238;380;196;184;1181;1160;8.0;13.0;17.0;13.0;2.0;2.0;86;3721;2333;1388;426;363;14.0
7110;2013 zaterdag 22 juni;420;215;205;347;157;190;278;273;2.0;3.0;0.0;0.0;0.0;0.0;0;1160;816;344;5;141;0.0
7111;2013 zondag 23 juni;400;221;179;328;159;169;10;8;2.0;0.0;0.0;0.0;0.0;0.0;1;493;310;183;1;114;0.0
7112;2013 maandag 24 juni;518;259;259;363;187;176;296;290;4.0;2.0;88.0;87.0;0.0;1.0;114;4684;2849;1835;558;436;166.0
7113;2013 dinsdag 25 juni;504;256;248;328;162;166;174;168;4.0;2.0;48.0;46.0;1.0;1.0;116;4143;2491;1652;540;446;29.0
7114;2013 woensdag 26 juni;505;262;243;336;158;178;194;187;2.0;5.0;33.0;31.0;1.0;1.0;119;4069;2414;1655;570;500;16.0
7115;2013 donderdag 27 juni;495;239;256;352;181;171;203;202;1.0;0.0;21.0;20.0;0.0;1.0;131;4559;2655;1904;572;532;12.0
7116;2013 vrijdag 28 juni;500;270;230;384;182;202;912;899;3.0;10.0;17.0;14.0;2.0;1.0;129;5201;3169;2032;430;684;7.0
7117;2013 zaterdag 29 juni;446;225;221;368;179;189;239;235;0.0;4.0;1.0;1.0;0.0;0.0;1;1268;772;496;4;249;1.0
7118;2013 zondag 30 juni;418;204;214;358;170;188;9;9;0.0;0.0;0.0;0.0;0.0;0.0;1;1369;854;515;1;509;0.0
7119;2013 maandag 1 juli;496;263;233;358;178;180;307;301;4.0;2.0;60.0;60.0;0.0;0.0;124;22176;12713;9463;822;1567;20.0
7120;2013 dinsdag 2 juli;529;268;261;359;168;191;144;140;1.0;3.0;47.0;47.0;0.0;0.0;148;5941;3261;2680;741;499;17.0
7121;2013 woensdag 3 juli;558;296;262;396;199;197;136;131;2.0;3.0;33.0;30.0;3.0;0.0;157;5468;3037;2431;669;467;282.0
7122;2013 donderdag 4 juli;510;256;254;370;183;187;216;208;4.0;4.0;20.0;19.0;0.0;1.0;156;5727;3192;2535;653;445;34.0
7123;2013 vrijdag 5 juli;559;280;279;389;174;215;703;691;3.0;9.0;15.0;14.0;0.0;1.0;129;4861;2766;2095;512;553;9.0
7124;2013 zaterdag 6 juli;403;199;204;340;165;175;253;250;1.0;2.0;1.0;1.0;0.0;0.0;1;958;581;377;4;170;1.0
7125;2013 zondag 7 juli;419;224;195;320;145;175;12;12;0.0;0.0;0.0;0.0;0.0;0.0;0;575;333;242;4;155;0.0
7126;2013 maandag 8 juli;524;285;239;347;174;173;242;236;4.0;2.0;81.0;78.0;1.0;2.0;107;5432;3067;2365;845;517;22.0
7127;2013 dinsdag 9 juli;574;310;264;349;172;177;133;130;1.0;2.0;40.0;38.0;0.0;2.0;148;4282;2491;1791;659;414;13.0
7128;2013 woensdag 10 juli;570;297;273;368;193;175;145;143;1.0;1.0;23.0;23.0;0.0;0.0;160;4627;2642;1985;735;476;1315.0
7129;2013 donderdag 11 juli;510;256;254;333;162;171;115;111;2.0;2.0;19.0;19.0;0.0;0.0;140;4441;2639;1802;585;491;22.0
7130;2013 vrijdag 12 juli;555;286;269;374;169;205;541;531;4.0;6.0;15.0;14.0;1.0;0.0;120;4311;2514;1797;479;563;12.0
7131;2013 zaterdag 13 juli;478;257;221;362;169;193;154;151;1.0;2.0;0.0;0.0;0.0;0.0;0;977;597;380;14;142;0.0
7132;2013 zondag 14 juli;448;235;213;326;159;167;9;9;0.0;0.0;0.0;0.0;0.0;0.0;1;542;307;235;4;135;0.0
7133;2013 maandag 15 juli;479;242;237;347;178;169;230;222;6.0;2.0;58.0;57.0;0.0;1.0;136;7151;4040;3111;645;767;16.0
7134;2013 dinsdag 16 juli;555;280;275;335;170;165;143;141;1.0;1.0;42.0;41.0;0.0;1.0;141;4517;2601;1916;662;466;23.0
7135;2013 woensdag 17 juli;556;305;251;374;190;184;127;125;0.0;2.0;19.0;19.0;0.0;0.0;141;3873;2239;1634;608;472;370.0
7136;2013 donderdag 18 juli;523;273;250;388;189;199;124;120;1.0;3.0;16.0;15.0;1.0;0.0;120;4157;2426;1731;586;439;15.0
7137;2013 vrijdag 19 juli;533;280;253;374;187;187;329;321;2.0;6.0;10.0;10.0;0.0;0.0;109;3839;2183;1656;432;462;312.0
7138;2013 zaterdag 20 juli;456;211;245;323;169;154;131;128;1.0;2.0;2.0;2.0;0.0;0.0;1;1353;827;526;5;158;0.0
7139;2013 zondag 21 juli;425;208;217;347;158;189;5;5;0.0;0.0;0.0;0.0;0.0;0.0;1;449;246;203;0;148;0.0
7140;2013 maandag 22 juli;527;261;266;356;173;183;226;224;1.0;1.0;75.0;73.0;1.0;1.0;110;4835;2702;2133;650;524;22.0
7141;2013 dinsdag 23 juli;558;288;270;405;190;215;147;145;0.0;2.0;46.0;44.0;1.0;1.0;188;3738;2130;1608;553;427;9.0
7142;2013 woensdag 24 juli;568;273;295;436;216;220;126;123;2.0;1.0;22.0;18.0;1.0;3.0;152;3704;2061;1643;626;476;23.0
7143;2013 donderdag 25 juli;563;308;255;396;197;199;103;102;0.0;1.0;19.0;18.0;1.0;0.0;118;4298;2462;1836;597;523;15.0
7144;2013 vrijdag 26 juli;552;278;274;421;196;225;302;301;1.0;0.0;8.0;7.0;1.0;0.0;101;4188;2393;1795;485;468;22.0
7145;2013 zaterdag 27 juli;414;212;202;362;179;183;76;75;1.0;0.0;0.0;0.0;0.0;0.0;0;1103;671;432;8;161;1.0
7146;2013 zondag 28 juli;417;206;211;345;175;170;8;8;0.0;0.0;0.0;0.0;0.0;0.0;0;535;289;246;2;127;0.0
7147;2013 maandag 29 juli;499;258;241;364;175;189;226;222;0.0;4.0;79.0;77.0;0.0;2.0;133;4896;2748;2148;802;558;8.0
7148;2013 dinsdag 30 juli;515;257;258;345;158;187;132;130;1.0;1.0;39.0;36.0;0.0;3.0;123;4264;2411;1853;716;524;31.0
7149;2013 woensdag 31 juli;534;294;240;344;148;196;128;126;2.0;0.0;24.0;23.0;1.0;0.0;109;5371;3090;2281;656;983;23.0
7150;2013 donderdag 1 augustus;543;268;275;375;162;213;122;116;2.0;4.0;20.0;20.0;0.0;0.0;124;22918;11601;11317;930;1266;15.0
7151;2013 vrijdag 2 augustus;564;301;263;390;181;209;283;279;2.0;2.0;10.0;10.0;0.0;0.0;104;4697;2463;2234;620;420;12.0
7152;2013 zaterdag 3 augustus;403;201;202;337;163;174;123;122;1.0;0.0;0.0;0.0;0.0;0.0;0;987;498;489;1;120;0.0
7153;2013 zondag 4 augustus;387;186;201;330;167;163;4;4;0.0;0.0;0.0;0.0;0.0;0.0;0;641;285;356;1;81;0.0
7154;2013 maandag 5 augustus;501;248;253;323;154;169;235;230;2.0;3.0;80.0;76.0;2.0;2.0;129;6022;3177;2845;841;421;14.0
7155;2013 dinsdag 6 augustus;580;306;274;367;187;180;156;152;1.0;3.0;45.0;42.0;3.0;0.0;136;4887;2657;2230;709;376;29.0
7156;2013 woensdag 7 augustus;511;262;249;328;164;164;119;118;0.0;1.0;21.0;19.0;0.0;2.0;170;4389;2270;2119;664;334;17.0
7157;2013 donderdag 8 augustus;495;248;247;369;171;198;169;164;3.0;2.0;12.0;11.0;0.0;1.0;118;4665;2488;2177;641;359;23.0
7158;2013 vrijdag 9 augustus;570;291;279;382;192;190;308;301;1.0;6.0;8.0;8.0;0.0;0.0;122;3950;2123;1827;548;492;15.0
7159;2013 zaterdag 10 augustus;421;218;203;312;143;169;123;118;1.0;4.0;0.0;0.0;0.0;0.0;1;1349;770;579;3;139;0.0
7160;2013 zondag 11 augustus;370;218;152;306;154;152;14;14;0.0;0.0;0.0;0.0;0.0;0.0;0;636;271;365;0;89;0.0
7161;2013 maandag 12 augustus;558;302;256;344;167;177;267;261;2.0;4.0;73.0;72.0;1.0;0.0;131;5567;2899;2668;882;486;13.0
7162;2013 dinsdag 13 augustus;538;263;275;388;183;205;195;192;1.0;2.0;44.0;40.0;3.0;1.0;160;4267;2225;2042;926;355;15.0
7163;2013 woensdag 14 augustus;520;273;247;334;156;178;129;128;0.0;1.0;27.0;24.0;2.0;1.0;150;4410;2268;2142;841;429;29.0
7164;2013 donderdag 15 augustus;539;286;253;316;132;184;166;161;2.0;3.0;18.0;16.0;2.0;0.0;160;6756;3569;3187;822;525;21.0
7165;2013 vrijdag 16 augustus;571;269;302;380;188;192;552;541;5.0;6.0;16.0;15.0;1.0;0.0;147;4703;2502;2201;978;381;9.0
7166;2013 zaterdag 17 augustus;440;217;223;335;160;175;160;159;0.0;1.0;1.0;1.0;0.0;0.0;3;1226;593;633;5;148;0.0
7167;2013 zondag 18 augustus;404;211;193;344;164;180;17;17;0.0;0.0;0.0;0.0;0.0;0.0;0;866;299;567;2;109;0.0
7168;2013 maandag 19 augustus;526;274;252;349;183;166;247;243;2.0;2.0;76.0;75.0;1.0;0.0;123;5706;2770;2936;1756;445;14.0
7169;2013 dinsdag 20 augustus;569;290;279;341;164;177;193;192;0.0;1.0;35.0;33.0;1.0;1.0;125;4900;2569;2331;1972;427;19.0
7170;2013 woensdag 21 augustus;489;251;238;386;188;198;147;143;1.0;3.0;26.0;25.0;0.0;1.0;150;4168;2125;2043;835;378;15.0
7171;2013 donderdag 22 augustus;541;286;255;339;164;175;212;202;8.0;2.0;16.0;12.0;2.0;2.0;140;4614;2505;2109;894;401;20.0
7172;2013 vrijdag 23 augustus;547;281;266;353;173;180;812;794;5.0;13.0;14.0;14.0;0.0;0.0;154;4195;2179;2016;705;407;22.0
7173;2013 zaterdag 24 augustus;427;215;212;348;159;189;272;271;0.0;1.0;0.0;0.0;0.0;0.0;1;1374;757;617;4;125;0.0
7174;2013 zondag 25 augustus;365;177;188;285;138;147;9;9;0.0;0.0;0.0;0.0;0.0;0.0;0;1020;424;596;11;157;0.0
7175;2013 maandag 26 augustus;466;234;232;364;183;181;279;272;1.0;6.0;91.0;85.0;2.0;4.0;139;5886;2858;3028;1106;668;16.0
7176;2013 dinsdag 27 augustus;473;244;229;359;173;186;189;186;0.0;3.0;40.0;36.0;1.0;3.0;165;4853;2448;2405;1297;525;21.0
7177;2013 woensdag 28 augustus;548;300;248;360;172;188;203;199;2.0;2.0;27.0;26.0;0.0;1.0;162;4532;2238;2294;962;519;12.0
7178;2013 donderdag 29 augustus;504;277;227;371;183;188;237;234;2.0;1.0;17.0;17.0;0.0;0.0;128;5024;2720;2304;1154;626;12.0
7179;2013 vrijdag 30 augustus;577;302;275;335;164;171;1111;1087;10.0;14.0;22.0;22.0;0.0;0.0;100;6260;3563;2697;851;749;1353.0
7180;2013 zaterdag 31 augustus;400;192;208;333;151;182;394;381;6.0;7.0;0.0;0.0;0.0;0.0;0;2276;1208;1068;5;729;0.0
7181;2013 zondag 1 september;403;212;191;313;160;153;14;14;0.0;0.0;0.0;0.0;0.0;0.0;0;16282;7030;9252;712;1014;0.0
7182;2013 maandag 2 september;478;249;229;344;157;187;266;260;0.0;6.0;85.0;84.0;1.0;0.0;126;9459;4920;4539;1095;602;26.0
7183;2013 dinsdag 3 september;550;291;259;327;178;149;164;161;2.0;1.0;49.0;46.0;1.0;2.0;166;6308;3223;3085;1319;450;19.0
7184;2013 woensdag 4 september;520;245;275;361;178;183;187;179;2.0;6.0;23.0;23.0;0.0;0.0;156;5690;2827;2863;1228;385;16.0
7185;2013 donderdag 5 september;492;250;242;377;175;202;281;279;1.0;1.0;19.0;19.0;0.0;0.0;115;5733;3067;2666;1799;410;32.0
7186;2013 vrijdag 6 september;554;302;252;388;196;192;1193;1183;6.0;4.0;18.0;16.0;2.0;0.0;115;4899;2609;2290;970;426;8.0
7187;2013 zaterdag 7 september;445;240;205;362;181;181;372;368;4.0;0.0;0.0;0.0;0.0;0.0;1;1069;540;529;97;142;3.0
7188;2013 zondag 8 september;404;209;195;318;155;163;12;12;0.0;0.0;0.0;0.0;0.0;0.0;0;787;319;468;1;88;0.0
7189;2013 maandag 9 september;544;307;237;354;170;184;299;295;0.0;4.0;89.0;89.0;0.0;0.0;129;5778;3152;2626;1387;438;21.0
7190;2013 dinsdag 10 september;556;279;277;332;161;171;164;160;2.0;2.0;41.0;40.0;0.0;1.0;129;4815;2600;2215;1450;378;2251.0
7191;2013 woensdag 11 september;523;254;269;309;145;164;145;140;4.0;1.0;30.0;30.0;0.0;0.0;126;4344;2319;2025;1233;348;21.0
7192;2013 donderdag 12 september;569;301;268;354;171;183;235;234;0.0;1.0;16.0;14.0;1.0;1.0;155;4732;2643;2089;1053;710;18.0
7193;2013 vrijdag 13 september;524;298;226;323;155;168;1118;1093;5.0;20.0;11.0;10.0;1.0;0.0;121;4166;2365;1801;704;330;15.0
7194;2013 zaterdag 14 september;432;221;211;326;153;173;278;271;4.0;3.0;1.0;1.0;0.0;0.0;0;1190;689;501;86;142;0.0
7195;2013 zondag 15 september;379;202;177;310;153;157;9;9;0.0;0.0;0.0;0.0;0.0;0.0;0;1399;740;659;2;249;0.0
7196;2013 maandag 16 september;505;264;241;334;170;164;210;206;3.0;1.0;88.0;85.0;1.0;2.0;126;6138;3519;2619;851;472;12.0
7197;2013 dinsdag 17 september;561;303;258;334;167;167;133;130;2.0;1.0;47.0;47.0;0.0;0.0;120;4222;2282;1940;1341;380;22.0
7198;2013 woensdag 18 september;569;297;272;372;185;187;162;160;1.0;1.0;29.0;29.0;0.0;0.0;124;4360;2372;1988;867;275;19.0
7199;2013 donderdag 19 september;579;281;298;368;181;187;183;176;3.0;4.0;15.0;15.0;0.0;0.0;86;4352;2415;1937;872;358;16.0
7200;2013 vrijdag 20 september;558;283;275;363;176;187;955;936;9.0;10.0;17.0;14.0;2.0;1.0;129;4378;2544;1834;653;445;549.0
7201;2013 zaterdag 21 september;444;242;202;386;177;209;221;218;2.0;1.0;0.0;0.0;0.0;0.0;2;1165;729;436;341;109;0.0
7202;2013 zondag 22 september;419;215;204;341;155;186;7;6;1.0;0.0;0.0;0.0;0.0;0.0;0;607;291;316;1;89;0.0
7203;2013 maandag 23 september;513;257;256;353;176;177;213;211;1.0;1.0;86.0;84.0;1.0;1.0;122;5055;2879;2176;762;417;405.0
7204;2013 dinsdag 24 september;529;279;250;344;157;187;128;123;4.0;1.0;46.0;44.0;2.0;0.0;125;4269;2586;1683;2096;378;22.0
7205;2013 woensdag 25 september;548;267;281;326;165;161;127;119;3.0;5.0;31.0;30.0;1.0;0.0;156;4151;2366;1785;760;484;21.0
7206;2013 donderdag 26 september;532;266;266;373;195;178;177;174;1.0;2.0;27.0;24.0;3.0;0.0;130;4412;2490;1922;787;431;13.0
7207;2013 vrijdag 27 september;531;283;248;351;146;205;692;680;5.0;7.0;16.0;13.0;0.0;3.0;111;4246;2437;1809;614;454;13.0
7208;2013 zaterdag 28 september;401;217;184;297;144;153;184;180;2.0;2.0;0.0;0.0;0.0;0.0;1;1412;844;568;3;185;0.0
7209;2013 zondag 29 september;394;190;204;321;152;169;3;3;0.0;0.0;0.0;0.0;0.0;0.0;0;635;328;307;2;135;1.0
7210;2013 maandag 30 september;524;264;260;358;168;190;210;207;2.0;1.0;78.0;73.0;2.0;3.0;105;6488;3651;2837;767;784;544.0
7211;2013 dinsdag 1 oktober;573;295;278;354;180;174;147;145;1.0;1.0;39.0;37.0;0.0;2.0;104;19775;11331;8444;812;1075;19.0
7212;2013 woensdag 2 oktober;485;255;230;345;165;180;108;108;0.0;0.0;23.0;22.0;0.0;1.0;149;5553;3149;2404;805;407;33.0
7213;2013 donderdag 3 oktober;540;280;260;374;179;195;126;125;1.0;0.0;24.0;23.0;1.0;0.0;147;5214;2988;2226;748;401;13.0
7214;2013 vrijdag 4 oktober;520;265;255;410;212;198;363;359;0.0;4.0;15.0;14.0;1.0;0.0;106;4668;2714;1954;547;348;18.0
7215;2013 zaterdag 5 oktober;418;193;225;384;187;197;112;110;0.0;2.0;0.0;0.0;0.0;0.0;1;1079;636;443;5;142;0.0
7216;2013 zondag 6 oktober;393;204;189;350;179;171;3;3;0.0;0.0;0.0;0.0;0.0;0.0;0;611;318;293;0;71;1.0
7217;2013 maandag 7 oktober;453;225;228;380;186;194;227;224;1.0;2.0;78.0;74.0;2.0;2.0;127;5410;3109;2301;806;325;10.0
7218;2013 dinsdag 8 oktober;538;267;271;350;169;181;97;94;1.0;2.0;38.0;35.0;1.0;2.0;142;4531;2645;1886;935;302;10.0
7219;2013 woensdag 9 oktober;498;252;246;374;180;194;84;82;2.0;0.0;28.0;25.0;1.0;2.0;116;4184;2461;1723;752;295;28.0
7220;2013 donderdag 10 oktober;496;259;237;394;193;201;140;136;1.0;3.0;22.0;21.0;0.0;1.0;140;4779;2796;1983;649;294;454.0
7221;2013 vrijdag 11 oktober;510;257;253;392;194;198;387;381;3.0;3.0;15.0;14.0;0.0;1.0;113;3710;2193;1517;502;307;13.0
7222;2013 zaterdag 12 oktober;380;191;189;364;155;209;97;97;0.0;0.0;0.0;0.0;0.0;0.0;0;1113;730;383;2;84;0.0
7223;2013 zondag 13 oktober;385;186;199;350;189;161;7;7;0.0;0.0;0.0;0.0;0.0;0.0;0;523;279;244;1;48;0.0
7224;2013 maandag 14 oktober;482;224;258;372;178;194;210;208;1.0;1.0;105.0;99.0;2.0;4.0;121;5023;2939;2084;785;386;22.0
7225;2013 dinsdag 15 oktober;477;229;248;389;188;201;115;112;1.0;2.0;49.0;48.0;1.0;0.0;131;5501;3330;2171;613;386;19.0
7226;2013 woensdag 16 oktober;503;255;248;346;158;188;96;90;3.0;3.0;31.0;28.0;1.0;2.0;126;4407;2577;1830;658;313;21.0
7227;2013 donderdag 17 oktober;498;246;252;376;200;176;101;101;0.0;0.0;16.0;16.0;0.0;0.0;133;4270;2594;1676;600;268;1119.0
7228;2013 vrijdag 18 oktober;488;241;247;338;163;175;385;381;2.0;2.0;13.0;10.0;2.0;1.0;101;4108;2462;1646;472;254;18.0
7229;2013 zaterdag 19 oktober;389;192;197;380;183;197;86;85;1.0;0.0;0.0;0.0;0.0;0.0;1;1048;659;389;2;75;0.0
7230;2013 zondag 20 oktober;354;192;162;341;173;168;5;5;0.0;0.0;0.0;0.0;0.0;0.0;0;715;419;296;0;99;0.0
7231;2013 maandag 21 oktober;471;242;229;382;180;202;205;200;4.0;1.0;90.0;87.0;1.0;2.0;166;5121;2958;2163;584;331;12.0
7232;2013 dinsdag 22 oktober;471;246;225;395;181;214;139;136;2.0;1.0;41.0;39.0;2.0;0.0;165;4116;2464;1652;564;259;17.0
7233;2013 woensdag 23 oktober;481;244;237;377;194;183;92;92;0.0;0.0;23.0;22.0;1.0;0.0;100;3867;2277;1590;617;349;19.0
7234;2013 donderdag 24 oktober;503;266;237;399;192;207;84;82;0.0;2.0;15.0;15.0;0.0;0.0;117;4011;2361;1650;593;295;11.0
7235;2013 vrijdag 25 oktober;480;250;230;360;174;186;247;243;2.0;2.0;19.0;17.0;2.0;0.0;125;4271;2569;1702;433;379;11.0
7236;2013 zaterdag 26 oktober;403;198;205;378;195;183;65;64;1.0;0.0;1.0;1.0;0.0;0.0;0;1457;923;534;0;59;1.0
7237;2013 zondag 27 oktober;374;183;191;386;192;194;5;5;0.0;0.0;0.0;0.0;0.0;0.0;0;624;340;284;1;92;0.0
7238;2013 maandag 28 oktober;444;233;211;353;195;158;191;186;3.0;2.0;87.0;86.0;1.0;0.0;115;4983;2905;2078;544;413;19.0
7239;2013 dinsdag 29 oktober;459;239;220;363;202;161;105;103;2.0;0.0;35.0;34.0;1.0;0.0;128;4120;2450;1670;591;377;427.0
7240;2013 woensdag 30 oktober;457;232;225;376;187;189;84;83;1.0;0.0;29.0;28.0;1.0;0.0;137;4319;2531;1788;580;391;16.0
7241;2013 donderdag 31 oktober;495;257;238;352;176;176;125;124;0.0;1.0;18.0;17.0;1.0;0.0;137;5482;3392;2090;601;636;26.0
7242;2013 vrijdag 1 november;509;282;227;337;178;159;227;223;2.0;2.0;19.0;18.0;0.0;1.0;105;18871;11226;7645;499;893;14.0
7243;2013 zaterdag 2 november;393;193;200;364;184;180;45;42;2.0;1.0;1.0;1.0;0.0;0.0;1;1039;655;384;13;108;0.0
7244;2013 zondag 3 november;369;177;192;320;152;168;2;2;0.0;0.0;0.0;0.0;0.0;0.0;0;718;350;368;3;78;0.0
7245;2013 maandag 4 november;432;228;204;343;182;161;162;161;0.0;1.0;88.0;87.0;1.0;0.0;129;6044;3518;2526;792;369;549.0
7246;2013 dinsdag 5 november;457;248;209;355;178;177;92;92;0.0;0.0;50.0;47.0;3.0;0.0;123;5029;2830;2199;606;342;15.0
7247;2013 woensdag 6 november;521;285;236;375;205;170;75;75;0.0;0.0;25.0;24.0;1.0;0.0;121;4430;2580;1850;589;231;22.0
7248;2013 donderdag 7 november;470;237;233;384;195;189;59;58;1.0;0.0;17.0;17.0;0.0;0.0;93;4640;2696;1944;614;297;10.0
7249;2013 vrijdag 8 november;550;276;274;366;193;173;146;145;1.0;0.0;10.0;10.0;0.0;0.0;141;4287;2633;1654;485;247;18.0
7250;2013 zaterdag 9 november;396;208;188;332;154;178;46;44;1.0;1.0;1.0;1.0;0.0;0.0;0;1107;644;463;4;52;449.0
7251;2013 zondag 10 november;399;217;182;347;175;172;1;1;0.0;0.0;0.0;0.0;0.0;0.0;0;634;369;265;1;72;0.0
7252;2013 maandag 11 november;454;228;226;375;196;179;225;221;0.0;4.0;89.0;88.0;0.0;1.0;112;5304;3133;2171;590;357;20.0
7253;2013 dinsdag 12 november;507;259;248;397;205;192;117;112;3.0;2.0;50.0;49.0;0.0;1.0;113;4043;2390;1653;576;261;17.0
7254;2013 woensdag 13 november;473;238;235;374;156;218;85;84;0.0;1.0;26.0;25.0;0.0;1.0;129;3931;2311;1620;533;209;12.0
7255;2013 donderdag 14 november;465;252;213;353;157;196;62;59;2.0;1.0;18.0;18.0;0.0;0.0;118;4205;2486;1719;539;272;19.0
7256;2013 vrijdag 15 november;530;256;274;356;180;176;186;179;3.0;4.0;14.0;12.0;0.0;2.0;111;6106;3895;2211;478;330;17.0
7257;2013 zaterdag 16 november;400;215;185;372;189;183;38;36;1.0;1.0;0.0;0.0;0.0;0.0;1;1222;750;472;3;95;0.0
7258;2013 zondag 17 november;356;169;187;340;175;165;1;1;0.0;0.0;0.0;0.0;0.0;0.0;0;608;339;269;1;63;0.0
7259;2013 maandag 18 november;469;229;240;361;171;190;158;152;2.0;4.0;76.0;72.0;1.0;3.0;132;5013;3010;2003;628;336;18.0
7260;2013 dinsdag 19 november;452;230;222;383;178;205;93;91;1.0;1.0;42.0;42.0;0.0;0.0;124;3898;2306;1592;540;265;12.0
7261;2013 woensdag 20 november;517;272;245;374;178;196;87;85;2.0;0.0;31.0;30.0;1.0;0.0;133;4220;2529;1691;521;290;17.0
7262;2013 donderdag 21 november;490;253;237;355;174;181;71;70;1.0;0.0;11.0;10.0;0.0;1.0;112;4167;2520;1647;539;292;17.0
7263;2013 vrijdag 22 november;531;282;249;354;165;189;166;164;1.0;1.0;14.0;13.0;0.0;1.0;107;4058;2464;1594;373;308;32.0
7264;2013 zaterdag 23 november;405;190;215;351;192;159;32;31;1.0;0.0;0.0;0.0;0.0;0.0;0;1326;903;423;3;77;0.0
7265;2013 zondag 24 november;356;190;166;380;175;205;4;4;0.0;0.0;0.0;0.0;0.0;0.0;0;592;362;230;3;54;1.0
7266;2013 maandag 25 november;459;224;235;349;163;186;157;151;4.0;2.0;99.0;93.0;5.0;1.0;100;5005;2973;2032;601;378;758.0
7267;2013 dinsdag 26 november;505;265;240;385;185;200;109;106;2.0;1.0;46.0;43.0;1.0;2.0;136;4271;2568;1703;618;323;38.0
7268;2013 woensdag 27 november;489;241;248;428;217;211;72;69;2.0;1.0;36.0;35.0;0.0;1.0;121;4030;2360;1670;515;385;11.0
7269;2013 donderdag 28 november;454;221;233;426;212;214;72;72;0.0;0.0;18.0;18.0;0.0;0.0;129;4656;2901;1755;519;332;18.0
7270;2013 vrijdag 29 november;481;237;244;391;187;204;151;145;5.0;1.0;16.0;14.0;1.0;1.0;105;5404;3459;1945;410;415;19.0
7271;2013 zaterdag 30 november;389;202;187;384;196;188;36;35;0.0;1.0;1.0;1.0;0.0;0.0;1;2000;1320;680;1;291;0.0
7272;2013 zondag 1 december;339;164;175;372;183;189;2;2;0.0;0.0;0.0;0.0;0.0;0.0;0;10839;6517;4322;21;475;0.0
7273;2013 maandag 2 december;461;231;230;342;176;166;176;173;0.0;3.0;82.0;79.0;3.0;0.0;122;8424;5131;3293;621;420;22.0
7274;2013 dinsdag 3 december;473;244;229;385;172;213;77;73;2.0;2.0;42.0;40.0;1.0;1.0;173;5435;3203;2232;576;310;33.0
7275;2013 woensdag 4 december;478;238;240;413;191;222;78;75;1.0;2.0;29.0;28.0;0.0;1.0;133;4915;2820;2095;583;300;475.0
7276;2013 donderdag 5 december;442;236;206;344;169;175;35;33;1.0;1.0;16.0;16.0;0.0;0.0;124;4502;2653;1849;503;325;17.0
7277;2013 vrijdag 6 december;456;228;228;378;190;188;113;110;2.0;1.0;10.0;9.0;0.0;1.0;113;4311;2653;1658;441;295;8.0
7278;2013 zaterdag 7 december;397;203;194;377;168;209;37;37;0.0;0.0;0.0;0.0;0.0;0.0;0;1101;745;356;2;77;0.0
7279;2013 zondag 8 december;347;178;169;352;190;162;0;0;0.0;0.0;0.0;0.0;0.0;0.0;0;652;383;269;0;80;1.0
7280;2013 maandag 9 december;456;236;220;364;176;188;159;155;1.0;3.0;113.0;110.0;2.0;1.0;128;5480;3282;2198;776;395;264.0
7281;2013 dinsdag 10 december;502;241;261;357;195;162;125;123;1.0;1.0;51.0;50.0;0.0;1.0;127;4512;2783;1729;582;381;28.0
7282;2013 woensdag 11 december;516;257;259;362;180;182;735;706;10.0;19.0;57.0;51.0;3.0;3.0;123;4309;2589;1720;508;303;17.0
7283;2013 donderdag 12 december;513;260;253;402;194;208;106;104;1.0;1.0;22.0;20.0;2.0;0.0;128;4656;2883;1773;522;311;21.0
7284;2013 vrijdag 13 december;472;246;226;380;182;198;239;226;6.0;7.0;7.0;6.0;0.0;1.0;133;4545;2864;1681;376;314;15.0
7285;2013 zaterdag 14 december;376;204;172;382;191;191;52;51;0.0;1.0;0.0;0.0;0.0;0.0;0;1565;1120;445;2;96;0.0
7286;2013 zondag 15 december;302;157;145;338;170;168;6;5;0.0;1.0;0.0;0.0;0.0;0.0;0;1536;993;543;5;146;0.0
7287;2013 maandag 16 december;442;223;219;432;220;212;206;200;1.0;5.0;79.0;77.0;1.0;1.0;121;6985;4380;2605;635;399;28.0
7288;2013 dinsdag 17 december;491;233;258;380;189;191;115;112;2.0;1.0;46.0;45.0;1.0;0.0;171;4513;2764;1749;483;379;19.0
7289;2013 woensdag 18 december;489;269;220;389;191;198;102;98;1.0;3.0;34.0;34.0;0.0;0.0;116;4810;2872;1938;478;386;25.0
7290;2013 donderdag 19 december;518;278;240;394;199;195;75;74;0.0;1.0;14.0;14.0;0.0;0.0;128;4524;2714;1810;498;324;3.0
7291;2013 vrijdag 20 december;484;231;253;426;222;204;219;214;3.0;2.0;21.0;20.0;0.0;1.0;140;5757;3505;2252;451;515;3.0
7292;2013 zaterdag 21 december;387;220;167;376;187;189;50;50;0.0;0.0;1.0;1.0;0.0;0.0;0;1659;1043;616;4;250;2.0
7293;2013 zondag 22 december;351;172;179;386;186;200;1;1;0.0;0.0;0.0;0.0;0.0;0.0;0;513;317;196;12;131;0.0
7294;2013 maandag 23 december;506;251;255;416;216;200;230;224;3.0;3.0;88.0;85.0;1.0;2.0;191;6379;3819;2560;572;511;11.0
7295;2013 dinsdag 24 december;497;246;251;428;207;221;121;119;2.0;0.0;53.0;52.0;1.0;0.0;156;4113;2327;1786;319;365;6.0
7296;2013 woensdag 25 december;375;183;192;389;202;187;2;2;0.0;0.0;0.0;0.0;0.0;0.0;0;365;237;128;1;73;0.0
7297;2013 donderdag 26 december;348;181;167;356;172;184;9;9;0.0;0.0;0.0;0.0;0.0;0.0;2;366;200;166;1;77;2.0
7298;2013 vrijdag 27 december;532;255;277;413;181;232;61;60;1.0;0.0;9.0;9.0;0.0;0.0;57;2961;1788;1173;146;271;9.0
7299;2013 zaterdag 28 december;441;242;199;386;186;200;38;37;1.0;0.0;1.0;1.0;0.0;0.0;3;1234;789;445;1;151;1.0
7300;2013 zondag 29 december;381;209;172;357;163;194;2;2;0.0;0.0;0.0;0.0;0.0;0.0;0;568;315;253;2;103;0.0
7301;2013 maandag 30 december;464;233;231;380;186;194;161;152;4.0;5.0;75.0;71.0;4.0;0.0;177;7287;4346;2941;565;595;5.0
7302;2013 dinsdag 31 december;432;231;201;391;187;204;129;124;1.0;4.0;34.0;34.0;0.0;0.0;133;4962;2930;2032;334;1000;8.0
7303;Totaal 2013;171341;87957;83384;141245;68360;72885;64549;63327;522.0;700.0;9445.0;9038.0;208.0;199.0;33636;1473168;859018;614150;164772;117180;25882.0
7304;Totaal op zondag in 2013;19545;10046;9499;18916;9113;9803;386;378;6.0;2.0;0.0;0.0;0.0;0.0;17;59537;31713;27824;829;6671;148.0
7305;Totaal op maandag in 2013;24743;12678;12065;20006;9856;10150;10938;10709;98.0;131.0;4124.0;3981.0;75.0;68.0;6303;309791;179589;130202;35244;22917;6183.0
7306;Totaal op dinsdag in 2013;26479;13523;12956;20585;9967;10618;6767;6616;67.0;84.0;2251.0;2157.0;45.0;49.0;7239;260599;150987;109612;36392;20261;3802.0
7307;Totaal op woensdag in 2013;26226;13535;12691;20399;9817;10582;7144;6970;75.0;99.0;1438.0;1374.0;31.0;33.0;7020;238633;138376;100257;32801;18921;5712.0
7308;Totaal op donderdag in 2013;26088;13475;12613;20739;10016;10723;6829;6707;55.0;67.0;872.0;829.0;26.0;17.0;6527;257943;149858;108085;32283;20186;3840.0
7309;Totaal op vrijdag in 2013;26930;13798;13132;20850;10071;10779;23521;23107;156.0;258.0;730.0;672.0;27.0;31.0;6042;272347;161926;110421;26086;20648;5224.0
7310;Totaal op zaterdag in 2013;21186;10831;10355;19653;9459;10194;6475;6361;58.0;56.0;21.0;19.0;1.0;1.0;39;72760;45592;27168;828;7189;468.0
7311;Overig 2013;144;71;73;97;61;36;2489;2479;7.0;3.0;9.0;6.0;3.0;0.0;449;1558;977;581;309;387;505.0
7312;Totaal januari 2013;14526;7584;6942;13509;6538;6971;2454;2418;16.0;20.0;787.0;764.0;10.0;13.0;2855;132028;78000;54028;12773;10095;3635.0
7313;Totaal februari 2013;12739;6575;6164;12537;6019;6518;2535;2484;23.0;28.0;756.0;721.0;18.0;17.0;2828;117909;69755;48154;12614;8263;1842.0
7314;Totaal maart 2013;14067;7213;6854;13808;6536;7272;3516;3458;27.0;31.0;709.0;682.0;13.0;14.0;2893;119952;72647;47305;11059;7895;1383.0
7315;Totaal april 2013;13693;6937;6756;12348;5914;6434;4690;4594;42.0;54.0;736.0;694.0;18.0;24.0;2536;107896;65178;42718;10413;7664;2283.0
7316;Totaal mei 2013;14177;7241;6936;11440;5438;6002;8210;8069;49.0;92.0;728.0;694.0;23.0;11.0;2678;111362;67644;43718;10858;7914;1282.0
7317;Totaal juni 2013;14097;7249;6848;10809;5264;5545;8717;8554;68.0;95.0;770.0;733.0;17.0;20.0;2461;106360;64116;42244;10749;9250;1049.0
7318;Totaal juli 2013;15807;8146;7661;11253;5458;5795;5673;5562;47.0;64.0;813.0;783.0;12.0;18.0;3074;132589;75659;56930;14759;14277;2637.0
7319;Totaal augustus 2013;15347;7891;7456;10783;5183;5600;7447;7290;60.0;97.0;739.0;699.0;21.0;19.0;3042;137744;71322;66422;20966;12686;1716.0
7320;Totaal september 2013;14980;7768;7212;10319;5002;5317;8342;8187;69.0;86.0;862.0;830.0;18.0;14.0;2676;132541;70776;61765;23853;11508;4067.0
7321;Totaal oktober 2013;14418;7298;7120;11484;5679;5805;4238;4171;33.0;34.0;854.0;812.0;22.0;20.0;2948;128593;75499;53094;14802;9461;2357.0
7322;Totaal november 2013;13678;7004;6674;11011;5447;5564;2777;2710;37.0;30.0;798.0;768.0;14.0;16.0;2497;120858;72480;48378;11597;8022;2103.0
7323;Totaal december 2013;13668;6980;6688;11847;5821;6026;3461;3351;44.0;66.0;884.0;852.0;19.0;13.0;2699;123778;74965;48813;10020;9758;1023.0
7324;2014 woensdag 1 januari;350;181;169;395;205;190;9;9;0.0;0.0;0.0;0.0;0.0;0.0;0;14751;8079;6672;66;1051;0.0
7325;2014 donderdag 2 januari;477;244;233;427;207;220;46;44;0.0;2.0;11.0;8.0;1.0;2.0;97;7370;4134;3236;650;523;26.0
7326;2014 vrijdag 3 januari;535;286;249;421;222;199;75;73;1.0;1.0;12.0;11.0;1.0;0.0;112;6419;3776;2643;572;417;12.0
7327;2014 zaterdag 4 januari;395;196;199;374;175;199;36;35;1.0;0.0;1.0;1.0;0.0;0.0;0;1359;838;521;7;120;0.0
7328;2014 zondag 5 januari;384;193;191;375;174;201;5;4;1.0;0.0;0.0;0.0;0.0;0.0;0;994;563;431;2;135;0.0
7329;2014 maandag 6 januari;503;258;245;402;203;199;133;128;2.0;3.0;81.0;78.0;1.0;2.0;135;7269;4273;2996;691;453;1625.0
7330;2014 dinsdag 7 januari;490;264;226;422;196;226;117;114;0.0;3.0;40.0;38.0;0.0;2.0;154;5345;3137;2208;744;315;17.0
7331;2014 woensdag 8 januari;524;260;264;416;207;209;98;97;1.0;0.0;41.0;39.0;0.0;2.0;146;5139;2945;2194;697;366;42.0
7332;2014 donderdag 9 januari;467;216;251;425;213;212;57;56;1.0;0.0;13.0;12.0;0.0;1.0;111;4969;2973;1996;757;372;36.0
7333;2014 vrijdag 10 januari;482;233;249;387;183;204;100;98;0.0;2.0;12.0;12.0;0.0;0.0;133;4793;2856;1937;542;322;52.0
7334;2014 zaterdag 11 januari;379;186;193;379;178;201;43;41;2.0;0.0;1.0;1.0;0.0;0.0;1;1143;725;418;7;98;0.0
7335;2014 zondag 12 januari;342;181;161;387;171;216;4;4;0.0;0.0;0.0;0.0;0.0;0.0;0;534;308;226;4;93;1.0
7336;2014 maandag 13 januari;449;239;210;449;223;226;135;134;1.0;0.0;80.0;78.0;2.0;0.0;111;5276;3217;2059;653;354;19.0
7337;2014 dinsdag 14 januari;482;239;243;407;192;215;157;152;1.0;4.0;48.0;46.0;2.0;0.0;139;4355;2607;1748;677;308;31.0
7338;2014 woensdag 15 januari;523;253;270;343;153;190;82;81;0.0;1.0;25.0;23.0;1.0;1.0;160;6393;3861;2532;671;328;25.0
7339;2014 donderdag 16 januari;483;256;227;386;192;194;66;66;0.0;0.0;8.0;8.0;0.0;0.0;162;5005;3002;2003;752;297;31.0
7340;2014 vrijdag 17 januari;513;261;252;432;213;219;103;101;1.0;1.0;10.0;10.0;0.0;0.0;145;4382;2691;1691;509;294;29.0
7341;2014 zaterdag 18 januari;409;204;205;387;184;203;31;30;1.0;0.0;1.0;1.0;0.0;0.0;4;1198;762;436;3;91;0.0
7342;2014 zondag 19 januari;369;195;174;336;159;177;6;6;0.0;0.0;0.0;0.0;0.0;0.0;0;579;320;259;1;69;0.0
7343;2014 maandag 20 januari;483;254;229;393;208;185;167;164;1.0;2.0;69.0;64.0;3.0;2.0;142;5612;3333;2279;800;391;31.0
7344;2014 dinsdag 21 januari;499;238;261;394;200;194;99;97;1.0;1.0;39.0;37.0;1.0;1.0;149;4041;2404;1637;633;314;25.0
7345;2014 woensdag 22 januari;521;259;262;371;197;174;78;78;0.0;0.0;28.0;28.0;0.0;0.0;138;4000;2387;1613;638;287;759.0
7346;2014 donderdag 23 januari;477;248;229;419;203;216;52;50;1.0;1.0;15.0;15.0;0.0;0.0;167;4152;2481;1671;625;361;28.0
7347;2014 vrijdag 24 januari;494;252;242;382;182;200;129;126;3.0;0.0;13.0;13.0;0.0;0.0;114;4115;2559;1556;461;358;25.0
7348;2014 zaterdag 25 januari;394;209;185;372;170;202;32;32;0.0;0.0;0.0;0.0;0.0;0.0;2;1905;1289;616;7;176;0.0
7349;2014 zondag 26 januari;369;183;186;378;176;202;7;7;0.0;0.0;0.0;0.0;0.0;0.0;0;629;366;263;6;137;0.0
7350;2014 maandag 27 januari;487;249;238;379;183;196;149;145;0.0;4.0;76.0;72.0;2.0;2.0;144;5168;2985;2183;645;552;28.0
7351;2014 dinsdag 28 januari;538;256;282;415;204;211;83;83;0.0;0.0;40.0;40.0;0.0;0.0;163;4294;2555;1739;689;483;37.0
7352;2014 woensdag 29 januari;519;264;255;375;177;198;73;71;2.0;0.0;30.0;29.0;1.0;0.0;171;4243;2526;1717;1077;398;26.0
7353;2014 donderdag 30 januari;476;232;244;369;173;196;71;69;0.0;2.0;12.0;11.0;1.0;0.0;150;4935;3010;1925;712;524;311.0
7354;2014 vrijdag 31 januari;532;283;249;395;191;204;108;104;3.0;1.0;12.0;10.0;1.0;1.0;128;7141;4325;2816;670;914;24.0
7355;2014 zaterdag 1 februari;428;220;208;382;184;198;47;45;0.0;2.0;0.0;0.0;0.0;0.0;0;15891;8722;7169;186;715;1.0
7356;2014 zondag 2 februari;414;179;235;391;181;210;8;8;0.0;0.0;1.0;1.0;0.0;0.0;0;1014;540;474;2;95;1.0
7357;2014 maandag 3 februari;464;229;235;366;164;202;140;137;2.0;1.0;75.0;72.0;2.0;1.0;128;7220;4126;3094;790;501;21.0
7358;2014 dinsdag 4 februari;527;275;252;411;204;207;95;93;2.0;0.0;41.0;38.0;2.0;1.0;164;5240;2909;2331;874;377;18.0
7359;2014 woensdag 5 februari;514;264;250;426;211;215;81;80;1.0;0.0;25.0;22.0;2.0;1.0;158;5467;3102;2365;668;344;17.0
7360;2014 donderdag 6 februari;538;272;266;427;200;227;59;57;1.0;1.0;16.0;16.0;0.0;0.0;153;4847;2742;2105;1044;303;441.0
7361;2014 vrijdag 7 februari;516;274;242;430;208;222;140;138;1.0;1.0;8.0;7.0;0.0;1.0;137;4660;2870;1790;646;333;15.0
7362;2014 zaterdag 8 februari;394;212;182;398;193;205;27;27;0.0;0.0;0.0;0.0;0.0;0.0;0;1314;875;439;87;103;1.0
7363;2014 zondag 9 februari;400;200;200;396;195;201;3;3;0.0;0.0;0.0;0.0;0.0;0.0;0;581;335;246;1;88;0.0
7364;2014 maandag 10 februari;482;252;230;369;199;170;190;187;2.0;1.0;80.0;78.0;1.0;1.0;149;5674;3344;2330;860;320;40.0
7365;2014 dinsdag 11 februari;474;233;241;432;209;223;106;105;0.0;1.0;42.0;39.0;2.0;1.0;135;4022;2392;1630;665;291;20.0
7366;2014 woensdag 12 februari;514;268;246;433;204;229;98;97;1.0;0.0;27.0;23.0;1.0;3.0;133;4209;2510;1699;641;304;432.0
7367;2014 donderdag 13 februari;528;269;259;394;188;206;48;48;0.0;0.0;9.0;8.0;0.0;1.0;149;4112;2416;1696;670;283;27.0
7368;2014 vrijdag 14 februari;574;298;276;396;172;224;678;665;8.0;5.0;21.0;21.0;0.0;0.0;109;5408;3334;2074;446;309;15.0
7369;2014 zaterdag 15 februari;420;214;206;392;183;209;46;45;0.0;1.0;0.0;0.0;0.0;0.0;1;2351;1450;901;0;130;0.0
7370;2014 zondag 16 februari;417;206;211;379;178;201;5;5;0.0;0.0;1.0;1.0;0.0;0.0;0;716;427;289;1;73;0.0
7371;2014 maandag 17 februari;476;256;220;389;177;212;155;152;1.0;2.0;84.0;82.0;1.0;1.0;133;5468;3332;2136;744;359;22.0
7372;2014 dinsdag 18 februari;502;247;255;386;178;208;110;107;1.0;2.0;52.0;49.0;1.0;2.0;145;4162;2465;1697;807;325;32.0
7373;2014 woensdag 19 februari;489;261;228;400;203;197;69;68;0.0;1.0;28.0;26.0;2.0;0.0;140;3963;2342;1621;673;267;15.0
7374;2014 donderdag 20 februari;477;231;246;421;190;231;78;74;2.0;2.0;23.0;23.0;0.0;0.0;136;4776;2831;1945;567;334;42.0
7375;2014 vrijdag 21 februari;473;223;250;401;194;207;146;144;2.0;0.0;11.0;10.0;0.0;1.0;115;4470;2736;1734;465;355;13.0
7376;2014 zaterdag 22 februari;393;196;197;406;188;218;37;36;0.0;1.0;1.0;1.0;0.0;0.0;2;1846;1223;623;5;80;0.0
7377;2014 zondag 23 februari;373;186;187;349;162;187;6;5;1.0;0.0;0.0;0.0;0.0;0.0;0;618;339;279;2;76;0.0
7378;2014 maandag 24 februari;460;240;220;386;181;205;190;186;3.0;1.0;80.0;77.0;3.0;0.0;143;5335;3165;2170;731;413;21.0
7379;2014 dinsdag 25 februari;501;251;250;375;192;183;97;96;1.0;0.0;41.0;41.0;0.0;0.0;154;4282;2564;1718;889;337;21.0
7380;2014 woensdag 26 februari;513;261;252;360;168;192;92;92;0.0;0.0;33.0;31.0;0.0;2.0;140;4522;2637;1885;838;327;25.0
7381;2014 donderdag 27 februari;493;259;234;394;185;209;81;78;1.0;2.0;20.0;20.0;0.0;0.0;98;4938;3028;1910;599;383;20.0
7382;2014 vrijdag 28 februari;503;254;249;450;210;240;136;133;1.0;2.0;12.0;11.0;0.0;1.0;127;7596;4750;2846;562;656;9.0
7383;2014 zaterdag 1 maart;395;178;217;397;198;199;42;42;0.0;0.0;0.0;0.0;0.0;0.0;4;14103;8176;5927;70;545;1.0
7384;2014 zondag 2 maart;380;198;182;351;165;186;8;8;0.0;0.0;0.0;0.0;0.0;0.0;0;848;486;362;23;95;0.0
7385;2014 maandag 3 maart;496;241;255;405;188;217;143;142;1.0;0.0;74.0;73.0;1.0;0.0;89;6837;4133;2704;545;380;743.0
7386;2014 dinsdag 4 maart;520;279;241;428;225;203;94;91;3.0;0.0;35.0;35.0;0.0;0.0;142;4987;2965;2022;570;265;14.0
7387;2014 woensdag 5 maart;515;280;235;376;175;201;79;77;1.0;1.0;35.0;31.0;2.0;2.0;126;5534;3200;2334;634;367;17.0
7388;2014 donderdag 6 maart;532;263;269;387;167;220;65;64;0.0;1.0;19.0;18.0;0.0;1.0;140;5180;3174;2006;612;320;612.0
7389;2014 vrijdag 7 maart;518;246;272;411;209;202;141;140;1.0;0.0;18.0;16.0;1.0;1.0;158;4607;2712;1895;519;269;4.0
7390;2014 zaterdag 8 maart;414;204;210;395;184;211;38;36;2.0;0.0;0.0;0.0;0.0;0.0;1;1290;865;425;2;68;0.0
7391;2014 zondag 9 maart;355;186;169;360;168;192;5;5;0.0;0.0;0.0;0.0;0.0;0.0;0;579;339;240;2;47;0.0
7392;2014 maandag 10 maart;456;230;226;394;194;200;184;182;2.0;0.0;70.0;67.0;0.0;3.0;151;5221;3125;2096;571;323;22.0
7393;2014 dinsdag 11 maart;516;245;271;420;203;217;123;121;2.0;0.0;48.0;45.0;1.0;2.0;165;3990;2336;1654;846;194;49.0
7394;2014 woensdag 12 maart;492;246;246;413;196;217;90;89;1.0;0.0;30.0;29.0;1.0;0.0;163;4127;2433;1694;590;235;44.0
7395;2014 donderdag 13 maart;490;257;233;364;187;177;55;54;1.0;0.0;11.0;11.0;0.0;0.0;152;3996;2409;1587;504;238;606.0
7396;2014 vrijdag 14 maart;525;256;269;397;185;212;225;219;1.0;5.0;15.0;14.0;1.0;0.0;127;4782;2907;1875;493;251;22.0
7397;2014 zaterdag 15 maart;415;207;208;411;188;223;41;40;0.0;1.0;0.0;0.0;0.0;0.0;1;2323;1498;825;6;129;0.0
7398;2014 zondag 16 maart;364;200;164;370;186;184;6;6;0.0;0.0;0.0;0.0;0.0;0.0;0;743;493;250;0;72;2.0
7399;2014 maandag 17 maart;487;236;251;345;165;180;153;149;2.0;2.0;82.0;78.0;0.0;4.0;133;5561;3322;2239;566;348;21.0
7400;2014 dinsdag 18 maart;478;227;251;393;183;210;113;112;1.0;0.0;39.0;37.0;0.0;2.0;168;4165;2455;1710;561;262;43.0
7401;2014 woensdag 19 maart;515;257;258;376;194;182;50;49;0.0;1.0;18.0;18.0;0.0;0.0;165;3943;2294;1649;528;232;21.0
7402;2014 donderdag 20 maart;506;257;249;408;192;216;76;75;0.0;1.0;12.0;12.0;0.0;0.0;140;4260;2610;1650;487;297;452.0
7403;2014 vrijdag 21 maart;558;297;261;421;208;213;286;276;1.0;9.0;19.0;16.0;2.0;1.0;108;3954;2456;1498;458;275;14.0
7404;2014 zaterdag 22 maart;427;226;201;372;178;194;36;35;1.0;0.0;2.0;1.0;0.0;1.0;4;1351;889;462;4;115;0.0
7405;2014 zondag 23 maart;348;160;188;345;162;183;7;7;0.0;0.0;0.0;0.0;0.0;0.0;1;632;367;265;1;69;1.0
7406;2014 maandag 24 maart;496;273;223;386;183;203;185;182;2.0;1.0;81.0;81.0;0.0;0.0;146;4821;2943;1878;609;367;463.0
7407;2014 dinsdag 25 maart;471;246;225;384;198;186;102;99;0.0;3.0;42.0;40.0;1.0;1.0;139;3948;2457;1491;721;318;42.0
7408;2014 woensdag 26 maart;498;254;244;408;196;212;104;103;0.0;1.0;31.0;29.0;0.0;2.0;138;4123;2505;1618;595;341;31.0
7409;2014 donderdag 27 maart;485;261;224;379;188;191;79;78;0.0;1.0;20.0;19.0;0.0;1.0;177;4047;2478;1569;588;366;21.0
7410;2014 vrijdag 28 maart;509;252;257;416;202;214;199;193;3.0;3.0;10.0;9.0;0.0;1.0;154;4649;2953;1696;479;440;18.0
7411;2014 zaterdag 29 maart;370;189;181;376;177;199;43;42;1.0;0.0;0.0;0.0;0.0;0.0;0;1389;921;468;2;130;0.0
7412;2014 zondag 30 maart;367;193;174;340;154;186;4;4;0.0;0.0;0.0;0.0;0.0;0.0;0;733;446;287;1;111;1.0
7413;2014 maandag 31 maart;497;233;264;375;161;214;174;169;1.0;4.0;77.0;72.0;1.0;4.0;140;6331;3841;2490;651;670;15.0
7414;2014 dinsdag 1 april;450;236;214;348;163;185;309;295;4.0;10.0;47.0;47.0;0.0;0.0;131;21139;12940;8199;701;976;37.0
7415;2014 woensdag 2 april;483;248;235;408;197;211;103;101;1.0;1.0;28.0;28.0;0.0;0.0;136;5022;2882;2140;669;265;41.0
7416;2014 donderdag 3 april;502;259;243;385;194;191;78;76;2.0;0.0;15.0;14.0;1.0;0.0;155;4689;2760;1929;641;289;609.0
7417;2014 vrijdag 4 april;567;296;271;427;206;221;658;644;3.0;11.0;13.0;11.0;1.0;1.0;126;4611;2860;1751;493;307;19.0
7418;2014 zaterdag 5 april;403;215;188;400;187;213;46;43;3.0;0.0;1.0;1.0;0.0;0.0;0;1234;817;417;9;85;0.0
7419;2014 zondag 6 april;387;205;182;362;178;184;12;10;1.0;1.0;0.0;0.0;0.0;0.0;0;656;389;267;2;53;0.0
7420;2014 maandag 7 april;461;262;199;350;161;189;204;200;2.0;2.0;87.0;85.0;1.0;1.0;129;5186;3136;2050;588;303;19.0
7421;2014 dinsdag 8 april;555;278;277;365;172;193;131;131;0.0;0.0;53.0;50.0;1.0;2.0;166;4198;2543;1655;582;281;35.0
7422;2014 woensdag 9 april;491;237;254;372;170;202;86;84;0.0;2.0;28.0;26.0;2.0;0.0;153;3975;2375;1600;673;238;603.0
7423;2014 donderdag 10 april;461;206;255;357;169;188;136;134;1.0;1.0;16.0;14.0;1.0;1.0;180;4329;2603;1726;708;325;29.0
7424;2014 vrijdag 11 april;511;262;249;406;194;212;327;320;4.0;3.0;8.0;8.0;0.0;0.0;145;3867;2405;1462;492;276;22.0
7425;2014 zaterdag 12 april;391;179;212;398;187;211;100;99;1.0;0.0;1.0;1.0;0.0;0.0;0;1274;877;397;1;64;0.0
7426;2014 zondag 13 april;368;179;189;343;167;176;2;2;0.0;0.0;0.0;0.0;0.0;0.0;0;489;308;181;2;63;0.0
7427;2014 maandag 14 april;498;266;232;363;180;183;436;417;4.0;15.0;84.0;82.0;1.0;1.0;128;4951;2995;1956;703;318;27.0
7428;2014 dinsdag 15 april;513;262;251;393;173;220;125;123;0.0;2.0;47.0;45.0;0.0;2.0;127;5462;3344;2118;674;324;20.0
7429;2014 woensdag 16 april;485;243;242;373;161;212;126;124;1.0;1.0;27.0;25.0;1.0;1.0;167;4244;2576;1668;576;286;14.0
7430;2014 donderdag 17 april;541;285;256;339;164;175;184;181;0.0;3.0;20.0;19.0;1.0;0.0;114;4477;2672;1805;569;299;622.0
7431;2014 vrijdag 18 april;500;259;241;398;185;213;147;143;1.0;3.0;4.0;4.0;0.0;0.0;44;2409;1546;863;146;169;4.0
7432;2014 zaterdag 19 april;388;186;202;379;186;193;84;84;0.0;0.0;0.0;0.0;0.0;0.0;1;1182;789;393;1;39;0.0
7433;2014 zondag 20 april;380;187;193;362;188;174;6;6;0.0;0.0;0.0;0.0;0.0;0.0;0;574;362;212;1;66;1.0
7434;2014 maandag 21 april;394;201;193;362;190;172;16;16;0.0;0.0;0.0;0.0;0.0;0.0;1;940;567;373;1;81;3.0
7435;2014 dinsdag 22 april;507;261;246;379;187;192;153;152;1.0;0.0;46.0;45.0;1.0;0.0;140;5318;3173;2145;586;517;26.0
7436;2014 woensdag 23 april;545;290;255;368;167;201;150;145;3.0;2.0;30.0;29.0;1.0;0.0;159;4063;2428;1635;579;283;21.0
7437;2014 donderdag 24 april;511;250;261;388;178;210;235;231;1.0;3.0;19.0;16.0;2.0;1.0;128;4402;2608;1794;614;329;738.0
7438;2014 vrijdag 25 april;536;272;264;401;196;205;548;540;3.0;5.0;15.0;14.0;1.0;0.0;124;4302;2574;1728;357;373;15.0
7439;2014 zaterdag 26 april;433;219;214;365;187;178;47;47;0.0;0.0;0.0;0.0;0.0;0.0;1;918;586;332;0;78;0.0
7440;2014 zondag 27 april;336;177;159;346;171;175;12;12;0.0;0.0;0.0;0.0;0.0;0.0;1;651;379;272;1;96;0.0
7441;2014 maandag 28 april;453;231;222;367;166;201;280;275;3.0;2.0;92.0;92.0;0.0;0.0;110;4805;2941;1864;651;365;458.0
7442;2014 dinsdag 29 april;501;257;244;364;181;183;148;147;1.0;0.0;54.0;53.0;0.0;1.0;163;4346;2512;1834;644;328;36.0
7443;2014 woensdag 30 april;470;237;233;384;200;184;186;181;1.0;4.0;28.0;26.0;0.0;2.0;146;5771;3534;2237;587;629;26.0
7444;2014 donderdag 1 mei;520;272;248;374;201;173;165;162;1.0;2.0;15.0;14.0;0.0;1.0;105;19309;11465;7844;575;803;38.0
7445;2014 vrijdag 2 mei;574;298;276;390;174;216;519;509;5.0;5.0;19.0;18.0;1.0;0.0;116;5138;3031;2107;490;335;6.0
7446;2014 zaterdag 3 mei;398;206;192;318;143;175;129;126;3.0;0.0;1.0;1.0;0.0;0.0;2;1207;808;399;2;104;0.0
7447;2014 zondag 4 mei;335;164;171;330;146;184;10;10;0.0;0.0;0.0;0.0;0.0;0.0;1;698;426;272;5;54;0.0
7448;2014 maandag 5 mei;399;200;199;339;167;172;45;44;1.0;0.0;2.0;2.0;0.0;0.0;12;2376;1439;937;63;159;3.0
7449;2014 dinsdag 6 mei;473;232;241;401;198;203;159;155;2.0;2.0;46.0;45.0;0.0;1.0;164;5587;3228;2359;640;347;17.0
7450;2014 woensdag 7 mei;503;239;264;363;180;183;149;144;1.0;4.0;23.0;23.0;0.0;0.0;160;4854;2909;1945;633;244;13.0
7451;2014 donderdag 8 mei;477;231;246;378;180;198;185;178;3.0;4.0;19.0;17.0;1.0;1.0;151;4732;2880;1852;580;265;21.0
7452;2014 vrijdag 9 mei;541;258;283;407;206;201;631;625;1.0;5.0;18.0;16.0;2.0;0.0;138;4070;2543;1527;399;229;10.0
7453;2014 zaterdag 10 mei;371;201;170;384;171;213;176;175;1.0;0.0;3.0;3.0;0.0;0.0;0;1330;879;451;3;103;0.0
7454;2014 zondag 11 mei;411;187;224;346;178;168;8;8;0.0;0.0;0.0;0.0;0.0;0.0;1;525;301;224;1;50;0.0
7455;2014 maandag 12 mei;471;250;221;373;184;189;285;280;2.0;3.0;100.0;98.0;0.0;2.0;113;4747;2808;1939;688;305;23.0
7456;2014 dinsdag 13 mei;469;245;224;389;171;218;135;131;3.0;1.0;33.0;31.0;1.0;1.0;146;3727;2230;1497;606;272;25.0
7457;2014 woensdag 14 mei;515;287;228;356;186;170;236;227;3.0;6.0;32.0;31.0;0.0;1.0;132;3822;2376;1446;587;252;14.0
7458;2014 donderdag 15 mei;486;257;229;381;188;193;175;174;0.0;1.0;19.0;19.0;0.0;0.0;146;5920;3669;2251;544;344;38.0
7459;2014 vrijdag 16 mei;502;259;243;364;184;180;798;790;3.0;5.0;13.0;11.0;2.0;0.0;100;3977;2544;1433;467;257;29.0
7460;2014 zaterdag 17 mei;441;235;206;384;199;185;194;189;3.0;2.0;2.0;1.0;0.0;1.0;0;1015;645;370;5;88;0.0
7461;2014 zondag 18 mei;367;186;181;372;177;195;8;6;1.0;1.0;0.0;0.0;0.0;0.0;2;533;326;207;2;65;0.0
7462;2014 maandag 19 mei;491;255;236;370;174;196;276;269;0.0;7.0;77.0;76.0;0.0;1.0;110;4500;2749;1751;597;249;19.0
7463;2014 dinsdag 20 mei;528;248;280;373;180;193;183;178;1.0;4.0;35.0;33.0;1.0;1.0;154;3719;2250;1469;524;283;24.0
7464;2014 woensdag 21 mei;528;272;256;385;187;198;159;156;2.0;1.0;21.0;20.0;1.0;0.0;147;3668;2213;1455;567;330;875.0
7465;2014 donderdag 22 mei;478;246;232;394;191;203;180;177;1.0;2.0;12.0;12.0;0.0;0.0;171;3550;2172;1378;511;245;167.0
7466;2014 vrijdag 23 mei;495;261;234;351;156;195;873;846;8.0;19.0;23.0;23.0;0.0;0.0;96;4047;2535;1512;357;305;25.0
7467;2014 zaterdag 24 mei;438;237;201;356;175;181;277;274;1.0;2.0;1.0;1.0;0.0;0.0;0;1380;951;429;1;53;0.0
7468;2014 zondag 25 mei;392;218;174;330;148;182;12;11;0.0;1.0;0.0;0.0;0.0;0.0;0;576;369;207;10;88;0.0
7469;2014 maandag 26 mei;527;250;277;357;158;199;275;269;4.0;2.0;79.0;77.0;1.0;1.0;113;4775;2913;1862;578;373;11.0
7470;2014 dinsdag 27 mei;530;277;253;399;199;200;204;198;2.0;4.0;44.0;44.0;0.0;0.0;164;3954;2343;1611;552;433;610.0
7471;2014 woensdag 28 mei;553;288;265;363;168;195;687;676;3.0;8.0;31.0;28.0;2.0;1.0;140;5187;3266;1921;595;481;36.0
7472;2014 donderdag 29 mei;436;221;215;352;167;185;29;29;0.0;0.0;0.0;0.0;0.0;0.0;3;1029;626;403;0;107;0.0
7473;2014 vrijdag 30 mei;487;238;249;328;171;157;739;728;4.0;7.0;7.0;7.0;0.0;0.0;37;3224;2056;1168;168;359;5.0
7474;2014 zaterdag 31 mei;431;218;213;357;170;187;227;220;5.0;2.0;0.0;0.0;0.0;0.0;2;1742;1154;588;6;312;0.0
7475;2014 zondag 1 juni;426;214;212;353;159;194;13;12;0.0;1.0;0.0;0.0;0.0;0.0;0;11007;6526;4481;26;522;1.0
7476;2014 maandag 2 juni;530;283;247;328;164;164;310;304;2.0;4.0;87.0;81.0;3.0;3.0;152;8706;5230;3476;695;471;24.0
7477;2014 dinsdag 3 juni;501;263;238;333;152;181;158;153;2.0;3.0;40.0;38.0;1.0;1.0;164;5425;3162;2263;752;295;16.0
7478;2014 woensdag 4 juni;506;262;244;379;176;203;184;179;3.0;2.0;28.0;24.0;1.0;3.0;155;4789;2741;2048;628;311;23.0
7479;2014 donderdag 5 juni;537;263;274;377;207;170;266;259;2.0;5.0;18.0;18.0;0.0;0.0;123;4844;2835;2009;650;304;28.0
7480;2014 vrijdag 6 juni;555;280;275;377;181;196;1214;1195;9.0;10.0;22.0;22.0;0.0;0.0;115;4366;2647;1719;471;328;27.0
7481;2014 zaterdag 7 juni;436;220;216;352;168;184;268;265;2.0;1.0;2.0;2.0;0.0;0.0;0;1070;710;360;3;90;0.0
7482;2014 zondag 8 juni;385;201;184;353;165;188;19;18;1.0;0.0;0.0;0.0;0.0;0.0;1;460;299;161;5;54;0.0
7483;2014 maandag 9 juni;368;182;186;318;153;165;14;14;0.0;0.0;0.0;0.0;0.0;0.0;3;940;557;383;1;95;1.0
7484;2014 dinsdag 10 juni;497;247;250;368;176;192;208;203;2.0;3.0;52.0;48.0;2.0;2.0;149;4983;3064;1919;642;460;27.0
7485;2014 woensdag 11 juni;486;259;227;367;172;195;155;151;2.0;2.0;30.0;25.0;3.0;2.0;141;4118;2393;1725;621;273;25.0
7486;2014 donderdag 12 juni;561;274;287;344;162;182;227;222;1.0;4.0;11.0;11.0;0.0;0.0;146;4271;2557;1714;574;294;15.0
7487;2014 vrijdag 13 juni;544;263;281;351;155;196;541;530;3.0;8.0;8.0;7.0;1.0;0.0;168;3749;2300;1449;482;316;21.0
7488;2014 zaterdag 14 juni;422;223;199;347;173;174;410;404;3.0;3.0;2.0;2.0;0.0;0.0;1;1119;715;404;7;140;1572.0
7489;2014 zondag 15 juni;351;185;166;333;157;176;9;9;0.0;0.0;0.0;0.0;0.0;0.0;0;1354;850;504;3;139;1.0
7490;2014 maandag 16 juni;512;256;256;368;164;204;284;278;4.0;2.0;88.0;86.0;2.0;0.0;157;6081;3567;2514;643;405;19.0
7491;2014 dinsdag 17 juni;544;260;284;370;185;185;169;165;1.0;3.0;38.0;37.0;0.0;1.0;152;4135;2454;1681;747;374;31.0
7492;2014 woensdag 18 juni;537;282;255;332;158;174;143;139;2.0;2.0;26.0;26.0;0.0;0.0;137;3991;2394;1597;517;331;15.0
7493;2014 donderdag 19 juni;507;250;257;342;163;179;195;191;2.0;2.0;26.0;23.0;2.0;1.0;168;3823;2322;1501;522;329;611.0
7494;2014 vrijdag 20 juni;504;268;236;358;183;175;1100;1076;7.0;17.0;17.0;15.0;1.0;1.0;128;4411;2780;1631;419;440;22.0
7495;2014 zaterdag 21 juni;467;248;219;341;159;182;366;355;5.0;6.0;2.0;2.0;0.0;0.0;2;1404;913;491;5;147;1.0
7496;2014 zondag 22 juni;405;201;204;330;152;178;15;15;0.0;0.0;0.0;0.0;0.0;0.0;0;600;382;218;0;101;0.0
7497;2014 maandag 23 juni;490;232;258;337;153;184;261;257;3.0;1.0;91.0;90.0;0.0;1.0;150;4738;2820;1918;626;419;21.0
7498;2014 dinsdag 24 juni;529;301;228;375;178;197;160;156;1.0;3.0;47.0;43.0;1.0;3.0;140;3921;2297;1624;587;376;9.0
7499;2014 woensdag 25 juni;544;278;266;361;175;186;162;156;3.0;3.0;29.0;27.0;2.0;0.0;139;4059;2431;1628;654;514;28.0
7500;2014 donderdag 26 juni;548;264;284;362;195;167;196;191;1.0;4.0;21.0;21.0;0.0;0.0;152;4229;2476;1753;559;511;453.0
7501;2014 vrijdag 27 juni;543;280;263;371;180;191;952;938;4.0;10.0;16.0;15.0;1.0;0.0;144;4771;2867;1904;490;631;10.0
7502;2014 zaterdag 28 juni;472;248;224;340;154;186;256;254;1.0;1.0;1.0;1.0;0.0;0.0;2;1624;1025;599;7;254;0.0
7503;2014 zondag 29 juni;374;181;193;335;152;183;11;11;0.0;0.0;0.0;0.0;0.0;0.0;0;574;322;252;2;188;0.0
7504;2014 maandag 30 juni;526;273;253;390;182;208;273;268;1.0;4.0;86.0;80.0;3.0;3.0;146;7175;4283;2892;929;1210;32.0
7505;2014 dinsdag 1 juli;563;300;263;359;183;176;202;198;2.0;2.0;44.0;41.0;2.0;1.0;152;23152;12810;10342;827;1390;29.0
7506;2014 woensdag 2 juli;512;276;236;369;182;187;172;170;1.0;1.0;21.0;21.0;0.0;0.0;116;6047;3374;2673;682;638;740.0
7507;2014 donderdag 3 juli;518;268;250;391;183;208;171;168;2.0;1.0;20.0;20.0;0.0;0.0;151;5505;3141;2364;574;467;17.0
7508;2014 vrijdag 4 juli;573;282;291;387;179;208;882;866;9.0;7.0;17.0;16.0;0.0;1.0;109;4963;2836;2127;557;572;7.0
7509;2014 zaterdag 5 juli;405;224;181;370;175;195;209;201;3.0;5.0;1.0;1.0;0.0;0.0;0;1452;873;579;4;220;0.0
7510;2014 zondag 6 juli;397;214;183;386;178;208;11;11;0.0;0.0;0.0;0.0;0.0;0.0;0;732;396;336;10;146;0.0
7511;2014 maandag 7 juli;541;258;283;357;186;171;567;548;9.0;10.0;82.0;82.0;0.0;0.0;134;6002;3262;2740;700;502;19.0
7512;2014 dinsdag 8 juli;514;293;221;364;177;187;173;165;4.0;4.0;51.0;49.0;0.0;2.0;170;4533;2613;1920;667;474;28.0
7513;2014 woensdag 9 juli;524;263;261;381;174;207;131;127;3.0;1.0;20.0;20.0;0.0;0.0;148;4177;2425;1752;671;373;595.0
7514;2014 donderdag 10 juli;559;312;247;394;183;211;181;181;0.0;0.0;18.0;18.0;0.0;0.0;160;4673;2724;1949;620;498;19.0
7515;2014 vrijdag 11 juli;583;285;298;373;201;172;653;642;5.0;6.0;14.0;14.0;0.0;0.0;113;4548;2694;1854;496;460;22.0
7516;2014 zaterdag 12 juli;442;231;211;362;176;186;187;185;2.0;0.0;0.0;0.0;0.0;0.0;1;1538;915;623;2;179;0.0
7517;2014 zondag 13 juli;369;189;180;337;165;172;8;8;0.0;0.0;0.0;0.0;0.0;0.0;0;588;333;255;5;139;0.0
7518;2014 maandag 14 juli;529;275;254;345;175;170;412;402;3.0;7.0;83.0;82.0;1.0;0.0;159;5659;3174;2485;683;580;24.0
7519;2014 dinsdag 15 juli;578;322;256;367;184;183;141;137;3.0;1.0;43.0;42.0;0.0;1.0;153;6637;3859;2778;901;582;20.0
7520;2014 woensdag 16 juli;585;269;316;366;193;173;138;136;1.0;1.0;28.0;28.0;0.0;0.0;112;4805;2688;2117;607;496;14.0
7521;2014 donderdag 17 juli;549;287;262;548;266;282;146;144;1.0;1.0;16.0;16.0;0.0;0.0;140;4474;2558;1916;648;413;27.0
7522;2014 vrijdag 18 juli;544;291;253;406;205;201;492;484;3.0;5.0;19.0;17.0;1.0;1.0;128;4155;2348;1807;487;477;5.0
7523;2014 zaterdag 19 juli;459;231;228;389;173;216;149;147;1.0;1.0;0.0;0.0;0.0;0.0;1;1265;745;520;6;146;0.0
7524;2014 zondag 20 juli;401;214;187;388;189;199;9;9;0.0;0.0;0.0;0.0;0.0;0.0;1;885;536;349;8;136;0.0
7525;2014 maandag 21 juli;484;251;233;367;181;186;263;259;3.0;1.0;100.0;96.0;3.0;1.0;124;5437;2970;2467;604;509;447.0
7526;2014 dinsdag 22 juli;494;256;238;380;195;185;130;130;0.0;0.0;59.0;58.0;1.0;0.0;126;4110;2270;1840;670;421;4.0
7527;2014 woensdag 23 juli;561;301;260;379;196;183;113;109;0.0;4.0;29.0;28.0;0.0;1.0;137;4069;2244;1825;586;519;13.0
7528;2014 donderdag 24 juli;558;285;273;369;181;188;146;142;2.0;2.0;18.0;17.0;0.0;1.0;112;3946;2217;1729;653;416;29.0
7529;2014 vrijdag 25 juli;528;273;255;400;191;209;356;351;2.0;3.0;12.0;11.0;0.0;1.0;148;4749;2699;2050;452;515;19.0
7530;2014 zaterdag 26 juli;429;200;229;366;201;165;120;118;1.0;1.0;1.0;1.0;0.0;0.0;2;1417;877;540;4;168;0.0
7531;2014 zondag 27 juli;390;195;195;397;192;205;7;7;0.0;0.0;0.0;0.0;0.0;0.0;0;585;308;277;2;184;0.0
7532;2014 maandag 28 juli;506;267;239;359;172;187;213;210;2.0;1.0;86.0;84.0;1.0;1.0;158;4869;2706;2163;654;518;15.0
7533;2014 dinsdag 29 juli;521;277;244;373;166;207;118;115;2.0;1.0;47.0;44.0;2.0;1.0;133;4051;2239;1812;593;503;11.0
7534;2014 woensdag 30 juli;539;274;265;356;177;179;102;100;2.0;0.0;22.0;21.0;0.0;1.0;136;4482;2483;1999;671;621;20.0
7535;2014 donderdag 31 juli;502;264;238;333;167;166;98;95;1.0;2.0;18.0;18.0;0.0;0.0;136;6120;3551;2569;790;1163;27.0
7536;2014 vrijdag 1 augustus;522;286;236;391;185;206;346;340;2.0;4.0;18.0;18.0;0.0;0.0;120;25714;12917;12797;769;1393;15.0
7537;2014 zaterdag 2 augustus;440;228;212;368;173;195;145;143;1.0;1.0;0.0;0.0;0.0;0.0;0;1337;723;614;9;148;0.0
7538;2014 zondag 3 augustus;389;210;179;321;185;136;16;16;0.0;0.0;0.0;0.0;0.0;0.0;0;779;415;364;1;105;0.0
7539;2014 maandag 4 augustus;523;272;251;354;183;171;240;234;5.0;1.0;84.0;79.0;2.0;3.0;103;6704;3517;3187;859;458;20.0
7540;2014 dinsdag 5 augustus;524;259;265;377;176;201;163;160;0.0;3.0;40.0;38.0;2.0;0.0;121;5250;2772;2478;799;412;16.0
7541;2014 woensdag 6 augustus;553;268;285;364;184;180;140;139;0.0;1.0;36.0;36.0;0.0;0.0;132;4896;2647;2249;691;430;19.0
7542;2014 donderdag 7 augustus;525;270;255;389;179;210;128;124;1.0;3.0;19.0;19.0;0.0;0.0;133;4795;2623;2172;772;357;27.0
7543;2014 vrijdag 8 augustus;496;264;232;373;197;176;550;538;5.0;7.0;15.0;15.0;0.0;0.0;119;4656;2561;2095;711;473;10.0
7544;2014 zaterdag 9 augustus;412;216;196;344;171;173;140;137;2.0;1.0;0.0;0.0;0.0;0.0;0;1115;616;499;7;144;0.0
7545;2014 zondag 10 augustus;406;223;183;337;158;179;11;11;0.0;0.0;0.0;0.0;0.0;0.0;1;1022;469;553;4;168;0.0
7546;2014 maandag 11 augustus;542;304;238;333;159;174;237;235;1.0;1.0;89.0;88.0;1.0;0.0;128;5529;2971;2558;899;500;16.0
7547;2014 dinsdag 12 augustus;502;274;228;351;186;165;165;163;0.0;2.0;54.0;53.0;0.0;1.0;178;4393;2368;2025;953;359;11.0
7548;2014 woensdag 13 augustus;508;252;256;341;172;169;102;102;0.0;0.0;34.0;33.0;0.0;1.0;135;4221;2191;2030;832;464;10.0
7549;2014 donderdag 14 augustus;574;289;285;394;193;201;245;242;3.0;0.0;30.0;29.0;1.0;0.0;141;4622;2523;2099;794;471;12.0
7550;2014 vrijdag 15 augustus;569;303;266;378;186;192;491;480;4.0;7.0;25.0;25.0;0.0;0.0;126;7398;3897;3501;1046;619;7.0
7551;2014 zaterdag 16 augustus;436;226;210;317;158;159;180;177;2.0;1.0;2.0;2.0;0.0;0.0;1;1568;786;782;7;146;0.0
7552;2014 zondag 17 augustus;384;192;192;308;131;177;16;16;0.0;0.0;0.0;0.0;0.0;0.0;0;983;411;572;1;139;0.0
7553;2014 maandag 18 augustus;515;249;266;348;156;192;257;252;1.0;4.0;84.0;81.0;0.0;3.0;155;6564;3403;3161;1925;518;21.0
7554;2014 dinsdag 19 augustus;545;255;290;353;164;189;156;148;2.0;6.0;52.0;51.0;1.0;0.0;153;4354;2238;2116;2105;377;10.0
7555;2014 woensdag 20 augustus;579;312;267;348;179;169;174;173;1.0;0.0;41.0;39.0;2.0;0.0;120;4951;2557;2394;863;488;21.0
7556;2014 donderdag 21 augustus;544;268;276;379;201;178;176;171;2.0;3.0;21.0;20.0;1.0;0.0;113;4601;2422;2179;971;433;24.0
7557;2014 vrijdag 22 augustus;528;273;255;368;177;191;866;858;5.0;3.0;17.0;17.0;0.0;0.0;133;4721;2606;2115;755;477;5.0
7558;2014 zaterdag 23 augustus;453;232;221;355;171;184;283;277;3.0;3.0;2.0;2.0;0.0;0.0;4;1726;887;839;6;139;0.0
7559;2014 zondag 24 augustus;407;234;173;327;158;169;21;21;0.0;0.0;0.0;0.0;0.0;0.0;1;964;379;585;5;123;0.0
7560;2014 maandag 25 augustus;521;289;232;381;179;202;309;304;0.0;5.0;94.0;91.0;1.0;2.0;145;6438;3080;3358;1277;609;5.0
7561;2014 dinsdag 26 augustus;539;262;277;376;175;201;194;188;1.0;5.0;40.0;39.0;0.0;1.0;148;4514;2297;2217;1536;533;24.0
7562;2014 woensdag 27 augustus;571;313;258;391;167;224;167;165;0.0;2.0;19.0;18.0;1.0;0.0;159;4649;2403;2246;991;546;25.0
7563;2014 donderdag 28 augustus;555;279;276;388;188;200;290;282;3.0;5.0;20.0;18.0;0.0;2.0;127;5275;2668;2607;1078;610;11.0
7564;2014 vrijdag 29 augustus;565;285;280;413;187;226;1033;1019;7.0;7.0;14.0;14.0;0.0;0.0;137;5592;2920;2672;1241;659;8.0
7565;2014 zaterdag 30 augustus;434;222;212;373;155;218;374;365;5.0;4.0;4.0;4.0;0.0;0.0;0;1744;880;864;10;285;0.0
7566;2014 zondag 31 augustus;379;190;189;352;175;177;16;15;1.0;0.0;0.0;0.0;0.0;0.0;0;2131;891;1240;2;597;0.0
7567;2014 maandag 1 september;497;249;248;353;176;177;291;288;2.0;1.0;94.0;93.0;0.0;1.0;151;28303;13700;14603;1713;2003;17.0
7568;2014 dinsdag 2 september;590;311;279;348;174;174;154;148;1.0;5.0;51.0;51.0;0.0;0.0;162;6457;3283;3174;1266;498;19.0
7569;2014 woensdag 3 september;547;290;257;367;171;196;152;149;3.0;0.0;30.0;28.0;2.0;0.0;158;5595;2820;2775;1224;419;14.0
7570;2014 donderdag 4 september;546;276;270;449;219;230;237;231;1.0;5.0;20.0;20.0;0.0;0.0;137;5594;2963;2631;1679;411;27.0
7571;2014 vrijdag 5 september;565;285;280;390;181;209;1265;1238;5.0;22.0;14.0;12.0;0.0;2.0;129;5257;2928;2329;807;469;24.0
7572;2014 zaterdag 6 september;434;209;225;359;174;185;389;384;3.0;2.0;0.0;0.0;0.0;0.0;0;1327;712;615;226;182;0.0
7573;2014 zondag 7 september;426;208;218;360;187;173;30;29;0.0;1.0;0.0;0.0;0.0;0.0;0;939;402;537;4;111;2.0
7574;2014 maandag 8 september;485;254;231;365;185;180;237;228;5.0;4.0;85.0;82.0;1.0;2.0;150;5945;3143;2802;1184;457;436.0
7575;2014 dinsdag 9 september;536;259;277;347;163;184;208;203;2.0;3.0;48.0;46.0;1.0;1.0;146;4498;2348;2150;1864;377;13.0
7576;2014 woensdag 10 september;563;286;277;378;185;193;147;142;1.0;4.0;37.0;35.0;0.0;2.0;118;4735;2557;2178;1264;396;20.0
7577;2014 donderdag 11 september;528;276;252;387;189;198;135;131;4.0;0.0;21.0;20.0;0.0;1.0;126;4535;2467;2068;1195;384;17.0
7578;2014 vrijdag 12 september;541;275;266;377;184;193;957;943;5.0;9.0;23.0;23.0;0.0;0.0;130;4351;2468;1883;820;415;21.0
7579;2014 zaterdag 13 september;464;236;228;347;172;175;212;210;1.0;1.0;2.0;1.0;1.0;0.0;0;1169;702;467;114;139;4.0
7580;2014 zondag 14 september;416;224;192;327;151;176;14;14;0.0;0.0;0.0;0.0;0.0;0.0;1;808;410;398;1;110;0.0
7581;2014 maandag 15 september;509;253;256;368;185;183;240;239;0.0;1.0;77.0;76.0;0.0;1.0;100;7774;4514;3260;1027;539;3069.0
7582;2014 dinsdag 16 september;581;286;295;370;195;175;126;124;1.0;1.0;52.0;48.0;1.0;3.0;136;4628;2554;2074;1266;353;16.0
7583;2014 woensdag 17 september;536;280;256;390;187;203;125;122;0.0;3.0;31.0;29.0;1.0;1.0;130;4234;2335;1899;1252;382;26.0
7584;2014 donderdag 18 september;588;303;285;356;184;172;199;193;3.0;3.0;11.0;11.0;0.0;0.0;158;4343;2474;1869;1144;365;17.0
7585;2014 vrijdag 19 september;553;279;274;419;215;204;873;858;4.0;11.0;15.0;12.0;3.0;0.0;132;4105;2341;1764;760;334;12.0
7586;2014 zaterdag 20 september;433;219;214;345;173;172;264;261;1.0;2.0;1.0;1.0;0.0;0.0;0;1571;936;635;5;155;0.0
7587;2014 zondag 21 september;423;225;198;341;163;178;13;12;0.0;1.0;0.0;0.0;0.0;0.0;0;747;371;376;3;92;1.0
7588;2014 maandag 22 september;543;262;281;332;160;172;232;228;1.0;3.0;96.0;93.0;3.0;0.0;113;5092;2813;2279;1104;442;15.0
7589;2014 dinsdag 23 september;565;284;281;367;190;177;147;142;2.0;3.0;55.0;53.0;1.0;1.0;140;4085;2292;1793;1487;359;16.0
7590;2014 woensdag 24 september;570;290;280;378;165;213;153;149;2.0;2.0;34.0;31.0;1.0;2.0;142;4076;2236;1840;1174;352;20.0
7591;2014 donderdag 25 september;577;299;278;339;156;183;177;174;2.0;1.0;20.0;19.0;1.0;0.0;152;4474;2563;1911;1047;418;318.0
7592;2014 vrijdag 26 september;549;277;272;387;168;219;670;664;1.0;5.0;23.0;21.0;1.0;1.0;114;4571;2721;1850;713;455;17.0
7593;2014 zaterdag 27 september;445;220;225;347;157;190;177;175;2.0;0.0;2.0;2.0;0.0;0.0;0;1615;978;637;507;148;1.0
7594;2014 zondag 28 september;428;209;219;332;150;182;5;5;0.0;0.0;0.0;0.0;0.0;0.0;0;730;384;346;0;145;0.0
7595;2014 maandag 29 september;530;281;249;346;161;185;191;190;0.0;1.0;93.0;90.0;2.0;1.0;102;5650;3250;2400;929;502;25.0
7596;2014 dinsdag 30 september;562;290;272;390;187;203;119;116;0.0;3.0;54.0;51.0;1.0;2.0;129;6064;3634;2430;937;740;32.0
7597;2014 woensdag 1 oktober;519;277;242;381;182;199;129;128;0.0;1.0;36.0;35.0;1.0;0.0;112;21899;12422;9477;1074;1166;22.0
7598;2014 donderdag 2 oktober;538;265;273;392;182;210;104;103;0.0;1.0;27.0;27.0;0.0;0.0;157;5669;3194;2475;901;437;173.0
7599;2014 vrijdag 3 oktober;534;291;243;408;209;199;404;399;1.0;4.0;7.0;5.0;1.0;1.0;129;4708;2713;1995;598;408;15.0
7600;2014 zaterdag 4 oktober;457;235;222;384;183;201;148;145;2.0;1.0;0.0;0.0;0.0;0.0;0;1156;664;492;12;130;0.0
7601;2014 zondag 5 oktober;382;208;174;336;160;176;4;4;0.0;0.0;0.0;0.0;0.0;0.0;0;935;507;428;7;91;0.0
7602;2014 maandag 6 oktober;493;254;239;367;167;200;204;200;4.0;0.0;86.0;84.0;2.0;0.0;107;5711;3232;2479;824;383;907.0
7603;2014 dinsdag 7 oktober;550;277;273;366;175;191;133;127;1.0;5.0;55.0;52.0;2.0;1.0;146;4381;2411;1970;859;305;17.0
7604;2014 woensdag 8 oktober;531;267;264;387;170;217;105;103;0.0;2.0;27.0;26.0;1.0;0.0;116;4355;2437;1918;868;386;27.0
7605;2014 donderdag 9 oktober;572;299;273;383;194;189;96;93;1.0;2.0;17.0;15.0;1.0;1.0;137;4254;2425;1829;786;307;9.0
7606;2014 vrijdag 10 oktober;535;284;251;355;173;182;577;569;2.0;6.0;17.0;17.0;0.0;0.0;128;4596;2875;1721;652;349;13.0
7607;2014 zaterdag 11 oktober;403;210;193;401;199;202;103;99;1.0;3.0;0.0;0.0;0.0;0.0;0;1124;667;457;5;97;0.0
7608;2014 zondag 12 oktober;384;210;174;354;169;185;7;7;0.0;0.0;0.0;0.0;0.0;0.0;0;647;339;308;2;78;0.0
7609;2014 maandag 13 oktober;495;240;255;325;148;177;191;186;4.0;1.0;96.0;92.0;3.0;1.0;110;4791;2700;2091;907;353;14.0
7610;2014 dinsdag 14 oktober;548;279;269;425;212;213;224;222;0.0;2.0;55.0;52.0;0.0;3.0;107;4039;2310;1729;874;314;465.0
7611;2014 woensdag 15 oktober;508;253;255;370;180;190;113;112;1.0;0.0;28.0;27.0;0.0;1.0;122;6123;3621;2502;712;368;23.0
7612;2014 donderdag 16 oktober;520;274;246;391;207;184;115;110;3.0;2.0;26.0;24.0;2.0;0.0;144;4749;2811;1938;793;330;24.0
7613;2014 vrijdag 17 oktober;548;291;257;373;188;185;335;331;4.0;0.0;28.0;28.0;0.0;0.0;115;4294;2511;1783;497;345;31.0
7614;2014 zaterdag 18 oktober;426;235;191;406;202;204;90;90;0.0;0.0;1.0;0.0;0.0;1.0;0;1340;865;475;3;75;0.0
7615;2014 zondag 19 oktober;406;216;190;353;181;172;9;9;0.0;0.0;0.0;0.0;0.0;0.0;0;620;343;277;2;77;0.0
7616;2014 maandag 20 oktober;470;227;243;406;176;230;226;218;4.0;4.0;135.0;127.0;6.0;2.0;147;5155;3037;2118;633;383;18.0
7617;2014 dinsdag 21 oktober;499;238;261;389;202;187;122;119;2.0;1.0;60.0;60.0;0.0;0.0;119;3678;2088;1590;638;295;39.0
7618;2014 woensdag 22 oktober;502;249;253;349;161;188;105;100;2.0;3.0;42.0;39.0;1.0;2.0;124;3907;2205;1702;646;322;19.0
7619;2014 donderdag 23 oktober;495;258;237;373;171;202;92;92;0.0;0.0;21.0;20.0;0.0;1.0;140;3849;2194;1655;638;372;18.0
7620;2014 vrijdag 24 oktober;526;261;265;379;183;196;310;302;3.0;5.0;18.0;17.0;1.0;0.0;120;4345;2682;1663;499;328;10.0
7621;2014 zaterdag 25 oktober;456;234;222;318;154;164;55;52;2.0;1.0;0.0;0.0;0.0;0.0;4;1810;1198;612;4;103;0.0
7622;2014 zondag 26 oktober;407;216;191;348;169;179;2;2;0.0;0.0;0.0;0.0;0.0;0.0;0;737;412;325;2;76;0.0
7623;2014 maandag 27 oktober;460;228;232;344;158;186;172;171;1.0;0.0;112.0;111.0;1.0;0.0;118;5026;2881;2145;674;400;608.0
7624;2014 dinsdag 28 oktober;494;264;230;409;184;225;126;123;1.0;2.0;54.0;51.0;2.0;1.0;123;4263;2535;1728;802;459;14.0
7625;2014 woensdag 29 oktober;525;287;238;396;181;215;67;62;2.0;3.0;48.0;46.0;1.0;1.0;156;4408;2522;1886;734;368;22.0
7626;2014 donderdag 30 oktober;496;262;234;375;186;189;75;73;1.0;1.0;24.0;24.0;0.0;0.0;158;5111;3001;2110;745;407;16.0
7627;2014 vrijdag 31 oktober;516;248;268;384;185;199;183;177;2.0;4.0;23.0;21.0;0.0;2.0;139;7039;4459;2580;561;684;16.0
7628;2014 zaterdag 1 november;432;215;217;388;185;203;44;42;2.0;0.0;1.0;1.0;0.0;0.0;1;14007;7973;6034;48;630;0.0
7629;2014 zondag 2 november;397;216;181;346;158;188;4;4;0.0;0.0;0.0;0.0;0.0;0.0;0;939;495;444;3;85;0.0
7630;2014 maandag 3 november;474;237;237;410;191;219;172;166;3.0;3.0;102.0;101.0;0.0;1.0;132;7417;4175;3242;729;371;8.0
7631;2014 dinsdag 4 november;514;258;256;384;183;201;117;116;1.0;0.0;58.0;56.0;2.0;0.0;143;5261;2989;2272;841;290;22.0
7632;2014 woensdag 5 november;492;226;266;341;158;183;75;74;1.0;0.0;35.0;34.0;0.0;1.0;157;4954;2864;2090;710;302;581.0
7633;2014 donderdag 6 november;481;239;242;403;183;220;75;75;0.0;0.0;13.0;13.0;0.0;0.0;123;4511;2696;1815;742;286;28.0
7634;2014 vrijdag 7 november;493;242;251;388;198;190;179;176;0.0;3.0;13.0;10.0;3.0;0.0;118;4493;2703;1790;538;304;21.0
7635;2014 zaterdag 8 november;424;233;191;382;169;213;38;36;1.0;1.0;0.0;0.0;0.0;0.0;1;1227;789;438;10;82;2.0
7636;2014 zondag 9 november;375;187;188;339;161;178;3;3;0.0;0.0;0.0;0.0;0.0;0.0;0;614;347;267;2;69;0.0
7637;2014 maandag 10 november;475;242;233;387;182;205;186;183;1.0;2.0;105.0;102.0;1.0;2.0;169;5465;3158;2307;686;352;454.0
7638;2014 dinsdag 11 november;493;271;222;393;197;196;157;156;0.0;1.0;70.0;70.0;0.0;0.0;112;4299;2503;1796;796;276;20.0
7639;2014 woensdag 12 november;497;257;240;426;196;230;86;83;2.0;1.0;34.0;33.0;0.0;1.0;151;4120;2364;1756;670;281;609.0
7640;2014 donderdag 13 november;519;261;258;395;191;204;57;57;0.0;0.0;17.0;17.0;0.0;0.0;124;3960;2329;1631;630;232;26.0
7641;2014 vrijdag 14 november;547;270;277;422;214;208;304;303;1.0;0.0;29.0;26.0;2.0;1.0;130;5198;3230;1968;446;280;18.0
7642;2014 zaterdag 15 november;415;223;192;404;178;226;39;38;0.0;1.0;0.0;0.0;0.0;0.0;0;2400;1584;816;6;160;1.0
7643;2014 zondag 16 november;389;204;185;347;173;174;4;4;0.0;0.0;0.0;0.0;0.0;0.0;0;788;426;362;3;72;0.0
7644;2014 maandag 17 november;454;227;227;401;175;226;172;168;2.0;2.0;100.0;97.0;2.0;1.0;114;5591;3332;2259;700;314;17.0
7645;2014 dinsdag 18 november;510;285;225;381;186;195;114;114;0.0;0.0;51.0;50.0;1.0;0.0;162;4128;2436;1692;651;253;14.0
7646;2014 woensdag 19 november;497;255;242;422;214;208;74;72;2.0;0.0;32.0;31.0;0.0;1.0;142;4048;2447;1601;606;367;24.0
7647;2014 donderdag 20 november;490;242;248;394;210;184;79;78;0.0;1.0;24.0;23.0;0.0;1.0;105;4442;2559;1883;622;373;629.0
7648;2014 vrijdag 21 november;515;260;255;372;181;191;168;167;0.0;1.0;25.0;24.0;0.0;1.0;115;4145;2577;1568;454;252;20.0
7649;2014 zaterdag 22 november;391;197;194;426;225;201;41;39;1.0;1.0;2.0;2.0;0.0;0.0;0;1583;1014;569;2;99;0.0
7650;2014 zondag 23 november;361;178;183;379;183;196;3;3;0.0;0.0;0.0;0.0;0.0;0.0;0;690;419;271;1;84;0.0
7651;2014 maandag 24 november;472;243;229;381;194;187;164;160;1.0;3.0;111.0;107.0;4.0;0.0;136;5072;2953;2119;780;344;884.0
7652;2014 dinsdag 25 november;458;255;203;401;194;207;116;114;1.0;1.0;66.0;64.0;1.0;1.0;150;4189;2460;1729;637;360;25.0
7653;2014 woensdag 26 november;494;261;233;402;208;194;83;81;2.0;0.0;39.0;39.0;0.0;0.0;147;4136;2410;1726;627;333;26.0
7654;2014 donderdag 27 november;525;269;256;415;210;205;79;77;2.0;0.0;24.0;23.0;1.0;0.0;109;4336;2556;1780;561;313;30.0
7655;2014 vrijdag 28 november;499;250;249;397;192;205;153;150;1.0;2.0;24.0;22.0;1.0;1.0;147;5230;3214;2016;416;426;8.0
7656;2014 zaterdag 29 november;427;228;199;398;187;211;41;41;0.0;0.0;1.0;1.0;0.0;0.0;0;1693;1073;620;3;152;0.0
7657;2014 zondag 30 november;369;180;189;382;170;212;2;2;0.0;0.0;0.0;0.0;0.0;0.0;0;1452;839;613;4;308;2.0
7658;2014 maandag 1 december;459;247;212;400;204;196;205;202;0.0;3.0;117.0;114.0;1.0;2.0;106;22755;13469;9286;725;789;15.0
7659;2014 dinsdag 2 december;478;214;264;430;208;222;128;124;1.0;3.0;56.0;54.0;2.0;0.0;131;5664;3380;2284;746;290;31.0
7660;2014 woensdag 3 december;531;270;261;412;190;222;75;73;2.0;0.0;28.0;26.0;0.0;2.0;132;5512;3149;2363;705;358;909.0
7661;2014 donderdag 4 december;452;226;226;438;214;224;57;55;2.0;0.0;19.0;15.0;3.0;1.0;141;5089;3002;2087;639;293;16.0
7662;2014 vrijdag 5 december;442;228;214;393;204;189;47;46;0.0;1.0;11.0;10.0;0.0;1.0;157;4590;2785;1805;456;349;20.0
7663;2014 zaterdag 6 december;396;216;180;433;209;224;32;32;0.0;0.0;0.0;0.0;0.0;0.0;0;1345;921;424;9;67;1.0
7664;2014 zondag 7 december;369;205;164;358;166;192;4;4;0.0;0.0;0.0;0.0;0.0;0.0;0;706;430;276;0;63;0.0
7665;2014 maandag 8 december;490;248;242;442;215;227;175;172;0.0;3.0;105.0;103.0;0.0;2.0;149;5847;3578;2269;682;371;906.0
7666;2014 dinsdag 9 december;472;250;222;431;219;212;114;109;4.0;1.0;73.0;71.0;1.0;1.0;126;4279;2637;1642;667;245;31.0
7667;2014 woensdag 10 december;487;241;246;429;197;232;146;146;0.0;0.0;37.0;37.0;0.0;0.0;126;4810;2916;1894;637;279;24.0
7668;2014 donderdag 11 december;482;246;236;411;197;214;73;70;1.0;2.0;23.0;21.0;2.0;0.0;127;4352;2631;1721;627;281;36.0
7669;2014 vrijdag 12 december;537;265;272;471;220;251;322;317;1.0;4.0;22.0;19.0;0.0;3.0;132;4626;2847;1779;447;368;22.0
7670;2014 zaterdag 13 december;398;195;203;470;220;250;45;43;1.0;1.0;0.0;0.0;0.0;0.0;0;1706;1135;571;2;90;0.0
7671;2014 zondag 14 december;382;190;192;437;219;218;4;4;0.0;0.0;0.0;0.0;0.0;0.0;0;780;449;331;3;73;1.0
7672;2014 maandag 15 december;456;240;216;444;225;219;213;210;3.0;0.0;104.0;101.0;2.0;1.0;148;9021;5625;3396;647;562;77.0
7673;2014 dinsdag 16 december;501;267;234;457;215;242;139;134;0.0;5.0;63.0;63.0;0.0;0.0;162;5035;3112;1923;732;373;11.0
7674;2014 woensdag 17 december;508;259;249;437;215;222;79;78;0.0;1.0;42.0;41.0;0.0;1.0;156;4844;2929;1915;668;290;864.0
7675;2014 donderdag 18 december;500;253;247;448;211;237;102;97;2.0;3.0;24.0;24.0;0.0;0.0;135;5007;3046;1961;544;379;28.0
7676;2014 vrijdag 19 december;523;245;278;471;259;212;214;209;3.0;2.0;20.0;20.0;0.0;0.0;143;5643;3445;2198;408;499;14.0
7677;2014 zaterdag 20 december;354;189;165;457;229;228;75;74;0.0;1.0;2.0;2.0;0.0;0.0;0;2617;1746;871;10;227;0.0
7678;2014 zondag 21 december;364;194;170;411;207;204;8;8;0.0;0.0;0.0;0.0;0.0;0.0;0;790;435;355;1;150;0.0
7679;2014 maandag 22 december;516;262;254;447;205;242;220;217;2.0;1.0;112.0;112.0;0.0;0.0;137;7137;4229;2908;683;486;13.0
7680;2014 dinsdag 23 december;531;260;271;424;192;232;158;154;3.0;1.0;56.0;54.0;0.0;2.0;213;5621;3275;2346;615;455;18.0
7681;2014 woensdag 24 december;484;246;238;450;213;237;103;101;0.0;2.0;47.0;46.0;1.0;0.0;156;4420;2718;1702;349;347;6.0
7682;2014 donderdag 25 december;352;168;184;436;217;219;10;10;0.0;0.0;0.0;0.0;0.0;0.0;0;469;302;167;2;59;2.0
7683;2014 vrijdag 26 december;330;169;161;397;189;208;6;6;0.0;0.0;0.0;0.0;0.0;0.0;1;422;255;167;0;77;0.0
7684;2014 zaterdag 27 december;400;217;183;402;191;211;31;31;0.0;0.0;0.0;0.0;0.0;0.0;0;1376;846;530;2;99;1.0
7685;2014 zondag 28 december;373;187;186;402;192;210;1;1;0.0;0.0;0.0;0.0;0.0;0.0;0;894;551;343;2;115;0.0
7686;2014 maandag 29 december;493;228;265;425;191;234;159;155;1.0;3.0;97.0;94.0;2.0;1.0;118;7059;4190;2869;512;501;10.0
7687;2014 dinsdag 30 december;545;269;276;471;229;242;124;123;1.0;0.0;62.0;60.0;2.0;0.0;161;6560;3923;2637;597;510;10.0
7688;2014 woensdag 31 december;454;231;223;447;196;251;93;92;1.0;0.0;36.0;33.0;2.0;1.0;133;5563;3316;2247;305;1074;10.0
7689;Totaal 2014;175181;89510;85671;139223;67121;72102;65333;64074;532.0;727.0;10363.0;9962.0;201.0;200.0;35409;1563338;908871;654467;182949;122248;32675.0
7690;Totaal op zondag in 2014;19972;10263;9709;18557;8859;9698;443;431;6.0;6.0;2.0;2.0;0.0;0.0;11;50382;28265;22117;184;6235;15.0
7691;Totaal op maandag in 2014;25288;12918;12370;19447;9314;10133;11205;10973;104.0;128.0;4411.0;4283.0;67.0;61.0;6481;331726;190206;141520;38359;23930;11791.0
7692;Totaal op dinsdag in 2014;26802;13682;13120;20207;9810;10397;7506;7329;67.0;110.0;2558.0;2465.0;43.0;50.0;7679;276868;160422;116446;42239;20858;2228.0
7693;Totaal op woensdag in 2014;27310;13983;13327;20360;9776;10584;6678;6542;61.0;75.0;1605.0;1526.0;37.0;42.0;7363;272013;156619;115394;37021;21649;7891.0
7694;Totaal op donderdag in 2014;26539;13481;13058;20343;9906;10437;6427;6286;59.0;82.0;911.0;870.0;22.0;19.0;6960;250946;146573;104373;35809;19520;7629.0
7695;Totaal op vrijdag in 2014;27252;13871;13381;20540;10001;10539;24149;23727;156.0;266.0;819.0;765.0;29.0;25.0;6360;264027;155845;108182;27639;21505;847.0
7696;Totaal op zaterdag in 2014;21789;11197;10592;19673;9399;10274;6690;6563;73.0;54.0;44.0;40.0;1.0;3.0;46;116190;70207;45983;1459;8267;1586.0
7697;Overig 2014;229;115;114;96;56;40;2235;2223;6.0;6.0;13.0;11.0;2.0;0.0;509;1186;734;452;239;284;688.0
7698;Totaal januari 2014;14345;7272;7073;12192;5914;6278;2351;2299;24.0;28.0;718.0;685.0;17.0;16.0;3078;137508;81287;56221;14968;10901;3240.0
7699;Totaal februari 2014;13257;6730;6527;11139;5301;5838;2968;2911;31.0;26.0;731.0;697.0;17.0;17.0;2749;124702;73506;51196;14463;8481;1269.0
7700;Totaal maart 2014;14395;7277;7118;12003;5759;6244;2950;2889;27.0;34.0;788.0;751.0;11.0;26.0;3032;123054;74188;48866;12238;8139;3279.0
7701;Totaal april 2014;14021;7145;6876;11252;5405;5847;5075;4963;41.0;71.0;763.0;735.0;15.0;13.0;2875;119484;72481;47003;12251;8105;3425.0
7702;Totaal mei 2014;14567;7436;7131;11364;5477;5887;8128;7964;64.0;100.0;675.0;651.0;12.0;12.0;2626;114918;70104;44814;10756;7894;2009.0
7703;Totaal juni 2014;14607;7441;7166;10592;5053;5539;8539;8368;67.0;104.0;788.0;744.0;23.0;21.0;2935;116737;69919;46818;12267;10322;3033.0
7704;Totaal juli 2014;15657;8127;7530;11718;5746;5972;6700;6565;67.0;68.0;869.0;845.0;11.0;13.0;3160;139625;78868;60757;14834;14425;2151.0
7705;Totaal augustus 2014;15440;7999;7441;11192;5408;5784;7631;7495;57.0;79.0;854.0;829.0;12.0;13.0;2833;143206;74038;69168;21919;13180;317.0
7706;Totaal september 2014;15530;7895;7635;10961;5307;5654;8139;7990;52.0;97.0;989.0;948.0;20.0;21.0;2956;143272;77299;65973;26716;12152;4199.0
7707;Totaal oktober 2014;15195;7837;7358;11627;5591;6036;4626;4528;44.0;54.0;1043.0;1000.0;25.0;18.0;2978;134719;78261;56458;16952;10196;2520.0
7708;Totaal november 2014;13879;7111;6768;11706;5646;6060;2829;2782;24.0;23.0;976.0;946.0;18.0;12.0;2688;120388;70914;49474;12924;8050;3469.0
7709;Totaal december 2014;14059;7125;6934;13381;6458;6923;3162;3097;28.0;37.0;1156.0;1120.0;18.0;18.0;2990;144539;87272;57267;12422;10119;3076.0
7710;2015 donderdag 1 januari;345;182;163;442;220;222;9;9;0.0;0.0;0.0;0.0;0.0;0.0;0;19250;10279;8971;140;988;0.0
7711;2015 vrijdag 2 januari;471;228;243;490;228;262;43;42;1.0;0.0;10.0;10.0;0.0;0.0;21;4399;2563;1836;250;346;14.0
7712;2015 zaterdag 3 januari;393;222;171;491;231;260;26;26;0.0;0.0;0.0;0.0;0.0;0.0;1;1651;969;682;14;147;0.0
7713;2015 zondag 4 januari;381;214;167;486;226;260;5;5;0.0;0.0;0.0;0.0;0.0;0.0;0;1309;720;589;6;99;0.0
7714;2015 maandag 5 januari;498;255;243;456;211;245;147;143;1.0;3.0;55.0;53.0;1.0;1.0;104;7980;4524;3456;822;489;14.0
7715;2015 dinsdag 6 januari;499;251;248;482;220;262;111;106;4.0;1.0;56.0;52.0;3.0;1.0;158;5152;3016;2136;815;468;19.0
7716;2015 woensdag 7 januari;508;273;235;476;221;255;76;75;0.0;1.0;39.0;38.0;0.0;1.0;164;5237;3107;2130;887;387;17.0
7717;2015 donderdag 8 januari;488;258;230;518;261;257;71;69;1.0;1.0;18.0;18.0;0.0;0.0;175;4994;2911;2083;760;316;50.0
7718;2015 vrijdag 9 januari;500;239;261;541;240;301;98;98;0.0;0.0;15.0;15.0;0.0;0.0;144;4412;2794;1618;563;359;28.0
7719;2015 zaterdag 10 januari;392;203;189;500;250;250;36;34;2.0;0.0;1.0;1.0;0.0;0.0;2;2229;1378;851;14;144;2.0
7720;2015 zondag 11 januari;385;209;176;455;222;233;6;6;0.0;0.0;0.0;0.0;0.0;0.0;0;899;493;406;1;78;0.0
7721;2015 maandag 12 januari;479;236;243;459;203;256;157;153;1.0;3.0;105.0;100.0;5.0;0.0;131;5757;3459;2298;851;426;766.0
7722;2015 dinsdag 13 januari;492;257;235;529;258;271;74;73;1.0;0.0;57.0;56.0;1.0;0.0;150;4194;2483;1711;815;333;29.0
7723;2015 woensdag 14 januari;522;272;250;494;270;224;66;65;0.0;1.0;32.0;30.0;1.0;1.0;134;4266;2533;1733;782;313;773.0
7724;2015 donderdag 15 januari;520;268;252;511;247;264;137;134;1.0;2.0;12.0;11.0;1.0;0.0;147;6691;4069;2622;819;420;34.0
7725;2015 vrijdag 16 januari;535;271;264;469;217;252;107;105;1.0;1.0;22.0;21.0;0.0;1.0;142;4738;2919;1819;574;384;29.0
7726;2015 zaterdag 17 januari;391;211;180;468;210;258;28;27;1.0;0.0;0.0;0.0;0.0;0.0;2;1862;1170;692;4;89;0.0
7727;2015 zondag 18 januari;358;176;182;446;195;251;6;6;0.0;0.0;1.0;1.0;0.0;0.0;0;929;537;392;4;103;0.0
7728;2015 maandag 19 januari;458;240;218;457;230;227;128;126;1.0;1.0;85.0;80.0;3.0;2.0;125;5523;3256;2267;755;341;18.0
7729;2015 dinsdag 20 januari;494;245;249;499;250;249;111;107;1.0;3.0;49.0;47.0;1.0;1.0;111;4236;2583;1653;879;318;19.0
7730;2015 woensdag 21 januari;499;244;255;458;224;234;70;69;1.0;0.0;37.0;35.0;2.0;0.0;157;3904;2301;1603;762;383;455.0
7731;2015 donderdag 22 januari;506;250;256;482;247;235;75;73;1.0;1.0;12.0;12.0;0.0;0.0;126;4133;2453;1680;668;368;46.0
7732;2015 vrijdag 23 januari;493;230;263;463;208;255;103;102;0.0;1.0;18.0;18.0;0.0;0.0;158;4454;2679;1775;552;438;24.0
7733;2015 zaterdag 24 januari;376;181;195;512;227;285;44;43;0.0;1.0;1.0;0.0;1.0;0.0;0;2268;1429;839;9;121;1.0
7734;2015 zondag 25 januari;368;180;188;481;214;267;9;9;0.0;0.0;0.0;0.0;0.0;0.0;0;1099;649;450;7;145;0.0
7735;2015 maandag 26 januari;413;223;190;486;217;269;145;143;1.0;1.0;111.0;108.0;1.0;2.0;138;5331;3092;2239;707;557;32.0
7736;2015 dinsdag 27 januari;497;251;246;461;211;250;100;99;0.0;1.0;61.0;61.0;0.0;0.0;120;3901;2232;1669;786;431;28.0
7737;2015 woensdag 28 januari;527;286;241;479;211;268;76;75;1.0;0.0;34.0;31.0;0.0;3.0;131;4037;2395;1642;1216;469;314.0
7738;2015 donderdag 29 januari;496;272;224;494;230;264;49;48;0.0;1.0;19.0;18.0;1.0;0.0;143;4523;2497;2026;779;456;34.0
7739;2015 vrijdag 30 januari;481;257;224;514;230;284;133;131;1.0;1.0;17.0;16.0;0.0;1.0;118;6383;3955;2428;767;628;20.0
7740;2015 zaterdag 31 januari;404;209;195;452;225;227;38;38;0.0;0.0;0.0;0.0;0.0;0.0;5;3178;1808;1370;6;620;0.0
7741;2015 zondag 1 februari;337;174;163;436;191;245;4;4;0.0;0.0;0.0;0.0;0.0;0.0;0;18612;9600;9012;172;558;0.0
7742;2015 maandag 2 februari;463;245;218;498;228;270;191;183;5.0;3.0;88.0;86.0;0.0;2.0;168;8968;5381;3587;875;496;17.0
7743;2015 dinsdag 3 februari;487;257;230;442;210;232;85;78;2.0;5.0;47.0;45.0;1.0;1.0;116;4459;2559;1900;833;308;26.0
7744;2015 woensdag 4 februari;449;222;227;444;211;233;73;72;0.0;1.0;29.0;27.0;0.0;2.0;153;4435;2694;1741;967;304;425.0
7745;2015 donderdag 5 februari;479;248;231;473;224;249;55;54;0.0;1.0;21.0;21.0;0.0;0.0;130;4431;2592;1839;1042;347;28.0
7746;2015 vrijdag 6 februari;478;259;219;519;230;289;115;115;0.0;0.0;15.0;15.0;0.0;0.0;127;4432;2693;1739;638;294;14.0
7747;2015 zaterdag 7 februari;395;198;197;453;233;220;47;45;0.0;2.0;2.0;1.0;1.0;0.0;1;1917;1132;785;98;116;1.0
7748;2015 zondag 8 februari;346;190;156;442;226;216;2;2;0.0;0.0;0.0;0.0;0.0;0.0;1;1127;617;510;0;114;1.0
7749;2015 maandag 9 februari;453;221;232;473;223;250;173;168;3.0;2.0;95.0;90.0;2.0;3.0;128;5586;3215;2371;655;337;30.0
7750;2015 dinsdag 10 februari;461;229;232;488;234;254;100;99;1.0;0.0;52.0;49.0;3.0;0.0;165;4381;2648;1733;791;361;436.0
7751;2015 woensdag 11 februari;500;273;227;475;218;257;80;79;1.0;0.0;28.0;28.0;0.0;0.0;191;4011;2337;1674;753;258;30.0
7752;2015 donderdag 12 februari;476;240;236;479;246;233;96;95;1.0;0.0;14.0;14.0;0.0;0.0;147;4328;2649;1679;941;341;43.0
7753;2015 vrijdag 13 februari;502;277;225;504;228;276;106;103;2.0;1.0;18.0;17.0;0.0;1.0;122;4361;2619;1742;605;310;24.0
7754;2015 zaterdag 14 februari;404;206;198;438;207;231;94;92;1.0;1.0;3.0;2.0;1.0;0.0;2;2255;1318;937;5;123;2.0
7755;2015 zondag 15 februari;360;180;180;452;208;244;13;13;0.0;0.0;1.0;1.0;0.0;0.0;0;1727;1033;694;10;151;1.0
7756;2015 maandag 16 februari;410;213;197;482;221;261;149;146;3.0;0.0;86.0;84.0;1.0;1.0;106;6038;3577;2461;773;408;22.0
7757;2015 dinsdag 17 februari;475;242;233;476;221;255;93;90;2.0;1.0;47.0;46.0;0.0;1.0;133;3491;2022;1469;633;310;27.0
7758;2015 woensdag 18 februari;493;220;273;504;231;273;88;87;0.0;1.0;42.0;40.0;1.0;1.0;154;4128;2438;1690;884;277;28.0
7759;2015 donderdag 19 februari;471;237;234;498;242;256;73;72;0.0;1.0;17.0;16.0;1.0;0.0;140;4007;2422;1585;682;349;637.0
7760;2015 vrijdag 20 februari;500;250;250;505;243;262;198;196;1.0;1.0;15.0;15.0;0.0;0.0;129;5143;3242;1901;508;353;35.0
7761;2015 zaterdag 21 februari;394;208;186;478;244;234;27;26;0.0;1.0;1.0;1.0;0.0;0.0;0;2552;1605;947;8;89;1.0
7762;2015 zondag 22 februari;364;191;173;436;185;251;7;6;0.0;1.0;0.0;0.0;0.0;0.0;0;961;549;412;2;67;0.0
7763;2015 maandag 23 februari;462;237;225;465;241;224;189;189;0.0;0.0;112.0;109.0;1.0;2.0;141;5879;3501;2378;622;342;19.0
7764;2015 dinsdag 24 februari;490;241;249;410;177;233;118;118;0.0;0.0;60.0;59.0;0.0;1.0;144;4198;2436;1762;1038;339;33.0
7765;2015 woensdag 25 februari;519;275;244;490;210;280;88;81;4.0;3.0;41.0;41.0;0.0;0.0;147;4413;2520;1893;584;350;32.0
7766;2015 donderdag 26 februari;470;243;227;447;206;241;89;89;0.0;0.0;20.0;19.0;0.0;1.0;128;4662;2793;1869;624;400;18.0
7767;2015 vrijdag 27 februari;487;258;229;488;234;254;121;118;1.0;2.0;14.0;12.0;2.0;0.0;104;6485;4040;2445;542;445;16.0
7768;2015 zaterdag 28 februari;393;202;191;483;236;247;38;38;0.0;0.0;1.0;1.0;0.0;0.0;1;3588;2200;1388;9;417;0.0
7769;2015 zondag 1 maart;401;199;202;424;200;224;7;7;0.0;0.0;0.0;0.0;0.0;0.0;0;16657;9409;7248;60;614;1.0
7770;2015 maandag 2 maart;474;243;231;465;239;226;174;168;2.0;4.0;107.0;106.0;1.0;0.0;136;9972;6034;3938;736;411;14.0
7771;2015 dinsdag 3 maart;524;275;249;457;207;250;143;140;2.0;1.0;54.0;53.0;0.0;1.0;125;5126;3046;2080;686;316;16.0
7772;2015 woensdag 4 maart;470;225;245;430;194;236;80;77;2.0;1.0;41.0;38.0;1.0;2.0;144;4383;2651;1732;700;459;575.0
7773;2015 donderdag 5 maart;495;248;247;486;210;276;93;89;0.0;4.0;15.0;12.0;0.0;3.0;134;4662;2851;1811;645;342;27.0
7774;2015 vrijdag 6 maart;482;239;243;502;237;265;166;162;2.0;2.0;11.0;11.0;0.0;0.0;141;4511;2775;1736;524;243;8.0
7775;2015 zaterdag 7 maart;374;181;193;457;219;238;36;35;1.0;0.0;1.0;1.0;0.0;0.0;1;1847;1133;714;5;71;0.0
7776;2015 zondag 8 maart;331;170;161;425;198;227;7;7;0.0;0.0;0.0;0.0;0.0;0.0;2;928;520;408;4;93;0.0
7777;2015 maandag 9 maart;475;237;238;454;218;236;179;175;3.0;1.0;104.0;101.0;1.0;2.0;158;5520;3231;2289;607;362;18.0
7778;2015 dinsdag 10 maart;462;222;240;497;232;265;105;102;1.0;2.0;63.0;60.0;2.0;1.0;152;4299;2595;1704;682;322;903.0
7779;2015 woensdag 11 maart;471;233;238;420;199;221;75;72;2.0;1.0;35.0;35.0;0.0;0.0;146;4142;2499;1643;740;266;26.0
7780;2015 donderdag 12 maart;449;240;209;443;199;244;81;81;0.0;0.0;24.0;22.0;1.0;1.0;135;4450;2649;1801;623;261;29.0
7781;2015 vrijdag 13 maart;451;239;212;446;210;236;123;115;4.0;4.0;12.0;11.0;0.0;1.0;128;4470;2763;1707;510;283;21.0
7782;2015 zaterdag 14 maart;373;186;187;420;203;217;48;47;0.0;1.0;1.0;1.0;0.0;0.0;1;1974;1188;786;9;71;0.0
7783;2015 zondag 15 maart;357;180;177;406;198;208;7;7;0.0;0.0;0.0;0.0;0.0;0.0;1;2000;1200;800;14;116;0.0
7784;2015 maandag 16 maart;431;229;202;456;225;231;168;166;1.0;1.0;95.0;94.0;0.0;1.0;135;7120;4170;2950;705;328;27.0
7785;2015 dinsdag 17 maart;486;262;224;439;215;224;97;93;1.0;3.0;59.0;56.0;1.0;2.0;135;4029;2427;1602;734;238;35.0
7786;2015 woensdag 18 maart;503;250;253;487;232;255;92;91;0.0;1.0;19.0;19.0;0.0;0.0;156;3950;2407;1543;506;274;35.0
7787;2015 donderdag 19 maart;461;258;203;459;224;235;68;67;0.0;1.0;12.0;12.0;0.0;0.0;140;3835;2337;1498;559;323;24.0
7788;2015 vrijdag 20 maart;482;239;243;442;229;213;254;249;0.0;5.0;19.0;17.0;2.0;0.0;147;4625;2842;1783;476;305;26.0
7789;2015 zaterdag 21 maart;386;209;177;409;189;220;71;70;0.0;1.0;1.0;1.0;0.0;0.0;3;2015;1244;771;5;84;0.0
7790;2015 zondag 22 maart;350;172;178;359;168;191;7;7;0.0;0.0;0.0;0.0;0.0;0.0;0;753;441;312;2;81;0.0
7791;2015 maandag 23 maart;424;215;209;429;201;228;174;170;0.0;4.0;91.0;89.0;0.0;2.0;138;5134;2966;2168;663;342;22.0
7792;2015 dinsdag 24 maart;437;212;225;457;202;255;109;106;0.0;3.0;55.0;54.0;1.0;0.0;136;3732;2126;1606;663;293;22.0
7793;2015 woensdag 25 maart;477;240;237;432;208;224;104;102;2.0;0.0;41.0;39.0;1.0;1.0;158;3885;2288;1597;604;359;24.0
7794;2015 donderdag 26 maart;487;245;242;491;234;257;82;80;0.0;2.0;27.0;26.0;0.0;1.0;132;4076;2428;1648;560;395;48.0
7795;2015 vrijdag 27 maart;426;203;223;414;203;211;223;219;1.0;3.0;14.0;13.0;1.0;0.0;139;4628;2732;1896;392;350;18.0
7796;2015 zaterdag 28 maart;379;207;172;463;234;229;73;72;1.0;0.0;1.0;1.0;0.0;0.0;1;2453;1570;883;4;146;0.0
7797;2015 zondag 29 maart;330;165;165;398;179;219;7;7;0.0;0.0;0.0;0.0;0.0;0.0;0;887;519;368;6;117;0.0
7798;2015 maandag 30 maart;482;263;219;377;191;186;218;213;1.0;4.0;109.0;107.0;0.0;2.0;154;5468;3225;2243;833;515;29.0
7799;2015 dinsdag 31 maart;464;236;228;428;212;216;109;108;1.0;0.0;54.0;52.0;1.0;1.0;142;5453;3452;2001;713;683;16.0
7800;2015 woensdag 1 april;444;220;224;387;185;202;145;142;2.0;1.0;44.0;43.0;1.0;0.0;118;24665;14826;9839;806;929;18.0
7801;2015 donderdag 2 april;479;227;252;405;204;201;102;101;1.0;0.0;24.0;23.0;0.0;1.0;171;4745;2853;1892;797;361;19.0
7802;2015 vrijdag 3 april;463;216;247;426;210;216;97;95;2.0;0.0;8.0;8.0;0.0;0.0;40;2714;1715;999;109;198;3.0
7803;2015 zaterdag 4 april;416;212;204;416;211;205;46;44;2.0;0.0;0.0;0.0;0.0;0.0;0;1643;1017;626;4;86;1.0
7804;2015 zondag 5 april;333;159;174;400;186;214;4;4;0.0;0.0;0.0;0.0;0.0;0.0;0;694;425;269;4;89;0.0
7805;2015 maandag 6 april;378;193;185;380;188;192;15;15;0.0;0.0;0.0;0.0;0.0;0.0;1;1346;762;584;5;85;0.0
7806;2015 dinsdag 7 april;450;240;210;392;190;202;164;160;2.0;2.0;65.0;62.0;0.0;3.0;155;5067;2919;2148;732;329;466.0
7807;2015 woensdag 8 april;531;276;255;463;211;252;103;99;3.0;1.0;42.0;41.0;0.0;1.0;160;4222;2449;1773;760;336;27.0
7808;2015 donderdag 9 april;460;237;223;396;187;209;84;84;0.0;0.0;22.0;21.0;0.0;1.0;164;4437;2555;1882;699;336;35.0
7809;2015 vrijdag 10 april;493;262;231;440;219;221;338;333;1.0;4.0;24.0;24.0;0.0;0.0;147;4472;2697;1775;464;297;34.0
7810;2015 zaterdag 11 april;408;205;203;419;187;232;99;99;0.0;0.0;0.0;0.0;0.0;0.0;1;1650;1063;587;6;71;0.0
7811;2015 zondag 12 april;348;188;160;398;200;198;5;5;0.0;0.0;0.0;0.0;0.0;0.0;0;813;488;325;3;63;0.0
7812;2015 maandag 13 april;424;210;214;405;205;200;190;186;1.0;3.0;127.0;120.0;3.0;4.0;182;5170;3028;2142;696;387;22.0
7813;2015 dinsdag 14 april;473;243;230;427;235;192;126;121;2.0;3.0;54.0;51.0;1.0;2.0;152;3645;2250;1395;818;318;35.0
7814;2015 woensdag 15 april;421;202;219;401;205;196;142;139;1.0;2.0;39.0;37.0;0.0;2.0;146;6093;3794;2299;666;345;19.0
7815;2015 donderdag 16 april;485;237;248;416;200;216;97;96;1.0;0.0;26.0;26.0;0.0;0.0;110;4312;2598;1714;679;294;2043.0
7816;2015 vrijdag 17 april;492;253;239;449;215;234;333;323;3.0;7.0;24.0;24.0;0.0;0.0;163;4342;2662;1680;461;278;25.0
7817;2015 zaterdag 18 april;376;198;178;374;169;205;84;82;1.0;1.0;1.0;1.0;0.0;0.0;5;1834;1150;684;4;74;0.0
7818;2015 zondag 19 april;351;197;154;421;208;213;3;3;0.0;0.0;0.0;0.0;0.0;0.0;0;726;419;307;3;62;0.0
7819;2015 maandag 20 april;499;259;240;401;188;213;290;282;3.0;5.0;121.0;119.0;2.0;0.0;127;5524;3228;2296;679;340;18.0
7820;2015 dinsdag 21 april;465;259;206;412;179;233;154;153;1.0;0.0;60.0;57.0;3.0;0.0;145;3410;2039;1371;644;234;35.0
7821;2015 woensdag 22 april;494;253;241;398;192;206;117;113;2.0;2.0;36.0;34.0;0.0;2.0;121;3640;2222;1418;611;286;456.0
7822;2015 donderdag 23 april;463;257;206;390;198;192;138;136;1.0;1.0;21.0;20.0;0.0;1.0;141;3643;2159;1484;577;276;37.0
7823;2015 vrijdag 24 april;504;263;241;417;188;229;469;458;9.0;2.0;23.0;22.0;1.0;0.0;126;4862;3018;1844;444;313;32.0
7824;2015 zaterdag 25 april;411;213;198;418;193;225;115;112;2.0;1.0;1.0;1.0;0.0;0.0;2;2734;1789;945;4;95;0.0
7825;2015 zondag 26 april;345;176;169;392;183;209;5;5;0.0;0.0;0.0;0.0;0.0;0.0;0;831;471;360;1;82;0.0
7826;2015 maandag 27 april;361;179;182;356;168;188;12;12;0.0;0.0;0.0;0.0;0.0;0.0;7;1330;800;530;5;111;0.0
7827;2015 dinsdag 28 april;495;252;243;369;189;180;171;169;1.0;1.0;60.0;59.0;0.0;1.0;140;4591;2713;1878;655;517;15.0
7828;2015 woensdag 29 april;484;258;226;385;188;197;132;130;0.0;2.0;35.0;34.0;0.0;1.0;137;4292;2543;1749;830;438;19.0
7829;2015 donderdag 30 april;487;242;245;441;222;219;247;236;4.0;7.0;19.0;19.0;0.0;0.0;147;6006;3719;2287;607;767;18.0
7830;2015 vrijdag 1 mei;510;269;241;395;186;209;1133;1105;10.0;18.0;46.0;44.0;1.0;1.0;135;24179;14359;9820;500;828;9.0
7831;2015 zaterdag 2 mei;423;220;203;347;168;179;160;157;0.0;3.0;0.0;0.0;0.0;0.0;0;1753;1027;726;5;126;0.0
7832;2015 zondag 3 mei;396;200;196;381;182;199;13;12;0.0;1.0;0.0;0.0;0.0;0.0;0;868;511;357;6;55;1.0
7833;2015 maandag 4 mei;419;223;196;391;201;190;122;119;1.0;2.0;60.0;60.0;0.0;0.0;90;4372;2601;1771;449;267;469.0
7834;2015 dinsdag 5 mei;469;237;232;416;191;225;58;57;0.0;1.0;0.0;0.0;0.0;0.0;4;1432;869;563;21;89;2.0
7835;2015 woensdag 6 mei;501;254;247;381;182;199;183;175;3.0;5.0;49.0;45.0;2.0;2.0;147;4323;2545;1778;707;251;27.0
7836;2015 donderdag 7 mei;493;276;217;407;179;228;186;182;2.0;2.0;22.0;20.0;2.0;0.0;162;4541;2581;1960;671;265;31.0
7837;2015 vrijdag 8 mei;505;236;269;418;210;208;603;593;6.0;4.0;27.0;24.0;1.0;2.0;131;4526;2719;1807;507;295;32.0
7838;2015 zaterdag 9 mei;410;220;190;344;155;189;131;129;2.0;0.0;1.0;1.0;0.0;0.0;0;1484;921;563;6;63;0.0
7839;2015 zondag 10 mei;362;191;171;384;182;202;13;13;0.0;0.0;0.0;0.0;0.0;0.0;0;963;573;390;8;107;1.0
7840;2015 maandag 11 mei;488;240;248;411;213;198;327;320;2.0;5.0;122.0;117.0;3.0;2.0;130;5080;3029;2051;723;335;26.0
7841;2015 dinsdag 12 mei;504;274;230;376;159;217;234;230;2.0;2.0;73.0;71.0;0.0;2.0;160;3908;2362;1546;693;389;25.0
7842;2015 woensdag 13 mei;512;254;258;377;181;196;418;404;8.0;6.0;40.0;39.0;1.0;0.0;145;4731;2910;1821;605;325;34.0
7843;2015 donderdag 14 mei;444;215;229;365;168;197;32;32;0.0;0.0;1.0;1.0;0.0;0.0;4;1241;773;468;7;57;1.0
7844;2015 vrijdag 15 mei;469;247;222;395;198;197;1699;1661;22.0;16.0;15.0;14.0;0.0;1.0;32;4616;2897;1719;204;247;455.0
7845;2015 zaterdag 16 mei;418;228;190;413;214;199;171;165;3.0;3.0;0.0;0.0;0.0;0.0;2;1528;997;531;9;87;2.0
7846;2015 zondag 17 mei;380;198;182;383;182;201;11;9;0.0;2.0;0.0;0.0;0.0;0.0;0;767;430;337;2;73;1.0
7847;2015 maandag 18 mei;495;242;253;357;146;211;343;335;2.0;6.0;101.0;95.0;3.0;3.0;155;6224;3668;2556;696;340;17.0
7848;2015 dinsdag 19 mei;480;228;252;375;186;189;180;177;2.0;1.0;62.0;61.0;1.0;0.0;155;3734;2253;1481;725;303;11.0
7849;2015 woensdag 20 mei;513;258;255;366;180;186;195;190;0.0;5.0;37.0;35.0;1.0;1.0;149;4391;2731;1660;689;329;24.0
7850;2015 donderdag 21 mei;504;252;252;375;188;187;234;229;3.0;2.0;25.0;25.0;0.0;0.0;133;4210;2577;1633;578;274;26.0
7851;2015 vrijdag 22 mei;550;297;253;377;180;197;851;832;5.0;14.0;21.0;19.0;2.0;0.0;130;4324;2660;1664;437;304;23.0
7852;2015 zaterdag 23 mei;450;230;220;377;180;197;216;216;0.0;0.0;0.0;0.0;0.0;0.0;1;1863;1172;691;8;83;0.0
7853;2015 zondag 24 mei;379;196;183;337;165;172;13;13;0.0;0.0;0.0;0.0;0.0;0.0;0;678;398;280;2;65;0.0
7854;2015 maandag 25 mei;418;215;203;350;169;181;23;23;0.0;0.0;0.0;0.0;0.0;0.0;3;1633;973;660;7;109;3.0
7855;2015 dinsdag 26 mei;494;240;254;369;176;193;202;195;3.0;4.0;58.0;55.0;2.0;1.0;139;4445;2731;1714;709;519;29.0
7856;2015 woensdag 27 mei;540;280;260;391;214;177;166;163;3.0;0.0;38.0;34.0;2.0;2.0;130;4020;2357;1663;682;431;25.0
7857;2015 donderdag 28 mei;515;243;272;385;197;188;200;198;2.0;0.0;24.0;23.0;0.0;1.0;157;4455;2677;1778;547;436;21.0
7858;2015 vrijdag 29 mei;511;274;237;400;202;198;833;820;9.0;4.0;22.0;21.0;0.0;1.0;143;5354;3290;2064;462;460;18.0
7859;2015 zaterdag 30 mei;412;214;198;363;172;191;249;245;3.0;1.0;4.0;3.0;1.0;0.0;0;2080;1339;741;8;211;0.0
7860;2015 zondag 31 mei;377;196;181;401;196;205;14;14;0.0;0.0;0.0;0.0;0.0;0.0;0;1604;1000;604;9;313;0.0
7861;2015 maandag 1 juni;486;281;205;352;184;168;320;316;2.0;2.0;112.0;110.0;0.0;2.0;133;26202;15602;10600;696;970;20.0
7862;2015 dinsdag 2 juni;507;260;247;376;185;191;173;168;4.0;1.0;50.0;49.0;1.0;0.0;116;4179;2451;1728;691;381;28.0
7863;2015 woensdag 3 juni;516;266;250;371;186;185;148;145;2.0;1.0;31.0;29.0;2.0;0.0;156;3755;2235;1520;675;292;20.0
7864;2015 donderdag 4 juni;485;239;246;354;157;197;189;186;0.0;3.0;15.0;15.0;0.0;0.0;135;3810;2394;1416;653;278;1500.0
7865;2015 vrijdag 5 juni;509;265;244;404;196;208;922;904;9.0;9.0;30.0;29.0;1.0;0.0;129;3952;2392;1560;502;307;20.0
7866;2015 zaterdag 6 juni;403;213;190;396;194;202;332;324;3.0;5.0;2.0;1.0;0.0;1.0;0;1636;1019;617;4;116;0.0
7867;2015 zondag 7 juni;362;191;171;342;159;183;16;16;0.0;0.0;0.0;0.0;0.0;0.0;1;768;451;317;9;81;0.0
7868;2015 maandag 8 juni;466;241;225;366;184;182;256;247;1.0;8.0;108.0;106.0;1.0;1.0;131;5179;3075;2104;643;353;24.0
7869;2015 dinsdag 9 juni;523;263;260;353;167;186;173;171;0.0;2.0;57.0;57.0;0.0;0.0;125;3587;2138;1449;646;320;174.0
7870;2015 woensdag 10 juni;529;269;260;375;180;195;178;174;4.0;0.0;36.0;34.0;1.0;1.0;134;3904;2295;1609;701;310;19.0
7871;2015 donderdag 11 juni;477;251;226;398;209;189;150;144;3.0;3.0;31.0;31.0;0.0;0.0;142;3738;2300;1438;606;251;47.0
7872;2015 vrijdag 12 juni;518;268;250;431;194;237;885;870;4.0;11.0;23.0;23.0;0.0;0.0;115;4242;2632;1610;498;320;6.0
7873;2015 zaterdag 13 juni;400;196;204;401;202;199;191;188;1.0;2.0;3.0;3.0;0.0;0.0;0;1513;954;559;5;98;0.0
7874;2015 zondag 14 juni;401;206;195;355;180;175;13;13;0.0;0.0;0.0;0.0;0.0;0.0;0;813;492;321;6;89;1.0
7875;2015 maandag 15 juni;466;241;225;317;153;164;302;296;1.0;5.0;121.0;116.0;1.0;4.0;141;8198;5018;3180;670;467;30.0
7876;2015 dinsdag 16 juni;546;273;273;358;176;182;179;177;1.0;1.0;53.0;51.0;1.0;1.0;154;4039;2435;1604;682;326;21.0
7877;2015 woensdag 17 juni;528;250;278;401;186;215;153;147;1.0;5.0;38.0;35.0;2.0;1.0;143;3829;2284;1545;639;391;17.0
7878;2015 donderdag 18 juni;514;272;242;383;187;196;201;197;0.0;4.0;26.0;26.0;0.0;0.0;145;3875;2320;1555;677;331;457.0
7879;2015 vrijdag 19 juni;515;247;268;361;175;186;816;801;8.0;7.0;16.0;15.0;0.0;1.0;157;4168;2612;1556;446;288;17.0
7880;2015 zaterdag 20 juni;408;200;208;370;175;195;382;369;7.0;6.0;3.0;2.0;1.0;0.0;1;2454;1576;878;11;166;0.0
7881;2015 zondag 21 juni;398;210;188;368;174;194;18;17;0.0;1.0;0.0;0.0;0.0;0.0;1;805;496;309;3;129;0.0
7882;2015 maandag 22 juni;487;243;244;358;160;198;272;264;3.0;5.0;102.0;100.0;0.0;2.0;138;5295;3210;2085;769;404;175.0
7883;2015 dinsdag 23 juni;490;258;232;346;156;190;152;152;0.0;0.0;68.0;63.0;2.0;3.0;135;3591;2134;1457;687;444;24.0
7884;2015 woensdag 24 juni;560;281;279;383;195;188;151;147;1.0;3.0;43.0;42.0;1.0;0.0;116;3912;2335;1577;625;464;22.0
7885;2015 donderdag 25 juni;510;254;256;361;184;177;234;229;3.0;2.0;30.0;30.0;0.0;0.0;124;4472;2620;1852;572;420;761.0
7886;2015 vrijdag 26 juni;527;280;247;385;191;194;962;934;12.0;16.0;35.0;32.0;2.0;1.0;138;4871;2970;1901;423;609;19.0
7887;2015 zaterdag 27 juni;397;209;188;366;169;197;297;296;1.0;0.0;3.0;3.0;0.0;0.0;0;2168;1333;835;8;271;0.0
7888;2015 zondag 28 juni;353;184;169;346;189;157;11;10;0.0;1.0;0.0;0.0;0.0;0.0;0;1124;640;484;21;229;0.0
7889;2015 maandag 29 juni;489;231;258;373;203;170;255;250;2.0;3.0;105.0;103.0;0.0;2.0;128;5637;3411;2226;889;696;22.0
7890;2015 dinsdag 30 juni;496;253;243;384;184;200;158;154;0.0;4.0;66.0;65.0;1.0;0.0;128;6686;4095;2591;785;1280;16.0
7891;2015 woensdag 1 juli;531;278;253;389;186;203;158;154;2.0;2.0;56.0;52.0;2.0;2.0;161;30981;17718;13263;1065;1518;25.0
7892;2015 donderdag 2 juli;545;273;272;417;206;211;171;166;1.0;4.0;28.0;26.0;1.0;1.0;148;4623;2606;2017;747;546;15.0
7893;2015 vrijdag 3 juli;521;260;261;430;196;234;720;705;10.0;5.0;22.0;21.0;1.0;0.0;153;4979;2904;2075;561;548;15.0
7894;2015 zaterdag 4 juli;426;223;203;434;201;233;262;254;4.0;4.0;0.0;0.0;0.0;0.0;0;1902;1140;762;11;233;0.0
7895;2015 zondag 5 juli;390;200;190;418;208;210;14;14;0.0;0.0;0.0;0.0;0.0;0.0;1;1095;587;508;13;198;0.0
7896;2015 maandag 6 juli;507;267;240;414;213;201;255;249;2.0;4.0;115.0;110.0;2.0;3.0;128;5854;3331;2523;846;575;444.0
7897;2015 dinsdag 7 juli;519;266;253;387;200;187;230;225;1.0;4.0;72.0;70.0;2.0;0.0;133;4695;2657;2038;782;535;19.0
7898;2015 woensdag 8 juli;502;240;262;368;182;186;152;148;3.0;1.0;47.0;43.0;1.0;3.0;149;4649;2646;2003;809;452;469.0
7899;2015 donderdag 9 juli;534;286;248;343;169;174;155;148;3.0;4.0;23.0;22.0;0.0;1.0;153;4773;2810;1963;847;460;413.0
7900;2015 vrijdag 10 juli;537;298;239;370;169;201;654;642;10.0;2.0;32.0;29.0;3.0;0.0;143;5583;3208;2375;596;577;41.0
7901;2015 zaterdag 11 juli;437;225;212;362;182;180;231;225;5.0;1.0;2.0;1.0;1.0;0.0;1;2078;1245;833;5;167;0.0
7902;2015 zondag 12 juli;366;178;188;343;157;186;7;7;0.0;0.0;0.0;0.0;0.0;0.0;0;982;551;431;10;151;0.0
7903;2015 maandag 13 juli;505;255;250;350;162;188;215;211;2.0;2.0;125.0;120.0;2.0;3.0;171;5838;3283;2555;746;605;18.0
7904;2015 dinsdag 14 juli;509;261;248;404;196;208;181;178;2.0;1.0;67.0;63.0;0.0;4.0;151;4192;2375;1817;770;461;15.0
7905;2015 woensdag 15 juli;543;278;265;334;155;179;213;209;3.0;1.0;28.0;28.0;0.0;0.0;148;8117;4787;3330;758;725;15.0
7906;2015 donderdag 16 juli;514;260;254;378;186;192;121;117;0.0;4.0;24.0;24.0;0.0;0.0;162;4975;2933;2042;723;495;22.0
7907;2015 vrijdag 17 juli;541;271;270;389;183;206;456;441;9.0;6.0;17.0;17.0;0.0;0.0;145;4803;2844;1959;577;531;11.0
7908;2015 zaterdag 18 juli;437;237;200;369;172;197;161;156;3.0;2.0;1.0;0.0;1.0;0.0;0;2168;1249;919;11;182;0.0
7909;2015 zondag 19 juli;379;200;179;342;166;176;9;9;0.0;0.0;0.0;0.0;0.0;0.0;0;804;446;358;11;122;0.0
7910;2015 maandag 20 juli;491;251;240;392;194;198;265;263;1.0;1.0;115.0;111.0;1.0;3.0;160;6511;3724;2787;766;563;28.0
7911;2015 dinsdag 21 juli;499;236;263;398;177;221;172;166;1.0;5.0;51.0;51.0;0.0;0.0;137;3946;2239;1707;860;494;19.0
7912;2015 woensdag 22 juli;564;279;285;361;189;172;136;135;1.0;0.0;36.0;35.0;0.0;1.0;124;4266;2388;1878;705;524;29.0
7913;2015 donderdag 23 juli;558;293;265;334;157;177;93;93;0.0;0.0;28.0;26.0;0.0;2.0;177;4308;2481;1827;712;486;14.0
7914;2015 vrijdag 24 juli;514;265;249;383;210;173;347;339;5.0;3.0;16.0;16.0;0.0;0.0;117;4856;2793;2063;487;464;18.0
7915;2015 zaterdag 25 juli;434;230;204;358;168;190;139;136;2.0;1.0;0.0;0.0;0.0;0.0;0;2457;1399;1058;7;177;1.0
7916;2015 zondag 26 juli;386;210;176;322;156;166;20;20;0.0;0.0;0.0;0.0;0.0;0.0;0;849;473;376;8;147;0.0
7917;2015 maandag 27 juli;496;247;249;364;156;208;250;242;5.0;3.0;100.0;99.0;0.0;1.0;137;5967;3466;2501;765;562;8.0
7918;2015 dinsdag 28 juli;557;309;248;376;190;186;159;154;4.0;1.0;48.0;46.0;2.0;0.0;131;4126;2398;1728;956;480;24.0
7919;2015 woensdag 29 juli;499;237;262;325;155;170;124;121;3.0;0.0;31.0;31.0;0.0;0.0;116;4378;2572;1806;710;574;22.0
7920;2015 donderdag 30 juli;514;261;253;366;162;204;106;101;3.0;2.0;22.0;21.0;0.0;1.0;149;4955;2984;1971;740;730;12.0
7921;2015 vrijdag 31 juli;542;262;280;364;184;180;259;252;3.0;4.0;16.0;16.0;0.0;0.0;108;8832;5300;3532;613;1371;16.0
7922;2015 zaterdag 1 augustus;441;220;221;366;155;211;160;157;2.0;1.0;0.0;0.0;0.0;0.0;0;24655;12449;12206;151;1002;0.0
7923;2015 zondag 2 augustus;413;215;198;326;166;160;15;15;0.0;0.0;0.0;0.0;0.0;0.0;0;943;464;479;8;179;0.0
7924;2015 maandag 3 augustus;513;253;260;341;174;167;234;227;4.0;3.0;92.0;92.0;0.0;0.0;134;7815;4466;3349;946;481;13.0
7925;2015 dinsdag 4 augustus;527;277;250;385;190;195;168;164;1.0;3.0;67.0;64.0;1.0;2.0;147;4223;2357;1866;827;404;22.0
7926;2015 woensdag 5 augustus;543;276;267;363;195;168;147;141;1.0;5.0;42.0;40.0;1.0;1.0;125;4389;2357;2032;954;687;13.0
7927;2015 donderdag 6 augustus;543;276;267;397;211;186;122;119;2.0;1.0;31.0;30.0;0.0;1.0;156;4111;2242;1869;850;369;19.0
7928;2015 vrijdag 7 augustus;544;273;271;365;188;177;434;421;4.0;9.0;11.0;9.0;1.0;1.0;112;4968;2823;2145;678;414;25.0
7929;2015 zaterdag 8 augustus;437;227;210;343;164;179;210;204;5.0;1.0;1.0;1.0;0.0;0.0;0;2330;1345;985;19;135;0.0
7930;2015 zondag 9 augustus;383;197;186;348;158;190;9;9;0.0;0.0;0.0;0.0;0.0;0.0;0;931;427;504;6;121;0.0
7931;2015 maandag 10 augustus;477;254;223;349;190;159;268;262;3.0;3.0;121.0;116.0;3.0;2.0;119;6927;3760;3167;852;489;7.0
7932;2015 dinsdag 11 augustus;554;311;243;351;164;187;168;167;0.0;1.0;69.0;64.0;0.0;5.0;154;3885;2118;1767;883;377;20.0
7933;2015 woensdag 12 augustus;526;281;245;383;206;177;150;148;1.0;1.0;37.0;35.0;1.0;1.0;159;4329;2321;2008;799;372;21.0
7934;2015 donderdag 13 augustus;479;251;228;385;189;196;107;106;0.0;1.0;26.0;26.0;0.0;0.0;130;4230;2273;1957;891;385;24.0
7935;2015 vrijdag 14 augustus;552;290;262;401;193;208;464;450;7.0;7.0;26.0;24.0;1.0;1.0;133;6340;3544;2796;1202;435;16.0
7936;2015 zaterdag 15 augustus;427;231;196;345;182;163;242;237;4.0;1.0;1.0;1.0;0.0;0.0;0;4240;2231;2009;23;305;0.0
7937;2015 zondag 16 augustus;398;202;196;314;156;158;12;12;0.0;0.0;0.0;0.0;0.0;0.0;0;1389;597;792;13;166;0.0
7938;2015 maandag 17 augustus;519;263;256;371;168;203;216;208;3.0;5.0;98.0;95.0;2.0;1.0;126;7390;3898;3492;1956;584;15.0
7939;2015 dinsdag 18 augustus;522;273;249;360;173;187;189;184;3.0;2.0;60.0;59.0;1.0;0.0;109;4182;2220;1962;1153;531;18.0
7940;2015 woensdag 19 augustus;527;251;276;334;168;166;152;148;0.0;4.0;31.0;30.0;0.0;1.0;125;3990;2119;1871;2318;403;19.0
7941;2015 donderdag 20 augustus;572;305;267;342;172;170;191;187;4.0;0.0;20.0;20.0;0.0;0.0;143;4921;2741;2180;1054;431;20.0
7942;2015 vrijdag 21 augustus;535;268;267;391;196;195;668;662;2.0;4.0;24.0;23.0;0.0;1.0;136;5267;3034;2233;789;434;10.0
7943;2015 zaterdag 22 augustus;445;235;210;355;192;163;231;226;3.0;2.0;0.0;0.0;0.0;0.0;0;2476;1333;1143;12;149;0.0
7944;2015 zondag 23 augustus;412;216;196;366;174;192;15;14;1.0;0.0;0.0;0.0;0.0;0.0;3;1239;546;693;7;146;0.0
7945;2015 maandag 24 augustus;555;304;251;346;177;169;255;247;5.0;3.0;105.0;101.0;1.0;3.0;117;7153;3620;3533;1519;597;19.0
7946;2015 dinsdag 25 augustus;565;271;294;341;175;166;196;190;4.0;2.0;58.0;58.0;0.0;0.0;144;4618;2410;2208;1683;562;9.0
7947;2015 woensdag 26 augustus;545;292;253;420;203;217;179;173;4.0;2.0;30.0;30.0;0.0;0.0;149;4533;2384;2149;1699;511;22.0
7948;2015 donderdag 27 augustus;527;277;250;360;169;191;221;215;3.0;3.0;15.0;14.0;1.0;0.0;158;4726;2576;2150;1314;546;16.0
7949;2015 vrijdag 28 augustus;522;280;242;402;205;197;1052;1027;12.0;13.0;34.0;33.0;1.0;0.0;162;6056;3378;2678;1397;735;13.0
7950;2015 zaterdag 29 augustus;424;223;201;339;177;162;360;358;1.0;1.0;4.0;4.0;0.0;0.0;2;2296;1181;1115;195;290;0.0
7951;2015 zondag 30 augustus;407;217;190;318;140;178;19;19;0.0;0.0;0.0;0.0;0.0;0.0;0;1665;693;972;6;300;1.0
7952;2015 maandag 31 augustus;510;249;261;362;176;186;259;251;2.0;6.0;94.0;92.0;0.0;2.0;133;9289;4765;4524;1568;1139;15.0
7953;2015 dinsdag 1 september;514;252;262;385;178;207;224;217;3.0;4.0;59.0;56.0;0.0;3.0;115;35166;18666;16500;1631;1575;21.0
7954;2015 woensdag 2 september;508;255;253;352;160;192;152;148;1.0;3.0;28.0;26.0;2.0;0.0;120;4795;2653;2142;1892;416;16.0
7955;2015 donderdag 3 september;528;280;248;358;172;186;253;248;3.0;2.0;25.0;23.0;1.0;1.0;134;4512;2513;1999;1583;413;13.0
7956;2015 vrijdag 4 september;541;278;263;375;198;177;1234;1222;6.0;6.0;21.0;17.0;1.0;3.0;126;4722;2629;2093;968;375;18.0
7957;2015 zaterdag 5 september;414;211;203;346;173;173;424;413;5.0;6.0;1.0;1.0;0.0;0.0;0;2081;1164;917;116;162;0.0
7958;2015 zondag 6 september;373;185;188;331;182;149;23;23;0.0;0.0;1.0;0.0;1.0;0.0;0;1123;551;572;5;104;1.0
7959;2015 maandag 7 september;501;262;239;361;180;181;274;269;0.0;5.0;85.0;84.0;0.0;1.0;104;6199;3331;2868;1544;466;39.0
7960;2015 dinsdag 8 september;504;264;240;388;185;203;161;157;2.0;2.0;63.0;61.0;0.0;2.0;153;4330;2422;1908;1952;414;31.0
7961;2015 woensdag 9 september;562;273;289;380;186;194;212;209;2.0;1.0;41.0;41.0;0.0;0.0;114;4494;2501;1993;1191;407;9.0
7962;2015 donderdag 10 september;554;284;270;362;180;182;223;218;3.0;2.0;30.0;29.0;1.0;0.0;125;4928;2728;2200;1236;377;2903.0
7963;2015 vrijdag 11 september;568;287;281;411;184;227;690;679;4.0;7.0;26.0;21.0;3.0;2.0;103;4444;2568;1876;912;374;12.0
7964;2015 zaterdag 12 september;488;234;254;348;161;187;357;351;3.0;3.0;8.0;8.0;0.0;0.0;1;2136;1334;802;10;152;1.0
7965;2015 zondag 13 september;424;213;211;349;180;169;14;13;0.0;1.0;0.0;0.0;0.0;0.0;0;927;484;443;4;103;0.0
7966;2015 maandag 14 september;503;256;247;392;215;177;243;238;0.0;5.0;106.0;103.0;2.0;1.0;113;6311;3493;2818;958;463;10.0
7967;2015 dinsdag 15 september;581;323;258;363;185;178;234;232;1.0;1.0;63.0;58.0;1.0;4.0;162;6865;3955;2910;1105;472;309.0
7968;2015 woensdag 16 september;571;279;292;381;196;185;159;155;2.0;2.0;37.0;35.0;2.0;0.0;95;4702;2611;2091;1497;366;12.0
7969;2015 donderdag 17 september;553;280;273;412;197;215;178;177;1.0;0.0;24.0;23.0;0.0;1.0;116;4189;2297;1892;2032;315;35.0
7970;2015 vrijdag 18 september;572;299;273;376;180;196;973;957;2.0;14.0;28.0;25.0;1.0;2.0;162;4790;2794;1996;865;335;17.0
7971;2015 zaterdag 19 september;465;229;236;368;159;209;276;271;3.0;2.0;0.0;0.0;0.0;0.0;0;2015;1205;810;11;110;0.0
7972;2015 zondag 20 september;424;222;202;337;167;170;16;15;0.0;1.0;0.0;0.0;0.0;0.0;0;1228;659;569;11;162;2.0
7973;2015 maandag 21 september;475;230;245;368;174;194;264;259;2.0;3.0;94.0;92.0;1.0;1.0;123;5713;3289;2424;1323;387;16.0
7974;2015 dinsdag 22 september;572;305;267;373;182;191;158;150;3.0;5.0;58.0;56.0;0.0;2.0;138;3920;2252;1668;993;589;19.0
7975;2015 woensdag 23 september;537;274;263;372;178;194;130;126;1.0;3.0;51.0;49.0;1.0;1.0;151;3994;2351;1643;1406;404;20.0
7976;2015 donderdag 24 september;567;269;298;426;202;224;182;175;3.0;4.0;23.0;23.0;0.0;0.0;100;4212;2442;1770;1129;368;33.0
7977;2015 vrijdag 25 september;579;283;296;438;205;233;803;792;3.0;8.0;27.0;25.0;0.0;2.0;90;5307;3215;2092;843;471;5.0
7978;2015 zaterdag 26 september;452;223;229;367;155;212;210;204;3.0;3.0;0.0;0.0;0.0;0.0;0;2657;1679;978;7;168;429.0
7979;2015 zondag 27 september;398;200;198;338;161;177;8;8;0.0;0.0;0.0;0.0;0.0;0.0;0;874;472;402;6;140;2.0
7980;2015 maandag 28 september;501;245;256;380;189;191;220;217;2.0;1.0;110.0;110.0;0.0;0.0;137;5889;3374;2515;1167;475;19.0
7981;2015 dinsdag 29 september;540;284;256;440;201;239;150;147;1.0;2.0;57.0;53.0;1.0;3.0;116;4273;2429;1844;1645;432;14.0
7982;2015 woensdag 30 september;547;268;279;366;175;191;126;122;1.0;3.0;40.0;36.0;2.0;2.0;116;6241;3833;2408;943;821;289.0
7983;2015 donderdag 1 oktober;507;260;247;376;187;189;130;127;1.0;2.0;27.0;26.0;0.0;1.0;108;28157;16394;11763;1095;1119;23.0
7984;2015 vrijdag 2 oktober;533;285;248;417;189;228;452;439;8.0;5.0;15.0;13.0;0.0;2.0;123;4630;2681;1949;753;426;16.0
7985;2015 zaterdag 3 oktober;464;233;231;386;204;182;124;123;0.0;1.0;5.0;5.0;0.0;0.0;0;1889;1087;802;10;144;0.0
7986;2015 zondag 4 oktober;390;206;184;375;179;196;9;8;1.0;0.0;0.0;0.0;0.0;0.0;0;1036;571;465;11;120;0.0
7987;2015 maandag 5 oktober;509;248;261;351;160;191;332;323;3.0;6.0;109.0;106.0;2.0;1.0;126;5810;3188;2622;889;466;11.0
7988;2015 dinsdag 6 oktober;560;277;283;419;200;219;125;122;2.0;1.0;76.0;74.0;0.0;2.0;129;3713;2134;1579;994;365;17.0
7989;2015 woensdag 7 oktober;487;241;246;439;225;214;106;103;0.0;3.0;40.0;39.0;1.0;0.0;102;4266;2457;1809;947;325;14.0
7990;2015 donderdag 8 oktober;529;260;269;404;191;213;116;114;2.0;0.0;19.0;16.0;2.0;1.0;104;4464;2571;1893;1009;322;22.0
7991;2015 vrijdag 9 oktober;528;284;244;368;181;187;379;368;6.0;5.0;22.0;22.0;0.0;0.0;133;4473;2570;1903;681;285;11.0
7992;2015 zaterdag 10 oktober;427;216;211;359;173;186;196;191;3.0;2.0;0.0;0.0;0.0;0.0;1;2751;1721;1030;17;146;0.0
7993;2015 zondag 11 oktober;388;211;177;350;163;187;4;4;0.0;0.0;0.0;0.0;0.0;0.0;0;845;477;368;6;84;0.0
7994;2015 maandag 12 oktober;474;255;219;369;173;196;198;193;4.0;1.0;123.0;122.0;0.0;1.0;127;5388;3054;2334;1078;333;444.0
7995;2015 dinsdag 13 oktober;496;248;248;365;181;184;112;108;2.0;2.0;54.0;54.0;0.0;0.0;87;3396;1966;1430;1048;322;14.0
7996;2015 woensdag 14 oktober;489;243;246;393;196;197;124;121;1.0;2.0;37.0;37.0;0.0;0.0;125;3981;2464;1517;850;325;465.0
7997;2015 donderdag 15 oktober;525;283;242;389;189;200;283;273;6.0;4.0;22.0;21.0;1.0;0.0;131;6997;4167;2830;855;377;36.0
7998;2015 vrijdag 16 oktober;522;273;249;388;197;191;339;333;1.0;5.0;33.0;30.0;1.0;2.0;139;5256;3094;2162;672;313;13.0
7999;2015 zaterdag 17 oktober;414;206;208;426;191;235;83;81;0.0;2.0;1.0;1.0;0.0;0.0;0;2138;1330;808;10;66;0.0
8000;2015 zondag 18 oktober;383;193;190;377;175;202;8;8;0.0;0.0;0.0;0.0;0.0;0.0;0;921;540;381;3;79;0.0
8001;2015 maandag 19 oktober;452;215;237;421;217;204;214;208;2.0;4.0;109.0;106.0;1.0;2.0;89;5314;3074;2240;770;365;16.0
8002;2015 dinsdag 20 oktober;460;253;207;420;215;205;136;131;2.0;3.0;69.0;68.0;0.0;1.0;134;4209;2428;1781;852;384;11.0
8003;2015 woensdag 21 oktober;533;284;249;401;205;196;91;86;4.0;1.0;45.0;42.0;2.0;1.0;135;4057;2310;1747;760;309;24.0
8004;2015 donderdag 22 oktober;504;267;237;406;214;192;109;107;1.0;1.0;24.0;23.0;1.0;0.0;144;4157;2387;1770;826;300;29.0
8005;2015 vrijdag 23 oktober;498;253;245;396;196;200;271;263;5.0;3.0;20.0;19.0;1.0;0.0;115;4732;2834;1898;637;318;13.0
8006;2015 zaterdag 24 oktober;358;204;154;394;205;189;82;80;1.0;1.0;6.0;3.0;3.0;0.0;0;2618;1649;969;16;84;0.0
8007;2015 zondag 25 oktober;372;193;179;392;184;208;8;7;1.0;0.0;0.0;0.0;0.0;0.0;0;1167;670;497;21;83;0.0
8008;2015 maandag 26 oktober;463;233;230;380;182;198;199;193;2.0;4.0;118.0;115.0;1.0;2.0;134;5682;3300;2382;776;430;22.0
8009;2015 dinsdag 27 oktober;460;235;225;460;219;241;105;100;2.0;3.0;65.0;63.0;0.0;2.0;121;3563;2102;1461;885;326;6.0
8010;2015 woensdag 28 oktober;468;257;211;409;184;225;96;95;0.0;1.0;35.0;35.0;0.0;0.0;129;4284;2464;1820;915;344;21.0
8011;2015 donderdag 29 oktober;507;266;241;430;215;215;74;74;0.0;0.0;25.0;24.0;0.0;1.0;123;4528;2717;1811;956;408;432.0
8012;2015 vrijdag 30 oktober;510;270;240;392;192;200;235;227;3.0;5.0;26.0;26.0;0.0;0.0;109;6990;4251;2739;572;579;888.0
8013;2015 zaterdag 31 oktober;378;191;187;374;157;217;59;58;1.0;0.0;3.0;3.0;0.0;0.0;0;2889;1840;1049;34;411;0.0
8014;2015 zondag 1 november;374;184;190;378;180;198;1;1;0.0;0.0;0.0;0.0;0.0;0.0;0;17223;9707;7516;97;637;0.0
8015;2015 maandag 2 november;469;252;217;371;183;188;187;183;3.0;1.0;114.0;112.0;2.0;0.0;102;9100;5303;3797;910;432;22.0
8016;2015 dinsdag 3 november;462;237;225;368;169;199;95;92;0.0;3.0;89.0;88.0;0.0;1.0;134;4316;2482;1834;886;299;19.0
8017;2015 woensdag 4 november;519;268;251;411;180;231;61;57;3.0;1.0;29.0;28.0;0.0;1.0;129;3968;2251;1717;813;307;41.0
8018;2015 donderdag 5 november;516;283;233;413;204;209;71;71;0.0;0.0;27.0;27.0;0.0;0.0;141;4097;2352;1745;843;350;25.0
8019;2015 vrijdag 6 november;510;271;239;393;208;185;186;185;0.0;1.0;26.0;26.0;0.0;0.0;94;4288;2488;1800;595;327;12.0
8020;2015 zaterdag 7 november;415;219;196;377;177;200;50;49;0.0;1.0;2.0;2.0;0.0;0.0;2;1993;1229;764;26;87;0.0
8021;2015 zondag 8 november;362;175;187;358;160;198;7;7;0.0;0.0;0.0;0.0;0.0;0.0;0;1066;606;460;18;87;0.0
8022;2015 maandag 9 november;530;276;254;342;175;167;160;156;1.0;3.0;105.0;103.0;2.0;0.0;126;5365;3096;2269;759;295;22.0
8023;2015 dinsdag 10 november;456;223;233;380;198;182;122;120;1.0;1.0;67.0;66.0;0.0;1.0;146;3998;2333;1665;879;357;7.0
8024;2015 woensdag 11 november;507;247;260;411;190;221;133;128;3.0;2.0;55.0;53.0;1.0;1.0;108;3883;2218;1665;804;247;42.0
8025;2015 donderdag 12 november;523;270;253;378;182;196;80;80;0.0;0.0;21.0;19.0;0.0;2.0;129;4374;2473;1901;727;241;20.0
8026;2015 vrijdag 13 november;500;244;256;392;192;200;118;114;1.0;3.0;15.0;14.0;1.0;0.0;138;4419;2596;1823;617;361;20.0
8027;2015 zaterdag 14 november;387;176;211;344;183;161;46;46;0.0;0.0;2.0;2.0;0.0;0.0;0;2214;1454;760;36;104;0.0
8028;2015 zondag 15 november;385;205;180;351;177;174;4;4;0.0;0.0;0.0;0.0;0.0;0.0;0;2165;1232;933;24;133;0.0
8029;2015 maandag 16 november;496;274;222;408;200;208;163;159;1.0;3.0;114.0;110.0;4.0;0.0;115;7271;4245;3026;822;326;19.0
8030;2015 dinsdag 17 november;483;260;223;363;183;180;121;115;2.0;4.0;79.0;79.0;0.0;0.0;128;3678;2078;1600;839;255;453.0
8031;2015 woensdag 18 november;505;249;256;411;204;207;86;83;2.0;1.0;40.0;40.0;0.0;0.0;111;3681;2271;1410;715;238;34.0
8032;2015 donderdag 19 november;436;208;228;445;219;226;69;67;2.0;0.0;25.0;25.0;0.0;0.0;136;3682;2172;1510;749;245;32.0
8033;2015 vrijdag 20 november;512;278;234;388;196;192;229;228;0.0;1.0;24.0;23.0;1.0;0.0;125;4740;2910;1830;585;311;21.0
8034;2015 zaterdag 21 november;403;209;194;398;178;220;40;38;1.0;1.0;0.0;0.0;0.0;0.0;0;2268;1418;850;13;99;0.0
8035;2015 zondag 22 november;384;202;182;389;177;212;3;3;0.0;0.0;0.0;0.0;0.0;0.0;0;886;518;368;25;77;0.0
8036;2015 maandag 23 november;436;229;207;333;167;166;174;169;1.0;4.0;105.0;103.0;1.0;1.0;154;5399;3165;2234;759;366;21.0
8037;2015 dinsdag 24 november;504;268;236;369;181;188;104;102;1.0;1.0;74.0;74.0;0.0;0.0;142;3400;2042;1358;690;285;41.0
8038;2015 woensdag 25 november;486;231;255;377;184;193;80;78;1.0;1.0;45.0;43.0;1.0;1.0;108;4213;2507;1706;734;298;28.0
8039;2015 donderdag 26 november;512;254;258;412;216;196;71;71;0.0;0.0;22.0;22.0;0.0;0.0;88;3857;2263;1594;708;342;55.0
8040;2015 vrijdag 27 november;507;283;224;430;216;214;175;171;3.0;1.0;31.0;29.0;1.0;1.0;147;5092;3087;2005;559;351;30.0
8041;2015 zaterdag 28 november;406;198;208;381;178;203;34;32;2.0;0.0;1.0;1.0;0.0;0.0;0;2763;1720;1043;18;152;1.0
8042;2015 zondag 29 november;368;178;190;417;202;215;1;1;0.0;0.0;0.0;0.0;0.0;0.0;0;990;585;405;13;116;1.0
8043;2015 maandag 30 november;490;243;247;416;210;206;171;166;3.0;2.0;119.0;118.0;1.0;0.0;130;7522;4501;3021;716;686;20.0
8044;2015 dinsdag 1 december;493;253;240;407;201;206;133;131;1.0;1.0;71.0;70.0;0.0;1.0;134;26364;15652;10712;892;774;32.0
8045;2015 woensdag 2 december;471;255;216;393;182;211;67;64;2.0;1.0;49.0;47.0;1.0;1.0;113;4430;2600;1830;814;330;49.0
8046;2015 donderdag 3 december;455;212;243;395;182;213;58;58;0.0;0.0;25.0;23.0;0.0;2.0;121;4395;2476;1919;696;269;1033.0
8047;2015 vrijdag 4 december;510;243;267;432;216;216;83;79;1.0;3.0;16.0;16.0;0.0;0.0;124;4267;2562;1705;550;323;20.0
8048;2015 zaterdag 5 december;383;198;185;338;159;179;21;21;0.0;0.0;1.0;0.0;1.0;0.0;1;2064;1297;767;15;97;0.0
8049;2015 zondag 6 december;313;165;148;374;191;183;3;3;0.0;0.0;0.0;0.0;0.0;0.0;0;899;512;387;14;86;1.0
8050;2015 maandag 7 december;422;220;202;399;187;212;163;159;3.0;1.0;112.0;109.0;2.0;1.0;115;5701;3287;2414;686;430;22.0
8051;2015 dinsdag 8 december;474;222;252;396;195;201;110;107;1.0;2.0;76.0;73.0;3.0;0.0;139;3873;2259;1614;864;274;50.0
8052;2015 woensdag 9 december;481;219;262;413;217;196;72;71;0.0;1.0;41.0;41.0;0.0;0.0;112;3904;2301;1603;756;280;744.0
8053;2015 donderdag 10 december;463;252;211;387;190;197;84;82;1.0;1.0;23.0;20.0;0.0;3.0;129;4774;2853;1921;642;359;54.0
8054;2015 vrijdag 11 december;488;237;251;451;199;252;210;204;2.0;4.0;22.0;20.0;1.0;1.0;82;4773;2952;1821;564;318;6.0
8055;2015 zaterdag 12 december;363;191;172;395;191;204;77;75;2.0;0.0;2.0;2.0;0.0;0.0;0;2636;1763;873;21;130;1.0
8056;2015 zondag 13 december;355;188;167;401;205;196;1;1;0.0;0.0;0.0;0.0;0.0;0.0;0;886;521;365;24;91;0.0
8057;2015 maandag 14 december;484;254;230;376;184;192;164;164;0.0;0.0;149.0;145.0;2.0;2.0;123;6323;3701;2622;720;378;3.0
8058;2015 dinsdag 15 december;485;233;252;411;200;211;167;163;0.0;4.0;86.0;84.0;1.0;1.0;120;7352;4482;2870;728;494;53.0
8059;2015 woensdag 16 december;502;267;235;434;223;211;81;81;0.0;0.0;50.0;49.0;0.0;1.0;161;4821;2889;1932;762;397;400.0
8060;2015 donderdag 17 december;484;259;225;429;207;222;72;68;2.0;2.0;33.0;33.0;0.0;0.0;113;4389;2585;1804;678;401;28.0
8061;2015 vrijdag 18 december;496;253;243;449;232;217;223;219;1.0;3.0;41.0;41.0;0.0;0.0;102;5963;3551;2412;479;568;8.0
8062;2015 zaterdag 19 december;406;204;202;392;195;197;60;57;3.0;0.0;3.0;1.0;1.0;1.0;0;2837;1746;1091;21;204;0.0
8063;2015 zondag 20 december;375;187;188;383;182;201;7;7;0.0;0.0;0.0;0.0;0.0;0.0;1;1462;877;585;33;176;0.0
8064;2015 maandag 21 december;544;276;268;384;183;201;217;213;1.0;3.0;125.0;118.0;3.0;4.0;148;6973;3967;3006;731;484;28.0
8065;2015 dinsdag 22 december;493;279;214;355;179;176;150;147;2.0;1.0;82.0;81.0;0.0;1.0;134;4822;2878;1944;752;453;15.0
8066;2015 woensdag 23 december;511;261;250;387;187;200;127;119;6.0;2.0;42.0;39.0;1.0;2.0;138;4918;2842;2076;656;420;19.0
8067;2015 donderdag 24 december;506;268;238;429;217;212;81;79;0.0;2.0;19.0;19.0;0.0;0.0;114;3616;2147;1469;366;356;378.0
8068;2015 vrijdag 25 december;326;160;166;352;168;184;3;3;0.0;0.0;0.0;0.0;0.0;0.0;2;685;412;273;2;66;0.0
8069;2015 zaterdag 26 december;292;154;138;361;176;185;8;8;0.0;0.0;0.0;0.0;0.0;0.0;0;507;324;183;3;75;0.0
8070;2015 zondag 27 december;350;169;181;322;151;171;9;9;0.0;0.0;0.0;0.0;0.0;0.0;0;880;535;345;2;107;0.0
8071;2015 maandag 28 december;487;258;229;421;199;222;162;160;0.0;2.0;121.0;120.0;0.0;1.0;82;6273;3668;2605;543;465;5.0
8072;2015 dinsdag 29 december;524;274;250;415;198;217;144;142;2.0;0.0;79.0;78.0;0.0;1.0;115;4969;2856;2113;634;451;17.0
8073;2015 woensdag 30 december;522;283;239;409;188;221;104;100;3.0;1.0;53.0;53.0;0.0;0.0;206;6222;3601;2621;514;510;16.0
8074;2015 donderdag 31 december;422;212;210;408;210;198;66;66;0.0;0.0;21.0;19.0;1.0;1.0;88;5207;3189;2018;319;951;6.0
8075;Totaal 2015;170510;87427;83083;147134;71029;76105;64308;62912;647.0;749.0;12772.0;12331.0;202.0;239.0;34232;1679632;982027;697605;204615;126884;27877.0
8076;Totaal op zondag in 2015;19405;10003;9402;19873;9493;10380;472;461;3.0;8.0;3.0;2.0;1.0;0.0;11;103817;57382;46435;764;7688;15.0
8077;Totaal op maandag in 2015;24607;12624;11983;20535;9998;10537;10641;10397;95.0;149.0;5205.0;5065.0;64.0;76.0;6401;334443;193385;141058;41646;23060;3160.0
8078;Totaal op dinsdag in 2015;25973;13354;12619;21097;10137;10960;7493;7314;78.0;101.0;3199.0;3102.0;38.0;59.0;6948;275039;159204;115835;44739;22534;3765.0
8079;Totaal op woensdag in 2015;26497;13400;13097;21084;10213;10871;6617;6436;93.0;88.0;2022.0;1940.0;38.0;44.0;7166;277054;162112;114942;45167;21736;6339.0
8080;Totaal op donderdag in 2015;26336;13540;12796;21880;10665;11215;6559;6417;65.0;77.0;1149.0;1105.0;15.0;29.0;6932;273684;159428;114256;40839;21613;11726.0
8081;Totaal op vrijdag in 2015;26362;13514;12848;21938;10574;11364;23388;22906;222.0;260.0;1105.0;1045.0;31.0;29.0;6329;270918;162261;108657;30112;21092;2245.0
8082;Totaal op zaterdag in 2015;21209;10928;10281;20653;9905;10748;7222;7070;87.0;65.0;75.0;61.0;12.0;2.0;40;137187;81033;56154;1090;8816;443.0
8083;Overig 2015;121;64;57;74;44;30;1916;1911;4.0;1.0;14.0;11.0;3.0;0.0;405;7490;7222;268;258;345;184.0
8084;Totaal januari 2015;14169;7293;6876;14951;7054;7897;2284;2239;21.0;24.0;867.0;832.0;21.0;14.0;2807;138919;81253;57666;16014;11164;2766.0
8085;Totaal februari 2015;12518;6436;6082;13178;6208;6970;2512;2458;27.0;27.0;869.0;839.0;14.0;16.0;2778;130575;76432;54143;15294;8564;1946.0
8086;Totaal maart 2015;13594;6922;6672;13672;6509;7163;3180;3104;27.0;49.0;1065.0;1031.0;13.0;21.0;3120;136984;81718;55266;13970;9063;1964.0
8087;Totaal april 2015;13233;6786;6447;12194;5903;6291;4027;3937;45.0;45.0;876.0;846.0;11.0;19.0;2808;123453;74371;49082;12773;8397;3377.0
8088;Totaal mei 2015;14341;7347;6994;11807;5702;6105;9213;9013;93.0;107.0;848.0;807.0;22.0;19.0;2437;119327;71930;47397;10682;8036;1313.0
8089;Totaal juni 2015;14266;7295;6971;11134;5434;5700;8489;8306;73.0;110.0;1207.0;1170.0;17.0;20.0;2966;132402;79919;52483;14242;11081;3440.0
8090;Totaal juli 2015;15297;7836;7461;11584;5587;5997;6435;6280;88.0;67.0;1122.0;1078.0;19.0;25.0;3303;158542;91537;67005;17217;15653;1713.0
8091;Totaal augustus 2015;15344;7958;7386;11169;5546;5623;7113;6948;81.0;84.0;1097.0;1061.0;14.0;22.0;2876;155506;82672;72834;25772;13679;357.0
8092;Totaal september 2015;15316;7747;7569;11243;5440;5803;8571;8412;60.0;99.0;1106.0;1055.0;20.0;31.0;2714;153037;85894;67143;28985;11816;4295.0
8093;Totaal oktober 2015;14588;7543;7045;12226;5939;6287;4799;4668;64.0;67.0;1128.0;1093.0;16.0;19.0;2668;144301;84492;59809;18948;9958;2548.0
8094;Totaal november 2015;13843;7094;6749;11604;5669;5935;2842;2776;31.0;35.0;1231.0;1207.0;15.0;9.0;2633;131911;77302;54609;15979;8411;986.0
8095;Totaal december 2015;13880;7106;6774;12298;5994;6304;2927;2860;33.0;34.0;1342.0;1301.0;17.0;24.0;2717;147185;87285;59900;14481;10717;2988.0
8096;2016 vrijdag 1 januari ;336;169;167;421;213;208;11;11;0.0;0.0;0.0;0.0;0.0;0.0;2;21790;11681;10109;144;1137;0.0
8097;2016 zaterdag 2 januari;373;186;187;404;217;187;19;19;0.0;0.0;0.0;0.0;0.0;0.0;2;2245;1297;948;19;173;0.0
8098;2016 zondag 3 januari ;381;192;189;433;217;216;5;5;0.0;0.0;0.0;0.0;0.0;0.0;0;1210;621;589;16;126;0.0
8099;2016 maandag 4 januari;499;243;256;489;222;267;114;113;1.0;0.0;54.0;53.0;0.0;1.0;54;7987;4536;3451;828;517;10.0
8100;2016 dinsdag 5 januari;539;288;251;420;209;211;105;104;0.0;1.0;67.0;66.0;0.0;1.0;156;4351;2457;1894;782;344;25.0
8101;2016 woensdag 6 januari;536;268;268;455;207;248;88;87;0.0;1.0;40.0;40.0;0.0;0.0;148;4165;2345;1820;815;354;15.0
8102;2016 donderdag 7 januari;471;262;209;453;239;214;69;65;1.0;3.0;24.0;22.0;0.0;2.0;180;4304;2422;1882;889;350;41.0
8103;2016 vrijdag 8 januari;539;281;258;485;250;235;115;112;3.0;0.0;25.0;24.0;0.0;1.0;127;4792;2762;2030;664;313;13.0
8104;2016 zaterdag 9 januari;374;198;176;465;242;223;35;35;0.0;0.0;0.0;0.0;0.0;0.0;1;2177;1376;801;22;118;1.0
8105;2016 zondag 10 januari;363;179;184;406;196;210;6;5;0.0;1.0;0.0;0.0;0.0;0.0;1;1424;818;606;9;127;0.0
8106;2016 maandag 11 januari;513;245;268;438;216;222;180;174;3.0;3.0;139.0;136.0;0.0;3.0;180;5738;3255;2483;790;398;22.0
8107;2016 dinsdag 12 januari;488;246;242;480;237;243;114;110;2.0;2.0;66.0;64.0;1.0;1.0;181;3839;2223;1616;871;359;35.0
8108;2016 woensdag 13 januari;449;233;216;460;235;225;66;66;0.0;0.0;41.0;40.0;0.0;1.0;161;3618;2056;1562;816;287;461.0
8109;2016 donderdag 14 januari;495;276;219;432;209;223;74;72;1.0;1.0;23.0;22.0;0.0;1.0;174;4248;2499;1749;786;360;24.0
8110;2016 vrijdag 15 januari;514;262;252;460;227;233;127;123;4.0;0.0;30.0;29.0;0.0;1.0;143;7846;4813;3033;592;454;19.0
8111;2016 zaterdag 16 januari;371;179;192;395;197;198;63;60;3.0;0.0;2.0;2.0;0.0;0.0;2;2477;1457;1020;24;135;1.0
8112;2016 zondag 17 januari;319;163;156;409;173;236;7;7;0.0;0.0;0.0;0.0;0.0;0.0;0;917;530;387;21;97;0.0
8113;2016 maandag 18 januari;437;225;212;440;213;227;145;141;1.0;3.0;102.0;100.0;0.0;2.0;134;5679;3306;2373;793;352;19.0
8114;2016 dinsdag 19 januari;452;233;219;459;223;236;98;96;1.0;1.0;68.0;67.0;1.0;0.0;128;3582;2047;1535;864;313;17.0
8115;2016 woensdag 20 januari;534;283;251;453;219;234;86;86;0.0;0.0;53.0;51.0;1.0;1.0;183;4207;2472;1735;810;355;13.0
8116;2016 donderdag 21 januari;503;250;253;468;238;230;64;64;0.0;0.0;20.0;18.0;0.0;2.0;147;3960;2289;1671;840;379;35.0
8117;2016 vrijdag 22 januari;482;246;236;439;217;222;121;118;2.0;1.0;28.0;27.0;0.0;1.0;145;4742;2869;1873;620;359;23.0
8118;2016 zaterdag 23 januari;409;211;198;412;201;211;23;21;1.0;1.0;1.0;1.0;0.0;0.0;2;2583;1639;944;18;135;0.0
8119;2016 zondag 24 januari ;378;208;170;391;198;193;6;6;0.0;0.0;0.0;0.0;0.0;0.0;0;990;520;470;20;132;1.0
8120;2016 maandag 25 januari;451;207;244;444;211;233;157;153;3.0;1.0;123.0;119.0;2.0;2.0;142;5876;3315;2561;779;553;25.0
8121;2016 dinsdag 26 januari;518;258;260;489;223;266;91;88;1.0;2.0;74.0;71.0;1.0;2.0;119;3742;2162;1580;904;461;36.0
8122;2016 woensdag 27 januari;500;258;242;467;221;246;79;75;2.0;2.0;38.0;37.0;0.0;1.0;149;3969;2293;1676;1583;425;1462.0
8123;2016 donderdag 28 januari;486;254;232;463;221;242;57;54;1.0;2.0;20.0;19.0;1.0;0.0;131;4571;2610;1961;952;486;38.0
8124;2016 vrijdag 29 januari;511;255;256;464;220;244;139;134;3.0;2.0;19.0;17.0;2.0;0.0;122;6018;3517;2501;1023;586;37.0
8125;2016 zaterdag 30 januari;398;190;208;440;228;212;30;30;0.0;0.0;1.0;1.0;0.0;0.0;0;2590;1534;1056;89;332;0.0
8126;2016 zondag 31 januari;360;183;177;433;195;238;2;2;0.0;0.0;0.0;0.0;0.0;0.0;1;2247;1169;1078;29;512;0.0
8127;2016 maandag 1 februari;508;254;254;468;223;245;152;148;2.0;2.0;109.0;104.0;3.0;2.0;141;31664;17453;14211;1134;1043;25.0
8128;2016 dinsdag 2 februari;504;252;252;438;228;210;126;123;0.0;3.0;65.0;65.0;0.0;0.0;95;4726;2654;2072;1145;433;35.0
8129;2016 woensdag 3 februari;481;239;242;412;208;204;67;65;2.0;0.0;43.0;41.0;1.0;1.0;145;4056;2316;1740;1075;374;29.0
8130;2016 donderdag 4 februari;524;273;251;473;226;247;66;65;0.0;1.0;27.0;27.0;0.0;0.0;152;3894;2224;1670;1197;370;23.0
8131;2016 vrijdag 5 februari;464;237;227;470;227;243;112;107;4.0;1.0;18.0;17.0;1.0;0.0;140;4814;2754;2060;756;336;38.0
8132;2016 zaterdag 6 februari;390;184;206;426;207;219;30;30;0.0;0.0;2.0;2.0;0.0;0.0;1;1906;1103;803;30;112;0.0
8133;2016 zondag 7 februari;397;204;193;416;213;203;3;3;0.0;0.0;0.0;0.0;0.0;0.0;0;1002;518;484;21;127;0.0
8134;2016 maandag 8 februari;489;231;258;431;199;232;153;152;1.0;0.0;100.0;96.0;3.0;1.0;110;5254;3013;2241;845;295;905.0
8135;2016 dinsdag 9 februari;539;266;273;458;219;239;85;83;0.0;2.0;53.0;51.0;1.0;1.0;122;3329;1864;1465;936;313;444.0
8136;2016 woensdag 10 februari;510;265;245;461;239;222;75;75;0.0;0.0;47.0;44.0;1.0;2.0;118;4357;2460;1897;1083;271;36.0
8137;2016 donderdag 11 februari;461;250;211;427;195;232;50;49;1.0;0.0;19.0;18.0;1.0;0.0;141;3936;2244;1692;931;310;36.0
8138;2016 vrijdag 12 februari;512;258;254;456;209;247;171;168;3.0;0.0;24.0;23.0;0.0;1.0;119;4799;2809;1990;722;522;7.0
8139;2016 zaterdag 13 februari;381;203;178;429;202;227;25;24;1.0;0.0;2.0;2.0;0.0;0.0;2;1957;1222;735;30;83;0.0
8140;2016 zondag 14 februari;368;175;193;374;182;192;13;11;1.0;1.0;0.0;0.0;0.0;0.0;0;1278;698;580;45;108;1.0
8141;2016 maandag 15 februari;439;208;231;403;202;201;184;180;0.0;4.0;103.0;98.0;3.0;2.0;126;9145;5272;3873;809;431;30.0
8142;2016 dinsdag 16 februari;518;286;232;443;207;236;197;195;1.0;1.0;83.0;81.0;0.0;2.0;145;4420;2396;2024;981;300;28.0
8143;2016 woensdag 17 februari;506;255;251;435;200;235;85;84;1.0;0.0;53.0;51.0;0.0;2.0;130;3751;2129;1622;895;266;43.0
8144;2016 donderdag 18 februari;515;231;284;438;217;221;76;74;0.0;2.0;31.0;29.0;1.0;1.0;169;3930;2272;1658;831;301;38.0
8145;2016 vrijdag 19 februari;509;265;244;450;212;238;121;119;2.0;0.0;27.0;27.0;0.0;0.0;126;4323;2475;1848;666;290;577.0
8146;2016 zaterdag 20 februari;387;211;176;432;187;245;55;54;0.0;1.0;1.0;1.0;0.0;0.0;3;3131;1980;1151;35;124;0.0
8147;2016 zondag 21 februari;373;189;184;426;196;230;4;4;0.0;0.0;0.0;0.0;0.0;0.0;1;1005;563;442;39;71;1.0
8148;2016 maandag 22 februari;435;227;208;458;220;238;168;166;1.0;1.0;137.0;127.0;4.0;6.0;139;5597;3182;2415;913;320;9.0
8149;2016 dinsdag 23 februari;501;261;240;469;238;231;114;110;3.0;1.0;72.0;68.0;1.0;3.0;127;3676;2087;1589;1268;310;27.0
8150;2016 woensdag 24 februari;464;243;221;507;227;280;89;88;1.0;0.0;45.0;42.0;3.0;0.0;120;3903;2200;1703;802;347;18.0
8151;2016 donderdag 25 februari;486;272;214;493;228;265;76;76;0.0;0.0;21.0;20.0;0.0;1.0;109;4389;2521;1868;884;420;49.0
8152;2016 vrijdag 26 februari;490;241;249;486;218;268;147;144;1.0;2.0;20.0;19.0;1.0;0.0;173;5498;3368;2130;624;418;40.0
8153;2016 zaterdag 27 februari;370;199;171;467;232;235;36;35;1.0;0.0;1.0;1.0;0.0;0.0;1;2821;1797;1024;47;135;0.0
8154;2016 zondag 28 februari;356;188;168;438;221;217;4;4;0.0;0.0;0.0;0.0;0.0;0.0;0;1284;686;598;41;178;1.0
8155;2016 maandag 29 februari;455;233;222;442;213;229;293;282;4.0;7.0;135.0;128.0;3.0;4.0;117;8032;4820;3212;799;890;16.0
8156;2016 dinsdag 1 maart;463;242;221;464;204;260;129;127;1.0;1.0;80.0;76.0;2.0;2.0;119;28920;16746;12174;921;917;24.0
8157;2016 woensdag 2 maart;525;273;252;471;253;218;92;88;3.0;1.0;45.0;42.0;1.0;2.0;132;4475;2613;1862;882;338;19.0
8158;2016 donderdag 3 maart;468;240;228;498;237;261;93;91;0.0;2.0;34.0;33.0;1.0;0.0;125;4317;2446;1871;797;276;28.0
8159;2016 vrijdag 4 maart;524;286;238;497;234;263;125;123;1.0;1.0;26.0;23.0;1.0;2.0;146;4352;2636;1716;634;299;30.0
8160;2016 zaterdag 5 maart;386;201;185;410;187;223;32;30;1.0;1.0;2.0;1.0;0.0;1.0;2;2167;1330;837;24;110;440.0
8161;2016 zondag 6 maart;352;173;179;403;189;214;5;5;0.0;0.0;0.0;0.0;0.0;0.0;0;1016;569;447;26;54;0.0
8162;2016 maandag 7 maart;488;253;235;421;205;216;181;178;1.0;2.0;128.0;121.0;2.0;5.0;126;5825;3253;2572;831;310;37.0
8163;2016 dinsdag 8 maart;507;247;260;443;205;238;115;113;0.0;2.0;80.0;76.0;2.0;2.0;136;4047;2408;1639;937;281;460.0
8164;2016 woensdag 9 maart;492;267;225;493;234;259;86;83;2.0;1.0;32.0;30.0;1.0;1.0;170;3852;2186;1666;878;238;15.0
8165;2016 donderdag 10 maart;474;245;229;482;239;243;69;66;2.0;1.0;21.0;21.0;0.0;0.0;142;4323;2530;1793;760;269;25.0
8166;2016 vrijdag 11 maart;553;274;279;454;215;239;165;165;0.0;0.0;17.0;17.0;0.0;0.0;124;4383;2633;1750;519;278;32.0
8167;2016 zaterdag 12 maart;383;207;176;425;206;219;43;42;1.0;0.0;2.0;2.0;0.0;0.0;1;2258;1429;829;33;87;1.0
8168;2016 zondag 13 maart;345;179;166;433;211;222;6;5;1.0;0.0;0.0;0.0;0.0;0.0;0;852;480;372;29;85;0.0
8169;2016 maandag 14 maart;447;243;204;441;215;226;192;185;6.0;1.0;113.0;110.0;1.0;2.0;126;5883;3489;2394;812;312;457.0
8170;2016 dinsdag 15 maart;487;245;242;445;228;217;123;116;4.0;3.0;67.0;65.0;1.0;1.0;130;6806;4164;2642;819;387;44.0
8171;2016 woensdag 16 maart;506;273;233;469;205;264;132;131;0.0;1.0;35.0;34.0;0.0;1.0;136;4228;2415;1813;797;275;612.0
8172;2016 donderdag 17 maart;482;241;241;450;209;241;73;73;0.0;0.0;25.0;24.0;0.0;1.0;125;3726;2128;1598;658;290;34.0
8173;2016 vrijdag 18 maart;456;249;207;462;219;243;210;206;1.0;3.0;31.0;29.0;1.0;1.0;139;4647;2732;1915;571;275;20.0
8174;2016 zaterdag 19 maart;368;200;168;408;228;180;45;44;0.0;1.0;0.0;0.0;0.0;0.0;2;2155;1381;774;24;74;3.0
8175;2016 zondag 20 maart;361;174;187;387;183;204;7;7;0.0;0.0;0.0;0.0;0.0;0.0;1;1105;655;450;28;100;1.0
8176;2016 maandag 21 maart;458;239;219;415;208;207;228;222;3.0;3.0;122.0;119.0;2.0;1.0;124;5616;3326;2290;750;365;11.0
8177;2016 dinsdag 22 maart;492;247;245;450;226;224;117;111;3.0;3.0;62.0;62.0;0.0;0.0;124;3726;2196;1530;717;279;22.0
8178;2016 woensdag 23 maart;493;239;254;453;230;223;112;110;1.0;1.0;47.0;45.0;2.0;0.0;151;3943;2295;1648;688;289;39.0
8179;2016 donderdag 24 maart;516;276;240;429;204;225;110;104;2.0;4.0;38.0;37.0;1.0;0.0;144;4689;2757;1932;736;410;465.0
8180;2016 vrijdag 25 maart;479;256;223;470;236;234;79;78;0.0;1.0;10.0;10.0;0.0;0.0;55;3806;2310;1496;187;257;6.0
8181;2016 zaterdag 26 maart;370;204;166;443;211;232;62;62;0.0;0.0;1.0;1.0;0.0;0.0;0;2882;1787;1095;41;175;1.0
8182;2016 zondag 27 maart;334;159;175;368;187;181;8;8;0.0;0.0;0.0;0.0;0.0;0.0;0;691;391;300;7;85;0.0
8183;2016 maandag 28 maart;400;205;195;390;180;210;8;7;0.0;1.0;0.0;0.0;0.0;0.0;1;1680;997;683;5;118;1.0
8184;2016 dinsdag 29 maart;457;217;240;440;223;217;159;159;0.0;0.0;72.0;72.0;0.0;0.0;155;5305;3079;2226;834;473;20.0
8185;2016 woensdag 30 maart;521;252;269;433;219;214;105;101;1.0;3.0;42.0;41.0;0.0;1.0;148;4546;2638;1908;825;475;639.0
8186;2016 donderdag 31 maart;511;245;266;449;211;238;93;92;0.0;1.0;25.0;24.0;1.0;0.0;136;6636;3971;2665;723;762;55.0
8187;2016 vrijdag 1 april;483;229;254;482;232;250;329;326;1.0;2.0;47.0;44.0;2.0;1.0;136;28501;16904;11597;769;1110;30.0
8188;2016 zaterdag 2 april;417;211;206;410;209;201;74;72;1.0;1.0;0.0;0.0;0.0;0.0;4;2099;1229;870;14;130;0.0
8189;2016 zondag 3 april;388;201;187;433;204;229;8;8;0.0;0.0;0.0;0.0;0.0;0.0;0;901;504;397;15;79;0.0
8190;2016 maandag 4 april;476;252;224;436;228;208;313;299;9.0;5.0;137.0;136.0;0.0;1.0;135;5711;3240;2471;900;362;29.0
8191;2016 dinsdag 5 april;504;256;248;440;212;228;140;140;0.0;0.0;70.0;67.0;1.0;2.0;131;4081;2315;1766;779;341;20.0
8192;2016 woensdag 6 april;499;231;268;471;229;242;89;86;1.0;2.0;38.0;38.0;0.0;0.0;153;3606;2017;1589;700;286;32.0
8193;2016 donderdag 7 april;493;262;231;409;199;210;86;86;0.0;0.0;25.0;24.0;1.0;0.0;141;4397;2363;2034;841;278;41.0
8194;2016 vrijdag 8 april;527;286;241;433;210;223;283;280;1.0;2.0;31.0;28.0;1.0;2.0;146;4821;2760;2061;585;313;14.0
8195;2016 zaterdag 9 april;396;201;195;424;189;235;57;57;0.0;0.0;1.0;1.0;0.0;0.0;2;2027;1331;696;38;118;0.0
8196;2016 zondag 10 april;374;194;180;396;197;199;8;8;0.0;0.0;0.0;0.0;0.0;0.0;1;1172;680;492;22;93;1.0
8197;2016 maandag 11 april;508;246;262;417;193;224;186;183;1.0;2.0;136.0;134.0;0.0;2.0;145;5156;2883;2273;737;467;305.0
8198;2016 dinsdag 12 april;511;260;251;430;217;213;161;160;1.0;0.0;67.0;65.0;2.0;0.0;172;3611;2016;1595;783;295;30.0
8199;2016 woensdag 13 april;447;216;231;398;185;213;87;87;0.0;0.0;52.0;51.0;0.0;1.0;135;3464;1910;1554;766;254;32.0
8200;2016 donderdag 14 april;505;265;240;369;184;185;110;105;0.0;5.0;31.0;31.0;0.0;0.0;134;4132;2437;1695;662;279;455.0
8201;2016 vrijdag 15 april;511;271;240;440;209;231;349;340;5.0;4.0;24.0;23.0;1.0;0.0;137;7702;4747;2955;535;356;22.0
8202;2016 zaterdag 16 april;382;207;175;358;162;196;147;145;0.0;2.0;3.0;3.0;0.0;0.0;3;2399;1448;951;44;123;2.0
8203;2016 zondag 17 april;358;189;169;355;164;191;10;10;0.0;0.0;0.0;0.0;0.0;0.0;0;906;500;406;34;55;0.0
8204;2016 maandag 18 april;461;243;218;414;197;217;218;215;1.0;2.0;117.0;116.0;1.0;0.0;113;5616;3252;2364;714;275;445.0
8205;2016 dinsdag 19 april;506;254;252;391;177;214;128;125;2.0;1.0;75.0;73.0;1.0;1.0;169;3501;1982;1519;905;257;27.0
8206;2016 woensdag 20 april;494;271;223;419;198;221;142;139;0.0;3.0;50.0;49.0;0.0;1.0;119;4193;2435;1758;740;256;49.0
8207;2016 donderdag 21 april;511;260;251;389;181;208;130;128;0.0;2.0;22.0;20.0;1.0;1.0;143;3998;2226;1772;704;271;38.0
8208;2016 vrijdag 22 april;480;248;232;429;211;218;511;501;3.0;7.0;44.0;43.0;0.0;1.0;125;4884;2945;1939;546;277;167.0
8209;2016 zaterdag 23 april;388;196;192;353;155;198;136;126;4.0;6.0;1.0;1.0;0.0;0.0;1;2668;1670;998;34;96;2.0
8210;2016 zondag 24 april;351;189;162;355;161;194;6;6;0.0;0.0;0.0;0.0;0.0;0.0;0;962;534;428;40;87;0.0
8211;2016 maandag 25 april;500;252;248;383;191;192;260;258;2.0;0.0;112.0;109.0;1.0;2.0;118;6090;3498;2592;682;391;39.0
8212;2016 dinsdag 26 april;495;277;218;423;202;221;233;229;3.0;1.0;56.0;56.0;0.0;0.0;167;4167;2505;1662;725;331;26.0
8213;2016 woensdag 27 april;410;208;202;390;205;185;20;20;0.0;0.0;0.0;0.0;0.0;0.0;2;1051;597;454;4;120;1.0
8214;2016 donderdag 28 april;479;271;208;372;171;201;145;143;0.0;2.0;32.0;31.0;0.0;1.0;123;4891;2871;2020;642;371;29.0
8215;2016 vrijdag 29 april;557;286;271;404;205;199;443;434;3.0;6.0;32.0;30.0;2.0;0.0;117;7009;4259;2750;510;449;16.0
8216;2016 zaterdag 30 april;396;213;183;402;193;209;173;168;2.0;3.0;0.0;0.0;0.0;0.0;3;3362;2072;1290;34;474;0.0
8217;2016 zondag 1 mei;411;211;200;367;176;191;14;14;0.0;0.0;0.0;0.0;0.0;0.0;1;16302;9527;6775;70;582;0.0
8218;2016 maandag 2 mei;505;250;255;416;188;228;260;254;2.0;4.0;139.0;133.0;3.0;3.0;126;10027;6050;3977;866;391;20.0
8219;2016 dinsdag 3 mei;515;281;234;383;190;193;203;201;1.0;1.0;82.0;77.0;3.0;2.0;135;4678;2704;1974;792;342;27.0
8220;2016 woensdag 4 mei;499;244;255;362;188;174;136;134;1.0;1.0;36.0;36.0;0.0;0.0;139;4391;2514;1877;843;317;325.0
8221;2016 donderdag 5 mei;411;201;210;410;183;227;35;34;1.0;0.0;1.0;1.0;0.0;0.0;2;1563;944;619;5;98;1.0
8222;2016 vrijdag 6 mei;534;260;274;372;167;205;462;453;5.0;4.0;21.0;20.0;1.0;0.0;66;2966;1848;1118;248;178;26.0
8223;2016 zaterdag 7 mei;445;235;210;418;199;219;144;142;1.0;1.0;1.0;1.0;0.0;0.0;0;1589;937;652;36;72;0.0
8224;2016 zondag 8 mei;378;187;191;392;194;198;7;7;0.0;0.0;0.0;0.0;0.0;0.0;0;969;552;417;49;70;0.0
8225;2016 maandag 9 mei;501;270;231;424;219;205;272;267;2.0;3.0;123.0;122.0;1.0;0.0;142;6127;3441;2686;764;355;40.0
8226;2016 dinsdag 10 mei;500;256;244;414;203;211;202;198;2.0;2.0;75.0;74.0;1.0;0.0;133;4454;2521;1933;845;282;32.0
8227;2016 woensdag 11 mei;516;265;251;435;214;221;165;162;2.0;1.0;53.0;51.0;1.0;1.0;164;3965;2273;1692;863;204;469.0
8228;2016 donderdag 12 mei;551;287;264;442;203;239;218;214;2.0;2.0;37.0;34.0;2.0;1.0;136;4430;2597;1833;693;254;36.0
8229;2016 vrijdag 13 mei;516;241;275;470;238;232;469;460;4.0;5.0;32.0;29.0;1.0;2.0;143;4962;3008;1954;560;246;17.0
8230;2016 zaterdag 14 mei;411;211;200;387;178;209;190;184;4.0;2.0;2.0;2.0;0.0;0.0;0;2244;1343;901;50;85;0.0
8231;2016 zondag 15 mei;375;195;180;380;188;192;14;14;0.0;0.0;0.0;0.0;0.0;0.0;0;1886;1152;734;5;118;0.0
8232;2016 maandag 16 mei;379;190;189;367;172;195;17;17;0.0;0.0;1.0;1.0;0.0;0.0;3;2123;1220;903;9;103;0.0
8233;2016 dinsdag 17 mei;450;240;210;355;170;185;188;182;2.0;4.0;73.0;70.0;2.0;1.0;127;5392;3213;2179;955;342;23.0
8234;2016 woensdag 18 mei;535;269;266;363;179;184;160;154;2.0;4.0;51.0;49.0;1.0;1.0;156;4500;2603;1897;847;232;24.0
8235;2016 donderdag 19 mei;483;250;233;423;209;214;139;136;1.0;2.0;35.0;33.0;1.0;1.0;163;4076;2243;1833;769;286;45.0
8236;2016 vrijdag 20 mei;491;250;241;426;195;231;944;935;5.0;4.0;38.0;36.0;1.0;1.0;147;5024;3045;1979;601;311;22.0
8237;2016 zaterdag 21 mei;418;219;199;384;177;207;223;218;2.0;3.0;0.0;0.0;0.0;0.0;1;2257;1454;803;30;95;0.0
8238;2016 zondag 22 mei;380;193;187;353;167;186;8;8;0.0;0.0;0.0;0.0;0.0;0.0;0;900;516;384;37;62;0.0
8239;2016 maandag 23 mei;508;252;256;368;179;189;264;262;1.0;1.0;133.0;128.0;3.0;2.0;152;5314;3087;2227;790;330;39.0
8240;2016 dinsdag 24 mei;472;231;241;389;199;190;171;165;5.0;1.0;81.0;79.0;1.0;1.0;128;3651;1983;1668;784;316;33.0
8241;2016 woensdag 25 mei;497;249;248;396;171;225;172;167;0.0;5.0;51.0;46.0;3.0;2.0;148;4278;2474;1804;791;293;33.0
8242;2016 donderdag 26 mei;536;274;262;402;169;233;211;206;1.0;4.0;26.0;24.0;1.0;1.0;126;4330;2510;1820;692;330;44.0
8243;2016 vrijdag 27 mei;497;267;230;399;204;195;906;888;10.0;8.0;26.0;25.0;1.0;0.0;149;5036;3060;1976;504;450;1044.0
8244;2016 zaterdag 28 mei;432;222;210;397;184;213;257;251;2.0;4.0;4.0;4.0;0.0;0.0;1;2865;1846;1019;52;190;0.0
8245;2016 zondag 29 mei;366;203;163;361;155;206;15;14;0.0;1.0;0.0;0.0;0.0;0.0;0;951;540;411;37;100;0.0
8246;2016 maandag 30 mei;463;239;224;374;183;191;260;255;3.0;2.0;125.0;122.0;2.0;1.0;123;5963;3424;2539;721;459;36.0
8247;2016 dinsdag 31 mei;523;262;261;393;183;210;150;146;3.0;1.0;70.0;69.0;1.0;0.0;105;5758;3396;2362;721;719;21.0
8248;2016 woensdag 1 juni;532;267;265;400;216;184;384;369;3.0;12.0;59.0;57.0;1.0;1.0;143;27113;16005;11108;944;876;293.0
8249;2016 donderdag 2 juni;465;245;220;373;177;196;213;208;2.0;3.0;27.0;27.0;0.0;0.0;146;4540;2553;1987;771;400;31.0
8250;2016 vrijdag 3 juni;478;240;238;433;212;221;866;849;6.0;11.0;31.0;26.0;3.0;2.0;126;4378;2553;1825;584;357;21.0
8251;2016 zaterdag 4 juni;456;246;210;345;169;176;314;307;4.0;3.0;0.0;0.0;0.0;0.0;1;1929;1154;775;79;112;0.0
8252;2016 zondag 5 juni;372;183;189;364;189;175;15;15;0.0;0.0;0.0;0.0;0.0;0.0;0;908;534;374;43;90;1.0
8253;2016 maandag 6 juni;515;272;243;375;188;187;477;467;2.0;8.0;125.0;124.0;0.0;1.0;144;5454;3201;2253;840;358;12.0
8254;2016 dinsdag 7 juni;484;216;268;378;179;199;165;162;1.0;2.0;78.0;74.0;1.0;3.0;113;3810;2159;1651;793;310;33.0
8255;2016 woensdag 8 juni;514;268;246;353;176;177;146;145;1.0;0.0;40.0;37.0;1.0;2.0;138;3876;2301;1575;912;279;19.0
8256;2016 donderdag 9 juni;513;258;255;356;170;186;186;182;2.0;2.0;20.0;19.0;1.0;0.0;105;3802;2193;1609;740;261;19.0
8257;2016 vrijdag 10 juni;526;292;234;402;194;208;1271;1248;13.0;10.0;40.0;36.0;3.0;1.0;133;5083;3026;2057;586;293;17.0
8258;2016 zaterdag 11 juni;413;216;197;350;171;179;294;287;2.0;5.0;3.0;2.0;0.0;1.0;1;2105;1300;805;59;104;2.0
8259;2016 zondag 12 juni;340;191;149;372;164;208;13;13;0.0;0.0;0.0;0.0;0.0;0.0;0;1030;599;431;35;86;0.0
8260;2016 maandag 13 juni;488;246;242;345;161;184;209;201;5.0;3.0;134.0;132.0;1.0;1.0;121;5368;3144;2224;679;327;634.0
8261;2016 dinsdag 14 juni;500;239;261;403;209;194;188;185;0.0;3.0;70.0;68.0;1.0;1.0;136;4000;2314;1686;749;345;38.0
8262;2016 woensdag 15 juni;533;279;254;384;194;190;124;115;5.0;4.0;47.0;43.0;1.0;3.0;139;6974;4236;2738;787;427;18.0
8263;2016 donderdag 16 juni;562;292;270;382;187;195;770;748;10.0;12.0;41.0;38.0;1.0;2.0;102;4433;2543;1890;686;352;30.0
8264;2016 vrijdag 17 juni;542;279;263;373;172;201;805;788;7.0;10.0;28.0;25.0;1.0;2.0;137;4814;2941;1873;587;346;25.0
8265;2016 zaterdag 18 juni;376;210;166;385;172;213;299;294;2.0;3.0;0.0;0.0;0.0;0.0;1;2259;1355;904;48;149;0.0
8266;2016 zondag 19 juni;338;149;189;348;171;177;10;10;0.0;0.0;0.0;0.0;0.0;0.0;0;846;488;358;40;88;0.0
8267;2016 maandag 20 juni;489;251;238;335;162;173;264;254;5.0;5.0;141.0;135.0;2.0;4.0;131;5821;3299;2522;830;345;32.0
8268;2016 dinsdag 21 juni;523;300;223;387;174;213;251;240;1.0;10.0;78.0;69.0;4.0;5.0;116;3753;2179;1574;729;416;33.0
8269;2016 woensdag 22 juni;520;261;259;397;207;190;163;157;1.0;5.0;53.0;49.0;2.0;2.0;131;3662;2057;1605;737;383;471.0
8270;2016 donderdag 23 juni;536;281;255;398;178;220;206;200;4.0;2.0;29.0;28.0;1.0;0.0;144;4017;2342;1675;663;444;35.0
8271;2016 vrijdag 24 juni;555;291;264;393;203;190;958;934;10.0;14.0;22.0;20.0;2.0;0.0;127;4854;2915;1939;472;489;10.0
8272;20106 zaterdag 25 juni;463;217;246;330;163;167;329;319;6.0;4.0;1.0;1.0;0.0;0.0;0;3341;2038;1303;75;243;5.0
8273;2016 zondag 26 juni;384;196;188;356;160;196;17;17;0.0;0.0;0.0;0.0;0.0;0.0;0;1076;593;483;39;203;0.0
8274;2016 maandag 27 juni;540;281;259;389;183;206;246;241;0.0;5.0;116.0;115.0;1.0;0.0;104;5786;3325;2461;844;641;24.0
8275;2016 dinsdag 28 juni;540;274;266;358;166;192;195;193;1.0;1.0;63.0;63.0;0.0;0.0;179;4285;2415;1870;770;575;26.0
8276;2016 woensdag 29 juni;491;249;242;404;200;204;141;135;3.0;3.0;41.0;40.0;0.0;1.0;147;4409;2562;1847;815;721;173.0
8277;2016 donderdag 30 juni;531;279;252;367;176;191;179;175;2.0;2.0;31.0;30.0;1.0;0.0;140;7691;4571;3120;708;1518;191.0
8278;2016 vrijdag 1 juli;539;284;255;403;199;204;942;930;5.0;7.0;34.0;31.0;0.0;3.0;106;34414;18992;15422;777;1509;13.0
8279;2016 zaterdag 2 juli;431;239;192;380;193;187;310;305;2.0;3.0;2.0;2.0;0.0;0.0;1;2453;1364;1089;67;282;0.0
8280;2016 zondag 3 juli;374;189;185;308;151;157;11;11;0.0;0.0;1.0;1.0;0.0;0.0;0;1099;589;510;38;188;0.0
8281;2016 maandag 4 juli;508;247;261;361;180;181;260;251;4.0;5.0;133.0;128.0;1.0;4.0;125;6621;3728;2893;970;590;13.0
8282;2016 dinsdag 5 juli;538;276;262;390;183;207;154;148;3.0;3.0;95.0;93.0;1.0;1.0;102;4091;2237;1854;966;507;290.0
8283;2016 woensdag 6 juli;541;264;277;377;171;206;162;161;0.0;1.0;53.0;50.0;1.0;2.0;148;4468;2609;1859;888;465;16.0
8284;2016 donderdag 7 juli;529;259;270;403;198;205;273;267;1.0;5.0;32.0;30.0;0.0;2.0;126;4785;2670;2115;797;473;26.0
8285;2016 vrijdag 8 juli;610;317;293;411;193;218;791;771;4.0;16.0;38.0;34.0;1.0;3.0;154;5567;3171;2396;657;502;440.0
8286;2016 zaterdag 9 juli;455;228;227;377;187;190;280;274;2.0;4.0;5.0;5.0;0.0;0.0;0;2487;1463;1024;18;247;0.0
8287;2016 zondag 10 juli;398;213;185;371;178;193;20;20;0.0;0.0;0.0;0.0;0.0;0.0;0;1371;753;618;22;272;0.0
8288;2016 maandag 11 juli;510;264;246;392;186;206;285;279;1.0;5.0;135.0;128.0;1.0;6.0;141;6380;3483;2897;848;463;27.0
8289;2016 dinsdag 12 juli;544;278;266;364;171;193;189;185;3.0;1.0;76.0;74.0;0.0;2.0;134;4428;2458;1970;874;542;38.0
8290;2016 woensdag 13 juli;558;303;255;397;179;218;141;138;3.0;0.0;39.0;37.0;1.0;1.0;156;4218;2294;1924;762;463;31.0
8291;2016 donderdag 14 juli;550;281;269;341;162;179;202;194;4.0;4.0;27.0;25.0;2.0;0.0;113;4934;2748;2186;726;465;35.0
8292;2016 vrijdag 15 juli;553;287;266;398;195;203;611;600;6.0;5.0;36.0;36.0;0.0;0.0;132;9919;5664;4255;648;694;8.0
8293;2016 zaterdag 16 juli;465;239;226;375;192;183;325;321;2.0;2.0;0.0;0.0;0.0;0.0;1;2819;1566;1253;54;190;1.0
8294;2016 zondag 17 juli;410;222;188;359;165;194;14;13;1.0;0.0;0.0;0.0;0.0;0.0;0;1029;550;479;37;142;0.0
8295;2016 maandag 18 juli;530;264;266;354;182;172;235;231;1.0;3.0;116.0;114.0;1.0;1.0;141;6695;3735;2960;939;565;11.0
8296;2016 dinsdag 19 juli;562;279;283;388;194;194;158;155;2.0;1.0;69.0;67.0;0.0;2.0;139;3812;2028;1784;930;469;32.0
8297;2016 woensdag 20 juli;557;272;285;441;222;219;149;147;1.0;1.0;51.0;47.0;2.0;2.0;153;4355;2376;1979;932;461;44.0
8298;2016 donderdag 21 juli;560;284;276;400;191;209;131;126;2.0;3.0;31.0;28.0;1.0;2.0;133;4409;2418;1991;746;464;25.0
8299;2016 vrijdag 22 juli;506;260;246;453;226;227;403;396;4.0;3.0;33.0;31.0;0.0;2.0;126;5064;2954;2110;621;484;6.0
8300;2016 zaterdag 23 juli;446;221;225;358;173;185;184;180;3.0;1.0;0.0;0.0;0.0;0.0;3;2726;1564;1162;47;168;0.0
8301;2016 zondag 24 juli;450;216;234;359;173;186;10;10;0.0;0.0;0.0;0.0;0.0;0.0;0;1017;589;428;24;133;0.0
8302;2016 maandag 25 juli;515;257;258;363;199;164;216;208;3.0;5.0;129.0;127.0;0.0;2.0;135;6776;3723;3053;749;572;17.0
8303;2016 dinsdag 26 juli;584;315;269;410;206;204;166;161;1.0;4.0;91.0;87.0;3.0;1.0;130;4094;2203;1891;780;559;32.0
8304;2016 woensdag 27 juli;535;292;243;351;170;181;142;135;2.0;5.0;48.0;46.0;2.0;0.0;126;4466;2443;2023;824;549;29.0
8305;2016 donderdag 28 juli;499;235;264;389;196;193;121;118;2.0;1.0;33.0;31.0;0.0;2.0;131;5399;2919;2480;796;593;38.0
8306;2016 vrijdag 29 juli;570;288;282;347;185;162;283;279;3.0;1.0;27.0;26.0;1.0;0.0;106;6305;3623;2682;730;651;4.0
8307;2016 zaterdag 30 juli;437;239;198;355;158;197;145;144;0.0;1.0;0.0;0.0;0.0;0.0;0;2499;1456;1043;42;328;0.0
8308;2016 zondag 31 juli;402;193;209;326;154;172;11;11;0.0;0.0;1.0;1.0;0.0;0.0;0;2121;1114;1007;41;742;0.0
8309;2016 maandag 1 augustus;474;259;215;351;168;183;260;256;1.0;3.0;118.0;118.0;0.0;0.0;115;36977;19513;17464;1364;1332;12.0
8310;2016 dinsdag 2 augustus;547;269;278;344;173;171;185;180;4.0;1.0;69.0;68.0;0.0;1.0;135;5022;2711;2311;1050;449;24.0
8311;2016 woensdag 3 augustus;547;281;266;400;203;197;113;112;1.0;0.0;53.0;51.0;0.0;2.0;137;4206;2239;1967;997;459;38.0
8312;2016 donderdag 4 augustus;561;290;271;362;189;173;201;195;3.0;3.0;26.0;26.0;0.0;0.0;128;4357;2404;1953;1015;369;25.0
8313;2016 vrijdag 5 augustus;548;270;278;370;186;184;320;315;1.0;4.0;31.0;29.0;1.0;1.0;112;5214;2868;2346;688;443;25.0
8314;2016 zaterdag 6 augustus;461;234;227;344;152;192;149;147;1.0;1.0;3.0;1.0;1.0;1.0;1;2074;1220;854;48;108;0.0
8315;2016 zondag 7 augustus;366;198;168;328;146;182;11;11;0.0;0.0;0.0;0.0;0.0;0.0;0;950;513;437;29;114;0.0
8316;2016 maandag 8 augustus;516;275;241;334;154;180;408;396;5.0;7.0;144.0;137.0;3.0;4.0;125;7074;3916;3158;890;497;20.0
8317;2016 dinsdag 9 augustus;540;287;253;334;163;171;150;147;1.0;2.0;79.0;79.0;0.0;0.0;116;3968;2059;1909;917;380;37.0
8318;2016 woensdag 10 augustus;534;280;254;352;177;175;150;147;2.0;1.0;42.0;41.0;0.0;1.0;116;4864;2593;2271;885;482;18.0
8319;2016 donderdag 11 augustus;524;280;244;383;183;200;106;103;2.0;1.0;21.0;21.0;0.0;0.0;149;4227;2349;1878;939;380;19.0
8320;2016 vrijdag 12 augustus;562;283;279;425;202;223;342;336;1.0;5.0;31.0;29.0;1.0;1.0;142;5265;2918;2347;750;460;10.0
8321;2016 zaterdag 13 augustus;433;229;204;366;175;191;124;124;0.0;0.0;2.0;2.0;0.0;0.0;1;2136;1161;975;38;163;0.0
8322;2016 zondag 14 augustus;388;201;187;361;190;171;19;19;0.0;0.0;0.0;0.0;0.0;0.0;0;1222;623;599;17;148;0.0
8323;2016 maandag 15 augustus;482;238;244;343;195;148;230;229;0.0;1.0;113.0;108.0;3.0;2.0;114;11368;6114;5254;1005;706;26.0
8324;2016 dinsdag 16 augustus;534;255;279;344;188;156;266;257;6.0;3.0;84.0;80.0;0.0;4.0;127;4681;2437;2244;1249;410;17.0
8325;2016 woensdag 17 augustus;542;276;266;394;211;183;151;146;3.0;2.0;41.0;41.0;0.0;0.0;101;4155;2240;1915;1060;411;27.0
8326;2016 donderdag 18 augustus;543;287;256;413;222;191;163;159;2.0;2.0;26.0;26.0;0.0;0.0;131;4461;2400;2061;1017;427;23.0
8327;2016 vrijdag 19 augustus;520;256;264;353;171;182;508;497;6.0;5.0;41.0;39.0;0.0;2.0;86;4707;2519;2188;1697;469;18.0
8328;2016 zaterdag 20 augustus;427;221;206;361;176;185;284;280;1.0;3.0;2.0;2.0;0.0;0.0;1;3238;1760;1478;28;207;0.0
8329;2016 zondag 21 augustus;405;196;209;359;153;206;12;12;0.0;0.0;0.0;0.0;0.0;0.0;0;1244;583;661;55;125;0.0
8330;2016 maandag 22 augustus;528;266;262;356;184;172;265;258;3.0;4.0;120.0;116.0;2.0;2.0;106;7105;3485;3620;3938;562;20.0
8331;2016 dinsdag 23 augustus;494;272;222;420;207;213;185;177;5.0;3.0;74.0;71.0;1.0;2.0;94;4273;2198;2075;1408;445;22.0
8332;2016 woensdag 24 augustus;563;282;281;385;183;202;193;189;2.0;2.0;53.0;53.0;0.0;0.0;128;4241;2222;2019;1396;415;33.0
8333;2016 donderdag 25 augustus;541;265;276;368;177;191;212;204;4.0;4.0;30.0;28.0;2.0;0.0;127;4900;2596;2304;1361;522;35.0
8334;2016 vrijdag 26 augustus;561;279;282;426;215;211;943;917;14.0;12.0;25.0;24.0;0.0;1.0;109;5782;3290;2492;1224;500;26.0
8335;2016 zaterdag 27 augustus;425;212;213;399;188;211;326;319;5.0;2.0;1.0;1.0;0.0;0.0;0;2880;1597;1283;114;160;0.0
8336;2016 zondag 28 augustus;419;231;188;344;161;183;19;18;0.0;1.0;0.0;0.0;0.0;0.0;0;1655;780;875;40;175;0.0
8337;2016 maandag 29 augustus;519;289;230;347;176;171;240;235;2.0;3.0;121.0;115.0;2.0;4.0;133;7083;3537;3546;1981;674;25.0
8338;2016 dinsdag 30 augustus;554;281;273;349;164;185;204;196;3.0;5.0;68.0;63.0;3.0;2.0;123;5100;2667;2433;2012;566;37.0
8339;2016 woensdag 31 augustus;526;285;241;384;187;197;160;158;1.0;1.0;45.0;41.0;0.0;4.0;107;6917;3761;3156;2222;1101;19.0
8340;2016 donderdag 1 september;513;276;237;389;192;197;278;272;2.0;4.0;32.0;31.0;0.0;1.0;125;34492;17726;16766;2045;1437;27.0
8341;2016 vrijdag 2 september;550;302;248;367;185;182;1037;1016;8.0;13.0;30.0;28.0;2.0;0.0;131;6024;3309;2715;1302;509;26.0
8342;2016 zaterdag 3 september;426;229;197;382;180;202;392;375;12.0;5.0;1.0;0.0;1.0;0.0;0;2440;1245;1195;98;235;0.0
8343;2016 zondag 4 september;398;206;192;372;179;193;18;16;0.0;2.0;0.0;0.0;0.0;0.0;0;1476;649;827;36;157;1.0
8344;2016 maandag 5 septmber;503;229;274;359;170;189;270;266;1.0;3.0;111.0;107.0;4.0;0.0;128;7467;3793;3674;1286;497;29.0
8345;2016 dinsdag 6 september;580;303;277;336;174;162;216;212;2.0;2.0;76.0;74.0;2.0;0.0;128;4198;2239;1959;1639;452;21.0
8346;2016 woensdag 7 september;545;288;257;377;173;204;158;154;2.0;2.0;44.0;40.0;2.0;2.0;148;4480;2398;2082;1836;398;2855.0
8347;2016 donderdag 8 september;516;261;255;418;201;217;216;212;0.0;4.0;24.0;22.0;0.0;2.0;114;4648;2520;2128;2112;381;27.0
8348;2016 vrijdag 9 september;500;259;241;416;200;216;1152;1130;12.0;10.0;37.0;35.0;0.0;2.0;96;4969;2713;2256;1119;392;29.0
8349;2016 zaterdag 10 september;461;250;211;366;178;188;311;305;3.0;3.0;2.0;0.0;1.0;1.0;1;2520;1414;1106;42;189;0.0
8350;2016 zondag 11 september;399;188;211;311;163;148;9;9;0.0;0.0;0.0;0.0;0.0;0.0;0;1195;613;582;25;98;2.0
8351;2016 maandag 12 september;526;270;256;403;191;212;215;210;2.0;3.0;122.0;119.0;1.0;2.0;128;6075;3333;2742;1541;398;34.0
8352;2016 dinsdag 13 september;584;304;280;381;194;187;159;155;3.0;1.0;69.0;67.0;1.0;1.0;136;3823;2086;1737;1199;364;13.0
8353;2016 woensdag 14 september;552;274;278;413;207;206;155;151;1.0;3.0;44.0;43.0;1.0;0.0;107;4040;2143;1897;1203;325;21.0
8354;2016 donderdag 15 september;538;283;255;411;195;216;192;187;3.0;2.0;39.0;36.0;0.0;3.0;141;7787;4459;3328;2067;448;27.0
8355;2016 vrijdag 16 september;599;314;285;384;199;185;1125;1090;12.0;23.0;30.0;29.0;1.0;0.0;106;5541;3222;2319;1094;326;10.0
8356;2016 zaterdag 17 september;454;244;210;371;187;184;303;294;6.0;3.0;3.0;3.0;0.0;0.0;1;2072;1217;855;92;118;2.0
8357;2016 zondag 18 september;366;177;189;361;178;183;11;11;0.0;0.0;0.0;0.0;0.0;0.0;1;1105;552;553;16;116;1.0
8358;2016 maandag 19 september;489;260;229;345;172;173;228;227;0.0;1.0;122.0;120.0;0.0;2.0;129;6168;3447;2721;1278;383;24.0
8359;2016 dinsdag 20 september;537;260;277;344;184;160;178;176;1.0;1.0;68.0;67.0;0.0;1.0;115;4277;2339;1938;1165;362;23.0
8360;2016 woensdag 21 september;519;264;255;367;162;205;127;120;2.0;5.0;55.0;54.0;0.0;1.0;118;4098;2242;1856;1220;331;17.0
8361;2016 donderdag 22 september;555;285;270;365;163;202;158;156;0.0;2.0;36.0;35.0;1.0;0.0;108;4429;2434;1995;1098;398;29.0
8362;2016 vrijdag 23 september;530;272;258;383;192;191;658;646;6.0;6.0;30.0;28.0;2.0;0.0;123;5181;2966;2215;847;400;13.0
8363;2016 zaterdag 24 september;463;250;213;350;177;173;236;229;5.0;2.0;1.0;1.0;0.0;0.0;1;2790;1756;1034;58;141;0.0
8364;2016 zondag 25 september;412;220;192;345;172;173;4;4;0.0;0.0;0.0;0.0;0.0;0.0;1;1265;653;612;6;163;3.0
8365;2016 maandag 26 september;482;251;231;376;174;202;215;211;1.0;3.0;121.0;119.0;1.0;1.0;124;6260;3595;2665;1014;469;19.0
8366;2016 dinsdag 27 september;503;242;261;371;165;206;180;178;0.0;2.0;70.0;69.0;0.0;1.0;113;3900;2102;1798;1429;430;606.0
8367;2016 woensdag 28 september;542;278;264;400;192;208;115;114;1.0;0.0;41.0;40.0;0.0;1.0;151;4470;2438;2032;998;471;470.0
8368;2016 donderdag 29 september;558;288;270;421;211;210;136;133;1.0;2.0;24.0;24.0;0.0;0.0;108;5347;3139;2208;1384;421;26.0
8369;2016 vrijdag 30 september;545;265;280;380;178;202;596;583;2.0;11.0;30.0;24.0;3.0;3.0;96;9961;6173;3788;813;920;20.0
8370;2016 zaterdag 1 oktober;467;245;222;364;180;184;181;177;1.0;3.0;3.0;2.0;1.0;0.0;0;21753;12254;9499;311;813;0.0
8371;2016 zondag 2 oktober;365;176;189;350;158;192;9;9;0.0;0.0;0.0;0.0;0.0;0.0;0;1150;640;510;5;114;2.0
8372;2016 maandag 3 oktober;508;270;238;372;186;186;179;174;3.0;2.0;141.0;138.0;0.0;3.0;94;8923;5163;3760;976;476;14.0
8373;2016 dinsdag 4 oktober;517;262;255;406;205;201;141;134;3.0;4.0;88.0;87.0;0.0;1.0;142;4345;2423;1922;1057;376;30.0
8374;2016 woensdag 5 oktober;506;254;252;372;182;190;110;106;1.0;3.0;57.0;54.0;3.0;0.0;116;4434;2503;1931;1098;346;754.0
8375;2016 donderdag 6 oktober;541;260;281;358;178;180;241;236;1.0;4.0;31.0;31.0;0.0;0.0;105;4315;2335;1980;970;289;35.0
8376;2016 vrijdag 7 oktober;522;267;255;420;226;194;428;423;3.0;2.0;38.0;36.0;0.0;2.0;92;5087;2899;2188;805;347;20.0
8377;2016 zaterdag 8 oktober;438;230;208;392;195;197;144;141;2.0;1.0;1.0;1.0;0.0;0.0;0;2406;1476;930;68;111;1.0
8378;2016 zondag 9 oktober;390;201;189;363;177;186;9;8;0.0;1.0;0.0;0.0;0.0;0.0;0;1038;581;457;28;62;1.0
8379;2016 maandag 10 oktober;481;237;244;399;199;200;256;249;2.0;5.0;122.0;118.0;2.0;2.0;123;6759;3786;2973;857;459;17.0
8380;2016 dinsdag 11 oktober;502;237;265;438;198;240;148;145;2.0;1.0;76.0;73.0;3.0;0.0;116;3713;2048;1665;922;382;38.0
8381;2016 woensdag 12 oktober ;501;242;259;409;213;196;118;114;4.0;0.0;53.0;52.0;1.0;0.0;105;4266;2334;1932;970;288;21.0
8382;2016 donderdag 13 oktober;529;265;264;406;188;218;93;93;0.0;0.0;27.0;26.0;0.0;1.0;108;4346;2414;1932;977;271;29.0
8383;2016 vrijdag 14 oktober;523;270;253;448;220;228;406;400;3.0;3.0;38.0;38.0;0.0;0.0;81;6530;3819;2711;784;296;20.0
8384;2016 zaterdag 15 oktober;390;185;205;441;213;228;114;112;2.0;0.0;1.0;1.0;0.0;0.0;1;4273;2565;1708;124;179;0.0
8385;2016 zondag 16 oktober;384;188;196;389;214;175;12;12;0.0;0.0;0.0;0.0;0.0;0.0;0;1324;721;603;38;90;1.0
8386;2016 maandag 17 oktober;517;266;251;381;201;180;210;200;6.0;4.0;143.0;139.0;2.0;2.0;102;7022;3921;3101;947;346;23.0
8387;2016 dinsdag 18 oktober;472;230;242;390;186;204;137;133;2.0;2.0;90.0;88.0;2.0;0.0;98;4075;2221;1854;1081;335;41.0
8388;2016 woensdag 19 oktober;517;262;255;409;205;204;102;102;0.0;0.0;38.0;35.0;2.0;1.0;121;3849;2200;1649;1008;244;17.0
8389;2016 donderdag 20 oktober;471;249;222;385;177;208;109;107;2.0;0.0;36.0;33.0;1.0;2.0;103;4741;2663;2078;767;348;44.0
8390;2016 vrijdag 21 oktober;520;251;269;443;209;234;303;302;1.0;0.0;39.0;34.0;4.0;1.0;117;4850;2804;2046;603;317;23.0
8391;2016 zaterdag 22 oktober;427;227;200;394;190;204;79;79;0.0;0.0;3.0;2.0;1.0;0.0;0;2744;1688;1056;119;111;0.0
8392;2016 zondag 23 oktober;382;195;187;338;163;175;10;10;0.0;0.0;0.0;0.0;0.0;0.0;0;962;526;436;45;78;0.0
8393;2016 maandag 24 oktober;449;249;200;429;196;233;189;185;2.0;2.0;152.0;144.0;3.0;5.0;124;6130;3571;2559;761;389;1037.0
8394;2016 dinsdag 25 oktober;491;255;236;405;189;216;136;134;1.0;1.0;82.0;81.0;1.0;0.0;89;3992;2211;1781;889;385;36.0
8395;2016 woensdag 26 oktober;494;264;230;418;211;207;96;90;2.0;4.0;59.0;56.0;2.0;1.0;103;4265;2392;1873;862;318;27.0
8396;2016 donderdag 27 oktober;473;249;224;473;234;239;87;85;1.0;1.0;29.0;29.0;0.0;0.0;131;4345;2406;1939;796;393;748.0
8397;2016 vrijdag 28 oktober;496;263;233;451;217;234;251;242;5.0;4.0;31.0;29.0;1.0;1.0;113;5763;3474;2289;624;380;20.0
8398;2016 zaterdag 29 oktober;370;175;195;390;185;205;64;63;1.0;0.0;1.0;1.0;0.0;0.0;0;2699;1642;1057;129;150;1.0
8399;2016 zondag 30 oktober;406;211;195;381;178;203;2;2;0.0;0.0;0.0;0.0;0.0;0.0;0;1254;717;537;41;141;0.0
8400;2016 maandag 31 oktober;467;246;221;371;186;185;166;161;1.0;4.0;127.0;124.0;2.0;1.0;132;8246;4970;3276;812;715;35.0
8401;2016 dinsdag 1 november;419;228;191;412;205;207;127;125;0.0;2.0;86.0;80.0;2.0;4.0;94;29000;16801;12199;936;863;32.0
8402;2016 woensdag 2 november;487;260;227;400;191;209;77;77;0.0;0.0;46.0;43.0;1.0;2.0;161;4552;2568;1984;855;342;15.0
8403;2016 donderdag 3 november;475;245;230;382;175;207;66;64;0.0;2.0;22.0;22.0;0.0;0.0;96;4174;2319;1855;931;288;26.0
8404;2016 vrijdag 4 november;508;250;258;405;202;203;183;182;0.0;1.0;35.0;31.0;3.0;1.0;110;4451;2640;1811;637;278;20.0
8405;2016 zaterdag 5 november;441;229;212;401;199;202;46;43;2.0;1.0;2.0;2.0;0.0;0.0;1;2308;1316;992;29;129;0.0
8406;2016 zondag 6 november;380;213;167;356;187;169;2;2;0.0;0.0;0.0;0.0;0.0;0.0;0;975;580;395;24;58;0.0
8407;2016 maandag 7 november;476;246;230;398;200;198;158;158;0.0;0.0;128.0;125.0;1.0;2.0;130;6045;3411;2634;955;382;41.0
8408;2016 dinsdag 8 november;455;235;220;451;202;249;104;102;1.0;1.0;73.0;69.0;3.0;1.0;131;4047;2293;1754;822;267;22.0
8409;2016 woensdag 9 november;475;249;226;426;204;222;87;86;1.0;0.0;49.0;46.0;2.0;1.0;112;3830;2121;1709;809;263;42.0
8410;2016 donderdag 10 november;534;258;276;416;205;211;75;75;0.0;0.0;32.0;30.0;2.0;0.0;127;4705;2722;1983;894;313;55.0
8411;2016 vrijdag 11 november;481;251;230;436;205;231;222;219;2.0;1.0;24.0;21.0;0.0;3.0;126;4993;2844;2149;690;292;37.0
8412;2016 zaterdag 12 november;372;206;166;363;154;209;47;46;1.0;0.0;4.0;4.0;0.0;0.0;0;2558;1586;972;75;86;0.0
8413;2016 zondag 13 november;353;175;178;417;201;216;6;6;0.0;0.0;0.0;0.0;0.0;0.0;0;919;476;443;46;53;0.0
8414;2016 maandag 14 november;455;219;236;402;205;197;157;154;1.0;2.0;136.0;127.0;4.0;5.0;128;6644;3772;2872;757;327;601.0
8415;2016 dinsdag 15 november;471;259;212;425;207;218;115;112;2.0;1.0;90.0;89.0;1.0;0.0;112;7031;4183;2848;740;346;651.0
8416;2016 woensdag 16 november;494;245;249;436;217;219;107;101;2.0;4.0;47.0;46.0;0.0;1.0;119;4599;2568;2031;853;304;36.0
8417;2016 donderdag 17 november;464;230;234;412;206;206;72;71;0.0;1.0;39.0;37.0;2.0;0.0;123;4221;2462;1759;710;243;24.0
8418;2016 vrijdag 18 november;475;253;222;453;207;246;156;154;2.0;0.0;33.0;30.0;2.0;1.0;99;4880;2873;2007;726;287;28.0
8419;2016 zaterdag 19 november;408;217;191;382;195;187;47;46;0.0;1.0;1.0;1.0;0.0;0.0;0;2535;1571;964;47;76;0.0
8420;2016 zondag 20 november;376;197;179;387;198;189;4;4;0.0;0.0;0.0;0.0;0.0;0.0;0;1338;746;592;70;111;0.0
8421;2016 maandag 21 november;487;263;224;444;205;239;156;153;1.0;2.0;122.0;119.0;2.0;1.0;118;6040;3510;2530;765;355;26.0
8422;2016 dinsdag 22 november;455;227;228;415;207;208;121;121;0.0;0.0;81.0;78.0;3.0;0.0;123;3829;2139;1690;818;239;39.0
8423;2016 woensdag 23 november;489;238;251;412;192;220;70;65;2.0;3.0;52.0;51.0;1.0;0.0;102;4105;2229;1876;815;253;532.0
8424;2016 donderdag 24 november;466;230;236;412;197;215;72;72;0.0;0.0;34.0;33.0;0.0;1.0;119;4173;2393;1780;727;284;42.0
8425;2016 vrijdag 25 november;486;263;223;399;181;218;174;169;1.0;4.0;43.0;40.0;1.0;2.0;158;5520;3301;2219;616;368;27.0
8426;2016 zaterdag 26 november;376;209;167;422;190;232;57;57;0.0;0.0;2.0;2.0;0.0;0.0;0;3465;2252;1213;89;111;369.0
8427;2016 zondag 27 november;346;198;148;401;197;204;3;3;0.0;0.0;0.0;0.0;0.0;0.0;0;992;536;456;62;101;0.0
8428;2016 maandag 28 november;446;239;207;415;200;215;160;156;3.0;1.0;139.0;135.0;2.0;2.0;125;6452;3898;2554;707;435;24.0
8429;2016 dinsdag 29 november;451;228;223;434;213;221;126;122;3.0;1.0;84.0;81.0;3.0;0.0;123;4277;2493;1784;768;411;32.0
8430;2016 woensdag 30 november;503;247;256;405;215;190;71;71;0.0;0.0;51.0;48.0;1.0;2.0;144;6715;4163;2552;739;632;21.0
8431;2016 donderdag 1 december;498;266;232;442;212;230;72;69;2.0;1.0;37.0;34.0;2.0;1.0;125;29468;17976;11492;982;866;22.0
8432;2016 vrijdag 2 december;493;233;260;457;222;235;116;114;1.0;1.0;34.0;31.0;2.0;1.0;124;5637;3371;2266;690;331;15.0
8433;2016 zaterdag 3 december;361;186;175;397;179;218;30;29;1.0;0.0;1.0;1.0;0.0;0.0;2;2325;1374;951;97;124;0.0
8434;2016 zondag 4 december;367;196;171;398;188;210;4;4;0.0;0.0;0.0;0.0;0.0;0.0;0;950;543;407;45;82;0.0
8435;2016 maandag 5 december;417;213;204;404;197;207;164;160;2.0;2.0;119.0;115.0;1.0;3.0;125;5979;3444;2535;753;314;36.0
8436;2016 dinsdag 6 december;484;260;224;415;196;219;127;118;4.0;5.0;85.0;78.0;3.0;4.0;143;4058;2358;1700;739;250;458.0
8437;2016 woensdag 7 december;438;234;204;453;210;243;85;83;2.0;0.0;48.0;43.0;1.0;4.0;134;4559;2574;1985;804;309;29.0
8438;2016 donderdag 8 december;476;236;240;429;202;227;69;67;2.0;0.0;29.0;28.0;1.0;0.0;106;4879;2765;2114;718;279;35.0
8439;2016 vrijdag 9 december;477;258;219;464;240;224;138;138;0.0;0.0;32.0;31.0;1.0;0.0;116;5234;3135;2099;696;333;37.0
8440;2016 zaterdag 10 december;386;197;189;456;230;226;47;43;2.0;2.0;0.0;0.0;0.0;0.0;0;3532;2294;1238;45;150;0.0
8441;2016 zondag 11 december;337;183;154;416;175;241;3;3;0.0;0.0;0.0;0.0;0.0;0.0;1;1023;582;441;54;66;0.0
8442;2016 maandag 12 december;472;251;221;436;217;219;213;209;3.0;1.0;176.0;166.0;3.0;7.0;137;6643;3940;2703;827;428;29.0
8443;2016 dinsdag 13 december;486;244;242;454;226;228;107;105;0.0;2.0;100.0;98.0;1.0;1.0;121;3911;2231;1680;628;316;301.0
8444;2016 woensdag 14 december;472;234;238;475;238;237;74;74;0.0;0.0;50.0;49.0;1.0;0.0;109;4591;2692;1899;719;286;29.0
8445;2016 donderdag 15 december;509;280;229;471;229;242;63;61;1.0;1.0;36.0;35.0;1.0;0.0;113;9005;5458;3547;686;394;69.0
8446;2016 vrijdag 16 december;515;267;248;396;204;192;314;306;5.0;3.0;46.0;45.0;0.0;1.0;126;6754;4024;2730;624;421;37.0
8447;2016 zaterdag 17 december;364;174;190;469;223;246;48;47;1.0;0.0;2.0;1.0;0.0;1.0;1;3573;2306;1267;130;165;0.0
8448;2016 zondag 18 december;319;160;159;421;211;210;4;4;0.0;0.0;0.0;0.0;0.0;0.0;0;1326;790;536;54;110;0.0
8449;2016 maandag 19 december;509;266;243;394;193;201;190;182;6.0;2.0;155.0;147.0;5.0;3.0;128;7230;4286;2944;669;439;30.0
8450;2016 dinsdag 20 december;482;253;229;447;219;228;146;141;2.0;3.0;89.0;87.0;1.0;1.0;143;5419;3111;2308;620;433;29.0
8451;2016 woensdag 21 december;537;265;272;467;223;244;112;110;1.0;1.0;54.0;51.0;1.0;2.0;140;4486;2559;1927;773;380;21.0
8452;2016 donderdag 22 december;503;273;230;433;203;230;91;86;3.0;2.0;36.0;33.0;1.0;2.0;133;5113;2877;2236;635;499;187.0
8453;2016 vrijdag 23 december;498;271;227;441;218;223;140;138;1.0;1.0;20.0;17.0;0.0;3.0;144;5903;3379;2524;507;534;14.0
8454;2016 zaterdag 24 december;390;188;202;449;203;246;23;21;0.0;2.0;1.0;1.0;0.0;0.0;0;1904;1117;787;55;137;0.0
8455;2016 zondag 25 december;326;165;161;437;191;246;1;1;0.0;0.0;0.0;0.0;0.0;0.0;0;552;325;227;2;88;0.0
8456;2016 maandag 26 december;309;144;165;446;211;235;0;0;0.0;0.0;0.0;0.0;0.0;0.0;0;1049;560;489;2;68;2.0
8457;2016 dinsdag 27 december;422;221;201;418;185;233;151;147;2.0;2.0;109.0;104.0;3.0;2.0;146;5525;3190;2335;480;411;23.0
8458;2016 woensdag 28 december;488;241;247;478;246;232;107;103;2.0;2.0;59.0;57.0;2.0;0.0;168;6235;3594;2641;653;441;26.0
8459;2016 donderdag 29 december;512;274;238;477;223;254;72;72;0.0;0.0;30.0;28.0;0.0;2.0;147;5885;3596;2289;623;468;22.0
8460;2016 vrijdag 30 december;471;257;214;537;232;305;113;110;2.0;1.0;32.0;29.0;2.0;1.0;89;6986;4238;2748;444;568;13.0
8461;2016 zaterdag 31 december;333;175;158;503;243;260;33;32;1.0;0.0;2.0;2.0;0.0;0.0;0;2771;1644;1127;35;793;0.0
8462;Totaal 2016;172520;88587;83933;148997;72180;76817;65249;63813;665.0;771.0;15706.0;15090.0;286.0;330.0;33414;1791450;1023962;767488;230739;127320;28534.0
8463;Totaal op zondag in 2016;19420;9955;9465;19707;9452;10255;459;449;3.0;7.0;2.0;2.0;0.0;0.0;9;74382;41261;33121;1697;7242;18.0
8464;Totaal op maandag in 2016;24927;12735;12192;20698;10098;10600;10926;10672;113.0;141.0;6169.0;5971.0;84.0;114.0;6187;383743;215915;167828;47055;23549;5414.0
8465;Totaal op dinsdag in 2016;26196;13394;12802;21327;10355;10972;8024;7827;94.0;103.0;3968.0;3840.0;65.0;63.0;6721;274499;155651;118848;48427;20990;4510.0
8466;Totaal op woensdag in 2016;26466;13499;12967;21739;10643;11096;6223;6063;70.0;90.0;2404.0;2299.0;47.0;58.0;6935;248016;140897;107119;47879;19679;10528.0
8467;Totaal op donderdag in 2016;26406;13629;12777;21606;10369;11237;7169;6994;71.0;104.0;1484.0;1416.0;32.0;36.0;6650;296768;168474;128294;46079;21838;3586.0
8468;Totaal op vrijdag in 2016;27224;14009;13215;22736;11058;11678;22894;22447;207.0;240.0;1589.0;1482.0;53.0;54.0;6370;358345;208553;149792;36222;23710;3232.0
8469;Totaal op zaterdag in 2016;21660;11255;10405;21106;10161;10945;7464;7289;94.0;81.0;77.0;67.0;5.0;5.0;53;154473;92377;62096;3128;9455;832.0
8470;Overig 2016;221;111;110;78;44;34;2090;2072;13.0;5.0;13.0;13.0;0.0;0.0;489;1224;834;390;252;857;414.0
8471;Totaal januari 2016;13979;7131;6848;13767;6734;7033;2296;2236;33.0;27.0;1058.0;1026.0;9.0;23.0;2915;137884;78890;58994;17412;11029;2373.0
8472;Totaal februari 2016;13332;6800;6532;12926;6195;6731;2777;2718;30.0;29.0;1238.0;1182.0;27.0;29.0;2772;141877;81080;60797;19584;9498;2456.0
8473;Totaal maart 2016;14098;7251;6847;13696;6641;7055;3004;2932;34.0;38.0;1157.0;1115.0;19.0;23.0;2920;142857;83970;58887;16493;8943;3541.0
8474;Totaal april 2016;13807;7145;6662;12225;5870;6355;4982;4884;40.0;58.0;1203.0;1173.0;14.0;16.0;2775;137078;80130;56948;14504;8594;1852.0
8475;Totaal mei 2016;14498;7404;7094;12222;5824;6398;6876;6742;64.0;70.0;1316.0;1266.0;30.0;20.0;2716;132971;78025;54946;15029;8212;2357.0
8476;Totaal juni 2016;14519;7468;7051;11235;5443;5792;9698;9458;98.0;142.0;1318.0;1258.0;28.0;32.0;2905;141417;82895;58522;16644;11538;2193.0
8477;Totaal juli 2016;15666;8005;7661;11701;5712;5989;7324;7169;65.0;90.0;1335.0;1279.0;18.0;38.0;2762;160821;89484;71337;17350;14732;1176.0
8478;Totaal augustus 2016;15584;8027;7557;11399;5619;5780;6899;6739;79.0;81.0;1463.0;1410.0;19.0;34.0;2764;171346;91273;80073;31434;13659;556.0
8479;Totaal september 2016;15145;7792;7353;11264;5488;5776;9048;8842;88.0;118.0;1262.0;1215.0;23.0;24.0;2678;162498;88915;73583;30062;11729;4375.0
8480;Totaal oktober 2016;14516;7381;7135;12385;6059;6326;4530;4428;51.0;51.0;1506.0;1452.0;31.0;23.0;2316;149599;85367;64232;19474;9549;3035.0
8481;Totaal november 2016;13504;7007;6497;12319;5962;6357;2868;2816;24.0;28.0;1455.0;1390.0;36.0;29.0;2681;149373;86766;62607;17712;8497;2742.0
8482;Totaal december 2016;13651;7065;6586;13780;6589;7191;2857;2777;46.0;34.0;1382.0;1311.0;32.0;39.0;2721;162505;96333;66172;14789;10483;1464.0
8483;Totaal januari 2017;14090;7146;6944;15812;7430;8382;2654;2599;25.0;30.0;1448.0;1408.0;13.0;27.0;2960;158411;90686;67725;17367;11450;1970.0
8484;2017 zondag 1 januari;326;158;168;469;221;248;7;7;0.0;0.0;0.0;0.0;0.0;0.0;0;21538;11669;9869;149;955;0.0
8485;2017 maandag 2 januari;454;229;225;470;208;262;113;112;0.0;1.0;61.0;58.0;0.0;3.0;114;8994;5094;3900;746;502;17.0
8486;2017 dinsdag 3 januari;507;280;227;529;240;289;130;129;1.0;0.0;100.0;96.0;1.0;3.0;118;4899;2705;2194;724;381;33.0
8487;2017 woensdag 4 januari;487;260;227;544;257;287;98;97;0.0;1.0;46.0;46.0;0.0;0.0;110;4486;2549;1937;737;330;23.0
8488;2017 donderdag 5 januari;484;220;264;493;220;273;69;67;1.0;1.0;31.0;30.0;1.0;0.0;137;5143;2874;2269;795;405;46.0
8489;2017 vrijdag 6 januari;479;233;246;516;250;266;119;116;3.0;0.0;31.0;31.0;0.0;0.0;90;5471;3224;2247;623;359;27.0
8490;2017 zaterdag 7 januari;406;214;192;533;259;274;41;39;1.0;1.0;1.0;1.0;0.0;0.0;0;2687;1609;1078;41;114;0.0
8491;2017 zondag 8 januari;351;170;181;482;242;240;7;7;0.0;0.0;1.0;0.0;1.0;0.0;2;1324;752;572;28;123;1.0
8492;2017 maandag 9 januari;440;228;212;517;247;270;164;163;1.0;0.0;127.0;124.0;0.0;3.0;121;6784;3793;2991;675;366;16.0
8493;2017 dinsdag 10 januari;518;252;266;525;245;280;122;118;2.0;2.0;103.0;100.0;1.0;2.0;140;4541;2593;1948;732;383;33.0
8494;2017 woensdag 11 januari;479;267;212;553;265;288;62;61;0.0;1.0;47.0;46.0;1.0;0.0;160;4061;2296;1765;747;317;24.0
8495;2017 donderdag 12 januari;508;244;264;551;267;284;70;69;0.0;1.0;28.0;27.0;0.0;1.0;141;4791;2694;2097;701;285;38.0
8496;2017 vrijdag 13 januari;489;249;240;545;265;280;91;89;0.0;2.0;21.0;20.0;0.0;1.0;120;5036;3011;2025;598;359;23.0
8497;2017 zaterdag 14 januari;359;179;180;480;232;248;41;41;0.0;0.0;1.0;1.0;0.0;0.0;2;2709;1696;1013;16;150;0.0
8498;2017 zondag 15 januari;357;177;180;466;220;246;6;6;0.0;0.0;0.0;0.0;0.0;0.0;0;2368;1387;981;24;192;0.0
8499;2017 maandag 16 januari;458;228;230;467;214;253;151;147;3.0;1.0;139.0;138.0;0.0;1.0;115;8680;5242;3438;921;415;608.0
8500;2017 dinsdag 17 januari;519;253;266;506;226;280;193;189;1.0;3.0;91.0;90.0;1.0;0.0;142;4153;2299;1854;746;276;36.0
8501;2017 woensdag 18 januari;438;225;213;487;228;259;76;74;2.0;0.0;41.0;40.0;0.0;1.0;139;4098;2358;1740;778;297;47.0
8502;2017 donderdag 19 januari;458;229;229;508;235;273;57;55;1.0;1.0;17.0;15.0;0.0;2.0;166;4022;2293;1729;782;314;12.0
8503;2017 vrijdag 20 januari;466;246;220;523;269;254;130;123;2.0;5.0;48.0;46.0;1.0;1.0;158;5638;3378;2260;637;462;16.0
8504;2017 zaterdag 21 januari;428;217;211;501;227;274;41;40;1.0;0.0;1.0;1.0;0.0;0.0;1;2844;1756;1088;49;128;0.0
8505;2017 zondag 22 januari;373;197;176;495;240;255;9;9;0.0;0.0;0.0;0.0;0.0;0.0;0;1085;631;454;61;104;0.0
8506;2017 maandag 23 januari;478;240;238;508;223;285;153;150;1.0;2.0;113.0;109.0;1.0;3.0;147;6112;3481;2631;749;354;37.0
8507;2017 dinsdag 24 januari;524;270;254;517;230;287;125;124;0.0;1.0;86.0;86.0;0.0;0.0;153;4189;2421;1768;676;317;477.0
8508;2017 woensdag 25 januari;521;264;257;524;233;291;75;73;1.0;1.0;59.0;55.0;2.0;2.0;138;4201;2453;1748;927;447;50.0
8509;2017 donderdag 26 januari;498;254;244;551;254;297;60;59;0.0;1.0;25.0;25.0;0.0;0.0;129;4475;2542;1933;745;475;301.0
8510;2017 vrijdag 27 januari;525;255;270;546;267;279;136;131;2.0;3.0;35.0;34.0;0.0;1.0;131;5663;3295;2368;633;581;34.0
8511;2017 zaterdag 28 januari;440;235;205;504;242;262;37;37;0.0;0.0;3.0;3.0;0.0;0.0;0;3506;2030;1476;184;297;0.0
8512;2017 zondag 29 januari;369;184;185;475;229;246;5;5;0.0;0.0;0.0;0.0;0.0;0.0;1;1238;657;581;51;215;0.0
8513;2017 maandag 30 januari;466;238;228;510;232;278;156;153;1.0;2.0;112.0;107.0;2.0;3.0;137;6699;3822;2877;834;684;38.0
8514;2017 dinsdag 31 januari;485;251;234;517;243;274;110;109;1.0;0.0;80.0;79.0;1.0;0.0;148;6976;4082;2894;1258;863;33.0
8515;Totaal februari 2017;12567;6512;6055;13640;6467;7173;2654;2607;28.0;19.0;1366.0;1317.0;19.0;30.0;2693;150226;85951;64275;19701;9176;2589.0
8516;2017 woensdag 1 februari;502;266;236;522;250;272;91;90;1.0;0.0;53.0;53.0;0.0;0.0;127;31215;17581;13634;1798;968;37.0
8517;2017 donderdag 2 februari;511;264;247;543;271;272;73;72;1.0;0.0;25.0;25.0;0.0;0.0;148;5096;2947;2149;1193;424;26.0
8518;2017 vrijdag 3 februari;525;276;249;543;247;296;89;84;2.0;3.0;19.0;17.0;1.0;1.0;120;5127;2853;2274;1119;458;22.0
8519;2017 zaterdag 4 februari;372;198;174;461;225;236;31;31;0.0;0.0;2.0;2.0;0.0;0.0;2;2548;1407;1141;157;182;0.0
8520;2017 zondag 5 februari;377;187;190;477;229;248;4;4;0.0;0.0;0.0;0.0;0.0;0.0;0;1307;664;643;81;142;1.0
8521;2017 maandag 6 februari;442;200;242;506;243;263;171;170;0.0;1.0;120.0;118.0;2.0;0.0;147;6147;3360;2787;1012;406;1297.0
8522;2017 dinsdag 7 februari;551;291;260;502;253;249;131;128;1.0;2.0;81.0;80.0;1.0;0.0;162;4267;2404;1863;973;406;35.0
8523;2017 woensdag 8 februari;448;224;224;487;229;258;81;80;1.0;0.0;43.0;41.0;1.0;1.0;135;4179;2473;1706;1002;304;17.0
8524;2017 donderdag 9 februari;518;269;249;510;256;254;54;53;0.0;1.0;40.0;34.0;2.0;4.0;125;4143;2435;1708;1220;351;47.0
8525;2017 vrijdag 10 februari;506;279;227;516;228;288;103;102;0.0;1.0;29.0;28.0;1.0;0.0;152;5476;3191;2285;745;471;18.0
8526;2017 zaterdag 11 februari;402;211;191;463;215;248;27;26;0.0;1.0;0.0;0.0;0.0;0.0;0;2768;1613;1155;53;103;0.0
8527;2017 zondag 12 februari;354;188;166;462;209;253;3;2;1.0;0.0;0.0;0.0;0.0;0.0;0;1137;596;541;79;96;1.0
8528;2017 maandag 13 februari;478;248;230;476;234;242;136;132;1.0;3.0;113.0;111.0;2.0;0.0;134;5737;3146;2591;982;264;35.0
8529;2017 dinsdag 14 februari;519;282;237;493;242;251;301;298;2.0;1.0;126.0;119.0;2.0;5.0;148;4623;2600;2023;871;305;40.0
8530;2017 woensdag 15 februari;480;239;241;531;255;276;77;77;0.0;0.0;54.0;53.0;0.0;1.0;140;7264;4271;2993;966;367;36.0
8531;2017 donderdag 16 februari ;468;239;229;490;244;246;67;65;1.0;1.0;32.0;32.0;0.0;0.0;144;4990;2838;2152;1030;330;27.0
8532;2017 vrijdag 17 februari;502;259;243;493;244;249;278;275;3.0;0.0;43.0;39.0;0.0;4.0;119;5481;3257;2224;711;318;25.0
8533;2017 zaterdag 18 februari;353;198;155;466;210;256;38;37;1.0;0.0;1.0;1.0;0.0;0.0;1;3314;2017;1297;86;108;1.0
8534;2017 zondag 19 februari;349;188;161;468;198;270;6;6;0.0;0.0;0.0;0.0;0.0;0.0;0;1127;643;484;64;64;0.0
8535;2017 maandag 20 februari;440;220;220;485;243;242;173;171;2.0;0.0;144.0;140.0;1.0;3.0;135;6957;4046;2911;836;376;36.0
8536;2017 dinsdag 21 februari;463;243;220;484;227;257;142;139;2.0;1.0;122.0;121.0;0.0;1.0;132;4155;2295;1860;1108;318;45.0
8537;2017 woensdag 22 februari;501;255;246;524;246;278;91;89;1.0;1.0;61.0;58.0;1.0;2.0;140;4574;2684;1890;789;301;19.0
8538;2017 donderdag 23 februari;427;216;211;474;213;261;67;67;0.0;0.0;27.0;25.0;0.0;2.0;117;4623;2588;2035;752;301;743.0
8539;2017 vrijdag 24 februari;466;232;234;489;231;258;115;109;5.0;1.0;29.0;27.0;2.0;0.0;121;6041;3548;2493;554;438;21.0
8540;2017 zaterdag 25 februari;361;189;172;437;199;238;41;40;1.0;0.0;3.0;3.0;0.0;0.0;0;3715;2259;1456;68;160;1.0
8541;2017 zondag 26 februari;307;150;157;434;199;235;7;7;0.0;0.0;0.0;0.0;0.0;0.0;0;1116;601;515;70;98;1.0
8542;2017 maandag 27 februari;461;249;212;446;204;242;144;142;1.0;1.0;106.0;102.0;2.0;2.0;132;6157;3538;2619;692;354;14.0
8543;2017 dinsdag 28 februari;484;252;232;458;223;235;113;111;1.0;1.0;93.0;88.0;1.0;4.0;112;6942;4096;2846;690;763;44.0
8544;Totaal maart 2017;13679;6940;6739;13036;6279;6757;3176;3113;34.0;29.0;1468.0;1414.0;23.0;31.0;3008;163889;96356;67533;17277;8876;2958.0
8545;2017 woensdag 1 maart;462;241;221;463;236;227;90;85;2.0;3.0;63.0;61.0;1.0;1.0;138;30910;18243;12667;931;822;61.0
8546;2017 donderdag 2 maart;477;233;244;470;233;237;81;79;2.0;0.0;24.0;24.0;0.0;0.0;136;5276;2870;2406;843;324;43.0
8547;2017 vrijdag 3 maart;492;241;251;443;221;222;175;172;1.0;2.0;34.0;30.0;2.0;2.0;115;5335;3225;2110;746;306;18.0
8548;2017 zaterdag 4 maart;402;204;198;439;198;241;38;37;1.0;0.0;0.0;0.0;0.0;0.0;0;2555;1537;1018;81;114;0.0
8549;2017 zondag 5 maart;362;194;168;433;196;237;6;6;0.0;0.0;0.0;0.0;0.0;0.0;0;1302;715;587;69;86;0.0
8550;2017 maandag 6 maart;443;226;217;422;201;221;180;176;1.0;3.0;135.0;129.0;3.0;3.0;112;6492;3714;2778;824;272;334.0
8551;2017 dinsdag 7 maart;487;238;249;446;229;217;145;142;3.0;0.0;89.0;85.0;2.0;2.0;130;4605;2543;2062;806;314;58.0
8552;2017 woensdag 8 maart;466;227;239;482;237;245;68;66;0.0;2.0;58.0;54.0;2.0;2.0;132;4453;2460;1993;801;266;41.0
8553;2017 donderdag 9 maart;430;217;213;439;218;221;73;72;0.0;1.0;24.0;24.0;0.0;0.0;120;4447;2512;1935;757;236;24.0
8554;2017 vrijdag 10 maart;488;242;246;458;199;259;156;154;0.0;2.0;34.0;32.0;1.0;1.0;142;5328;3181;2147;494;296;40.0
8555;2017 zaterdag 11 maart;349;175;174;411;201;210;38;37;1.0;0.0;0.0;0.0;0.0;0.0;1;2395;1510;885;39;88;0.0
8556;2017 zondag 12 maart;328;162;166;395;195;200;2;2;0.0;0.0;0.0;0.0;0.0;0.0;0;999;583;416;76;52;0.0
8557;2017 maandag 13 maart;438;211;227;396;182;214;131;131;0.0;0.0;136.0;132.0;1.0;3.0;135;5698;3291;2407;627;320;577.0
8558;2017 dinsdag 14 maart;453;203;250;436;197;239;122;120;2.0;0.0;79.0;76.0;0.0;3.0;129;4263;2517;1746;724;270;467.0
8559;2017 woensdag 15 maart;485;275;210;439;209;230;57;56;1.0;0.0;28.0;26.0;2.0;0.0;107;7828;4789;3039;732;350;29.0
8560;2017 donderdag 16 maart;437;231;206;385;183;202;62;61;1.0;0.0;27.0;26.0;1.0;0.0;97;4598;2595;2003;653;259;15.0
8561;2017 vrijdag 17 maart;453;216;237;408;190;218;239;235;1.0;3.0;38.0;38.0;0.0;0.0;151;5081;2928;2153;589;284;34.0
8562;2017 zaterdag 18 maart;372;190;182;385;180;205;40;38;2.0;0.0;1.0;0.0;0.0;1.0;0;2838;1774;1064;62;87;1.0
8563;2017 zondag 19 maart;354;187;167;394;209;185;6;6;0.0;0.0;0.0;0.0;0.0;0.0;0;1034;590;444;47;86;0.0
8564;2017 maandag 20 maart;450;233;217;384;194;190;179;174;2.0;3.0;141.0;138.0;2.0;1.0;135;6500;3745;2755;738;329;57.0
8565;2017 dinsdag 21 maart;470;254;216;453;202;251;184;181;3.0;0.0;93.0;91.0;1.0;1.0;150;3957;2306;1651;734;279;323.0
8566;2017 woensdag 22 maart;475;244;231;402;189;213;88;85;0.0;3.0;53.0;53.0;0.0;0.0;162;3878;2238;1640;794;272;42.0
8567;2017 donderdag 23 maart;498;246;252;405;196;209;78;75;3.0;0.0;27.0;27.0;0.0;0.0;128;4124;2287;1837;684;315;49.0
8568;2017 vrijdag 24 maart;498;256;242;394;186;208;176;171;2.0;3.0;29.0;27.0;2.0;0.0;128;5234;3262;1972;585;321;20.0
8569;2017 zaterdag 25 maart;384;198;186;385;197;188;59;59;0.0;0.0;3.0;2.0;0.0;1.0;1;3783;2399;1384;70;115;0.0
8570;2017 zondag 26 maart;361;190;171;355;163;192;2;2;0.0;0.0;0.0;0.0;0.0;0.0;0;1091;591;500;49;104;0.0
8571;2017 maandag 27 maart;457;237;220;438;221;217;184;182;0.0;2.0;138.0;135.0;1.0;2.0;144;6065;3490;2575;763;408;47.0
8572;2017 dinsdag 28 maart;464;238;226;412;190;222;152;151;1.0;0.0;107.0;106.0;0.0;1.0;108;4203;2471;1732;677;350;589.0
8573;2017 woensdag 29 maart;484;248;236;419;205;214;92;88;3.0;1.0;50.0;48.0;0.0;2.0;164;4138;2387;1751;904;319;38.0
8574;2017 donderdag 30 maart;479;244;235;393;197;196;70;70;0.0;0.0;31.0;27.0;1.0;3.0;124;5280;3076;2204;786;425;19.0
8575;2017 vrijdag 31 maart;481;239;242;452;225;227;203;200;2.0;1.0;26.0;23.0;1.0;2.0;119;10199;6527;3672;592;807;32.0
8576;Totaal april 2017;13401;6919;6482;11792;5696;6096;4198;4109;37.0;52.0;1284.0;1229.0;32.0;23.0;2296;137694;81680;56014;13768;7637;2198.0
8577;2017 zaterdag 1 april;401;219;182;352;175;177;74;71;1.0;2.0;1.0;1.0;0.0;0.0;1;22969;13473;9496;168;651;0.0
8578;2017 zondag 2 april;308;143;165;383;191;192;9;9;0.0;0.0;0.0;0.0;0.0;0.0;0;1183;679;504;49;104;0.0
8579;2017 maandag 3 april;465;245;220;378;181;197;170;167;1.0;2.0;150.0;145.0;2.0;3.0;154;8802;5128;3674;842;357;37.0
8580;2017 dinsdag 4 april;475;241;234;422;201;221;182;176;3.0;3.0;98.0;93.0;2.0;3.0;154;4401;2473;1928;809;287;572.0
8581;2017 woensdag 5 april ;467;248;219;404;189;215;98;97;0.0;1.0;48.0;46.0;1.0;1.0;137;4115;2410;1705;752;286;32.0
8582;2017 donderdag 6 april;451;235;216;412;188;224;84;84;0.0;0.0;26.0;24.0;0.0;2.0;120;3952;2287;1665;803;299;37.0
8583;2017 vrijdag 7 april;494;241;253;404;194;210;312;305;1.0;6.0;34.0;33.0;1.0;0.0;108;5136;2980;2156;668;340;27.0
8584;2017 zaterdag 8 april;380;195;185;385;196;189;70;69;0.0;1.0;3.0;3.0;0.0;0.0;1;2570;1626;944;65;79;0.0
8585;2017 zondag 9 april;346;178;168;358;158;200;5;5;0.0;0.0;0.0;0.0;0.0;0.0;0;904;545;359;61;88;0.0
8586;2017 maandag 10 april;472;237;235;358;174;184;194;189;2.0;3.0;128.0;126.0;2.0;0.0;141;6461;3875;2586;815;319;39.0
8587;2017 dinsdag 11 april;522;272;250;425;213;212;153;151;0.0;2.0;88.0;86.0;2.0;0.0;152;3784;2125;1659;794;239;51.0
8588;2017 woensdag 12 april;494;245;249;448;216;232;129;127;2.0;0.0;60.0;57.0;1.0;2.0;102;4122;2401;1721;744;263;33.0
8589;2017 donderdag 13 april;494;251;243;394;195;199;127;123;2.0;2.0;30.0;30.0;0.0;0.0;124;5423;3216;2207;836;277;51.0
8590;2017 vrijdag 14 april;506;252;254;402;200;202;121;118;0.0;3.0;13.0;11.0;1.0;1.0;67;4407;2757;1650;290;190;15.0
8591;2017 zaterdag 15 april;394;198;196;412;200;212;71;67;2.0;2.0;0.0;0.0;0.0;0.0;1;4206;2640;1566;41;109;0.0
8592;2017 zondag 16 april;369;205;164;369;182;187;9;9;0.0;0.0;0.0;0.0;0.0;0.0;0;1042;586;456;74;72;0.0
8593;2017 maandag 17 april;357;182;175;357;154;203;13;13;0.0;0.0;1.0;1.0;0.0;0.0;1;1973;1168;805;31;88;2.0
8594;2017 dinsdag 18 april;447;247;200;390;199;191;199;198;0.0;1.0;126.0;118.0;5.0;3.0;138;5668;3412;2256;800;359;46.0
8595;2017 woensdag 19 april;460;242;218;394;194;200;142;137;2.0;3.0;57.0;54.0;3.0;0.0;117;4165;2476;1689;691;201;47.0
8596;2017 donderdag 20 april;468;230;238;391;176;215;159;157;1.0;1.0;47.0;45.0;0.0;2.0;132;5188;3110;2078;917;322;930.0
8597;2017 vrijdag 21 april;538;284;254;419;208;211;582;574;2.0;6.0;49.0;46.0;2.0;1.0;122;5557;3294;2263;582;336;56.0
8598;2017 zaterdag 22 april;396;212;184;382;196;186;124;119;3.0;2.0;1.0;1.0;0.0;0.0;1;2921;1839;1082;62;79;0.0
8599;2017 zondag 23 april;406;213;193;379;198;181;10;10;0.0;0.0;0.0;0.0;0.0;0.0;0;963;524;439;59;87;0.0
8600;2017 maandag 24 april;501;265;236;417;195;222;261;251;4.0;6.0;139.0;130.0;5.0;4.0;135;6570;3818;2752;724;389;21.0
8601;2017 dinsdag 25 april;489;237;252;390;193;197;197;192;4.0;1.0;98.0;95.0;3.0;0.0;141;4471;2679;1792;775;336;83.0
8602;2017 woensdag 26 april;533;296;237;417;211;206;199;196;2.0;1.0;53.0;53.0;0.0;0.0;163;5146;3012;2134;799;427;56.0
8603;2017 donderdag 27 april;444;230;214;395;185;210;22;22;0.0;0.0;0.0;0.0;0.0;0.0;4;1261;755;506;65;106;1.0
8604;2017 vrijdag 28 april;482;234;248;421;185;236;338;330;4.0;4.0;31.0;29.0;1.0;1.0;80;5647;3438;2209;354;319;62.0
8605;2017 zaterdag 29 april;445;248;197;341;154;187;130;129;1.0;0.0;2.0;1.0;1.0;0.0;0;2533;1649;884;19;215;0.0
8606;2017 zondag 30 april;397;194;203;393;195;198;14;14;0.0;0.0;1.0;1.0;0.0;0.0;0;2154;1305;849;79;413;0.0
8607;Totaal mei 2017;14355;7319;7036;12328;5948;6380;6783;6638;60.0;85.0;1587.0;1532.0;26.0;29.0;2721;150381;89615;60766;15711;8213;3150.0
8608;2017 maandag 1 mei;475;230;245;423;198;225;271;266;0.0;5.0;125.0;123.0;0.0;2.0;127;31152;18721;12431;848;882;32.0
8609;2017 dinsdag 2 mei;523;268;255;362;196;166;192;186;5.0;1.0;80.0;76.0;2.0;2.0;148;5295;3026;2269;713;352;31.0
8610;2017 woensdag 3 mei;512;254;258;407;210;197;140;139;1.0;0.0;47.0;46.0;0.0;1.0;140;4560;2654;1906;837;285;41.0
8611;2017 donderdag 4 mei;446;226;220;444;222;222;63;63;0.0;0.0;33.0;32.0;1.0;0.0;119;4044;2282;1762;704;297;31.0
8612;2017 vrijdag 5 mei;436;228;208;397;187;210;125;121;3.0;1.0;7.0;7.0;0.0;0.0;20;3537;2163;1374;149;129;7.0
8613;2017 zaterdag 6 mei;386;203;183;383;176;207;175;169;3.0;3.0;1.0;1.0;0.0;0.0;0;2101;1320;781;39;88;0.0
8614;2017 zondag 7 mei;389;206;183;353;170;183;12;12;0.0;0.0;0.0;0.0;0.0;0.0;0;981;530;451;48;65;0.0
8615;2017 maandag 8 mei;495;251;244;375;180;195;191;188;0.0;3.0;129.0;125.0;3.0;1.0;155;6457;3833;2624;791;349;564.0
8616;2017 dinsdag 9 mei;502;237;265;433;200;233;162;159;3.0;0.0;93.0;91.0;1.0;1.0;153;3901;2235;1666;693;342;73.0
8617;2017 woensdag 10 mei;497;256;241;378;177;201;128;127;0.0;1.0;52.0;50.0;0.0;2.0;157;4560;2621;1939;716;255;51.0
8618;2017 donderdag 11 mei;511;271;240;411;198;213;150;147;0.0;3.0;48.0;48.0;0.0;0.0;121;3940;2253;1687;830;218;34.0
8619;2017 vrijdag 12 mei;476;232;244;416;203;213;808;791;7.0;10.0;55.0;49.0;0.0;6.0;118;4923;3011;1912;598;248;14.0
8620;2017 zaterdag 13 mei;369;201;168;403;187;216;126;125;0.0;1.0;0.0;0.0;0.0;0.0;2;2156;1385;771;55;86;0.0
8621;2017 zondag 14 mei;359;195;164;385;175;210;8;8;0.0;0.0;0.0;0.0;0.0;0.0;0;961;581;380;55;88;0.0
8622;2017 maandag 15 mei;475;249;226;388;202;186;231;226;3.0;2.0;129.0;127.0;1.0;1.0;137;9575;5831;3744;755;370;37.0
8623;2017 dinsdag 16 mei;501;259;242;423;198;225;180;176;1.0;3.0;74.0;68.0;5.0;1.0;122;4120;2371;1749;696;295;32.0
8624;2017 woensdag 17 mei;505;236;269;400;199;201;218;214;2.0;2.0;53.0;51.0;1.0;1.0;141;3906;2250;1656;957;236;29.0
8625;2017 donderdag 18 mei;540;297;243;422;195;227;171;167;3.0;1.0;37.0;37.0;0.0;0.0;116;4213;2418;1795;715;214;55.0
8626;2017 vrijdag 19 mei;503;248;255;454;213;241;699;689;4.0;6.0;38.0;38.0;0.0;0.0;119;4424;2727;1697;559;231;44.0
8627;2017 zaterdag 20 mei;387;208;179;368;173;195;301;294;3.0;4.0;1.0;1.0;0.0;0.0;0;2802;1758;1044;45;120;0.0
8628;2017 zondag 21 mei;377;200;177;346;168;178;20;20;0.0;0.0;0.0;0.0;0.0;0.0;0;945;574;371;57;50;0.0
8629;2017 maandag 22 mei;513;280;233;374;163;211;235;231;1.0;3.0;113.0;109.0;3.0;1.0;149;5663;3386;2277;722;305;47.0
8630;2017 dinsdag 23 mei;524;263;261;444;219;225;228;224;2.0;2.0;99.0;95.0;2.0;2.0;130;3965;2193;1772;702;283;899.0
8631;2017 woensdag 24 mei;484;235;249;429;212;217;510;498;3.0;9.0;59.0;55.0;3.0;1.0;154;5118;3004;2114;778;342;28.0
8632;2017 donderdag 25 mei;399;200;199;400;200;200;28;27;0.0;1.0;0.0;0.0;0.0;0.0;3;2028;1194;834;91;108;0.0
8633;2017 vrijdag 26 mei;499;250;249;373;180;193;646;626;8.0;12.0;27.0;26.0;1.0;0.0;43;3847;2435;1412;352;198;10.0
8634;2017 zaterdag 27 mei;431;198;233;380;190;190;217;210;2.0;5.0;2.0;2.0;0.0;0.0;0;2532;1614;918;43;100;0.0
8635;2017 zondag 28 mei;372;179;193;372;197;175;9;8;1.0;0.0;0.0;0.0;0.0;0.0;0;1129;664;465;25;90;0.0
8636;2017 maandag 29 mei;475;244;231;393;174;219;228;222;3.0;3.0;134.0;130.0;1.0;3.0;100;6263;3700;2563;777;398;606.0
8637;2017 dinsdag 30 mei;520;275;245;390;200;190;178;174;1.0;3.0;109.0;105.0;0.0;4.0;121;4676;2742;1934;701;427;35.0
8638;2017 woensdag 31 mei;474;240;234;402;186;216;133;131;1.0;1.0;42.0;40.0;2.0;0.0;126;6607;4139;2468;660;762;450.0
8639;Totaal juni 2017;13992;7165;6827;11391;5519;5872;8031;7849;77.0;105.0;1287.0;1228.0;27.0;32.0;2800;150905;90095;60810;16217;11756;2536.0
8640;2017 donderdag 1 juni;492;257;235;393;210;183;233;228;2.0;3.0;40.0;37.0;1.0;2.0;159;27894;16746;11148;821;848;41.0
8641;2017 vrijdag 2 juni;511;285;226;400;190;210;728;716;5.0;7.0;44.0;36.0;4.0;4.0;148;5293;3087;2206;631;327;30.0
8642;2017 zaterdag 3 juni;377;196;181;376;164;212;213;211;1.0;1.0;1.0;1.0;0.0;0.0;0;2286;1438;848;25;160;1.0
8643;2017 zondag 4 juni;382;184;198;346;171;175;21;21;0.0;0.0;0.0;0.0;0.0;0.0;0;872;511;361;22;87;0.0
8644;2017 maandag 5 juni;367;183;184;342;152;190;14;14;0.0;0.0;0.0;0.0;0.0;0.0;4;2148;1273;875;70;124;0.0
8645;2017 dinsdag 6 juni;468;233;235;414;186;228;228;221;3.0;4.0;93.0;86.0;3.0;4.0;115;5093;3008;2085;837;325;14.0
8646;2017 woensdag 7 juni;471;229;242;365;172;193;156;153;0.0;3.0;55.0;54.0;1.0;0.0;136;4771;2779;1992;864;349;30.0
8647;2017 donderdag 8 juni;483;262;221;366;173;193;149;145;1.0;3.0;39.0;38.0;1.0;0.0;133;4756;2755;2001;770;357;43.0
8648;2017 vrijdag 9 juni;527;273;254;409;197;212;680;661;11.0;8.0;31.0;31.0;0.0;0.0;127;4625;2745;1880;530;310;26.0
8649;2017 zaterdag 10 juni;420;219;201;377;189;188;279;267;7.0;5.0;1.0;1.0;0.0;0.0;2;2753;1775;978;79;144;2.0
8650;2017 zondag 11 juni;364;171;193;348;157;191;12;12;0.0;0.0;0.0;0.0;0.0;0.0;0;963;523;440;23;104;0.0
8651;2017 maandag 12 juni;467;232;235;371;183;188;259;255;0.0;4.0;122.0;117.0;1.0;4.0;131;5909;3437;2472;856;433;27.0
8652;2017 dinsdag 13 juni;486;244;242;380;163;217;159;157;1.0;1.0;87.0;84.0;2.0;1.0;125;3531;2030;1501;868;362;444.0
8653;2017 woensdag 14 juni;538;294;244;367;180;187;138;135;2.0;1.0;62.0;57.0;3.0;2.0;142;4218;2440;1778;737;315;21.0
8654;2017 donderdag 15 juni;520;258;262;397;201;196;168;166;1.0;1.0;28.0;28.0;0.0;0.0;160;7355;4360;2995;1021;381;62.0
8655;2017 vrijdag 16 juni;517;248;269;382;181;201;785;772;5.0;8.0;37.0;35.0;1.0;1.0;139;5491;3334;2157;578;365;17.0
8656;2017 zaterdag 17 juni;356;183;173;369;183;186;380;373;4.0;3.0;5.0;5.0;0.0;0.0;2;2613;1649;964;42;110;2.0
8657;2017 zondag 18 juni;416;205;211;376;188;188;11;11;0.0;0.0;0.0;0.0;0.0;0.0;0;893;510;383;26;88;0.0
8658;2017 maandag 19 juni;489;262;227;382;194;188;241;235;3.0;3.0;120.0;119.0;0.0;1.0;119;5461;3180;2281;852;390;16.0
8659;2017 dinsdag 20 juni;460;242;218;397;171;226;177;167;3.0;7.0;84.0;83.0;1.0;0.0;137;4006;2380;1626;639;418;32.0
8660;2017 woensdag 21 juni;512;260;252;387;184;203;214;199;4.0;11.0;49.0;49.0;0.0;0.0;136;3876;2252;1624;783;380;42.0
8661;2017 donderdag 22 juni;499;239;260;379;184;195;187;185;0.0;2.0;27.0;24.0;2.0;1.0;137;4053;2337;1716;717;376;42.0
8662;2017 vrijdag 23 juni;495;249;246;383;182;201;727;718;4.0;5.0;44.0;41.0;1.0;2.0;120;5166;3071;2095;584;464;1014.0
8663;2017 zaterdag 24 juni;413;220;193;367;192;175;328;324;4.0;0.0;3.0;3.0;0.0;0.0;0;3558;2310;1248;34;249;0.0
8664;2017 zondag 25 juni;358;185;173;330;160;170;13;12;1.0;0.0;0.0;0.0;0.0;0.0;0;1330;770;560;31;200;0.0
8665;2017 maandag 26 juni;478;226;252;399;212;187;235;227;4.0;4.0;140.0;132.0;2.0;6.0;132;6026;3603;2423;730;564;46.0
8666;2017 dinsdag 27 juni;583;309;274;401;206;195;177;171;3.0;3.0;67.0;66.0;1.0;0.0;131;4136;2428;1708;797;591;39.0
8667;2017 woensdag 28 juni;536;271;265;400;196;204;150;147;1.0;2.0;41.0;38.0;1.0;2.0;130;4868;2982;1886;838;613;489.0
8668;2017 donderdag 29 juni;497;264;233;390;206;184;162;160;1.0;1.0;33.0;30.0;1.0;2.0;123;5778;3494;2284;760;740;35.0
8669;2017 vrijdag 30 juni;510;282;228;398;192;206;807;786;6.0;15.0;34.0;33.0;1.0;0.0;112;11183;6888;4295;652;1582;21.0
8670;Totaal juli 2017;15022;7762;7260;11529;5622;5907;8658;8459;86.0;113.0;1527.0;1477.0;31.0;19.0;2838;167546;94190;73356;18249;15434;938.0
8671;2017 zaterdag 1 juli;404;195;209;375;181;194;655;643;6.0;6.0;8.0;7.0;1.0;0.0;0;25220;13696;11524;173;1141;2.0
8672;2017 zondag 2 juli;421;206;215;328;157;171;8;8;0.0;0.0;0.0;0.0;0.0;0.0;0;1337;725;612;42;234;0.0
8673;2017 maandag 3 juli;446;252;194;376;177;199;256;248;0.0;8.0;114.0;113.0;1.0;0.0;120;9516;5651;3865;942;638;38.0
8674;2017 dinsdag 4 juli;485;240;245;410;188;222;230;220;6.0;4.0;87.0;83.0;2.0;2.0;153;4415;2451;1964;900;515;31.0
8675;2017 woensdag 5 juli;517;259;258;368;164;204;169;161;3.0;5.0;54.0;51.0;2.0;1.0;158;4639;2649;1990;826;540;203.0
8676;2017 donderdag 6 juli;535;265;270;414;196;218;190;184;0.0;6.0;52.0;52.0;0.0;0.0;117;4417;2555;1862;870;454;176.0
8677;2017 vrijdag 7 juli;544;289;255;424;223;201;1991;1941;17.0;33.0;58.0;55.0;2.0;1.0;133;6082;3451;2631;679;544;48.0
8678;2017 zaterdag 8 juli;421;221;200;370;186;184;291;284;5.0;2.0;2.0;2.0;0.0;0.0;0;2895;1692;1203;17;219;0.0
8679;2017 zondag 9 juli;401;223;178;333;153;180;15;15;0.0;0.0;0.0;0.0;0.0;0.0;0;1109;566;543;30;211;0.0
8680;2017 maandag 10 juli;514;283;231;367;178;189;297;291;1.0;5.0;129.0;127.0;2.0;0.0;126;7846;4414;3432;955;579;42.0
8681;2017 dinsdag 11 juli;515;265;250;352;166;186;195;193;0.0;2.0;99.0;91.0;5.0;3.0;152;4228;2262;1966;952;637;36.0
8682;2017 woensdag 12 juli;479;248;231;374;190;184;148;147;0.0;1.0;45.0;43.0;0.0;2.0;166;4580;2511;2069;815;554;37.0
8683;2017 donderdag 13 juli;533;289;244;366;176;190;135;132;3.0;0.0;21.0;21.0;0.0;0.0;128;4820;2651;2169;872;558;31.0
8684;2017 vrijdag 14 juli;545;285;260;396;209;187;675;665;6.0;4.0;29.0;28.0;0.0;1.0;132;7457;4338;3119;780;593;16.0
8685;2017 zaterdag 15 juli;423;219;204;342;181;161;236;231;2.0;3.0;1.0;1.0;0.0;0.0;1;4948;2800;2148;31;416;0.0
8686;2017 zondag 16 juli;412;209;203;321;146;175;13;13;0.0;0.0;0.0;0.0;0.0;0.0;0;1423;773;650;28;204;0.0
8687;2017 maandag 17 juli;501;261;240;364;177;187;682;666;10.0;6.0;117.0;116.0;1.0;0.0;130;8043;4501;3542;905;574;14.0
8688;2017 dinsdag 18 juli;521;270;251;374;191;183;170;168;1.0;1.0;96.0;94.0;2.0;0.0;140;4409;2421;1988;907;448;26.0
8689;2017 woensdag 19 juli;521;259;262;428;211;217;131;130;1.0;0.0;45.0;43.0;1.0;1.0;137;4169;2385;1784;802;435;40.0
8690;2017 donderdag 20 juli;502;263;239;391;173;218;186;182;2.0;2.0;40.0;40.0;0.0;0.0;104;5366;2954;2412;870;530;28.0
8691;2017 vrijdag 21 juli;538;281;257;365;188;177;460;450;4.0;6.0;44.0;38.0;5.0;1.0;136;5480;3178;2302;600;478;30.0
8692;2017 zaterdag 22 juli;457;230;227;413;207;206;187;181;5.0;1.0;1.0;1.0;0.0;0.0;1;3365;1975;1390;17;178;0.0
8693;2017 zondag 23 juli;350;181;169;338;171;167;16;16;0.0;0.0;1.0;1.0;0.0;0.0;1;1147;614;533;33;139;0.0
8694;2017 maandag 24 juli;519;260;259;340;176;164;239;234;2.0;3.0;145.0;141.0;3.0;1.0;142;7164;3928;3236;948;593;14.0
8695;2017 dinsdag 25 juli;545;298;247;377;184;193;165;159;3.0;3.0;98.0;98.0;0.0;0.0;138;4899;2740;2159;869;497;16.0
8696;2017 woensdag 26 juli;561;289;272;384;187;197;121;120;0.0;1.0;54.0;53.0;0.0;1.0;132;4387;2483;1904;799;503;30.0
8697;2017 donderdag 27 juli;537;272;265;348;157;191;195;188;0.0;7.0;43.0;40.0;2.0;1.0;128;4775;2695;2080;865;550;52.0
8698;2017 vrijdag 28 juli;524;270;254;383;177;206;265;258;5.0;2.0;32.0;29.0;0.0;3.0;118;6468;3715;2753;670;612;14.0
8699;2017 zaterdag 29 juli;434;228;206;390;192;198;130;128;1.0;1.0;2.0;2.0;0.0;0.0;0;2904;1681;1223;28;293;0.0
8700;2017 zondag 30 juli;386;193;193;348;173;175;18;18;0.0;0.0;0.0;0.0;0.0;0.0;0;1299;721;578;20;283;0.0
8701;2017 maandag 31 juli;531;259;272;370;187;183;189;185;3.0;1.0;110.0;107.0;2.0;1.0;145;8739;5014;3725;1004;1284;14.0
8702;Totaal augustus 2017;15439;7896;7543;11380;5587;5793;6284;6152;58.0;74.0;1580.0;1536.0;18.0;26.0;2887;172187;91636;80551;32217;13256;536.0
8703;2017 dinsdag 1 augustus;514;251;263;337;171;166;218;213;3.0;2.0;96.0;91.0;3.0;2.0;124;35579;18648;16931;1183;1280;22.0
8704;2017 woensdag 2 augustus;548;285;263;356;175;181;110;107;3.0;0.0;52.0;51.0;1.0;0.0;160;4907;2705;2202;1079;393;14.0
8705;2017 donderdag 3 augustus;553;290;263;362;187;175;104;99;1.0;4.0;29.0;27.0;1.0;1.0;133;4446;2427;2019;1009;418;35.0
8706;2017 vrijdag 4 augustus;566;274;292;380;167;213;254;252;0.0;2.0;27.0;25.0;1.0;1.0;134;5063;2805;2258;833;415;38.0
8707;2017 zaterdag 5 augustus;423;216;207;358;185;173;124;124;0.0;0.0;1.0;1.0;0.0;0.0;0;2575;1439;1136;30;182;0.0
8708;2017 zondag 6 augustus;404;198;206;344;171;173;17;16;1.0;0.0;0.0;0.0;0.0;0.0;0;1018;550;468;19;130;0.0
8709;2017 maandag 7 augustus;502;240;262;390;178;212;227;220;2.0;5.0;122.0;122.0;0.0;0.0;132;6808;3751;3057;982;446;30.0
8710;2017 dinsdag 8 augustus;568;289;279;392;188;204;226;223;1.0;2.0;95.0;92.0;1.0;2.0;157;4520;2479;2041;991;444;53.0
8711;2017 woensdag 9 augustus;554;301;253;391;196;195;142;139;2.0;1.0;35.0;35.0;0.0;0.0;117;4160;2108;2052;842;365;4.0
8712;2017 donderdag 10 augustus;525;255;270;373;181;192;108;108;0.0;0.0;42.0;41.0;0.0;1.0;125;4900;2689;2211;921;435;24.0
8713;2017 vrijdag 11 augustus;526;267;259;372;166;206;282;277;1.0;4.0;38.0;37.0;1.0;0.0;83;4968;2669;2299;800;371;12.0
8714;2017 zaterdag 12 augustus;444;239;205;371;181;190;163;157;3.0;3.0;0.0;0.0;0.0;0.0;0;2600;1362;1238;34;159;1.0
8715;2017 zondag 13 augustus;350;186;164;364;183;181;13;13;0.0;0.0;0.0;0.0;0.0;0.0;1;1155;565;590;30;151;1.0
8716;2017 maandag 14 augustus;466;256;210;374;182;192;218;213;1.0;4.0;137.0;133.0;1.0;3.0;108;7667;3996;3671;1150;494;23.0
8717;2017 dinsdag 15 augustus;542;280;262;379;200;179;210;206;4.0;0.0;93.0;89.0;1.0;3.0;137;8023;4270;3753;1053;578;25.0
8718;2017 woensdag 16 augustus;540;265;275;368;197;171;145;144;0.0;1.0;52.0;51.0;1.0;0.0;108;4975;2666;2309;1008;373;14.0
8719;2017 donderdag 17 augustus;514;257;257;362;185;177;208;203;2.0;3.0;34.0;33.0;0.0;1.0;125;4399;2327;2072;1097;408;11.0
8720;2017 vrijdag 18 augustus;531;267;264;368;168;200;495;488;3.0;4.0;41.0;40.0;0.0;1.0;116;5487;2978;2509;1469;348;10.0
8721;2017 zaterdag 19 augustus;400;211;189;334;163;171;196;190;3.0;3.0;5.0;4.0;1.0;0.0;2;2602;1403;1199;38;115;0.0
8722;2017 zondag 20 augustus;366;188;178;353;166;187;16;15;1.0;0.0;0.0;0.0;0.0;0.0;1;1753;744;1009;23;192;1.0
8723;2017 maandag 21 augustus;493;252;241;328;167;161;244;239;1.0;4.0;128.0;125.0;1.0;2.0;113;7055;3609;3446;4175;454;29.0
8724;2017 dinsdag 22 augustus;564;317;247;347;177;170;214;208;4.0;2.0;98.0;97.0;1.0;0.0;105;3941;2036;1905;1771;593;17.0
8725;2017 woensdag 23 augustus;516;270;246;352;165;187;174;172;1.0;1.0;52.0;51.0;0.0;1.0;150;4254;2274;1980;1392;412;15.0
8726;2017 donderdag 24 augustus;515;279;236;408;214;194;191;188;0.0;3.0;46.0;45.0;1.0;0.0;102;4758;2575;2183;1354;472;41.0
8727;2017 vrijdag 25 augustus;548;249;299;392;180;212;782;763;8.0;11.0;44.0;43.0;0.0;1.0;119;6035;3253;2782;1182;499;13.0
8728;2017 zaterdag 26 augustus;439;213;226;368;176;192;342;335;2.0;5.0;5.0;5.0;0.0;0.0;1;3030;1743;1287;245;208;0.0
8729;2017 zondag 27 augustus;414;224;190;345;167;178;19;19;0.0;0.0;0.0;0.0;0.0;0.0;0;1392;597;795;34;166;1.0
8730;2017 maandag 28 augustus;503;274;229;372;194;178;243;237;4.0;2.0;131.0;129.0;1.0;1.0;148;7103;3762;3341;1645;616;22.0
8731;2017 dinsdag 29 augustus;532;262;270;383;184;199;200;195;2.0;3.0;73.0;69.0;1.0;3.0;139;4126;2122;2004;1840;424;26.0
8732;2017 woensdag 30 augustus;517;245;272;402;211;191;180;175;1.0;4.0;65.0;61.0;1.0;3.0;131;4986;2682;2304;2348;582;31.0
8733;2017 donderdag 31 augustus;562;296;266;355;162;193;219;214;4.0;1.0;39.0;39.0;0.0;0.0;116;7902;4402;3500;1640;1133;23.0
8734;Totaal september 2017;14808;7627;7181;11378;5665;5713;9539;9335;84.0;120.0;1391.0;1334.0;28.0;29.0;2332;164077;90213;73864;32128;11505;3479.0
8735;2017 vrijdag 1 september;530;263;267;384;189;195;1201;1173;14.0;14.0;38.0;36.0;1.0;1.0;114;36320;19135;17185;1664;1463;20.0
8736;2017 zaterdag 2 september;411;213;198;339;176;163;425;414;6.0;5.0;3.0;2.0;0.0;1.0;1;2651;1310;1341;227;229;0.0
8737;2017 zondag 3 september;373;189;184;337;170;167;26;26;0.0;0.0;0.0;0.0;0.0;0.0;0;1670;714;956;21;172;0.0
8738;2017 maandag 4 september;499;267;232;341;171;170;259;254;2.0;3.0;133.0;126.0;3.0;4.0;128;7994;4062;3932;1813;530;19.0
8739;2017 dinsdag 5 september;534;274;260;381;182;199;202;200;2.0;0.0;75.0;73.0;1.0;1.0;129;4390;2348;2042;1873;408;20.0
8740;2017 woensdag 6 september;529;271;258;361;168;193;176;170;3.0;3.0;38.0;36.0;2.0;0.0;115;4349;2339;2010;1773;369;1927.0
8741;2017 donderdag 7 september;504;259;245;385;201;184;259;255;1.0;3.0;27.0;26.0;1.0;0.0;127;4690;2500;2190;1783;367;44.0
8742;2017 vrijdag 8 september;548;265;283;419;214;205;1200;1174;10.0;16.0;41.0;38.0;2.0;1.0;132;5260;2933;2327;1721;405;305.0
8743;2017 zaterdag 9 september;444;229;215;349;181;168;460;449;6.0;5.0;0.0;0.0;0.0;0.0;2;2530;1514;1016;33;168;0.0
8744;2017 zondag 10 september;417;230;187;332;159;173;18;18;0.0;0.0;1.0;1.0;0.0;0.0;0;1752;869;883;36;116;0.0
8745;2017 maandag 11 september;468;266;202;387;208;179;218;210;4.0;4.0;129.0;124.0;3.0;2.0;108;6306;3399;2907;1846;358;24.0
8746;2017 dinsdag 12 september;567;290;277;375;181;194;186;183;2.0;1.0;86.0;83.0;2.0;1.0;83;4107;2136;1971;1602;341;17.0
8747;2017 woensdag 13 september;523;284;239;374;177;197;127;127;0.0;0.0;46.0;44.0;0.0;2.0;108;4025;2124;1901;1431;361;15.0
8748;2017 donderdag 14 september;526;282;244;388;201;187;230;227;0.0;3.0;34.0;34.0;0.0;0.0;125;4562;2486;2076;2269;365;32.0
8749;2017 vrijdag 15 september;520;258;262;414;209;205;876;860;6.0;10.0;31.0;30.0;1.0;0.0;106;8996;5375;3621;1166;480;329.0
8750;2017 zaterdag 16 september;427;220;207;407;190;217;369;361;1.0;7.0;2.0;2.0;0.0;0.0;1;3002;1708;1294;43;167;0.0
8751;2017 zondag 17 september;418;200;218;358;174;184;16;16;0.0;0.0;0.0;0.0;0.0;0.0;0;1135;587;548;62;117;0.0
8752;2017 maandag 18 september;532;263;269;380;192;188;234;227;2.0;5.0;138.0;132.0;3.0;3.0;95;6189;3453;2736;1301;406;29.0
8753;2017 dinsdag 19 september;532;275;257;362;197;165;184;179;3.0;2.0;81.0;80.0;0.0;1.0;98;3756;2006;1750;1518;397;30.0
8754;2017 woensdag 20 september;556;289;267;414;205;209;151;147;1.0;3.0;51.0;48.0;1.0;2.0;109;4570;2571;1999;1318;424;29.0
8755;2017 donderdag 21 september;528;269;259;412;192;220;191;188;0.0;3.0;34.0;33.0;1.0;0.0;92;4335;2401;1934;1165;369;43.0
8756;2017 vrijdag 22 september;506;253;253;407;194;213;753;734;6.0;13.0;33.0;32.0;0.0;1.0;107;4988;2932;2056;968;375;417.0
8757;2017 zaterdag 23 september;447;224;223;369;180;189;270;260;5.0;5.0;2.0;1.0;0.0;1.0;0;3263;2019;1244;197;179;0.0
8758;2017 zondag 24 september;395;181;214;370;193;177;12;12;0.0;0.0;0.0;0.0;0.0;0.0;1;1148;599;549;26;108;0.0
8759;2017 maandag 25 september;544;268;276;362;183;179;215;207;2.0;6.0;160.0;154.0;2.0;4.0;113;6709;3818;2891;1055;462;27.0
8760;2017 dinsdag 26 september;503;259;244;396;190;206;178;174;3.0;1.0;73.0;70.0;1.0;2.0;116;3817;2156;1661;1523;412;26.0
8761;2017 woensdag 27 september;580;326;254;408;208;200;132;132;0.0;0.0;48.0;47.0;0.0;1.0;112;4127;2406;1721;1123;445;45.0
8762;2017 donderdag 28 september;531;276;255;390;194;196;154;151;2.0;1.0;33.0;32.0;0.0;1.0;107;5127;2933;2194;1107;448;58.0
8763;2017 vrijdag 29 september;520;269;251;423;208;215;598;589;3.0;6.0;54.0;50.0;4.0;0.0;103;8218;4904;3314;1389;494;23.0
8764;2017 zaterdag 30 september;396;215;181;354;178;176;219;218;0.0;1.0;0.0;0.0;0.0;0.0;0;4091;2476;1615;75;570;0.0
8765;Totaal oktober 2017;14616;7459;7157;11882;5811;6071;4498;4403;50.0;45.0;1738.0;1651.0;44.0;43.0;2613;155840;89484;66356;20843;9798;1860.0
8766;2017 zondag 1 oktober;396;191;205;335;149;186;9;8;0.0;1.0;0.0;0.0;0.0;0.0;0;19270;10470;8800;87;689;2.0
8767;2017 maandag 2 oktober;478;254;224;354;180;174;199;196;2.0;1.0;131.0;123.0;1.0;7.0;100;12159;7236;4923;1273;499;22.0
8768;2017 dinsdag 3 oktober;535;266;269;399;206;193;150;148;1.0;1.0;87.0;81.0;3.0;3.0;98;4895;2816;2079;1141;406;428.0
8769;2017 woensdag 4 oktober;501;265;236;405;216;189;90;87;1.0;2.0;46.0;44.0;2.0;0.0;120;4561;2503;2058;1082;369;31.0
8770;2017 donderdag 5 oktober;510;263;247;366;182;184;98;95;3.0;0.0;33.0;31.0;0.0;2.0;139;4420;2493;1927;1106;522;34.0
8771;2017 vrijdag 6 oktober;515;250;265;360;170;190;452;445;4.0;3.0;41.0;37.0;1.0;3.0;153;4932;2853;2079;834;302;20.0
8772;2017 zaterdag 7 oktober;428;214;214;374;198;176;272;262;3.0;7.0;4.0;4.0;0.0;0.0;1;2570;1531;1039;42;96;0.0
8773;2017 zondag 8 oktober;388;198;190;382;177;205;5;4;0.0;1.0;1.0;1.0;0.0;0.0;0;1216;635;581;32;69;0.0
8774;2017 maandag 9 oktober;492;257;235;400;205;195;188;182;3.0;3.0;133.0;131.0;1.0;1.0;114;6091;3448;2643;955;306;22.0
8775;2017 dinsdag 10 oktober;551;270;281;403;185;218;203;197;3.0;3.0;116.0;111.0;3.0;2.0;103;4601;2622;1979;1026;383;23.0
8776;2017 woensdag 11 oktober;519;232;287;369;187;182;97;96;0.0;1.0;54.0;52.0;1.0;1.0;145;4130;2350;1780;939;333;26.0
8777;2017 donderdag 12 oktober;534;277;257;383;196;187;134;132;1.0;1.0;34.0;33.0;1.0;0.0;109;4679;2648;2031;1137;282;884.0
8778;2017 vrijdag 13 oktober;482;248;234;453;214;239;262;257;3.0;2.0;24.0;24.0;0.0;0.0;114;5263;3090;2173;723;335;12.0
8779;2017 zaterdag 14 oktober;388;197;191;400;210;190;124;124;0.0;0.0;3.0;2.0;1.0;0.0;2;2833;1740;1093;50;109;0.0
8780;2017 zondag 15 oktober;378;206;172;354;176;178;11;11;0.0;0.0;0.0;0.0;0.0;0.0;0;2194;1246;948;45;159;0.0
8781;2017 maandag 16 oktober;480;244;236;401;188;213;197;196;0.0;1.0;122.0;117.0;2.0;3.0;122;8602;5002;3600;950;383;35.0
8782;2017 dinsdag 17 oktober;548;289;259;409;208;201;250;240;4.0;6.0;116.0;110.0;3.0;3.0;133;3900;2147;1753;977;248;27.0
8783;2017 woensdag 18 oktober;496;257;239;388;177;211;106;104;1.0;1.0;57.0;56.0;0.0;1.0;120;4281;2432;1849;914;265;28.0
8784;2017 donderdag 19 oktober;502;243;259;413;203;210;96;95;0.0;1.0;42.0;37.0;1.0;4.0;85;4039;2350;1689;900;284;39.0
8785;2017 vrijdag 20 oktober;515;255;260;403;200;203;351;345;3.0;3.0;53.0;48.0;3.0;2.0;106;5497;3215;2282;709;321;9.0
8786;2017 zaterdag 21 oktober;375;203;172;334;154;180;74;73;1.0;0.0;4.0;4.0;0.0;0.0;0;3008;1781;1227;44;86;1.0
8787;2017 zondag 22 oktober;365;181;184;357;168;189;4;3;1.0;0.0;1.0;0.0;1.0;0.0;0;1161;641;520;21;73;0.0
8788;2017 maandag 23 oktober;498;264;234;357;184;173;174;173;0.0;1.0;144.0;141.0;2.0;1.0;117;6230;3506;2724;824;392;31.0
8789;2017 dinsdag 24 oktober;466;238;228;385;191;194;135;129;5.0;1.0;107.0;101.0;4.0;2.0;137;3902;2247;1655;946;375;23.0
8790;2017 woensdag 25 oktober;488;250;238;387;182;205;108;108;0.0;0.0;57.0;50.0;5.0;2.0;145;4466;2565;1901;810;329;45.0
8791;2017 donderdag 26 oktober;474;252;222;413;184;229;87;85;1.0;1.0;40.0;35.0;2.0;3.0;106;4211;2385;1826;808;380;37.0
8792;2017 vrijdag 27 oktober;541;273;268;393;188;205;253;250;1.0;2.0;40.0;40.0;0.0;0.0;120;5579;3305;2274;649;388;29.0
8793;2017 zaterdag 28 oktober;392;192;200;381;198;183;71;68;3.0;0.0;0.0;0.0;0.0;0.0;0;3455;2173;1282;19;138;0.0
8794;2017 zondag 29 oktober;399;218;181;359;159;200;3;3;0.0;0.0;0.0;0.0;0.0;0.0;1;1199;669;530;24;109;1.0
8795;2017 maandag 30 oktober;476;255;221;384;188;196;156;153;3.0;0.0;156.0;149.0;5.0;2.0;109;6349;3702;2647;925;474;28.0
8796;2017 dinsdag 31 oktober;506;257;249;381;188;193;139;134;3.0;2.0;92.0;89.0;2.0;1.0;114;6147;3683;2464;851;694;23.0
8797;Totaal november 2017;13973;7215;6758;12237;5946;6291;2858;2784;38.0;36.0;1552.0;1492.0;26.0;34.0;2805;149303;87242;62061;17466;8669;2759.0
8798;2017 woensdag 1 november;488;244;244;380;180;200;96;94;1.0;1.0;57.0;55.0;1.0;1.0;104;29403;17349;12054;999;848;48.0
8799;2017 donderdag 2 november;522;266;256;398;190;208;61;61;0.0;0.0;38.0;34.0;1.0;3.0;108;4677;2621;2056;898;330;29.0
8800;2017 vrijdag 3 november;519;261;258;429;210;219;162;159;2.0;1.0;32.0;32.0;0.0;0.0;125;4896;2867;2029;720;322;10.0
8801;2017 zaterdag 4 november;394;205;189;394;201;193;52;51;1.0;0.0;2.0;1.0;0.0;1.0;0;2409;1458;951;15;118;0.0
8802;2017 zondag 5 november;388;169;219;359;169;190;4;4;0.0;0.0;0.0;0.0;0.0;0.0;0;1185;610;575;26;69;0.0
8803;2017 maandag 6 november;470;242;228;376;190;186;153;148;2.0;3.0;132.0;130.0;2.0;0.0;127;5894;3278;2616;949;397;32.0
8804;2017 dinsdag 7 november;533;280;253;392;193;199;136;130;3.0;3.0;98.0;93.0;2.0;3.0;121;3733;2049;1684;803;257;31.0
8805;2017 woensdag 8 november;499;249;250;381;189;192;60;58;0.0;2.0;46.0;43.0;0.0;3.0;112;4079;2350;1729;756;301;19.0
8806;2017 donderdag 9 november;493;258;235;411;184;227;67;65;1.0;1.0;35.0;33.0;0.0;2.0;148;3857;2255;1602;808;246;31.0
8807;2017 vrijdag 10 november;527;279;248;420;200;220;143;136;2.0;5.0;44.0;44.0;0.0;0.0;128;5070;2954;2116;675;345;30.0
8808;2017 zaterdag 11 november;398;211;187;416;205;211;63;63;0.0;0.0;0.0;0.0;0.0;0.0;0;2877;1810;1067;40;127;0.0
8809;2017 zondag 12 november;379;208;171;399;192;207;3;3;0.0;0.0;0.0;0.0;0.0;0.0;0;1048;616;432;38;84;2.0
8810;2017 maandag 13 november;472;236;236;398;192;206;121;120;1.0;0.0;132.0;129.0;2.0;1.0;129;5779;3321;2458;804;338;1368.0
8811;2017 dinsdag 14 november;499;250;249;470;203;267;140;134;4.0;2.0;90.0;88.0;0.0;2.0;142;3978;2305;1673;773;262;29.0
8812;2017 woensdag 15 november;516;260;256;412;195;217;79;74;2.0;3.0;50.0;48.0;1.0;1.0;138;7694;4525;3169;771;322;18.0
8813;2017 donderdag 16 november;509;261;248;428;214;214;78;74;2.0;2.0;28.0;28.0;0.0;0.0;136;4619;2559;2060;819;282;22.0
8814;2017 vrijdag 17 november;510;255;255;418;192;226;261;255;5.0;1.0;47.0;40.0;2.0;5.0;113;5054;2982;2072;685;346;10.0
8815;2017 zaterdag 18 november;386;214;172;422;193;229;47;47;0.0;0.0;3.0;3.0;0.0;0.0;1;2613;1627;986;49;90;0.0
8816;2017 zondag 19 november;359;198;161;367;186;181;4;4;0.0;0.0;0.0;0.0;0.0;0.0;0;1024;531;493;28;98;0.0
8817;2017 maandag 20 november;432;220;212;392;182;210;162;160;0.0;2.0;151.0;148.0;1.0;2.0;160;6357;3787;2570;844;337;385.0
8818;2017 dinsdag 21 november;499;248;251;439;209;230;144;142;0.0;2.0;97.0;95.0;2.0;0.0;116;3492;1928;1564;717;271;40.0
8819;2017 woensdag 22 november;500;261;239;413;220;193;99;98;0.0;1.0;54.0;54.0;0.0;0.0;139;3724;2190;1534;899;276;32.0
8820;2017 donderdag 23 november;487;271;216;447;230;217;85;83;1.0;1.0;29.0;27.0;1.0;1.0;92;4009;2266;1743;726;276;43.0
8821;2017 vrijdag 24 november;505;273;232;433;224;209;153;145;5.0;3.0;37.0;35.0;1.0;1.0;147;5268;3081;2187;615;360;34.0
8822;2017 zaterdag 25 november;397;204;193;395;194;201;41;41;0.0;0.0;1.0;1.0;0.0;0.0;0;4118;2745;1373;38;120;403.0
8823;2017 zondag 26 november;354;190;164;394;181;213;3;3;0.0;0.0;0.0;0.0;0.0;0.0;0;1173;636;537;63;78;0.0
8824;2017 maandag 27 november;482;247;235;419;216;203;165;163;2.0;0.0;148.0;142.0;5.0;1.0;108;6012;3440;2572;741;357;48.0
8825;2017 dinsdag 28 november;528;267;261;410;210;200;146;142;2.0;2.0;110.0;104.0;1.0;5.0;120;3979;2276;1703;706;357;20.0
8826;2017 woensdag 29 november;460;260;200;389;200;189;67;65;2.0;0.0;58.0;53.0;3.0;2.0;152;4168;2432;1736;708;361;34.0
8827;2017 donderdag 30 november;468;228;240;436;202;234;63;62;0.0;1.0;33.0;32.0;1.0;0.0;139;7114;4394;2720;753;694;41.0
8828;Totaal december 2017;13686;7096;6590;13709;6639;7070;2889;2810;39.0;40.0;1627.0;1566.0;28.0;33.0;2326;155313;92536;62777;13690;10386;1580.0
8829;2017 vrijdag 1 december;514;258;256;414;229;185;148;141;3.0;4.0;49.0;44.0;5.0;0.0;135;30516;18280;12236;712;857;22.0
8830;2017 zaterdag 2 december;354;182;172;415;196;219;21;21;0.0;0.0;1.0;1.0;0.0;0.0;0;2597;1619;978;48;143;0.0
8831;2017 zondag 3 december;370;180;190;400;210;190;1;1;0.0;0.0;0.0;0.0;0.0;0.0;0;1200;675;525;59;88;0.0
8832;2017 maandag 4 december;424;227;197;399;205;194;176;173;2.0;1.0;162.0;156.0;2.0;4.0;140;6322;3653;2669;945;336;30.0
8833;2017 dinsdag 5 december;412;199;213;422;190;232;138;135;2.0;1.0;118.0;114.0;3.0;1.0;102;3977;2259;1718;808;276;30.0
8834;2017 woensdag 6 december;442;250;192;431;198;233;80;77;1.0;2.0;58.0;52.0;3.0;3.0;156;3746;2170;1576;707;237;38.0
8835;2017 donderdag 7 december;506;262;244;455;230;225;80;80;0.0;0.0;46.0;46.0;0.0;0.0;118;4403;2576;1827;776;349;750.0
8836;2017 vrijdag 8 december;535;276;259;461;228;233;130;127;2.0;1.0;50.0;50.0;0.0;0.0;117;5674;3441;2233;596;335;19.0
8837;2017 zaterdag 9 december;385;197;188;444;225;219;41;39;1.0;1.0;0.0;0.0;0.0;0.0;0;3046;1900;1146;52;84;0.0
8838;2017 zondag 10 december;421;207;214;410;209;201;1;1;0.0;0.0;0.0;0.0;0.0;0.0;2;1524;973;551;43;100;0.0
8839;2017 maandag 11 december;474;247;227;413;206;207;200;195;2.0;3.0;153.0;150.0;0.0;3.0;119;5972;3601;2371;673;369;37.0
8840;2017 dinsdag 12 december;500;244;256;452;217;235;190;187;2.0;1.0;117.0;110.0;2.0;5.0;86;3863;2226;1637;664;284;17.0
8841;2017 woensdag 13 december;463;243;220;474;241;233;74;73;0.0;1.0;60.0;58.0;1.0;1.0;126;4037;2352;1685;742;277;30.0
8842;2017 donderdag 14 december;469;249;220;484;236;248;88;87;0.0;1.0;57.0;56.0;0.0;1.0;101;4641;2741;1900;738;359;42.0
8843;2017 vrijdag 15 december;512;263;249;499;240;259;205;197;4.0;4.0;63.0;61.0;0.0;2.0;103;10861;6696;4165;631;505;50.0
8844;2017 zaterdag 16 december;373;189;184;451;211;240;61;59;2.0;0.0;1.0;1.0;0.0;0.0;0;4023;2549;1474;64;146;0.0
8845;2017 zondag 17 december;386;200;186;434;215;219;8;8;0.0;0.0;1.0;1.0;0.0;0.0;1;1233;726;507;36;130;1.0
8846;2017 maandag 18 december;453;245;208;393;195;198;211;208;2.0;1.0;182.0;178.0;1.0;3.0;120;7466;4460;3006;758;482;345.0
8847;2017 dinsdag 19 december;486;254;232;451;200;251;152;151;1.0;0.0;124.0;120.0;2.0;2.0;140;4075;2408;1667;768;400;41.0
8848;2017 woensdag 20 december;491;254;237;445;214;231;99;95;1.0;3.0;91.0;86.0;2.0;3.0;119;5447;3214;2233;710;456;17.0
8849;2017 donderdag 21 december;513;276;237;426;199;227;123;117;3.0;3.0;57.0;51.0;5.0;1.0;121;4799;2798;2001;684;456;35.0
8850;2017 vrijdag 22 december;497;259;238;508;243;265;178;173;1.0;4.0;49.0;47.0;1.0;1.0;107;6323;3658;2665;514;624;14.0
8851;2017 zaterdag 23 december;419;211;208;423;194;229;43;41;1.0;1.0;3.0;3.0;0.0;0.0;1;3059;1795;1264;61;217;0.0
8852;2017 zondag 24 december;333;179;154;422;191;231;3;3;0.0;0.0;0.0;0.0;0.0;0.0;0;992;580;412;50;122;0.0
8853;2017 maandag 25 december;321;159;162;432;206;226;2;2;0.0;0.0;0.0;0.0;0.0;0.0;0;962;551;411;10;73;0.0
8854;2017 dinsdag 26 december;300;159;141;417;191;226;2;2;0.0;0.0;0.0;0.0;0.0;0.0;0;607;379;228;21;91;0.0
8855;2017 woensdag 27 december;476;244;232;475;234;241;123;118;2.0;3.0;76.0;75.0;0.0;1.0;139;5775;3393;2382;547;458;22.0
8856;2017 donderdag 28 december;535;279;256;474;227;247;114;108;5.0;1.0;62.0;61.0;1.0;0.0;133;6610;3976;2634;656;542;31.0
8857;2017 vrijdag 29 december;558;297;261;477;229;248;154;151;2.0;1.0;47.0;45.0;0.0;2.0;140;6957;4141;2816;516;523;9.0
8858;2017 zaterdag 30 december;388;218;170;462;210;252;22;21;0.0;1.0;0.0;0.0;0.0;0.0;0;2424;1448;976;69;274;0.0
8859;2017 zondag 31 december;376;189;187;446;220;226;21;19;0.0;2.0;0.0;0.0;0.0;0.0;0;2182;1298;884;32;793;0.0
8860;Totaal 2017;169836;87159;82677;150214;72661;77553;64402;63027;620.0;755.0;17866.0;17194.0;316.0;356.0;32768;1877109;1080500;796609;234957;127452;27663.0
8861;Totaal op zondag in 2017;19810;10112;9698;20432;9845;10587;510;500;6.0;4.0;7.0;5.0;2.0;0.0;11;104925;57311;47614;2445;8737;13.0
8862;Totaal op maandag in 2017;24404;12571;11833;20851;10115;10736;10203;9987;87.0;129.0;6454.0;6268.0;84.0;102.0;6266;370816;213058;157758;48584;22195;7295.0
8863;Totaal op dinsdag in 2017;26229;13425;12804;21844;10482;11362;8885;8683;113.0;89.0;4868.0;4689.0;87.0;92.0;6622;260179;145854;114325;47726;21119;5641.0
8864;Totaal op woensdag in 2017;25991;13401;12590;21904;10652;11252;6485;6339;58.0;88.0;2735.0;2624.0;54.0;57.0;6991;318956;183930;135026;48202;20662;4605.0
8865;Totaal op donderdag in 2017;25824;13263;12561;21894;10616;11278;6128;6001;53.0;74.0;1754.0;1681.0;30.0;43.0;6227;267468;153415;114053;46622;20496;5368.0
8866;Totaal op vrijdag in  2017;26540;13466;13074;22379;10793;11586;22052;21573;203.0;276.0;1946.0;1835.0;54.0;57.0;6130;357058;209039;148019;37653;23139;3216.0
8867;Totaal op zaterdag in 2017;20830;10818;10012;20810;10106;10704;7959;7775;96.0;88.0;91.0;82.0;4.0;5.0;32;196370;117077;79293;3402;9808;415.0
8868;Overig 2017;208;103;105;100;52;48;2180;2169;4.0;7.0;11.0;10.0;1.0;0.0;489;1337;816;521;323;1296;1110.0
8869;Totaal januari 2018;14107;7133;6974;14856;7093;7763;2660;2601;35.0;24.0;1672.0;1629.0;20.0;23.0;2861;154718;89069;65649;18441;11694;2252.0
8870;2018 maandag 1 januari;322;158;164;478;227;251;10;9;1.0;0.0;0.0;0.0;0.0;0.0;0;22762;12350;10412;116;941;0.0
8871;2018 dinsdag 2 januari;443;230;213;454;214;240;139;133;3.0;3.0;106.0;104.0;1.0;1.0;95;7843;4380;3463;829;463;22.0
8872;2018 woensdag 3 januari;480;236;244;505;242;263;97;97;0.0;0.0;55.0;54.0;0.0;1.0;124;5465;3053;2412;815;397;21.0
8873;2018 donderdag 4 januari;501;254;247;493;239;254;72;72;0.0;0.0;60.0;56.0;0.0;4.0;155;4938;2863;2075;821;403;38.0
8874;2018 vrijdag 5 januari;524;282;242;528;249;279;111;107;2.0;2.0;42.0;41.0;1.0;0.0;124;5881;3358;2523;666;468;20.0
8875;2018 zaterdag 6 januari;389;196;193;469;217;252;28;28;0.0;0.0;0.0;0.0;0.0;0.0;3;2407;1449;958;13;104;0.0
8876;2018 zondag 7 januari;366;186;180;416;169;247;4;4;0.0;0.0;0.0;0.0;0.0;0.0;0;1151;618;533;6;106;0.0
8877;2018 maandag 8 januari;441;200;241;460;194;266;224;222;1.0;1.0;139.0;139.0;0.0;0.0;112;6804;3874;2930;762;391;26.0
8878;2018 dinsdag 9 januari;430;218;212;466;232;234;126;124;2.0;0.0;103.0;95.0;2.0;6.0;138;3814;2155;1659;798;295;34.0
8879;2018 woensdag 10 januari;519;269;250;546;270;276;82;80;1.0;1.0;48.0;45.0;3.0;0.0;141;4807;2739;2068;784;470;41.0
8880;2018 donderdag 11 januari;454;228;226;467;219;248;68;67;0.0;1.0;24.0;24.0;0.0;0.0;176;4210;2380;1830;934;333;17.0
8881;2018 vrijdag 12 januari;558;269;289;488;250;238;105;103;1.0;1.0;29.0;29.0;0.0;0.0;116;5033;3023;2010;620;347;28.0
8882;2018 zaterdag 13 januari;390;208;182;510;216;294;14;13;1.0;0.0;2.0;2.0;0.0;0.0;1;2243;1271;972;29;108;0.0
8883;2018 zondag 14 januari;374;195;179;422;211;211;4;4;0.0;0.0;0.0;0.0;0.0;0.0;0;1171;695;476;35;89;0.0
8884;2018 maandag 15 januari;483;250;233;432;197;235;157;154;2.0;1.0;156.0;153.0;1.0;2.0;108;10363;6107;4256;820;527;33.0
8885;2018 dinsdag 16 januari;511;272;239;488;244;244;127;123;3.0;1.0;98.0;95.0;0.0;3.0;134;4354;2476;1878;715;367;35.0
8886;2018 woensdag 17 januari;475;237;238;471;232;239;79;79;0.0;0.0;57.0;55.0;0.0;2.0;145;3845;2221;1624;766;370;51.0
8887;2018 donderdag 18 januari;518;268;250;507;257;250;162;157;3.0;2.0;47.0;46.0;0.0;1.0;131;4025;2397;1628;827;295;39.0
8888;2018 vrijdag 19 januari;503;244;259;533;242;291;114;111;3.0;0.0;31.0;31.0;0.0;0.0;118;4576;2678;1898;658;350;34.0
8889;2018 zaterdag 20 januari;397;205;192;478;224;254;44;43;1.0;0.0;1.0;1.0;0.0;0.0;1;3442;2161;1281;38;154;0.0
8890;2018 zondag 21 januari;394;208;186;455;224;231;3;3;0.0;0.0;0.0;0.0;0.0;0.0;0;1061;586;475;27;118;0.0
8891;2018 maandag 22 januari;534;244;290;468;248;220;154;148;3.0;3.0;151.0;148.0;1.0;2.0;141;5535;3204;2331;836;396;757.0
8892;2018 dinsdag 23 januari;495;262;233;460;216;244;112;110;2.0;0.0;103.0;99.0;4.0;0.0;135;3644;2082;1562;760;296;22.0
8893;2018 woensdag 24 januari;474;236;238;491;236;255;76;75;1.0;0.0;59.0;56.0;3.0;0.0;147;3814;2187;1627;796;344;25.0
8894;2018 donderdag 25 januari;478;250;228;475;241;234;47;45;1.0;1.0;40.0;38.0;2.0;0.0;127;4462;2579;1883;790;405;922.0
8895;2018 vrijdag 26 januari;491;256;235;496;253;243;121;119;2.0;0.0;30.0;30.0;0.0;0.0;118;5434;3310;2124;592;501;17.0
8896;2018 zaterdag 27 januari;401;205;196;453;216;237;34;33;0.0;1.0;2.0;2.0;0.0;0.0;0;3490;2158;1332;117;227;0.0
8897;2018 zondag 28 januari;383;178;205;478;240;238;7;7;0.0;0.0;0.0;0.0;0.0;0.0;1;1356;735;621;29;205;1.0
8898;2018 maandag 29 januari;441;227;214;491;219;272;130;128;0.0;2.0;155.0;153.0;1.0;1.0;134;5834;3326;2508;805;552;22.0
8899;2018 dinsdag 30 januari;465;228;237;502;232;270;130;124;2.0;4.0;89.0;88.0;1.0;0.0;122;4151;2469;1682;962;625;28.0
8900;2018 woensdag 31 januari;473;234;239;476;223;253;79;79;0.0;0.0;45.0;45.0;0.0;0.0;114;6803;4185;2618;1675;1047;19.0
8901;Totaal februari 2018;12264;6245;6019;14452;6838;7614;2645;2596;28.0;21.0;1538.0;1477.0;30.0;31.0;2575;142300;82547;59753;19822;9429;2488.0
8902;2018 donderdag 1 februari;474;229;245;473;215;258;51;49;2.0;0.0;36.0;34.0;1.0;1.0;116;30185;17335;12850;1244;1034;34.0
8903;2018 vrijdag 2 februari;477;236;241;504;228;276;147;146;0.0;1.0;44.0;41.0;1.0;2.0;133;5693;3207;2486;1117;496;469.0
8904;2018 zaterdag 3 februari;394;202;192;517;236;281;24;24;0.0;0.0;0.0;0.0;0.0;0.0;1;2681;1559;1122;33;222;0.0
8905;2018 zondag 4 februari ;343;160;183;439;205;234;9;9;0.0;0.0;1.0;1.0;0.0;0.0;0;1213;608;605;25;166;0.0
8906;2018 maandag 5 februari;449;223;226;510;237;273;178;177;1.0;0.0;128.0;124.0;1.0;3.0;144;6525;3655;2870;1023;409;34.0
8907;2018 dinsdag 6 februari;474;240;234;481;229;252;122;119;1.0;2.0;100.0;95.0;2.0;3.0;138;3480;1937;1543;1277;386;22.0
8908;2018 woensdag 7 februari;478;253;225;505;250;255;79;77;0.0;2.0;48.0;46.0;2.0;0.0;139;3831;2123;1708;1007;323;36.0
8909;2018 donderdag 8 februari;507;266;241;511;245;266;62;61;1.0;0.0;30.0;27.0;2.0;1.0;121;4076;2277;1799;1245;322;36.0
8910;2018 vrijdag 9 februari;480;258;222;555;272;283;105;102;2.0;1.0;22.0;20.0;0.0;2.0;142;4480;2625;1855;926;298;15.0
8911;2018 zaterdag 10 februari;343;178;165;476;197;279;33;33;0.0;0.0;3.0;2.0;1.0;0.0;0;2900;1708;1192;100;112;0.0
8912;2018 zondag 11 februari;360;196;164;475;210;265;7;7;0.0;0.0;0.0;0.0;0.0;0.0;0;1018;549;469;35;74;2.0
8913;2018 maandag 12 februari;428;236;192;492;252;240;125;122;0.0;3.0;131.0;127.0;2.0;2.0;115;5346;3081;2265;902;333;20.0
8914;2018 dinsdag 13 februari;477;246;231;516;240;276;112;110;2.0;0.0;89.0;84.0;3.0;2.0;124;3176;1889;1287;979;407;33.0
8915;2018 woensdag 14 februari;538;277;261;512;245;267;230;223;1.0;6.0;80.0;78.0;1.0;1.0;125;4520;2574;1946;923;290;482.0
8916;2018 donderdag 15 februari;454;235;219;566;265;301;68;67;1.0;0.0;39.0;36.0;2.0;1.0;123;7050;4237;2813;1163;409;613.0
8917;2018 vrijdag 16 februari;478;249;229;527;260;267;141;137;2.0;2.0;35.0;35.0;0.0;0.0;93;5316;3121;2195;754;307;16.0
8918;2018 zaterdag 17 februari;384;183;201;518;263;255;34;33;1.0;0.0;1.0;1.0;0.0;0.0;0;2792;1723;1069;2;119;0.0
8919;2018 zondag 18 februari;343;174;169;528;254;274;27;27;0.0;0.0;0.0;0.0;0.0;0.0;1;1236;709;527;1;74;0.0
8920;2018 maandag 19 februari;443;228;215;476;216;260;155;150;5.0;0.0;166.0;158.0;2.0;6.0;112;5733;3375;2358;955;343;34.0
8921;2018 dinsdag 20 februari;490;251;239;536;262;274;130;127;2.0;1.0;107.0;105.0;1.0;1.0;143;4252;2346;1906;906;297;42.0
8922;2018 woensdag 21 februari;433;209;224;543;249;294;82;82;0.0;0.0;58.0;55.0;0.0;3.0;106;4007;2366;1641;849;312;465.0
8923;2018 donderdag 22 februari;470;236;234;535;259;276;96;93;2.0;1.0;39.0;38.0;1.0;0.0;123;4251;2485;1766;813;350;30.0
8924;2018 vrijdag 23 februari;487;266;221;584;284;300;142;138;3.0;1.0;37.0;35.0;1.0;1.0;151;5269;3143;2126;635;333;15.0
8925;2018 zaterdag 24 februari;382;176;206;540;246;294;38;38;0.0;0.0;0.0;0.0;0.0;0.0;0;4054;2501;1553;40;114;0.0
8926;2018 zondag 25 februari;351;172;179;477;234;243;8;8;0.0;0.0;1.0;1.0;0.0;0.0;4;1373;811;562;39;144;1.0
8927;2018 maandag 26 februari;430;217;213;554;248;306;194;193;1.0;0.0;170.0;165.0;4.0;1.0;142;6288;3652;2636;821;534;28.0
8928;2018 dinsdag 27 februari;449;235;214;554;262;292;147;146;0.0;1.0;115.0;111.0;3.0;1.0;161;4512;2645;1867;1246;404;29.0
8929;2018 woensdag 28 februari;448;214;234;548;275;273;99;98;1.0;0.0;58.0;58.0;0.0;0.0;118;7043;4306;2737;762;817;32.0
8930;Totaal maart 2018;13408;6905;6503;16331;7784;8547;3024;2953;30.0;41.0;1544.0;1493.0;22.0;29.0;2723;155360;91669;63691;15672;10029;2476.0
8931;2018 donderdag 1 maart;457;242;215;572;265;307;89;88;1.0;0.0;31.0;30.0;0.0;1.0;130;30189;17573;12616;892;1084;27.0
8932;2018 vrijdag 2 maart;460;225;235;565;294;271;126;123;1.0;2.0;34.0;34.0;0.0;0.0;111;5346;3145;2201;703;353;7.0
8933;2018 zaterdag 3 maart;365;177;188;563;255;308;51;49;2.0;0.0;0.0;0.0;0.0;0.0;1;2725;1601;1124;40;135;0.0
8934;2018 zondag 4 maart;334;172;162;581;269;312;8;8;0.0;0.0;1.0;1.0;0.0;0.0;2;1314;739;575;36;117;0.0
8935;2018 maandag 5 maart;423;218;205;606;275;331;169;166;0.0;3.0;163.0;159.0;2.0;2.0;128;6827;3886;2941;789;380;30.0
8936;2018 dinsdag 6 maart;452;227;225;591;275;316;148;145;3.0;0.0;104.0;100.0;1.0;3.0;107;3860;2205;1655;822;327;19.0
8937;2018 woensdag 7 maart;483;237;246;595;278;317;90;87;2.0;1.0;62.0;59.0;1.0;2.0;141;4384;2547;1837;767;335;18.0
8938;2018 donderdag 8 maart;472;242;230;610;289;321;82;79;2.0;1.0;33.0;30.0;1.0;2.0;112;4540;2630;1910;864;268;28.0
8939;2018 vrijdag 9 maart;485;244;241;579;275;304;122;120;2.0;0.0;30.0;28.0;0.0;2.0;133;4497;2678;1819;621;427;757.0
8940;2018 zaterdag 10 maart;342;174;168;594;286;308;48;47;1.0;0.0;1.0;1.0;0.0;0.0;3;3234;2000;1234;36;113;0.0
8941;2018 zondag 11 maart;358;175;183;517;226;291;5;4;0.0;1.0;0.0;0.0;0.0;0.0;0;1118;639;479;36;93;0.0
8942;2018 maandag 12 maart;443;236;207;540;251;289;164;160;1.0;3.0;148.0;144.0;2.0;2.0;124;5893;3449;2444;786;381;34.0
8943;2018 dinsdag 13 maart;409;229;180;583;278;305;111;109;1.0;1.0;74.0;72.0;0.0;2.0;146;3447;1962;1485;807;303;306.0
8944;2018 woensdag 14 maart;463;230;233;528;245;283;68;64;1.0;3.0;54.0;53.0;1.0;0.0;125;4031;2344;1687;679;319;36.0
8945;2018 donderdag 15 maart;443;237;206;572;268;304;81;81;0.0;0.0;33.0;33.0;0.0;0.0;132;7270;4309;2961;729;400;31.0
8946;2018 vrijdag 16 maart;477;247;230;532;266;266;166;160;2.0;4.0;47.0;46.0;1.0;0.0;102;5397;3249;2148;598;285;42.0
8947;2018 zaterdag 17 maart;366;198;168;516;242;274;38;37;0.0;1.0;0.0;0.0;0.0;0.0;3;2639;1650;989;47;112;0.0
8948;2018 zondag 18 maart;369;189;180;462;209;253;9;9;0.0;0.0;0.0;0.0;0.0;0.0;1;1050;625;425;42;109;0.0
8949;2018 maandag 19 maart;469;228;241;467;246;221;172;169;1.0;2.0;138.0;134.0;3.0;1.0;131;5587;3375;2212;754;312;36.0
8950;2018 dinsdag 20 maart;460;247;213;471;223;248;144;139;2.0;3.0;107.0;104.0;2.0;1.0;132;4027;2359;1668;666;369;446.0
8951;2018 woensdag 21 maart;470;250;220;510;252;258;77;75;0.0;2.0;28.0;27.0;0.0;1.0;143;3684;2082;1602;549;299;28.0
8952;2018 donderdag 22 maart;462;240;222;536;263;273;65;62;1.0;2.0;27.0;26.0;0.0;1.0;131;4071;2363;1708;588;259;15.0
8953;2018 vrijdag 23 maart;506;234;272;511;247;264;212;210;1.0;1.0;53.0;53.0;0.0;0.0;109;4840;2897;1943;550;314;18.0
8954;2018 zaterdag 24 maart;378;208;170;483;231;252;77;74;1.0;2.0;3.0;3.0;0.0;0.0;0;3356;2079;1277;41;125;0.0
8955;2018 zondag 25 maart;322;158;164;452;229;223;2;2;0.0;0.0;0.0;0.0;0.0;0.0;0;1244;707;537;27;96;0.0
8956;2018 maandag 26 maart;425;212;213;464;223;241;203;199;1.0;3.0;145.0;140.0;0.0;5.0;131;5901;3498;2403;748;407;37.0
8957;2018 dinsdag 27 maart;463;233;230;422;197;225;146;145;1.0;0.0;95.0;88.0;4.0;3.0;145;3790;2197;1593;728;411;476.0
8958;2018 woensdag 28 maart;489;269;220;470;224;246;109;108;0.0;1.0;70.0;68.0;1.0;1.0;112;4951;2973;1978;674;397;57.0
8959;2018 donderdag 29 maart;491;261;230;482;243;239;111;105;3.0;3.0;47.0;46.0;1.0;0.0;130;6859;4231;2628;776;577;21.0
8960;2018 vrijdag 30 maart;478;258;220;484;238;246;78;77;0.0;1.0;14.0;12.0;2.0;0.0;58;5404;3261;2143;239;426;7.0
8961;2018 zaterdag 31 maart;394;208;186;473;222;251;53;52;0.0;1.0;2.0;2.0;0.0;0.0;0;3885;2416;1469;38;496;0.0
8962;Totaal april 2018;13411;6806;6605;12154;5796;6358;4358;4258;41.0;59.0;1607.0;1548.0;30.0;29.0;2522;135737;80384;55353;14988;8635;1947.0
8963;2018 zondag 1 april;336;193;143;429;213;216;15;15;0.0;0.0;0.0;0.0;0.0;0.0;0;17386;9967;7419;54;531;1.0
8964;2018 maandag 2 april;331;170;161;419;185;234;12;12;0.0;0.0;1.0;1.0;0.0;0.0;1;2371;1371;1000;9;114;0.0
8965;2018 dinsdag 3 april;473;227;246;459;204;255;158;154;2.0;2.0;117.0;111.0;2.0;4.0;141;8770;5244;3526;907;407;18.0
8966;2018 woensdag 4 april;505;234;271;462;227;235;137;135;0.0;2.0;58.0;57.0;0.0;1.0;148;4857;2754;2103;960;376;31.0
8967;2018 donderdag 5 april;483;243;240;418;202;216;84;80;1.0;3.0;38.0;36.0;2.0;0.0;152;4584;2706;1878;849;325;44.0
8968;2018 vrijdag 6 april;533;275;258;461;230;231;246;239;1.0;6.0;56.0;52.0;4.0;0.0;116;4597;2726;1871;667;292;29.0
8969;2018 zaterdag 7 april;374;192;182;414;196;218;77;76;0.0;1.0;1.0;1.0;0.0;0.0;1;2491;1593;898;43;103;0.0
8970;2018 zondag 8 april;384;207;177;407;201;206;8;8;0.0;0.0;0.0;0.0;0.0;0.0;1;1113;624;489;4;76;1.0
8971;2018 maandag 9 april;490;254;236;396;196;200;195;192;2.0;1.0;164.0;159.0;1.0;4.0;150;5739;3325;2414;768;379;51.0
8972;2018 dinsdag 10 april;478;249;229;435;202;233;148;146;0.0;2.0;99.0;96.0;1.0;2.0;157;4093;2432;1661;805;364;45.0
8973;2018 woensdag 11 april;486;237;249;425;202;223;103;103;0.0;0.0;65.0;64.0;1.0;0.0;105;3737;2130;1607;756;295;579.0
8974;2018 donderdag 12 april;460;227;233;410;188;222;129;124;2.0;3.0;48.0;48.0;0.0;0.0;117;4134;2405;1729;764;302;36.0
8975;2018 vrijdag 13 april;461;239;222;437;201;236;225;221;2.0;2.0;27.0;26.0;1.0;0.0;132;4639;2809;1830;722;302;23.0
8976;2018 zaterdag 14 april;409;219;190;378;184;194;152;147;3.0;2.0;2.0;2.0;0.0;0.0;2;2763;1714;1049;38;108;0.0
8977;2018 zondag 15 april;358;182;176;379;172;207;5;5;0.0;0.0;0.0;0.0;0.0;0.0;0;2026;1189;837;21;147;0.0
8978;2018 maandag 16 april;465;226;239;418;200;218;195;189;4.0;2.0;162.0;155.0;4.0;3.0;138;7686;4464;3222;887;416;31.0
8979;2018 dinsdag 17 april;502;234;268;392;195;197;151;147;4.0;0.0;87.0;80.0;2.0;5.0;128;3701;2209;1492;776;357;30.0
8980;2018 woensdag 18 april;511;261;250;422;200;222;199;194;1.0;4.0;66.0;65.0;1.0;0.0;122;3663;2110;1553;695;277;324.0
8981;2018 donderdag 19 april;486;241;245;403;178;225;118;116;2.0;0.0;35.0;34.0;1.0;0.0;121;3721;2110;1611;788;319;38.0
8982;2018 vrijdag 20 april;492;230;262;368;173;195;527;519;3.0;5.0;53.0;50.0;0.0;3.0;120;5219;3247;1972;608;345;8.0
8983;2018 zaterdag 21 april;356;180;176;405;200;205;136;131;3.0;2.0;3.0;3.0;0.0;0.0;2;2991;1886;1105;33;100;0.0
8984;2018 zondag 22 april;365;183;182;352;167;185;11;11;0.0;0.0;0.0;0.0;0.0;0.0;0;1023;585;438;9;83;0.0
8985;2018 maandag 23 april;464;231;233;381;182;199;222;217;2.0;3.0;166.0;161.0;2.0;3.0;138;5848;3464;2384;764;310;21.0
8986;2018 dinsdag 24 april;484;248;236;391;191;200;186;181;1.0;4.0;94.0;88.0;4.0;2.0;112;3802;2298;1504;650;310;24.0
8987;2018 woensdag 25 april;566;292;274;392;184;208;155;150;3.0;2.0;50.0;48.0;1.0;1.0;144;4643;2789;1854;711;347;483.0
8988;2018 donderdag 26 april;481;238;243;386;173;213;302;296;3.0;3.0;48.0;46.0;2.0;0.0;148;5619;3377;2242;847;417;70.0
8989;2018 vrijdag 27 april;406;208;198;397;190;207;47;47;0.0;0.0;0.0;0.0;0.0;0.0;1;1805;1040;765;1;140;0.0
8990;2018 zaterdag 28 april;385;205;180;384;188;196;138;134;1.0;3.0;3.0;3.0;0.0;0.0;1;3184;2007;1177;51;118;0.0
8991;2018 zondag 29 april;389;207;182;331;170;161;13;13;0.0;0.0;1.0;1.0;0.0;0.0;0;1174;675;499;41;157;0.0
8992;2018 maandag 30 april;498;274;224;403;202;201;264;256;1.0;7.0;163.0;161.0;1.0;1.0;124;8358;5134;3224;760;818;60.0
8993;Totaal mei 2018;14609;7419;7190;11809;5807;6002;6812;6644;66.0;102.0;1593.0;1536.0;27.0;30.0;2660;140035;83357;56678;16248;8383;1984.0
8994;2018 dinsdag 1 mei;525;266;259;362;184;178;228;223;2.0;3.0;118.0;115.0;3.0;0.0;119;27809;16291;11518;898;811;44.0
8995;2018 woensdag 2 mei;511;263;248;371;186;185;136;134;1.0;1.0;61.0;57.0;1.0;3.0;148;4626;2681;1945;830;343;46.0
8996;2018 donderdag 3 mei;548;288;260;397;197;200;163;159;3.0;1.0;39.0;37.0;2.0;0.0;127;4141;2362;1779;804;283;331.0
8997;2018 vrijdag 4 mei;450;223;227;382;195;187;108;107;1.0;0.0;21.0;20.0;1.0;0.0;120;4235;2515;1720;629;293;9.0
8998;2018 zaterdag 5 mei;411;228;183;375;184;191;90;89;1.0;0.0;1.0;1.0;0.0;0.0;2;2207;1288;919;2;122;1.0
8999;2018 zondag 6 mei;401;187;214;355;166;189;17;16;0.0;1.0;0.0;0.0;0.0;0.0;1;823;489;334;32;62;0.0
9000;2018 maandag 7 mei;504;255;249;418;195;223;249;244;2.0;3.0;159.0;155.0;1.0;3.0;140;5862;3447;2415;790;287;45.0
9001;2018 dinsdag 8 mei;526;259;267;400;207;193;225;216;3.0;6.0;86.0;85.0;1.0;0.0;117;3844;2257;1587;781;311;51.0
9002;2018 woensdag 9 mei;520;268;252;374;196;178;401;390;4.0;7.0;68.0;66.0;1.0;1.0;141;4558;2759;1799;870;325;52.0
9003;2018 donderdag 10 mei;431;225;206;369;188;181;35;33;2.0;0.0;1.0;1.0;0.0;0.0;2;2033;1270;763;0;106;0.0
9004;2018 vrijdag 11 mei;493;253;240;374;193;181;501;490;6.0;5.0;30.0;29.0;1.0;0.0;56;3107;1869;1238;304;236;4.0
9005;2018 zaterdag 12 mei;396;207;189;377;192;185;200;194;3.0;3.0;1.0;0.0;0.0;1.0;0;2122;1328;794;69;81;0.0
9006;2018 zondag 13 mei;412;225;187;329;171;158;11;10;0.0;1.0;0.0;0.0;0.0;0.0;0;966;573;393;38;79;0.0
9007;2018 maandag 14 mei;519;244;275;387;180;207;240;233;1.0;6.0;163.0;162.0;0.0;1.0;130;6654;4067;2587;859;338;37.0
9008;2018 dinsdag 15 mei;451;239;212;395;188;207;192;185;2.0;5.0;80.0;76.0;1.0;3.0;159;6555;3901;2654;774;386;26.0
9009;2018 woensdag 16 mei;511;254;257;354;178;176;121;119;1.0;1.0;66.0;63.0;0.0;3.0;110;4084;2393;1691;797;262;31.0
9010;2018 donderdag 17 mei;504;260;244;325;158;167;168;165;2.0;1.0;48.0;46.0;2.0;0.0;109;3718;2166;1552;758;249;26.0
9011;2018 vrijdag 18 mei;534;273;261;397;198;199;1098;1075;9.0;14.0;70.0;69.0;0.0;1.0;156;4614;2867;1747;639;224;450.0
9012;2018 zaterdag 19 mei;393;201;192;372;183;189;208;203;2.0;3.0;1.0;1.0;0.0;0.0;1;2359;1489;870;90;99;0.0
9013;2018 zondag 20 mei;395;191;204;376;192;184;22;22;0.0;0.0;0.0;0.0;0.0;0.0;0;1192;684;508;6;86;0.0
9014;2018 maandag 21 mei;385;196;189;384;186;198;20;19;1.0;0.0;0.0;0.0;0.0;0.0;1;1992;1177;815;4;122;0.0
9015;2018 dinsdag 22 mei;517;271;246;371;184;187;204;198;2.0;4.0;96.0;92.0;3.0;1.0;145;4517;2680;1837;824;301;44.0
9016;2018 woensdag 23 mei;551;277;274;389;187;202;127;123;1.0;3.0;53.0;50.0;1.0;2.0;138;4032;2434;1598;774;291;38.0
9017;2018 donderdag 24 mei;484;242;242;398;196;202;171;164;2.0;5.0;40.0;37.0;0.0;3.0;120;4041;2371;1670;810;295;35.0
9018;2018 vrijdag 25 mei;489;245;244;401;179;222;827;805;5.0;17.0;39.0;37.0;2.0;0.0;101;5143;3010;2133;601;337;33.0
9019;2018 zaterdag 26 mei;396;196;200;377;187;190;290;287;2.0;1.0;4.0;3.0;1.0;0.0;0;3099;1928;1171;68;112;2.0
9020;2018 zondag 27 mei;390;204;186;352;182;170;12;11;1.0;0.0;0.0;0.0;0.0;0.0;0;1050;619;431;33;88;0.0
9021;2018 maandag 28 mei;502;245;257;403;184;219;271;267;1.0;3.0;161.0;157.0;2.0;2.0;141;5361;3179;2182;762;393;323.0
9022;2018 dinsdag 29 mei;501;254;247;403;185;218;172;167;2.0;3.0;96.0;92.0;1.0;3.0;132;3764;2244;1520;764;360;34.0
9023;2018 woensdag 30 mei;486;250;236;414;195;219;143;140;3.0;0.0;50.0;47.0;2.0;1.0;151;4476;2690;1786;870;383;304.0
9024;2018 donderdag 31 mei;473;230;243;428;211;217;162;156;1.0;5.0;41.0;38.0;1.0;2.0;93;7051;4329;2722;768;718;18.0
9025;Totaal juni 2018;14182;7272;6910;11241;5584;5657;8879;8687;79.0;113.0;1637.0;1592.0;26.0;19.0;2402;142546;84196;58350;16053;12392;1644.0
9026;2018 vrijdag 1 juni;546;287;259;387;202;185;882;867;5.0;10.0;56.0;53.0;2.0;1.0;110;27449;16069;11380;656;805;9.0
9027;2018 zaterdag 2 juni;394;214;180;376;204;172;300;292;3.0;5.0;3.0;3.0;0.0;0.0;0;2311;1340;971;32;321;0.0
9028;2018 zondag 3 juni;364;196;168;363;167;196;17;17;0.0;0.0;1.0;0.0;0.0;1.0;0;1019;603;416;9;119;0.0
9029;2018 maandag 4 juni;489;238;251;371;190;181;240;238;1.0;1.0;156.0;149.0;3.0;4.0;110;6153;3605;2548;879;379;28.0
9030;2018 dinsdag 5 juni;471;244;227;399;224;175;174;168;3.0;3.0;113.0;113.0;0.0;0.0;141;3776;2209;1567;843;351;27.0
9031;2018 woensdag 6 juni;481;249;232;355;159;196;181;181;0.0;0.0;71.0;69.0;2.0;0.0;119;3599;2061;1538;869;331;328.0
9032;2018 donderdag 7 juni;512;259;253;405;196;209;165;158;0.0;7.0;41.0;39.0;0.0;2.0;117;4057;2299;1758;762;315;37.0
9033;2018 vrijdag 8 juni;531;277;254;394;178;216;851;832;9.0;10.0;46.0;45.0;1.0;0.0;100;4576;2783;1793;617;306;58.0
9034;2018 zaterdag 9 juni;394;201;193;379;176;203;308;302;3.0;3.0;2.0;2.0;0.0;0.0;0;2299;1445;854;37;119;1.0
9035;2018 zondag 10 juni;388;202;186;373;188;185;12;12;0.0;0.0;0.0;0.0;0.0;0.0;0;1364;794;570;9;100;0.0
9036;2018 maandag 11 juni;497;248;249;364;182;182;206;202;1.0;3.0;147.0;145.0;0.0;2.0;110;5618;3217;2401;792;362;44.0
9037;2018 dinsdag 12 juni;496;246;250;335;177;158;213;208;0.0;5.0;92.0;89.0;1.0;2.0;124;3797;2214;1583;726;400;13.0
9038;2018 woensdag 13 juni;489;232;257;374;182;192;92;88;4.0;0.0;54.0;52.0;1.0;1.0;120;3422;1976;1446;850;317;34.0
9039;2018 donderdag 14 juni;515;289;226;400;198;202;205;202;1.0;2.0;40.0;39.0;1.0;0.0;88;4292;2551;1741;729;317;31.0
9040;2018 vrijdag 15 juni;544;293;251;385;187;198;693;676;8.0;9.0;42.0;39.0;2.0;1.0;87;7694;4697;2997;548;505;172.0
9041;2018 zaterdag 16 juni;402;199;203;346;163;183;340;335;2.0;3.0;3.0;3.0;0.0;0.0;2;2657;1639;1018;16;151;0.0
9042;2018 zondag 17 juni;353;160;193;351;158;193;12;12;0.0;0.0;1.0;1.0;0.0;0.0;0;983;585;398;4;124;0.0
9043;2018 maandag 18 juni;507;253;254;384;182;202;350;339;1.0;10.0;133.0;129.0;4.0;0.0;136;5923;3555;2368;737;417;37.0
9044;2018 dinsdag 19 juni;534;279;255;381;178;203;175;169;3.0;3.0;91.0;87.0;3.0;1.0;122;3490;1999;1491;777;399;48.0
9045;2018 woensdag 20 juni;545;279;266;380;181;199;151;145;2.0;4.0;52.0;51.0;1.0;0.0;100;4061;2425;1636;630;381;28.0
9046;2018 donderdag 21 juni;504;260;244;373;197;176;276;265;4.0;7.0;40.0;40.0;0.0;0.0;131;3827;2149;1678;722;407;29.0
9047;2018 vrijdag 22 juni;518;254;264;386;193;193;850;842;4.0;4.0;58.0;58.0;0.0;0.0;109;4619;2780;1839;543;442;13.0
9048;2018 zaterdag 23 juni;394;207;187;359;202;157;305;296;5.0;4.0;4.0;4.0;0.0;0.0;1;3136;1977;1159;35;204;0.0
9049;2018 zondag 24 juni;377;210;167;337;167;170;13;13;0.0;0.0;1.0;1.0;0.0;0.0;0;1090;617;473;27;203;0.0
9050;2018 maandag 25 juni;470;241;229;382;186;196;259;251;3.0;5.0;167.0;166.0;1.0;0.0;135;6202;3591;2611;926;585;339.0
9051;2018 dinsdag 26 juni;530;261;269;337;176;161;198;193;3.0;2.0;88.0;85.0;2.0;1.0;109;4009;2444;1565;857;575;32.0
9052;2018 woensdag 27 juni;504;244;260;375;206;169;148;146;2.0;0.0;51.0;50.0;0.0;1.0;98;3864;2233;1631;893;677;306.0
9053;2018 donderdag 28 juni;481;262;219;397;185;212;214;210;0.0;4.0;34.0;33.0;1.0;0.0;129;5158;2980;2178;808;753;21.0
9054;2018 vrijdag 29 juni;534;276;258;406;210;196;700;684;8.0;8.0;44.0;42.0;1.0;1.0;104;7553;4578;2975;700;901;9.0
9055;2018 zaterdag 30 juni;418;212;206;387;190;197;349;344;4.0;1.0;6.0;5.0;0.0;1.0;0;4548;2781;1767;20;1126;0.0
9056;Totaal juli 2018;15288;7839;7449;12010;5800;6210;6341;6212;64.0;65.0;1819.0;1764.0;33.0;22.0;2613;158240;89386;68854;19990;16585;1201.0
9057;2018 zondag 1 juli;394;223;171;334;157;177;20;19;0.0;1.0;0.0;0.0;0.0;0.0;0;20253;10840;9413;79;837;0.0
9058;2018 maandag 2 juli;501;261;240;386;194;192;257;250;2.0;5.0;148.0;146.0;1.0;1.0;122;11476;6874;4602;1029;798;18.0
9059;2018 dinsdag 3 juli;529;265;264;359;190;169;192;188;3.0;1.0;91.0;88.0;2.0;1.0;111;4748;2769;1979;1107;605;324.0
9060;2018 woensdag 4 juli;487;247;240;452;238;214;167;161;2.0;4.0;52.0;50.0;0.0;2.0;127;4318;2456;1862;886;593;24.0
9061;2018 donderdag 5 juli;548;294;254;378;166;212;182;175;3.0;4.0;40.0;37.0;3.0;0.0;119;4459;2550;1909;1007;567;44.0
9062;2018 vrijdag 6 juli;560;294;266;419;197;222;847;839;2.0;6.0;48.0;47.0;1.0;0.0;131;4959;2864;2095;762;578;15.0
9063;2018 zaterdag 7 juli;427;229;198;383;191;192;348;337;5.0;6.0;9.0;7.0;0.0;2.0;2;2973;1780;1193;42;253;0.0
9064;2018 zondag 8 juli;370;225;145;349;150;199;17;17;0.0;0.0;0.0;0.0;0.0;0.0;0;1312;734;578;19;207;0.0
9065;2018 maandag 9 juli;500;240;260;369;174;195;244;240;3.0;1.0;160.0;159.0;0.0;1.0;111;6520;3693;2827;938;588;29.0
9066;2018 dinsdag 10 juli;542;286;256;382;175;207;189;188;1.0;0.0;101.0;98.0;3.0;0.0;96;4427;2461;1966;919;602;26.0
9067;2018 woensdag 11 juli;523;247;276;406;204;202;136;131;1.0;4.0;59.0;55.0;1.0;3.0;102;4268;2481;1787;1021;519;417.0
9068;2018 donderdag 12 juli;513;251;262;417;193;224;193;190;1.0;2.0;33.0;32.0;0.0;1.0;118;4648;2633;2015;889;560;37.0
9069;2018 vrijdag 13 juli;564;275;289;398;215;183;438;431;4.0;3.0;37.0;35.0;1.0;1.0;111;5372;2964;2408;702;552;6.0
9070;2018 zaterdag 14 juli;424;206;218;343;156;187;271;266;4.0;1.0;1.0;1.0;0.0;0.0;0;3166;1805;1361;22;240;0.0
9071;2018 zondag 15 juli;443;232;211;356;162;194;12;12;0.0;0.0;0.0;0.0;0.0;0.0;0;2630;1396;1234;27;431;0.0
9072;2018 maandag 16 juli;562;308;254;390;189;201;211;209;2.0;0.0;156.0;152.0;2.0;2.0;169;9249;5133;4116;896;596;16.0
9073;2018 dinsdag 17 juli;498;247;251;406;211;195;187;187;0.0;0.0;107.0;104.0;3.0;0.0;206;4273;2337;1936;893;498;27.0
9074;2018 woensdag 18 juli;553;292;261;382;196;186;206;199;5.0;2.0;55.0;53.0;2.0;0.0;118;4353;2420;1933;878;417;20.0
9075;2018 donderdag 19 juli;532;262;270;420;192;228;139;137;0.0;2.0;44.0;41.0;2.0;1.0;113;4117;2356;1761;882;464;23.0
9076;2018 vrijdag 20 juli;551;273;278;393;185;208;467;453;7.0;7.0;43.0;42.0;1.0;0.0;96;5616;3223;2393;674;608;16.0
9077;2018 zaterdag 21 juli;425;190;235;376;175;201;198;195;3.0;0.0;2.0;2.0;0.0;0.0;0;2987;1690;1297;33;234;0.0
9078;2018 zondag 22 juli;381;198;183;334;161;173;14;14;0.0;0.0;0.0;0.0;0.0;0.0;0;1123;635;488;18;177;0.0
9079;2018 maandag 23 juli;493;265;228;400;220;180;186;182;2.0;2.0;147.0;145.0;2.0;0.0;119;6618;3752;2866;872;572;27.0
9080;2018 dinsdag 24 juli;494;261;233;371;164;207;165;163;2.0;0.0;107.0;103.0;2.0;2.0;140;3781;2058;1723;968;503;30.0
9081;2018 woensdag 25 juli;565;291;274;355;180;175;128;123;3.0;2.0;61.0;60.0;1.0;0.0;109;4398;2480;1918;881;554;34.0
9082;2018 donderdag 26 juli;545;274;271;394;190;204;117;114;2.0;1.0;36.0;36.0;0.0;0.0;92;4118;2389;1729;800;519;22.0
9083;2018 vrijdag 27 juli;513;264;249;459;224;235;283;279;1.0;3.0;44.0;43.0;1.0;0.0;88;5441;3157;2284;699;675;12.0
9084;2018 zaterdag 28 juli;415;215;200;454;207;247;145;143;1.0;1.0;4.0;4.0;0.0;0.0;0;3097;1798;1299;33;281;0.0
9085;2018 zondag 29 juli;387;197;190;334;159;175;10;10;0.0;0.0;0.0;0.0;0.0;0.0;0;1030;554;476;39;239;0.0
9086;2018 maandag 30 juli;500;265;235;402;202;200;195;189;3.0;3.0;142.0;136.0;4.0;2.0;109;6007;3354;2653;992;802;8.0
9087;2018 dinsdag 31 juli;549;262;287;409;183;226;177;171;2.0;4.0;92.0;88.0;1.0;3.0;104;6503;3750;2753;983;1516;26.0
9088;Totaal augustus 2018;15116;7745;7371;11752;5826;5926;8751;8485;116.0;150.0;1633.0;1580.0;28.0;25.0;2461;166101;88202;77899;34615;15073;505.0
9089;2018 woensdag 1 augustus;532;270;262;381;196;185;356;343;8.0;5.0;56.0;52.0;2.0;2.0;129;31937;16810;15127;1076;1380;33.0
9090;2018 donderdag 2 augustus;534;310;224;368;175;193;122;119;1.0;2.0;32.0;31.0;0.0;1.0;121;4654;2528;2126;1089;441;29.0
9091;2018 vrijdag 3 augustus;523;263;260;451;225;226;255;246;4.0;5.0;35.0;32.0;2.0;1.0;92;4743;2673;2070;791;469;26.0
9092;2018 zaterdag 4 augustus;422;221;201;382;179;203;156;155;1.0;0.0;2.0;2.0;0.0;0.0;2;2146;1189;957;25;182;0.0
9093;2018 zondag 5 augustus;370;186;184;366;175;191;23;21;1.0;1.0;0.0;0.0;0.0;0.0;0;1306;682;624;10;165;0.0
9094;2018 maandag 6 augustus;470;234;236;394;206;188;220;218;1.0;1.0;149.0;145.0;1.0;3.0;116;6054;3211;2843;1035;510;14.0
9095;2018 dinsdag 7 augustus;519;275;244;430;207;223;197;191;4.0;2.0;96.0;92.0;2.0;2.0;96;4015;2162;1853;934;451;21.0
9096;2018 woensdag 8 augustus;556;280;276;434;213;221;668;642;8.0;18.0;76.0;72.0;1.0;3.0;99;4466;2375;2091;1021;456;17.0
9097;2018 donderdag 9 augustus;505;245;260;403;201;202;115;109;2.0;4.0;34.0;33.0;0.0;1.0;148;3844;2078;1766;997;360;26.0
9098;2018 vrijdag 10 augustus;511;268;243;358;162;196;582;560;12.0;10.0;42.0;39.0;2.0;1.0;70;5493;3001;2492;796;436;15.0
9099;2018 zaterdag 11 augustus;413;201;212;362;186;176;176;173;1.0;2.0;0.0;0.0;0.0;0.0;3;2427;1333;1094;32;146;0.0
9100;2018 zondag 12 augustus;367;171;196;364;164;200;18;16;1.0;1.0;0.0;0.0;0.0;0.0;1;1308;628;680;14;146;0.0
9101;2018 maandag 13 augustus;493;255;238;373;181;192;220;214;2.0;4.0;139.0;137.0;2.0;0.0;91;6376;3332;3044;1059;562;14.0
9102;2018 dinsdag 14 augustus;559;276;283;356;172;184;191;187;4.0;0.0;90.0;88.0;1.0;1.0;105;4207;2196;2011;992;415;16.0
9103;2018 woensdag 15 augustus;543;305;238;394;194;200;137;132;4.0;1.0;54.0;52.0;0.0;2.0;133;7828;4161;3667;1002;618;20.0
9104;2018 donderdag 16 augustus;515;258;257;377;194;183;187;182;3.0;2.0;45.0;42.0;2.0;1.0;124;4852;2548;2304;1345;594;20.0
9105;2018 vrijdag 17 augustus;549;288;261;388;193;195;454;436;5.0;13.0;27.0;24.0;3.0;0.0;84;4932;2667;2265;1759;402;19.0
9106;2018 zaterdag 18 augustus;440;217;223;382;183;199;931;899;14.0;18.0;4.0;2.0;2.0;0.0;0;2832;1506;1326;20;169;0.0
9107;2018 zondag 19 augustus;404;208;196;335;163;172;19;18;1.0;0.0;0.0;0.0;0.0;0.0;0;1234;555;679;19;132;2.0
9108;2018 maandag 20 augustus;493;252;241;404;204;200;309;300;4.0;5.0;125.0;122.0;1.0;2.0;107;7439;3762;3677;3042;537;11.0
9109;2018 dinsdag 21 augustus;486;262;224;368;200;168;202;196;3.0;3.0;109.0;107.0;1.0;1.0;90;3973;1954;2019;3189;632;36.0
9110;2018 woensdag 22 augustus;528;268;260;407;216;191;148;143;1.0;4.0;50.0;50.0;0.0;0.0;91;4069;2153;1916;1378;424;19.0
9111;2018 donderdag 23 augustus;534;281;253;365;174;191;164;161;1.0;2.0;30.0;28.0;1.0;1.0;115;4330;2307;2023;1353;496;19.0
9112;2018 vrijdag 24 augustus;527;261;266;372;188;184;715;700;6.0;9.0;49.0;49.0;0.0;0.0;106;5421;2804;2617;1204;458;7.0
9113;2018 zaterdag 25 augustus;384;179;205;364;170;194;334;325;4.0;5.0;2.0;2.0;0.0;0.0;2;3441;1848;1593;103;223;0.0
9114;2018 zondag 26 augustus;397;197;200;331;169;162;18;18;0.0;0.0;2.0;2.0;0.0;0.0;0;1491;676;815;18;197;0.0
9115;2018 maandag 27 augustus;493;254;239;359;184;175;267;258;4.0;5.0;135.0;132.0;2.0;1.0;109;6679;3556;3123;1865;726;12.0
9116;2018 dinsdag 28 augustus;503;247;256;374;177;197;276;268;4.0;4.0;103.0;100.0;2.0;1.0;111;4404;2278;2126;2154;561;26.0
9117;2018 woensdag 29 augustus;482;254;228;360;180;180;176;170;1.0;5.0;57.0;56.0;1.0;0.0;113;4383;2276;2107;2757;661;31.0
9118;2018 donderdag 30 augustus;524;271;253;384;199;185;223;218;2.0;3.0;43.0;43.0;0.0;0.0;100;5661;3096;2565;1919;756;36.0
9119;2018 vrijdag 31 augustus;540;288;252;366;196;170;892;867;9.0;16.0;47.0;46.0;0.0;1.0;103;10156;5857;4299;1617;1368;36.0
9120;Totaal september 2018;14933;7642;7291;11230;5581;5649;8419;8225;87.0;107.0;1551.0;1491.0;27.0;33.0;2293;146837;80257;66580;31650;11525;3072.0
9121;2018 zaterdag 1 september;398;205;193;363;193;170;460;442;12.0;6.0;2.0;2.0;0.0;0.0;1;25276;12443;12833;747;1074;0.0
9122;2018 zondag 2 september;397;225;172;320;146;174;22;22;0.0;0.0;2.0;1.0;0.0;1.0;1;1636;662;974;13;220;0.0
9123;2018 maandag 3 september;520;261;259;365;190;175;273;268;2.0;3.0;133.0;130.0;1.0;2.0;114;9942;5224;4718;1772;569;21.0
9124;2018 dinsdag 4 september;527;273;254;374;178;196;207;204;1.0;2.0;96.0;93.0;1.0;2.0;136;4297;2292;2005;1916;407;34.0
9125;2018 woensdag 5 september;540;269;271;390;208;182;171;164;6.0;1.0;44.0;42.0;1.0;1.0;113;4167;2191;1976;2114;405;23.0
9126;2018 donderdag 6 september;524;283;241;400;196;204;243;239;1.0;3.0;36.0;35.0;0.0;1.0;116;4305;2373;1932;1917;368;19.0
9127;2018 vrijdag 7 september;551;269;282;356;160;196;1061;1037;8.0;16.0;45.0;40.0;2.0;3.0;95;5000;2822;2178;1221;425;9.0
9128;2018 zaterdag 8 september;428;222;206;375;187;188;426;420;4.0;2.0;2.0;2.0;0.0;0.0;1;2476;1364;1112;50;173;0.0
9129;2018 zondag 9 september;422;212;210;350;165;185;39;34;3.0;2.0;0.0;0.0;0.0;0.0;0;1387;721;666;6;133;0.0
9130;2018 maandag 10 september;517;260;257;361;196;165;282;277;2.0;3.0;139.0;135.0;1.0;3.0;98;7047;3907;3140;1824;523;17.0
9131;2018 dinsdag 11 september;557;271;286;367;185;182;174;169;2.0;3.0;95.0;89.0;3.0;3.0;147;3754;2056;1698;1715;398;29.0
9132;2018 woensdag 12 september;547;280;267;352;175;177;167;166;1.0;0.0;59.0;57.0;0.0;2.0;114;3981;2258;1723;1383;411;1739.0
9133;2018 donderdag 13 september;505;253;252;372;186;186;165;160;1.0;4.0;36.0;32.0;0.0;4.0;130;4040;2240;1800;2790;298;28.0
9134;2018 vrijdag 14 september;563;296;267;395;215;180;961;940;9.0;12.0;46.0;45.0;1.0;0.0;105;6157;3509;2648;1029;392;10.0
9135;2018 zaterdag 15 september;463;234;229;346;177;169;335;325;4.0;6.0;7.0;7.0;0.0;0.0;0;4070;2366;1704;75;222;2.0
9136;2018 zondag 16 september;406;214;192;345;163;182;18;18;0.0;0.0;1.0;1.0;0.0;0.0;0;1419;740;679;17;143;0.0
9137;2018 maandag 17 september;524;267;257;392;187;205;224;218;2.0;4.0;136.0;133.0;2.0;1.0;129;6801;3895;2906;1438;445;25.0
9138;2018 dinsdag 18 september;577;292;285;415;230;185;269;266;0.0;3.0;124.0;117.0;6.0;1.0;122;3803;2093;1710;1690;394;77.0
9139;2018 woensdag 19 september;522;276;246;393;204;189;130;128;1.0;1.0;52.0;51.0;1.0;0.0;97;3656;1989;1667;1328;339;580.0
9140;2018 donderdag 20 september;559;301;258;395;187;208;183;181;0.0;2.0;41.0;41.0;0.0;0.0;106;4784;2682;2102;1290;341;48.0
9141;2018 vrijdag 21 september;546;289;257;417;200;217;776;761;6.0;9.0;32.0;31.0;0.0;1.0;95;4821;2769;2052;903;355;22.0
9142;2018 zaterdag 22 september;431;228;203;329;158;171;303;297;4.0;2.0;6.0;6.0;0.0;0.0;0;2940;1802;1138;15;141;3.0
9143;2018 zondag 23 september;429;209;220;363;159;204;12;12;0.0;0.0;0.0;0.0;0.0;0.0;0;1190;638;552;3;116;0.0
9144;2018 maandag 24 september;494;244;250;385;189;196;214;212;2.0;0.0;165.0;160.0;2.0;3.0;112;6122;3465;2657;1031;478;21.0
9145;2018 dinsdag 25 september;526;244;282;371;181;190;173;167;4.0;2.0;100.0;94.0;3.0;3.0;131;3898;2210;1688;1687;414;27.0
9146;2018 woensdag 26 september;512;259;253;382;178;204;113;108;3.0;2.0;64.0;61.0;1.0;2.0;120;3949;2251;1698;1237;413;299.0
9147;2018 donderdag 27 september;516;285;231;388;199;189;164;158;2.0;4.0;38.0;37.0;1.0;0.0;106;4421;2458;1963;1532;454;24.0
9148;2018 vrijdag 28 september;579;307;272;425;215;210;601;587;5.0;9.0;43.0;42.0;1.0;0.0;104;6530;3865;2665;837;559;15.0
9149;2018 zaterdag 29 september;459;218;241;395;205;190;237;230;2.0;5.0;7.0;7.0;0.0;0.0;0;2646;1609;1037;65;302;0.0
9150;2018 zondag 30 september;394;196;198;349;169;180;16;15;0.0;1.0;0.0;0.0;0.0;0.0;0;2322;1363;959;5;613;0.0
9151;Totaal oktober 2018;14413;7373;7040;12178;6010;6168;4638;4525;51.0;62.0;1982.0;1922.0;22.0;38.0;2403;153954;88149;65805;22506;10664;3659.0
9152;2018 maandag 1 oktober;502;270;232;389;186;203;230;220;4.0;6.0;158.0;156.0;1.0;1.0;107;31796;17962;13834;1267;1136;18.0
9153;2018 dinsdag 2 oktober;523;281;242;409;205;204;137;135;1.0;1.0;97.0;92.0;2.0;3.0;118;4556;2553;2003;1117;454;36.0
9154;2018 woensdag 3 oktober;511;243;268;413;207;206;99;96;1.0;2.0;56.0;54.0;1.0;1.0;103;4156;2432;1724;1154;402;728.0
9155;2018 donderdag 4 oktober;510;239;271;405;203;202;106;105;0.0;1.0;41.0;40.0;0.0;1.0;107;4277;2450;1827;1187;327;23.0
9156;2018 vrijdag 5 oktober;544;264;280;448;215;233;406;392;3.0;11.0;49.0;48.0;0.0;1.0;91;4885;2768;2117;870;334;15.0
9157;2018 zaterdag 6 oktober;429;230;199;424;200;224;140;139;0.0;1.0;1.0;1.0;0.0;0.0;0;2364;1444;920;19;114;1.0
9158;2018 zondag 7 oktober;384;203;181;315;157;158;9;9;0.0;0.0;0.0;0.0;0.0;0.0;0;1169;597;572;12;116;0.0
9159;2018 maandag 8 oktober;525;266;259;388;188;200;290;279;4.0;7.0;151.0;146.0;1.0;4.0;97;6081;3412;2669;1034;451;18.0
9160;2018 dinsdag 9 oktober;510;252;258;396;197;199;150;146;4.0;0.0;92.0;89.0;0.0;3.0;124;3401;1872;1529;909;342;16.0
9161;2018 woensdag 10 oktober;501;262;239;381;190;191;174;170;2.0;2.0;61.0;59.0;1.0;1.0;84;4613;2565;2048;1085;400;29.0
9162;2018 donderdag 11 oktober;540;286;254;414;193;221;93;90;0.0;3.0;28.0;28.0;0.0;0.0;100;3912;2207;1705;1111;332;44.0
9163;2018 vrijdag 12 oktober;498;264;234;437;208;229;360;356;3.0;1.0;38.0;36.0;0.0;2.0;98;4943;3069;1874;786;293;601.0
9164;2018 zaterdag 13 oktober;415;216;199;392;210;182;101;100;0.0;1.0;3.0;2.0;0.0;1.0;1;2393;1513;880;13;109;1.0
9165;2018 zondag 14 oktober;335;181;154;351;175;176;4;4;0.0;0.0;1.0;1.0;0.0;0.0;0;1157;650;507;13;93;0.0
9166;2018 maandag 15 oktober;451;236;215;402;208;194;191;190;0.0;1.0;156.0;153.0;2.0;1.0;100;10006;5745;4261;1069;495;28.0
9167;2018 dinsdag 16 oktober;478;238;240;414;199;215;133;132;0.0;1.0;101.0;95.0;2.0;4.0;88;4013;2223;1790;1080;295;30.0
9168;2018 woensdag 17 oktober;481;246;235;431;208;223;94;92;1.0;1.0;60.0;58.0;2.0;0.0;111;3784;2138;1646;989;264;881.0
9169;2018 donderdag 18 oktober;480;246;234;369;168;201;277;272;2.0;3.0;63.0;62.0;0.0;1.0;108;4195;2356;1839;961;332;26.0
9170;2018 vrijdag 19 oktober;497;261;236;430;210;220;311;299;5.0;7.0;45.0;42.0;1.0;2.0;114;4509;2591;1918;733;296;32.0
9171;2018 zaterdag 20 oktober;393;196;197;335;164;171;116;114;1.0;1.0;3.0;3.0;0.0;0.0;1;3410;2117;1293;44;136;0.0
9172;2018 zondag 21 oktober;360;184;176;354;175;179;8;7;1.0;0.0;0.0;0.0;0.0;0.0;1;1070;580;490;8;85;2.0
9173;2018 maandag 22 oktober;492;224;268;407;215;192;193;187;2.0;4.0;162.0;160.0;0.0;2.0;96;5768;3159;2609;846;370;38.0
9174;2018 dinsdag 23 oktober;456;235;221;384;194;190;128;124;4.0;0.0;120.0;117.0;2.0;1.0;123;3616;2034;1582;815;398;26.0
9175;2018 woensdag 24 oktober;480;244;236;382;195;187;95;90;4.0;1.0;56.0;55.0;0.0;1.0;103;3807;2156;1651;926;358;36.0
9176;2018 donderdag 25 oktober;454;236;218;360;183;177;89;87;1.0;1.0;51.0;48.0;2.0;1.0;101;4558;2555;2003;916;317;27.0
9177;2018 vrijdag 26 oktober;496;266;230;380;191;189;226;220;4.0;2.0;56.0;53.0;1.0;2.0;81;5093;3060;2033;707;398;29.0
9178;2018 zaterdag 27 oktober;404;217;187;371;183;188;76;75;0.0;1.0;0.0;0.0;0.0;0.0;1;3252;1932;1320;19;139;3.0
9179;2018 zondag 28 oktober;371;178;193;386;183;203;8;8;0.0;0.0;0.0;0.0;0.0;0.0;0;1392;779;613;16;128;1.0
9180;2018 maandag 29 oktober;455;225;230;398;205;193;175;174;1.0;0.0;163.0;160.0;1.0;2.0;98;5571;3139;2432;978;449;917.0
9181;2018 dinsdag 30 oktober;474;242;232;408;196;212;130;126;2.0;2.0;107.0;104.0;1.0;2.0;133;4043;2313;1730;981;586;35.0
9182;2018 woensdag 31 oktober;464;242;222;405;199;206;89;87;1.0;1.0;63.0;60.0;2.0;1.0;114;6164;3778;2386;841;715;18.0
9183;Totaal november 2018;13568;6982;6586;12122;5915;6207;2826;2740;51.0;35.0;1678.0;1620.0;27.0;31.0;2562;146090;85150;60940;19130;9199;4464.0
9184;2018 donderdag 1 november;503;250;253;440;212;228;96;95;1.0;0.0;40.0;38.0;1.0;1.0;106;27912;16017;11895;1160;834;27.0
9185;2018 vrijdag 2 november;484;243;241;405;186;219;177;168;6.0;3.0;37.0;37.0;0.0;0.0;93;5032;2942;2090;816;409;27.0
9186;2018 zaterdag 3 november;361;195;166;400;198;202;38;35;2.0;1.0;2.0;2.0;0.0;0.0;0;2300;1295;1005;23;155;2.0
9187;2018 zondag 4 november;400;213;187;355;173;182;2;2;0.0;0.0;0.0;0.0;0.0;0.0;0;1175;615;560;7;99;1.0
9188;2018 maandag 5 november;456;226;230;399;199;200;181;175;5.0;1.0;155.0;150.0;1.0;4.0;111;6194;3649;2545;920;462;24.0
9189;2018 dinsdag 6 november;462;235;227;419;215;204;133;130;1.0;2.0;92.0;90.0;0.0;2.0;127;3436;1888;1548;889;291;892.0
9190;2018 woensdag 7 november;485;257;228;406;207;199;84;80;2.0;2.0;55.0;54.0;1.0;0.0;125;3875;2230;1645;916;283;22.0
9191;2018 donderdag 8 november;482;253;229;389;210;179;79;78;0.0;1.0;33.0;33.0;0.0;0.0;113;4160;2406;1754;976;415;36.0
9192;2018 vrijdag 9 november;500;271;229;423;211;212;130;123;6.0;1.0;44.0;43.0;0.0;1.0;113;4196;2475;1721;701;290;15.0
9193;2018 zaterdag 10 november;419;214;205;398;199;199;61;58;3.0;0.0;1.0;1.0;0.0;0.0;0;3068;1811;1257;11;101;0.0
9194;2018 zondag 11 november;411;215;196;362;164;198;10;9;0.0;1.0;0.0;0.0;0.0;0.0;0;1281;724;557;17;99;0.0
9195;2018 maandag 12 november;469;241;228;419;219;200;158;153;2.0;3.0;178.0;172.0;2.0;4.0;130;5693;3235;2458;891;409;29.0
9196;2018 dinsdag 13 november;460;213;247;399;191;208;111;108;2.0;1.0;93.0;90.0;2.0;1.0;136;3453;1999;1454;883;377;732.0
9197;2018 woensdag 14 november;471;262;209;390;189;201;80;77;2.0;1.0;72.0;68.0;2.0;2.0;110;3938;2260;1678;875;281;1019.0
9198;2018 donderdag 15 november;484;251;233;411;193;218;61;61;0.0;0.0;33.0;33.0;0.0;0.0;139;7043;4118;2925;1066;386;22.0
9199;2018 vrijdag 16 november;497;253;244;394;182;212;164;161;2.0;1.0;29.0;28.0;1.0;0.0;95;5275;3045;2230;669;250;15.0
9200;2018 zaterdag 17 november;389;199;190;385;177;208;44;41;3.0;0.0;2.0;2.0;0.0;0.0;0;2610;1607;1003;77;97;2.0
9201;2018 zondag 18 november;347;170;177;360;179;181;3;3;0.0;0.0;1.0;1.0;0.0;0.0;0;1145;606;539;7;86;0.0
9202;2018 maandag 19 november;496;248;248;387;171;216;155;152;1.0;2.0;143.0;139.0;2.0;2.0;108;5358;3078;2280;843;314;27.0
9203;2018 dinsdag 20 november;505;260;245;399;204;195;124;119;2.0;3.0;104.0;103.0;1.0;0.0;112;4090;2319;1771;820;290;42.0
9204;2018 woensdag 21 november;503;244;259;429;200;229;86;82;1.0;3.0;58.0;57.0;1.0;0.0;125;3676;2170;1506;899;256;36.0
9205;2018 donderdag 22 november;490;260;230;440;211;229;86;84;1.0;1.0;34.0;30.0;1.0;3.0;117;3895;2283;1612;854;259;951.0
9206;2018 vrijdag 23 november;454;239;215;432;224;208;132;128;1.0;3.0;49.0;48.0;1.0;0.0;105;4676;2826;1850;692;342;17.0
9207;2018 zaterdag 24 november;389;210;179;380;190;190;41;40;0.0;1.0;1.0;1.0;0.0;0.0;0;3542;2227;1315;25;107;0.0
9208;2018 zondag 25 november;321;160;161;387;195;192;3;3;0.0;0.0;0.0;0.0;0.0;0.0;0;1376;766;610;31;101;0.0
9209;2018 maandag 26 november;474;235;239;440;210;230;166;165;1.0;0.0;151.0;148.0;1.0;2.0;102;5704;3306;2398;846;376;40.0
9210;2018 dinsdag 27 november;480;255;225;369;182;187;117;112;4.0;1.0;111.0;105.0;3.0;3.0;132;3602;2049;1553;804;339;40.0
9211;2018 woensdag 28 november;450;226;224;398;199;199;78;78;0.0;0.0;62.0;59.0;1.0;2.0;143;4211;2530;1681;783;357;415.0
9212;2018 donderdag 29 november;442;232;210;468;222;246;77;72;3.0;2.0;49.0;44.0;3.0;2.0;111;4545;2665;1880;907;365;25.0
9213;2018 vrijdag 30 november;484;252;232;439;203;236;149;148;0.0;1.0;49.0;44.0;3.0;2.0;109;9629;6009;3620;722;769;6.0
9214;Totaal december 2018;13092;6771;6321;13145;6436;6709;2648;2581;29.0;38.0;1566.0;1519.0;19.0;28.0;2157;141978;83671;58307;14380;10724;1714.0
9215;2018 zaterdag 1 december;368;179;189;415;215;200;58;55;1.0;2.0;0.0;0.0;0.0;0.0;1;20929;12065;8864;95;524;2.0
9216;2018 zondag 2 december;351;177;174;371;171;200;2;1;1.0;0.0;0.0;0.0;0.0;0.0;0;1309;738;571;13;109;0.0
9217;2018 maandag 3 december;471;248;223;426;211;215;138;135;1.0;2.0;157.0;153.0;2.0;2.0;134;8729;5233;3496;946;404;37.0
9218;2018 dinsdag 4 december;445;231;214;422;212;210;118;117;0.0;1.0;122.0;120.0;1.0;1.0;111;3873;2268;1605;916;346;49.0
9219;2018 woensdag 5 december;379;194;185;420;204;216;64;62;1.0;1.0;54.0;50.0;1.0;3.0;97;4168;2443;1725;878;295;28.0
9220;2018 donderdag 6 december;433;209;224;437;222;215;87;87;0.0;0.0;41.0;39.0;1.0;1.0;115;4055;2338;1717;992;308;24.0
9221;2018 vrijdag 7 december;482;256;226;419;214;205;135;131;2.0;2.0;46.0;42.0;2.0;2.0;112;5180;3033;2147;629;349;23.0
9222;2018 zaterdag 8 december;382;206;176;421;196;225;50;48;0.0;2.0;2.0;2.0;0.0;0.0;0;3062;1916;1146;17;98;0.0
9223;2018 zondag 9 december;375;185;190;422;203;219;2;2;0.0;0.0;0.0;0.0;0.0;0.0;0;1058;624;434;8;91;0.0
9224;2018 maandag 10 december;440;238;202;411;200;211;160;154;3.0;3.0;174.0;172.0;1.0;1.0;121;6761;3967;2794;879;425;27.0
9225;2018 dinsdag 11 december;488;261;227;424;218;206;127;125;1.0;1.0;122.0;121.0;0.0;1.0;117;3738;2205;1533;823;294;25.0
9226;2018 woensdag 12 december;463;244;219;439;215;224;108;106;1.0;1.0;86.0;83.0;2.0;1.0;126;4304;2485;1819;975;389;33.0
9227;2018 donderdag 13 december;439;229;210;467;235;232;54;51;0.0;3.0;43.0;41.0;1.0;1.0;88;4076;2375;1701;815;368;17.0
9228;2018 vrijdag 14 december;448;235;213;408;214;194;193;185;2.0;6.0;53.0;51.0;1.0;1.0;90;7046;4296;2750;639;393;928.0
9229;2018 zaterdag 15 december;333;164;169;445;218;227;43;43;0.0;0.0;2.0;2.0;0.0;0.0;1;5721;3638;2083;13;234;0.0
9230;2018 zondag 16 december;351;169;182;417;209;208;6;6;0.0;0.0;0.0;0.0;0.0;0.0;0;1415;831;584;28;149;0.0
9231;2018 maandag 17 december;460;244;216;424;194;230;184;179;3.0;2.0;164.0;160.0;0.0;4.0;111;7416;4531;2885;845;514;69.0
9232;2018 dinsdag 18 december;476;261;215;420;203;217;182;176;2.0;4.0;124.0;121.0;2.0;1.0;113;4196;2372;1824;776;389;27.0
9233;2018 woensdag 19 december;514;279;235;457;217;240;92;87;2.0;3.0;75.0;72.0;0.0;3.0;95;4073;2356;1717;748;411;17.0
9234;2018 donderdag 20 december;485;246;239;462;230;232;89;88;0.0;1.0;38.0;38.0;0.0;0.0;171;5271;3209;2062;798;527;311.0
9235;2018 vrijdag 21 december;503;250;253;420;202;218;226;224;2.0;0.0;49.0;47.0;0.0;2.0;131;5946;3620;2326;628;584;36.0
9236;2018 zaterdag 22 december;400;215;185;423;208;215;47;47;0.0;0.0;2.0;2.0;0.0;0.0;0;3439;2019;1420;8;303;2.0
9237;2018 zondag 23 december;346;196;150;426;212;214;5;5;0.0;0.0;0.0;0.0;0.0;0.0;0;1125;636;489;3;202;0.0
9238;2018 maandag 24 december;463;228;235;395;174;221;122;118;3.0;1.0;71.0;69.0;1.0;1.0;80;3782;2138;1644;364;288;12.0
9239;2018 dinsdag 25 december;314;155;159;407;203;204;3;3;0.0;0.0;0.0;0.0;0.0;0.0;0;625;329;296;0;83;0.0
9240;2018 woensdag 26 december;320;172;148;398;195;203;4;4;0.0;0.0;0.0;0.0;0.0;0.0;0;725;392;333;0;96;0.0
9241;2018 donderdag 27 december;469;239;230;395;193;202;80;79;1.0;0.0;44.0;43.0;0.0;1.0;137;5200;2989;2211;622;540;13.0
9242;2018 vrijdag 28 december;501;253;248;439;222;217;122;117;3.0;2.0;39.0;34.0;4.0;1.0;129;6406;3729;2677;550;516;18.0
9243;2018 zaterdag 29 december;419;210;209;431;200;231;31;31;0.0;0.0;1.0;1.0;0.0;0.0;0;2166;1280;886;43;175;0.0
9244;2018 zondag 30 december;359;190;169;428;213;215;6;6;0.0;0.0;0.0;0.0;0.0;0.0;0;1391;778;613;17;176;0.0
9245;2018 maandag 31 december;415;208;207;456;213;243;110;109;0.0;1.0;57.0;56.0;0.0;1.0;77;4793;2838;1955;312;1144;16.0
9246;Totaal 2018;168525;86204;82321;153363;74522;78841;64315;62813;682.0;820.0;19830.0;19181.0;311.0;338.0;30729;1785054;1026769;758285;243736;134797;27852.0
9247;Totaal op zondag in 2018;19481;10024;9457;20200;9665;10535;587;568;9.0;10.0;14.0;12.0;0.0;2.0;14;101218;55773;45445;1092;8536;12.0
9248;Totaal op maandag in 2018;24981;12655;12326;22269;10792;11477;10313;10081;98.0;134.0;7446.0;7270.0;74.0;102.0;5954;383147;218978;164169;48887;25769;3640.0
9249;Totaal op dinsdag in 2018;25443;12975;12468;21836;10671;11165;8310;8107;104.0;99.0;5143.0;4957.0;94.0;92.0;6455;239002;136564;102438;51837;22162;4599.0
9250;Totaal op woensdag in 2018;25801;13144;12657;22224;10911;11313;7191;6993;91.0;107.0;2984.0;2878.0;49.0;57.0;6125;252074;143371;108703;49582;22022;10413.0
9251;Totaal op donderdag in 2018;25608;13196;12412;22426;10862;11564;6717;6546;68.0;103.0;2005.0;1923.0;40.0;42.0;6182;313834;180940;132894;51270;22473;4488.0
9252;Totaal op vrijdag in 2018;26400;13543;12857;22732;11144;11588;20308;19845;199.0;264.0;2111.0;2023.0;50.0;38.0;5461;299873;176323;123550;38050;22533;4232.0
9253;Totaal op zaterdag in 2018;20677;10595;10082;21593;10425;11168;8575;8367;108.0;100.0;117.0;108.0;4.0;5.0;41;194748;114088;80660;2777;10837;22.0
9254;Overig 2018;134;72;62;83;52;31;2314;2306;5.0;3.0;10.0;10.0;0.0;0.0;497;1158;732;426;241;465;446.0
9255;Totaal januari 2019;14183;7149;7034;13994;6784;7210;2674;2621;24.0;29.0;1717.0;1669.0;23.0;25.0;2826;152081;87507;64574;21538;12432;3394.0
9256;2019 dinsdag 1 januari;320;163;157;417;213;204;5;5;0.0;0.0;0.0;0.0;0.0;0.0;1;22636;12257;10379;82;870;1.0
9257;2019 woensdag 2 januari;458;233;225;451;214;237;76;75;1.0;0.0;38.0;36.0;2.0;0.0;114;7360;4216;3144;939;467;19.0
9258;2019 donderdag 3 januari;512;241;271;418;189;229;73;71;0.0;2.0;37.0;34.0;0.0;3.0;108;5771;3138;2633;971;454;26.0
9259;2019 vrijdag 4 januari;499;272;227;448;224;224;108;108;0.0;0.0;43.0;43.0;0.0;0.0;127;5935;3458;2477;758;404;19.0
9260;2019 zaterdag 5 januari;423;210;213;457;229;228;32;32;0.0;0.0;0.0;0.0;0.0;0.0;0;2791;1667;1124;21;198;1.0
9261;2019 zondag 6 januari;371;188;183;415;181;234;6;6;0.0;0.0;1.0;1.0;0.0;0.0;0;1387;743;644;12;150;1.0
9262;2019 maandag 7 januari;491;245;246;474;232;242;192;187;3.0;2.0;131.0;128.0;2.0;1.0;126;7038;3911;3127;1016;411;32.0
9263;2019 dinsdag 8 januari;522;247;275;440;217;223;150;145;3.0;2.0;109.0;107.0;1.0;1.0;159;4122;2302;1820;971;405;32.0
9264;2019 woensdag 9 januari;479;247;232;494;246;248;103;102;0.0;1.0;58.0;55.0;1.0;2.0;135;3869;2238;1631;842;323;39.0
9265;2019 donderdag 10 januari;466;247;219;477;229;248;69;68;1.0;0.0;38.0;35.0;1.0;2.0;139;4725;2786;1939;922;362;68.0
9266;2019 vrijdag 11 januari;506;252;254;460;212;248;127;125;1.0;1.0;39.0;39.0;0.0;0.0;132;4657;2653;2004;693;342;47.0
9267;2019 zaterdag 12 januari;393;205;188;456;220;236;28;28;0.0;0.0;3.0;3.0;0.0;0.0;1;2762;1711;1051;20;120;1.0
9268;2019 zondag 13 januari;379;178;201;458;220;238;3;3;0.0;0.0;0.0;0.0;0.0;0.0;0;1084;593;491;6;111;1.0
9269;2019 maandag 14 januari;468;235;233;454;223;231;161;159;1.0;1.0;165.0;162.0;1.0;2.0;138;6601;3837;2764;971;409;48.0
9270;2019 dinsdag 15 januari;482;260;222;440;203;237;119;116;1.0;2.0;117.0;111.0;2.0;4.0;96;6596;3941;2655;929;574;27.0
9271;2019 woensdag 16 januari;436;204;232;445;217;228;84;82;1.0;1.0;55.0;54.0;1.0;0.0;129;4211;2453;1758;942;339;26.0
9272;2019 donderdag 17 januari;494;248;246;448;204;244;58;57;1.0;0.0;36.0;36.0;0.0;0.0;136;3831;2261;1570;967;329;51.0
9273;2019 vrijdag 18 januari;500;270;230;484;232;252;147;143;1.0;3.0;55.0;53.0;1.0;1.0;114;4795;2784;2011;857;372;24.0
9274;2019 zaterdag 19 januari;409;195;214;434;223;211;94;92;0.0;2.0;5.0;5.0;0.0;0.0;1;2817;1770;1047;15;121;0.0
9275;2019 zondag 20 januari;378;189;189;447;220;227;8;8;0.0;0.0;0.0;0.0;0.0;0.0;0;1522;837;685;21;139;0.0
9276;2019 maandag 21 januari;501;244;257;456;225;231;153;147;2.0;4.0;158.0;154.0;3.0;1.0;157;5877;3393;2484;1046;462;45.0
9277;2019 dinsdag 22 januari;480;263;217;464;227;237;126;125;0.0;1.0;116.0;112.0;3.0;1.0;137;3539;2022;1517;983;403;36.0
9278;2019 woensdag 23 januari;477;250;227;473;231;242;89;86;2.0;1.0;64.0;60.0;1.0;3.0;166;3541;1962;1579;906;390;1857.0
9279;2019 donderdag 24 januari;437;224;213;413;208;205;68;68;0.0;0.0;42.0;42.0;0.0;0.0;122;3802;2240;1562;878;415;68.0
9280;2019 vrijdag 25 januari;526;264;262;489;254;235;103;99;2.0;2.0;37.0;37.0;0.0;0.0;128;5129;3160;1969;842;554;28.0
9281;2019 zaterdag 26 januari;417;195;222;449;214;235;38;38;0.0;0.0;2.0;2.0;0.0;0.0;1;3663;2320;1343;49;216;1.0
9282;2019 zondag 27 januari;396;195;201;434;185;249;11;11;0.0;0.0;0.0;0.0;0.0;0.0;0;1217;698;519;12;242;0.0
9283;2019 maandag 28 januari;487;241;246;446;222;224;169;166;2.0;1.0;162.0;160.0;1.0;1.0;108;5824;3380;2444;939;634;42.0
9284;2019 dinsdag 29 januari;490;244;246;445;231;214;121;119;0.0;2.0;113.0;110.0;1.0;2.0;109;3727;2159;1568;1187;520;42.0
9285;2019 woensdag 30 januari;490;253;237;417;198;219;82;80;1.0;1.0;53.0;51.0;2.0;0.0;125;4165;2402;1763;1711;516;738.0
9286;2019 donderdag 31 januari;496;247;249;491;241;250;71;70;1.0;0.0;40.0;39.0;0.0;1.0;117;7087;4215;2872;1030;1180;74.0
9287;Totaal februari 2019;12142;6245;5897;12756;6229;6527;2707;2643;37.0;27.0;1690.0;1636.0;30.0;24.0;2426;140637;81564;59073;21582;9834;2921.0
9288;2019 vrijdag 1 februari;544;271;273;498;259;239;139;137;2.0;0.0;37.0;36.0;1.0;0.0;104;29704;16837;12867;1433;1174;21.0
9289;2019 zaterdag 2 februari;438;218;220;416;206;210;44;43;1.0;0.0;3.0;2.0;0.0;1.0;0;2742;1565;1177;92;300;2.0
9290;2019 zondag 3 februari;349;188;161;425;218;207;2;2;0.0;0.0;1.0;1.0;0.0;0.0;0;1498;751;747;20;185;0.0
9291;2019 maandag 4 februari;454;231;223;441;243;198;150;149;0.0;1.0;146.0;143.0;3.0;0.0;117;6202;3493;2709;1133;433;24.0
9292;2019 dinsdag 5 februari;463;253;210;435;210;225;114;112;1.0;1.0;120.0;113.0;3.0;4.0;105;3782;2206;1576;1277;415;55.0
9293;2019 woensdag 6 februari;447;230;217;479;227;252;81;80;1.0;0.0;47.0;46.0;1.0;0.0;114;3722;2147;1575;1305;332;37.0
9294;2019 donderdag 7 februari;423;216;207;459;244;215;65;63;1.0;1.0;44.0;41.0;1.0;2.0;156;4052;2367;1685;1268;339;768.0
9295;2019 vrijdag 8 februari;487;257;230;493;240;253;119;114;2.0;3.0;40.0;36.0;3.0;1.0;120;4766;2820;1946;900;341;38.0
9296;2019 zaterdag 9 februari;374;192;182;434;230;204;48;48;0.0;0.0;1.0;1.0;0.0;0.0;0;2876;1694;1182;13;153;0.0
9297;2019 zondag 10 februari;326;164;162;442;195;247;10;8;1.0;1.0;0.0;0.0;0.0;0.0;0;1603;883;720;9;152;0.0
9298;2019 maandag 11 februari;460;232;228;465;225;240;155;145;6.0;4.0;144.0;139.0;3.0;2.0;132;5560;3122;2438;1176;352;54.0
9299;2019 dinsdag 12 februari;461;239;222;486;232;254;134;130;2.0;2.0;95.0;92.0;1.0;2.0;127;3542;2038;1504;1120;345;35.0
9300;2019 woensdag 13 februari;463;241;222;490;224;266;76;74;2.0;0.0;41.0;39.0;1.0;1.0;134;3350;1962;1388;1291;309;766.0
9301;2019 donderdag 14 februari;478;248;230;488;247;241;192;188;4.0;0.0;78.0;74.0;3.0;1.0;104;4781;2752;2029;1245;319;35.0
9302;2019 vrijdag 15 februari;490;265;225;454;245;209;141;140;0.0;1.0;49.0;46.0;1.0;2.0;122;8078;4750;3328;822;382;17.0
9303;2019 zaterdag 16 februari;356;181;175;431;193;238;38;37;1.0;0.0;2.0;2.0;0.0;0.0;3;3090;1914;1176;23;124;13.0
9304;2019 zondag 17 februari;341;159;182;439;214;225;10;10;0.0;0.0;0.0;0.0;0.0;0.0;1;1151;638;513;8;89;0.0
9305;2019 maandag 18 februari;459;250;209;421;190;231;154;154;0.0;0.0;195.0;188.0;5.0;2.0;113;5639;3240;2399;875;342;41.0
9306;2019 dinsdag 19 februari;489;230;259;497;257;240;225;217;1.0;7.0;110.0;108.0;0.0;2.0;130;3589;2071;1518;921;362;50.0
9307;2019 woensdag 20 februari;422;210;212;435;199;236;81;79;1.0;1.0;54.0;53.0;1.0;0.0;146;4464;2693;1771;914;335;771.0
9308;2019 donderdag 21 februari;461;237;224;487;218;269;88;88;0.0;0.0;36.0;36.0;0.0;0.0;110;4071;2351;1720;1051;317;40.0
9309;2019 vrijdag 22 februari;508;261;247;465;234;231;141;137;2.0;2.0;51.0;51.0;0.0;0.0;122;5159;3025;2134;763;330;18.0
9310;2019 zaterdag 23 februari;379;192;187;460;220;240;43;39;3.0;1.0;3.0;3.0;0.0;0.0;4;4067;2542;1525;25;115;0.0
9311;2019 zondag 24 februari;348;181;167;455;211;244;11;11;0.0;0.0;0.0;0.0;0.0;0.0;0;1301;724;577;18;145;0.0
9312;2019 maandag 25 februari;401;197;204;438;194;244;166;162;2.0;2.0;168.0;166.0;1.0;1.0;117;6143;3590;2553;907;398;37.0
9313;2019 dinsdag 26 februari;438;234;204;440;214;226;135;133;2.0;0.0;121.0;121.0;0.0;0.0;115;3876;2163;1713;1177;458;24.0
9314;2019 woensdag 27 februari;452;229;223;399;194;205;69;68;1.0;0.0;63.0;59.0;2.0;2.0;138;4319;2578;1741;848;451;38.0
9315;2019 donderdag 28 februari;431;239;192;484;246;238;76;75;1.0;0.0;41.0;40.0;0.0;1.0;92;7510;4648;2862;948;837;37.0
9316;Totaal maart 2019;13538;6949;6589;13754;6748;7006;3114;3044;34.0;36.0;1643.0;1578.0;26.0;39.0;2568;145861;85651;60210;18248;9716;4161.0
9317;2019 vrijdag 1 maart;468;223;245;440;205;235;153;148;4.0;1.0;27.0;25.0;1.0;1.0;143;29801;17338;12463;995;881;26.0
9318;2019 zaterdag 2 maart;388;198;190;418;197;221;31;31;0.0;0.0;0.0;0.0;0.0;0.0;1;2443;1445;998;11;119;0.0
9319;2019 zondag 3 maart;365;199;166;446;212;234;10;10;0.0;0.0;0.0;0.0;0.0;0.0;0;1281;741;540;8;104;0.0
9320;2019 maandag 4 maart;438;230;208;435;198;237;172;168;2.0;2.0;117.0;116.0;1.0;0.0;86;5635;3246;2389;809;315;908.0
9321;2019 dinsdag 5 maart;476;248;228;455;229;226;144;142;0.0;2.0;107.0;102.0;1.0;4.0;132;3821;2142;1679;921;320;49.0
9322;2019 woensdag 6 maart;433;225;208;431;209;222;85;82;1.0;2.0;52.0;50.0;1.0;1.0;123;3948;2272;1676;991;346;36.0
9323;2019 donderdag 7 maart;490;260;230;488;263;225;80;78;0.0;2.0;41.0;37.0;1.0;3.0;115;4258;2440;1818;948;364;38.0
9324;2019 vrijdag 8 maart;427;219;208;482;250;232;142;142;0.0;0.0;36.0;32.0;1.0;3.0;123;5320;3154;2166;803;323;42.0
9325;2019 zaterdag 9 maart;357;174;183;457;216;241;42;42;0.0;0.0;1.0;1.0;0.0;0.0;0;2635;1643;992;18;106;1.0
9326;2019 zondag 10 maart;349;180;169;423;216;207;9;9;0.0;0.0;0.0;0.0;0.0;0.0;0;1561;853;708;16;121;0.0
9327;2019 maandag 11 maart;448;224;224;434;222;212;171;169;1.0;1.0;173.0;167.0;1.0;5.0;132;5734;3242;2492;911;350;79.0
9328;2019 dinsdag 12 maart;470;276;194;469;237;232;150;144;3.0;3.0;106.0;102.0;2.0;2.0;109;3720;2186;1534;884;340;62.0
9329;2019 woensdag 13 maart;469;229;240;458;220;238;74;73;1.0;0.0;56.0;53.0;2.0;1.0;133;3612;2139;1473;932;287;46.0
9330;2019 donderdag 14 maart;459;230;229;463;225;238;80;79;1.0;0.0;39.0;37.0;0.0;2.0;102;4115;2448;1667;911;317;1226.0
9331;2019 vrijdag 15 maart;482;265;217;496;231;265;159;153;3.0;3.0;42.0;38.0;3.0;1.0;112;8245;4947;3298;737;377;31.0
9332;2019 zaterdag 16 maart;405;221;184;482;241;241;44;44;0.0;0.0;2.0;2.0;0.0;0.0;1;2698;1626;1072;16;111;0.0
9333;2019 zondag 17 maart;352;192;160;423;206;217;2;2;0.0;0.0;0.0;0.0;0.0;0.0;1;1084;625;459;2;113;0.0
9334;2019 maandag 18 maart;449;231;218;408;214;194;187;182;4.0;1.0;163.0;157.0;0.0;6.0;112;5645;3263;2382;902;336;51.0
9335;2019 dinsdag 19 maart;500;246;254;449;210;239;178;173;1.0;4.0;105.0;103.0;1.0;1.0;130;3356;1965;1391;777;301;58.0
9336;2019 woensdag 20 maart;463;229;234;461;216;245;83;82;0.0;1.0;54.0;54.0;0.0;0.0;104;4070;2358;1712;653;315;326.0
9337;2019 donderdag 21 maart;461;233;228;461;217;244;106;103;1.0;2.0;37.0;36.0;0.0;1.0;112;3815;2236;1579;771;350;50.0
9338;2019 vrijdag 22 maart;481;242;239;498;236;262;182;179;2.0;1.0;35.0;32.0;1.0;2.0;146;4606;2721;1885;707;269;26.0
9339;2019 zaterdag 23 maart;402;194;208;400;201;199;52;52;0.0;0.0;2.0;2.0;0.0;0.0;2;3365;2113;1252;9;113;1.0
9340;2019 zondag 24 maart;341;167;174;365;170;195;7;7;0.0;0.0;1.0;1.0;0.0;0.0;0;1130;652;478;10;96;0.0
9341;2019 maandag 25 maart;447;221;226;399;199;200;174;168;3.0;3.0;189.0;187.0;1.0;1.0;120;6084;3585;2499;880;396;178.0
9342;2019 dinsdag 26 maart;466;239;227;461;235;226;136;134;1.0;1.0;109.0;101.0;7.0;1.0;134;3705;2151;1554;911;416;49.0
9343;2019 woensdag 27 maart;449;244;205;431;205;226;97;95;0.0;2.0;59.0;58.0;1.0;0.0;152;3747;2158;1589;1031;420;780.0
9344;2019 donderdag 28 maart;527;256;271;451;223;228;93;90;1.0;2.0;53.0;51.0;0.0;2.0;120;4462;2629;1833;958;466;45.0
9345;2019 vrijdag 29 maart;510;273;237;454;231;223;189;182;4.0;3.0;36.0;33.0;1.0;2.0;123;6707;4030;2677;714;510;47.0
9346;2019 zaterdag 30 maart;390;198;192;438;213;225;75;74;1.0;0.0;1.0;1.0;0.0;0.0;0;2918;1870;1048;9;332;6.0
9347;2019 zondag 31 maart;376;183;193;378;201;177;7;7;0.0;0.0;0.0;0.0;0.0;0.0;0;2340;1433;907;3;502;0.0
9348;Totaal april 2019;13708;7096;6612;12591;6130;6461;4301;4217;44.0;40.0;1911.0;1849.0;36.0;26.0;2518;143696;84724;58972;17524;8929;3090.0
9349;2019 maandag 1 april;425;217;208;391;189;202;289;282;3.0;4.0;181.0;171.0;4.0;6.0;135;32012;18814;13198;1050;950;38.0
9350;2019 dinsdag 2 april;492;257;235;426;197;229;150;147;0.0;3.0;113.0;112.0;1.0;0.0;101;4382;2515;1867;979;379;49.0
9351;2019 woensdag 3 april;456;242;214;419;202;217;81;81;0.0;0.0;64.0;62.0;1.0;1.0;138;3777;2189;1588;900;303;45.0
9352;2019 donderdag 4 april;475;260;215;452;226;226;102;99;1.0;2.0;41.0;39.0;2.0;0.0;112;3701;2078;1623;898;318;495.0
9353;2019 vrijdag 5 april;503;265;238;433;212;221;219;213;1.0;5.0;51.0;49.0;1.0;1.0;129;4492;2680;1812;786;289;32.0
9354;2019 zaterdag 6 april;398;213;185;431;204;227;67;63;3.0;1.0;4.0;4.0;0.0;0.0;3;2389;1484;905;35;114;0.0
9355;2019 zondag 7 april;375;198;177;346;154;192;6;6;0.0;0.0;0.0;0.0;0.0;0.0;0;986;550;436;7;93;0.0
9356;2019 maandag 8 april;443;228;215;421;208;213;183;181;1.0;1.0;157.0;154.0;1.0;2.0;120;5836;3340;2496;1048;315;68.0
9357;2019 dinsdag 9 april;506;277;229;439;238;201;157;155;1.0;1.0;114.0;111.0;2.0;1.0;119;3421;1981;1440;876;270;33.0
9358;2019 woensdag 10 april;503;268;235;414;202;212;118;117;1.0;0.0;61.0;60.0;0.0;1.0;133;4040;2442;1598;835;299;839.0
9359;2019 donderdag 11 april;488;255;233;416;221;195;98;97;1.0;0.0;36.0;36.0;0.0;0.0;83;3515;2067;1448;943;271;39.0
9360;2019 vrijdag 12 april;523;274;249;448;235;213;343;342;0.0;1.0;53.0;50.0;2.0;1.0;127;4550;2732;1818;668;304;179.0
9361;2019 zaterdag 13 april;401;204;197;390;184;206;96;95;1.0;0.0;2.0;2.0;0.0;0.0;1;2475;1566;909;14;106;0.0
9362;2019 zondag 14 april;397;212;185;373;183;190;10;10;0.0;0.0;0.0;0.0;0.0;0.0;0;1191;660;531;14;108;0.0
9363;2019 maandag 15 april;467;231;236;415;207;208;227;218;3.0;6.0;180.0;175.0;2.0;3.0;135;9278;5581;3697;872;429;58.0
9364;2019 dinsdag 16 april;451;253;198;445;213;232;179;174;3.0;2.0;118.0;113.0;3.0;2.0;124;3857;2209;1648;906;350;60.0
9365;2019 woensdag 17 april;480;227;253;405;200;205;107;105;2.0;0.0;65.0;63.0;2.0;0.0;130;3520;2105;1415;832;308;506.0
9366;2019 donderdag 18 april;490;233;257;469;223;246;202;198;3.0;1.0;51.0;50.0;1.0;0.0;128;4343;2516;1827;818;351;39.0
9367;2019 vrijdag 19 april;537;290;247;457;231;226;215;212;2.0;1.0;14.0;13.0;0.0;1.0;50;3665;2156;1509;237;203;11.0
9368;2019 zaterdag 20 april;407;182;225;441;212;229;127;125;0.0;2.0;3.0;3.0;0.0;0.0;2;3720;2302;1418;8;110;0.0
9369;2019 zondag 21 april;399;208;191;404;189;215;12;12;0.0;0.0;0.0;0.0;0.0;0.0;0;871;516;355;1;79;0.0
9370;2019 maandag 22 april;372;191;181;439;212;227;12;12;0.0;0.0;0.0;0.0;0.0;0.0;1;2100;1175;925;0;99;0.0
9371;2019 dinsdag 23 april;507;264;243;400;191;209;202;199;2.0;1.0;128.0;126.0;1.0;1.0;146;5152;2972;2180;890;331;19.0
9372;2019 woensdag 24 april;489;253;236;448;226;222;135;132;2.0;1.0;67.0;64.0;3.0;0.0;133;4336;2569;1767;791;315;23.0
9373;2019 donderdag 25 april;543;270;273;446;197;249;146;142;2.0;2.0;46.0;45.0;1.0;0.0;112;4801;2832;1969;800;331;464.0
9374;2019 vrijdag 26 april;469;227;242;452;221;231;331;324;5.0;2.0;43.0;40.0;2.0;1.0;100;5630;3366;2264;668;384;22.0
9375;2019 zaterdag 27 april;387;211;176;429;213;216;35;35;0.0;0.0;0.0;0.0;0.0;0.0;2;1982;1213;769;2;115;0.0
9376;2019 zondag 28 april;381;210;171;341;156;185;14;14;0.0;0.0;0.0;0.0;0.0;0.0;1;1428;787;641;6;172;0.0
9377;2019 maandag 29 april;469;229;240;396;196;200;222;217;3.0;2.0;210.0;205.0;3.0;2.0;105;5741;3392;2349;829;454;50.0
9378;2019 dinsdag 30 april;475;247;228;405;188;217;216;210;4.0;2.0;109.0;102.0;4.0;3.0;148;6505;3935;2570;811;779;21.0
9379;Totaal mei 2019;14340;7326;7014;12425;6039;6386;7478;7333;57.0;88.0;1864.0;1798.0;27.0;39.0;2629;145120;85899;59221;17407;8980;3024.0
9380;2019 woensdag 1 mei;502;249;253;443;203;240;147;144;2.0;1.0;62.0;59.0;2.0;1.0;142;28867;17064;11803;762;809;40.0
9381;2019 donderdag 2 mei;485;248;237;442;224;218;141;138;2.0;1.0;49.0;48.0;1.0;0.0;129;4549;2657;1892;906;358;54.0
9382;2019 vrijdag 3 mei;518;262;256;403;189;214;402;397;1.0;4.0;46.0;46.0;0.0;0.0;98;4744;2799;1945;730;300;46.0
9383;2019 zaterdag 4 mei;412;202;210;385;196;189;49;49;0.0;0.0;0.0;0.0;0.0;0.0;1;2500;1473;1027;6;107;0.0
9384;2019 zondag 5 mei;353;187;166;332;167;165;21;21;0.0;0.0;0.0;0.0;0.0;0.0;1;1363;773;590;4;113;0.0
9385;2019 maandag 6 mei;471;235;236;394;180;214;220;213;1.0;6.0;170.0;167.0;2.0;1.0;147;5572;3214;2358;1025;312;506.0
9386;2019 dinsdag 7 mei;503;268;235;387;190;197;178;174;1.0;3.0;111.0;109.0;0.0;2.0;111;3742;2159;1583;856;282;57.0
9387;2019 woensdag 8 mei;492;256;236;395;195;200;122;120;0.0;2.0;66.0;64.0;1.0;1.0;118;3994;2369;1625;855;243;21.0
9388;2019 donderdag 9 mei;489;253;236;416;190;226;147;141;2.0;4.0;44.0;43.0;1.0;0.0;119;3664;2202;1462;867;271;35.0
9389;2019 vrijdag 10 mei;538;275;263;443;225;218;594;581;5.0;8.0;47.0;42.0;2.0;3.0;122;5229;3166;2063;681;340;24.0
9390;2019 zaterdag 11 mei;400;211;189;368;179;189;191;188;1.0;2.0;4.0;2.0;0.0;2.0;1;2474;1520;954;4;98;0.0
9391;2019 zondag 12 mei;359;179;180;368;174;194;17;17;0.0;0.0;0.0;0.0;0.0;0.0;0;1104;650;454;5;81;0.0
9392;2019 maandag 13 mei;466;234;232;385;185;200;216;209;3.0;4.0;149.0;142.0;3.0;4.0;110;5176;2993;2183;912;268;74.0
9393;2019 dinsdag 14 mei;486;244;242;364;166;198;203;201;1.0;1.0;118.0;117.0;0.0;1.0;121;3529;2115;1414;862;256;51.0
9394;2019 woensdag 15 mei;492;251;241;401;205;196;147;145;0.0;2.0;59.0;59.0;0.0;0.0;121;6870;4013;2857;882;333;37.0
9395;2019 donderdag 16 mei;450;225;225;426;206;220;154;151;1.0;2.0;54.0;53.0;1.0;0.0;122;4020;2341;1679;777;275;58.0
9396;2019 vrijdag 17 mei;477;246;231;459;213;246;635;625;3.0;7.0;49.0;47.0;1.0;1.0;127;4474;2696;1778;648;367;1220.0
9397;2019 zaterdag 18 mei;393;191;202;395;203;192;249;247;2.0;0.0;7.0;7.0;0.0;0.0;2;2515;1499;1016;12;110;0.0
9398;2019 zondag 19 mei;383;188;195;391;188;203;30;28;1.0;1.0;0.0;0.0;0.0;0.0;0;952;534;418;5;72;0.0
9399;2019 maandag 20 mei;493;272;221;396;202;194;254;246;4.0;4.0;191.0;181.0;4.0;6.0;120;5994;3625;2369;884;366;44.0
9400;2019 dinsdag 21 mei;484;251;233;437;208;229;206;200;4.0;2.0;117.0;114.0;1.0;2.0;143;3367;1974;1393;857;337;66.0
9401;2019 woensdag 22 mei;459;234;225;416;209;207;161;155;4.0;2.0;59.0;57.0;0.0;2.0;128;3563;2148;1415;762;241;491.0
9402;2019 donderdag 23 mei;508;274;234;439;193;246;170;170;0.0;0.0;38.0;37.0;0.0;1.0;112;3830;2280;1550;615;250;33.0
9403;2019 vrijdag 24 mei;490;252;238;405;190;215;862;843;5.0;14.0;57.0;55.0;1.0;1.0;107;4664;2777;1887;520;289;18.0
9404;2019 zaterdag 25 mei;414;223;191;380;179;201;315;310;2.0;3.0;3.0;2.0;1.0;0.0;3;3403;2093;1310;15;150;0.0
9405;2019 zondag 26 mei;367;183;184;400;189;211;13;13;0.0;0.0;0.0;0.0;0.0;0.0;2;991;545;446;20;86;1.0
9406;2019 maandag 27 mei;522;259;263;381;188;193;266;262;1.0;3.0;152.0;149.0;1.0;2.0;102;5467;3209;2258;890;412;49.0
9407;2019 dinsdag 28 mei;474;258;216;435;217;218;212;205;2.0;5.0;122.0;113.0;3.0;6.0;127;4278;2472;1806;800;342;18.0
9408;2019 woensdag 29 mei;490;229;261;393;197;196;506;498;4.0;4.0;61.0;57.0;2.0;2.0;130;6211;3798;2413;921;454;62.0
9409;2019 donderdag 30 mei;458;231;227;357;188;169;34;33;1.0;0.0;0.0;0.0;0.0;0.0;3;2222;1269;953;4;221;0.0
9410;2019 vrijdag 31 mei;512;256;256;389;201;188;616;609;4.0;3.0;29.0;28.0;0.0;1.0;60;5792;3472;2320;320;837;19.0
9411;Totaal juni 2019;14221;7351;6870;11683;5785;5898;8223;8018;102.0;103.0;1618.0;1558.0;25.0;35.0;2288;130250;76580;53670;17043;12138;2704.0
9412;2019 zaterdag 1 juni;427;237;190;382;182;200;323;319;3.0;1.0;2.0;2.0;0.0;0.0;0;19275;10823;8452;66;659;1.0
9413;2019 zondag 2 juni;401;215;186;393;183;210;15;15;0.0;0.0;0.0;0.0;0.0;0.0;0;983;535;448;20;97;0.0
9414;2019 maandag 3 juni;479;255;224;387;195;192;285;280;2.0;3.0;189.0;184.0;0.0;5.0;100;8963;5400;3563;1072;496;36.0
9415;2019 dinsdag 4 juni;455;230;225;375;181;194;183;176;3.0;4.0;122.0;120.0;0.0;2.0;123;4057;2394;1663;950;360;28.0
9416;2019 woensdag 5 juni;555;289;266;398;207;191;162;157;2.0;3.0;54.0;52.0;1.0;1.0;135;3669;2059;1610;923;347;22.0
9417;2019 donderdag 6 juni;500;228;272;395;202;193;285;284;0.0;1.0;47.0;45.0;2.0;0.0;125;3842;2156;1686;988;288;1054.0
9418;2019 vrijdag 7 juni;521;270;251;419;184;235;703;688;9.0;6.0;54.0;52.0;1.0;1.0;126;4639;2784;1855;711;292;40.0
9419;2019 zaterdag 8 juni;412;213;199;399;186;213;266;258;6.0;2.0;6.0;5.0;0.0;1.0;0;2530;1515;1015;11;136;0.0
9420;2019 zondag 9 juni;380;201;179;361;172;189;31;29;0.0;2.0;0.0;0.0;0.0;0.0;0;853;533;320;22;112;0.0
9421;2019 maandag 10 juni;391;200;191;410;205;205;23;22;1.0;0.0;0.0;0.0;0.0;0.0;0;2530;1521;1009;3;185;5.0
9422;2019 dinsdag 11 juni;502;252;250;392;199;193;235;231;1.0;3.0;115.0;107.0;5.0;3.0;84;4384;2498;1886;908;325;34.0
9423;2019 woensdag 12 juni;531;257;274;371;170;201;137;136;1.0;0.0;54.0;53.0;1.0;0.0;120;4154;2457;1697;879;323;46.0
9424;2019 donderdag 13 juni;527;285;242;338;179;159;177;174;2.0;1.0;39.0;37.0;0.0;2.0;139;3867;2302;1565;957;327;29.0
9425;2019 vrijdag 14 juni;539;279;260;378;202;176;792;777;6.0;9.0;47.0;43.0;1.0;3.0;132;5786;3416;2370;677;395;55.0
9426;2019 zaterdag 15 juni;408;209;199;387;197;190;325;315;7.0;3.0;4.0;3.0;0.0;1.0;0;3855;2375;1480;22;232;0.0
9427;2019 zondag 16 juni;385;185;200;371;185;186;18;18;0.0;0.0;0.0;0.0;0.0;0.0;1;1261;722;539;7;120;0.0
9428;2019 maandag 17 juni;497;260;237;409;214;195;275;267;4.0;4.0;184.0;181.0;0.0;3.0;121;5944;3524;2420;894;420;52.0
9429;2019 dinsdag 18 juni;472;242;230;396;208;188;208;202;4.0;2.0;110.0;104.0;5.0;1.0;121;3418;2006;1412;852;345;53.0
9430;2019 woensdag 19 juni;522;271;251;424;219;205;227;217;4.0;6.0;64.0;61.0;2.0;1.0;116;3396;1985;1411;916;345;49.0
9431;2019 donderdag 20 juni;505;255;250;382;183;199;229;225;3.0;1.0;50.0;50.0;0.0;0.0;112;4323;2558;1765;898;468;30.0
9432;2019 vrijdag 21 juni;521;266;255;378;166;212;992;951;19.0;22.0;51.0;48.0;2.0;1.0;108;4681;2836;1845;663;484;29.0
9433;2019 zaterdag 22 juni;408;211;197;329;169;160;362;354;5.0;3.0;2.0;2.0;0.0;0.0;2;3137;2102;1035;22;239;0.0
9434;2019 zondag 23 juni;460;240;220;374;195;179;17;16;0.0;1.0;0.0;0.0;0.0;0.0;0;1065;593;472;33;154;3.0
9435;2019 maandag 24 juni;512;258;254;402;222;180;305;299;3.0;3.0;145.0;143.0;0.0;2.0;145;5710;3420;2290;868;551;23.0
9436;2019 dinsdag 25 juni;502;262;240;425;211;214;198;196;1.0;1.0;127.0;124.0;0.0;3.0;114;3875;2242;1633;989;521;1050.0
9437;2019 woensdag 26 juni;507;261;246;394;193;201;165;160;1.0;4.0;63.0;60.0;1.0;2.0;148;3773;2191;1582;847;643;12.0
9438;2019 donderdag 27 juni;517;279;238;413;206;207;205;200;3.0;2.0;41.0;37.0;3.0;1.0;116;4349;2539;1810;955;618;31.0
9439;2019 vrijdag 28 juni;535;290;245;426;202;224;728;713;6.0;9.0;46.0;43.0;1.0;2.0;98;6636;3944;2692;805;891;22.0
9440;2019 zaterdag 29 juni;415;225;190;402;181;221;337;324;6.0;7.0;2.0;2.0;0.0;0.0;2;2790;1724;1066;48;477;0.0
9441;2019 zondag 30 juni;435;226;209;373;187;186;15;15;0.0;0.0;0.0;0.0;0.0;0.0;0;2505;1426;1079;37;1288;0.0
9442;Totaal juli 2019;15461;7896;7565;12306;6014;6292;6470;6320;75.0;75.0;2048.0;1990.0;25.0;33.0;2752;165759;93351;72408;23027;17457;1426.0
9443;2019 maandag 1 juli;517;258;259;405;202;203;291;285;3.0;3.0;162.0;159.0;0.0;3.0;110;34275;19594;14681;1272;1508;24.0
9444;2019 dinsdag 2 juli;555;278;277;394;194;200;191;183;2.0;6.0;107.0;104.0;1.0;2.0;127;4676;2600;2076;1216;622;17.0
9445;2019 woensdag 3 juli;519;262;257;430;211;219;133;129;2.0;2.0;63.0;61.0;1.0;1.0;119;4461;2560;1901;1013;678;23.0
9446;2019 donderdag 4 juli;513;256;257;376;187;189;205;198;3.0;4.0;51.0;48.0;2.0;1.0;128;4074;2373;1701;941;535;28.0
9447;2019 vrijdag 5 juli;538;293;245;411;208;203;657;641;5.0;11.0;63.0;61.0;1.0;1.0;90;5173;2936;2237;855;570;444.0
9448;2019 zaterdag 6 juli;452;239;213;367;179;188;318;311;5.0;2.0;3.0;3.0;0.0;0.0;4;2636;1567;1069;3;261;1.0
9449;2019 zondag 7 juli;415;225;190;338;172;166;33;33;0.0;0.0;0.0;0.0;0.0;0.0;0;1271;687;584;49;268;0.0
9450;2019 maandag 8 juli;495;252;243;374;166;208;234;230;2.0;2.0;161.0;154.0;2.0;5.0;116;6744;3787;2957;1103;693;52.0
9451;2019 dinsdag 9 juli;523;250;273;397;201;196;196;193;1.0;2.0;118.0;116.0;2.0;0.0;143;4010;2355;1655;1057;619;45.0
9452;2019 woensdag 10 juli;511;252;259;415;202;213;147;142;2.0;3.0;57.0;56.0;1.0;0.0;118;4582;2548;2034;994;582;271.0
9453;2019 donderdag 11 juli;517;281;236;422;188;234;158;155;2.0;1.0;52.0;50.0;0.0;2.0;131;4282;2390;1892;1061;453;16.0
9454;2019 vrijdag 12 juli;589;307;282;422;192;230;566;560;3.0;3.0;58.0;55.0;0.0;3.0;108;5637;3077;2560;803;575;16.0
9455;2019 zaterdag 13 juli;435;231;204;372;195;177;181;179;2.0;0.0;1.0;1.0;0.0;0.0;2;2817;1619;1198;51;253;0.0
9456;2019 zondag 14 juli;427;202;225;358;182;176;16;16;0.0;0.0;0.0;0.0;0.0;0.0;0;1362;759;603;25;220;0.0
9457;2019 maandag 15 juli;487;251;236;368;213;155;229;223;3.0;3.0;169.0;163.0;2.0;4.0;153;11107;6128;4979;1098;907;203.0
9458;2019 dinsdag 16 juli;505;233;272;371;182;189;203;199;1.0;3.0;104.0;103.0;1.0;0.0;138;4507;2497;2010;990;577;13.0
9459;2019 woensdag 17 juli;549;287;262;368;166;202;137;133;2.0;2.0;56.0;54.0;1.0;1.0;120;4287;2389;1898;958;482;26.0
9460;2019 donderdag 18 juli;488;230;258;361;184;177;165;161;3.0;1.0;47.0;47.0;0.0;0.0;115;4413;2436;1977;973;502;25.0
9461;2019 vrijdag 19 juli;521;271;250;384;193;191;597;582;10.0;5.0;56.0;56.0;0.0;0.0;127;4944;2669;2275;752;586;24.0
9462;2019 zaterdag 20 juli;427;203;224;377;175;202;195;190;1.0;4.0;4.0;4.0;0.0;0.0;2;3564;2062;1502;32;252;1.0
9463;2019 zondag 21 juli;374;221;153;355;159;196;21;20;0.0;1.0;0.0;0.0;0.0;0.0;0;1142;633;509;13;173;0.0
9464;2019 maandag 22 juli;522;267;255;370;180;190;235;228;4.0;3.0;144.0;140.0;2.0;2.0;113;6731;3811;2920;1026;625;43.0
9465;2019 dinsdag 23 juli;511;276;235;380;180;200;175;174;1.0;0.0;112.0;110.0;1.0;1.0;109;3769;1986;1783;1074;458;36.0
9466;2019 woensdag 24 juli;493;237;256;408;210;198;121;118;1.0;2.0;54.0;52.0;1.0;1.0;113;3979;2151;1828;923;490;26.0
9467;2019 donderdag 25 juli;549;273;276;404;189;215;122;121;0.0;1.0;40.0;38.0;1.0;1.0;133;4582;2585;1997;948;546;18.0
9468;2019 vrijdag 26 juli;560;300;260;549;264;285;284;277;4.0;3.0;54.0;52.0;2.0;0.0;104;5211;2975;2236;739;537;13.0
9469;2019 zaterdag 27 juli;447;236;211;466;217;249;150;143;4.0;3.0;3.0;2.0;0.0;1.0;0;3301;1896;1405;21;294;0.0
9470;2019 zondag 28 juli;411;206;205;429;213;216;19;18;0.0;1.0;0.0;0.0;0.0;0.0;0;1304;703;601;18;242;0.0
9471;2019 maandag 29 juli;499;241;258;394;204;190;218;212;5.0;1.0;145.0;142.0;1.0;2.0;99;6130;3469;2661;963;698;15.0
9472;2019 dinsdag 30 juli;550;284;266;433;225;208;185;179;3.0;3.0;108.0;105.0;1.0;2.0;118;4114;2297;1817;1066;684;28.0
9473;2019 woensdag 31 juli;562;294;268;408;181;227;88;87;1.0;0.0;56.0;54.0;2.0;0.0;112;6674;3812;2862;990;1567;18.0
9474;Totaal augustus 2019;15425;7953;7472;11766;5745;6021;6769;6618;57.0;94.0;1805.0;1742.0;33.0;30.0;2376;162998;87767;75231;37239;14894;584.0
9475;2019 donderdag 1 augustus;517;268;249;405;214;191;131;127;1.0;3.0;48.0;45.0;2.0;1.0;111;32774;17776;14998;1417;1434;26.0
9476;2019 vrijdag 2 augustus;522;277;245;393;194;199;240;235;0.0;5.0;37.0;36.0;0.0;1.0;106;5438;3029;2409;958;481;14.0
9477;2019 zaterdag 3 augustus;461;238;223;344;163;181;123;122;1.0;0.0;0.0;0.0;0.0;0.0;0;2252;1216;1036;22;215;0.0
9478;2019 zondag 4 augustus;394;205;189;354;167;187;15;15;0.0;0.0;0.0;0.0;0.0;0.0;0;1091;584;507;14;211;0.0
9479;2019 maandag 5 augustus;503;258;245;371;178;193;226;222;1.0;3.0;167.0;163.0;4.0;0.0;91;6759;3626;3133;1272;537;41.0
9480;2019 dinsdag 6 augustus;550;273;277;381;190;191;177;176;0.0;1.0;118.0;117.0;1.0;0.0;86;3789;2063;1726;1173;452;26.0
9481;2019 woensdag 7 augustus;495;241;254;360;177;183;177;173;1.0;3.0;66.0;65.0;0.0;1.0;109;3864;2134;1730;1125;424;36.0
9482;2019 donderdag 8 augustus;531;272;259;388;188;200;178;177;0.0;1.0;32.0;32.0;0.0;0.0;107;4405;2373;2032;1198;470;22.0
9483;2019 vrijdag 9 augustus;551;283;268;450;209;241;309;304;3.0;2.0;42.0;41.0;1.0;0.0;118;4846;2652;2194;846;478;23.0
9484;2019 zaterdag 10 augustus;431;235;196;349;166;183;167;165;0.0;2.0;3.0;3.0;0.0;0.0;0;3040;1699;1341;32;219;0.0
9485;2019 zondag 11 augustus;394;204;190;327;171;156;9;9;0.0;0.0;0.0;0.0;0.0;0.0;0;1282;654;628;14;156;1.0
9486;2019 maandag 12 augustus;506;256;250;355;189;166;203;197;0.0;6.0;161.0;154.0;1.0;6.0;120;6529;3553;2976;1179;478;29.0
9487;2019 dinsdag 13 augustus;516;274;242;392;189;203;173;170;1.0;2.0;96.0;93.0;2.0;1.0;88;3585;1879;1706;1115;415;24.0
9488;2019 woensdag 14 augustus;585;316;269;380;183;197;126;122;2.0;2.0;61.0;58.0;3.0;0.0;114;4020;2099;1921;1350;430;21.0
9489;2019 donderdag 15 augustus;508;258;250;390;186;204;142;140;1.0;1.0;44.0;42.0;1.0;1.0;84;7680;4200;3480;1410;593;19.0
9490;2019 vrijdag 16 augustus;498;264;234;391;190;201;358;351;3.0;4.0;45.0;43.0;2.0;0.0;134;5766;3018;2748;1899;486;12.0
9491;2019 zaterdag 17 augustus;458;244;214;367;179;188;230;224;2.0;4.0;1.0;1.0;0.0;0.0;0;2702;1426;1276;16;177;0.0
9492;2019 zondag 18 augustus;383;195;188;335;165;170;16;15;0.0;1.0;0.0;0.0;0.0;0.0;0;1404;666;738;13;148;1.0
9493;2019 maandag 19 augustus;522;263;259;369;171;198;289;281;0.0;8.0;155.0;149.0;0.0;6.0;103;6625;3455;3170;3305;495;29.0
9494;2019 dinsdag 20 augustus;540;274;266;398;209;189;202;197;2.0;3.0;115.0;111.0;2.0;2.0;119;4479;2385;2094;2222;535;24.0
9495;2019 woensdag 21 augustus;508;267;241;372;172;200;147;142;4.0;1.0;69.0;67.0;1.0;1.0;119;3997;2109;1888;1497;462;42.0
9496;2019 donderdag 22 augustus;544;262;282;392;198;194;186;179;2.0;5.0;58.0;56.0;1.0;1.0;103;4283;2339;1944;1671;425;24.0
9497;2019 vrijdag 23 augustus;530;279;251;386;199;187;565;547;12.0;6.0;51.0;47.0;2.0;2.0;126;5275;2809;2466;1430;444;12.0
9498;2019 zaterdag 24 augustus;445;226;219;345;177;168;311;307;1.0;3.0;3.0;3.0;0.0;0.0;1;3324;1748;1576;77;197;0.0
9499;2019 zondag 25 augustus;433;242;191;354;179;175;20;20;0.0;0.0;0.0;0.0;0.0;0.0;0;1678;776;902;11;222;0.0
9500;2019 maandag 26 augustus;540;275;265;387;185;202;258;253;2.0;3.0;152.0;146.0;5.0;1.0;122;6464;3326;3138;2304;652;46.0
9501;2019 dinsdag 27 augustus;545;289;256;449;223;226;206;201;4.0;1.0;111.0;107.0;2.0;2.0;98;4042;2119;1923;2381;537;22.0
9502;2019 woensdag 28 augustus;505;252;253;415;191;224;164;158;1.0;5.0;64.0;62.0;0.0;2.0;117;4725;2554;2171;3016;572;46.0
9503;2019 donderdag 29 augustus;563;290;273;392;187;205;194;188;2.0;4.0;50.0;48.0;2.0;0.0;117;4879;2730;2149;2371;595;29.0
9504;2019 vrijdag 30 augustus;527;254;273;377;185;192;828;815;5.0;8.0;49.0;48.0;1.0;0.0;81;7865;4442;3423;1748;875;15.0
9505;2019 zaterdag 31 augustus;420;219;201;398;171;227;399;386;6.0;7.0;7.0;5.0;0.0;2.0;2;4136;2328;1808;153;1079;0.0
9506;Totaal september 2019;15116;7782;7334;11263;5539;5724;8659;8450;89.0;120.0;1792.0;1738.0;26.0;28.0;2109;151486;83562;67924;36730;12333;4070.0
9507;2019 zondag 1 september;406;216;190;365;188;177;43;41;0.0;2.0;0.0;0.0;0.0;0.0;0;23213;11693;11520;334;1033;1.0
9508;2019 maandag 2 september;533;266;267;362;176;186;263;253;5.0;5.0;146.0;142.0;2.0;2.0;82;12075;6535;5540;2756;703;26.0
9509;2019 dinsdag 3 september;505;258;247;396;174;222;230;227;2.0;1.0;101.0;100.0;1.0;0.0;96;4844;2588;2256;2282;522;15.0
9510;2019 woensdag 4 september;531;278;253;373;185;188;153;149;3.0;1.0;50.0;49.0;1.0;0.0;107;4370;2406;1964;1924;399;21.0
9511;2019 donderdag 5 september;530;276;254;357;162;195;202;198;2.0;2.0;44.0;43.0;0.0;1.0;93;4639;2538;2101;2360;471;21.0
9512;2019 vrijdag 6 september;522;270;252;368;186;182;970;949;11.0;10.0;52.0;50.0;1.0;1.0;121;4750;2621;2129;1881;434;37.0
9513;2019 zaterdag 7 september;379;186;193;357;172;185;398;387;3.0;8.0;1.0;1.0;0.0;0.0;0;2468;1397;1071;217;193;0.0
9514;2019 zondag 8 september;410;215;195;340;169;171;19;19;0.0;0.0;0.0;0.0;0.0;0.0;1;1387;635;752;11;140;0.0
9515;2019 maandag 9 september;560;302;258;377;165;212;549;534;5.0;10.0;167.0;164.0;1.0;2.0;80;6454;3562;2892;1727;462;43.0
9516;2019 dinsdag 10 september;513;253;260;378;195;183;253;248;2.0;3.0;105.0;102.0;2.0;1.0;122;4111;2206;1905;1681;401;2599.0
9517;2019 woensdag 11 september;578;302;276;401;189;212;130;126;3.0;1.0;52.0;51.0;0.0;1.0;96;3737;2053;1684;1956;356;23.0
9518;2019 donderdag 12 september;533;277;256;355;183;172;216;211;2.0;3.0;41.0;39.0;1.0;1.0;106;4346;2461;1885;2451;400;23.0
9519;2019 vrijdag 13 september;533;279;254;405;189;216;628;613;5.0;10.0;33.0;30.0;1.0;2.0;95;4911;2779;2132;1194;353;30.0
9520;2019 zaterdag 14 september;442;232;210;383;199;184;354;346;5.0;3.0;2.0;2.0;0.0;0.0;0;2702;1533;1169;214;176;0.0
9521;2019 zondag 15 september;411;212;199;342;169;173;15;15;0.0;0.0;0.0;0.0;0.0;0.0;0;2471;1367;1104;32;200;0.0
9522;2019 maandag 16 september;482;255;227;324;159;165;233;224;4.0;5.0;140.0;136.0;1.0;3.0;119;8070;4539;3531;1808;483;420.0
9523;2019 dinsdag 17 september;571;308;263;371;197;174;202;196;2.0;4.0;100.0;99.0;0.0;1.0;120;3828;2155;1673;1484;358;13.0
9524;2019 woensdag 18 september;529;270;259;373;171;202;153;149;0.0;4.0;55.0;52.0;3.0;0.0;91;3741;2028;1713;1495;403;7.0
9525;2019 donderdag 19 september;567;275;292;379;180;199;720;692;11.0;17.0;61.0;59.0;0.0;2.0;108;3793;2135;1658;1387;389;38.0
9526;2019 vrijdag 20 september;563;289;274;400;195;205;851;837;3.0;11.0;51.0;48.0;3.0;0.0;73;5247;3162;2085;1564;448;28.0
9527;2019 zaterdag 21 september;472;241;231;367;185;182;299;289;4.0;6.0;4.0;4.0;0.0;0.0;0;2948;1809;1139;102;135;0.0
9528;2019 zondag 22 september;451;221;230;366;179;187;12;12;0.0;0.0;0.0;0.0;0.0;0.0;0;1237;621;616;18;114;0.0
9529;2019 maandag 23 september;544;273;271;370;196;174;252;249;3.0;0.0;141.0;138.0;0.0;3.0;92;5848;3274;2574;1084;500;29.0
9530;2019 dinsdag 24 september;548;286;262;411;208;203;177;174;3.0;0.0;98.0;96.0;0.0;2.0;121;3670;1965;1705;2011;396;20.0
9531;2019 woensdag 25 september;532;279;253;389;189;200;131;125;2.0;4.0;62.0;60.0;2.0;0.0;109;4120;2298;1822;1199;408;23.0
9532;2019 donderdag 26 september;550;275;275;381;190;191;146;145;0.0;1.0;37.0;34.0;1.0;2.0;110;4320;2450;1870;1267;436;26.0
9533;2019 vrijdag 27 september;524;268;256;423;197;226;603;591;5.0;7.0;67.0;64.0;2.0;1.0;82;5399;3204;2195;1011;473;591.0
9534;2019 zaterdag 28 september;446;235;211;399;198;201;223;221;1.0;1.0;5.0;5.0;0.0;0.0;1;3131;1892;1239;87;222;0.0
9535;2019 zondag 29 september;424;214;210;375;195;180;16;16;0.0;0.0;2.0;2.0;0.0;0.0;0;1354;728;626;6;235;0.0
9536;2019 maandag 30 september;527;271;256;376;199;177;218;214;3.0;1.0;175.0;168.0;4.0;3.0;84;8302;4928;3374;1187;1090;36.0
9537;Totaal oktober 2019;14686;7466;7220;12559;6285;6274;4545;4428;62.0;55.0;2030.0;1970.0;31.0;29.0;2439;150841;86544;64297;24816;10926;1407.0
9538;2019 dinsdag 1 oktober;564;291;273;399;202;197;172;164;6.0;2.0;122.0;118.0;2.0;2.0;83;29539;16584;12955;1368;1103;20.0
9539;2019 woensdag 2 oktober;478;247;231;369;190;179;88;86;2.0;0.0;64.0;61.0;1.0;2.0;103;4592;2621;1971;1241;473;28.0
9540;2019 donderdag 3 oktober;511;277;234;352;173;179;103;101;1.0;1.0;40.0;40.0;0.0;0.0;93;4134;2310;1824;1356;363;22.0
9541;2019 vrijdag 4 oktober;530;254;276;427;208;219;354;346;4.0;4.0;42.0;38.0;2.0;2.0;93;4619;2673;1946;1004;353;301.0
9542;2019 zaterdag 5 oktober;449;231;218;364;176;188;145;141;1.0;3.0;4.0;4.0;0.0;0.0;0;2768;1521;1247;25;182;2.0
9543;2019 zondag 6 oktober;376;184;192;426;221;205;10;10;0.0;0.0;0.0;0.0;0.0;0.0;1;1044;549;495;8;97;0.0
9544;2019 maandag 7 oktober;522;272;250;401;211;190;197;191;5.0;1.0;183.0;177.0;3.0;3.0;129;5829;3249;2580;1079;386;33.0
9545;2019 dinsdag 8 oktober;515;270;245;395;210;185;136;131;3.0;2.0;120.0;118.0;2.0;0.0;111;3841;2185;1656;1170;375;35.0
9546;2019 woensdag 9 oktober;513;246;267;381;205;176;197;195;1.0;1.0;70.0;66.0;2.0;2.0;105;3433;1931;1502;1101;314;473.0
9547;2019 donderdag 10 oktober;522;258;264;434;226;208;165;160;1.0;4.0;58.0;55.0;1.0;2.0;97;4646;2651;1995;1201;429;59.0
9548;2019 vrijdag 11 oktober;504;250;254;468;234;234;334;329;2.0;3.0;50.0;46.0;2.0;2.0;109;4400;2609;1791;885;294;15.0
9549;2019 zaterdag 12 oktober;428;218;210;394;195;199;130;129;1.0;0.0;1.0;1.0;0.0;0.0;0;2637;1591;1046;8;125;1.0
9550;2019 zondag 13 oktober;411;188;223;437;199;238;7;7;0.0;0.0;0.0;0.0;0.0;0.0;0;999;536;463;11;110;0.0
9551;2019 maandag 14 oktober;509;277;232;405;201;204;208;202;4.0;2.0;165.0;161.0;1.0;3.0;106;6439;3622;2817;1069;380;21.0
9552;2019 dinsdag 15 oktober;487;227;260;421;215;206;156;155;0.0;1.0;117.0;110.0;4.0;3.0;82;6608;3950;2658;1300;505;29.0
9553;2019 woensdag 16 oktober;490;243;247;440;208;232;102;100;2.0;0.0;71.0;70.0;1.0;0.0;104;4270;2442;1828;993;303;29.0
9554;2019 donderdag 17 oktober;461;240;221;433;214;219;115;113;0.0;2.0;46.0;44.0;1.0;1.0;100;4011;2327;1684;1149;420;31.0
9555;2019 vrijdag 18 oktober;530;270;260;399;196;203;350;344;4.0;2.0;53.0;50.0;1.0;2.0;102;5048;2909;2139;781;333;38.0
9556;2019 zaterdag 19 oktober;401;204;197;383;182;201;221;212;2.0;7.0;4.0;4.0;0.0;0.0;2;2625;1550;1075;12;119;2.0
9557;2019 zondag 20 oktober;398;205;193;394;190;204;8;8;0.0;0.0;0.0;0.0;0.0;0.0;0;1613;953;660;7;122;0.0
9558;2019 maandag 21 oktober;472;266;206;405;197;208;219;215;2.0;2.0;165.0;162.0;1.0;2.0;104;5856;3383;2473;896;370;29.0
9559;2019 dinsdag 22 oktober;445;225;220;384;188;196;165;159;3.0;3.0;115.0;112.0;1.0;2.0;132;3667;2022;1645;996;396;38.0
9560;2019 woensdag 23 oktober;456;231;225;396;191;205;90;85;3.0;2.0;64.0;63.0;0.0;1.0;115;3703;2119;1584;981;316;18.0
9561;2019 donderdag 24 oktober;497;243;254;413;207;206;103;99;2.0;2.0;44.0;43.0;1.0;0.0;86;3849;2146;1703;1110;295;17.0
9562;2019 vrijdag 25 oktober;453;229;224;440;214;226;228;226;1.0;1.0;49.0;49.0;0.0;0.0;110;5231;3034;2197;705;391;13.0
9563;2019 zaterdag 26 oktober;402;207;195;427;232;195;68;67;0.0;1.0;4.0;4.0;0.0;0.0;0;3448;2093;1355;9;139;0.0
9564;2019 zondag 27 oktober;368;184;184;401;206;195;2;2;0.0;0.0;0.0;0.0;0.0;0.0;0;1319;756;563;23;134;0.0
9565;2019 maandag 28 oktober;462;228;234;359;179;180;179;170;6.0;3.0;165.0;163.0;2.0;0.0;114;5990;3490;2500;958;470;48.0
9566;2019 dinsdag 29 oktober;535;274;261;416;204;212;128;123;4.0;1.0;107.0;105.0;2.0;0.0;108;3649;2115;1534;1171;401;29.0
9567;2019 woensdag 30 oktober;485;258;227;389;201;188;95;92;2.0;1.0;56.0;56.0;0.0;0.0;132;4406;2620;1786;1114;495;45.0
9568;2019 donderdag 31 oktober;512;269;243;407;210;197;70;66;0.0;4.0;51.0;50.0;1.0;0.0;118;6628;4003;2625;1085;733;31.0
9569;Totaal november 2019;13667;7041;6626;13003;6395;6608;2923;2854;39.0;30.0;1842.0;1773.0;36.0;33.0;2324;144891;84276;60615;18526;9324;3694.0
9570;2019 vrijdag1 november;514;267;247;449;230;219;191;186;3.0;2.0;62.0;61.0;1.0;0.0;88;29682;17098;12584;878;939;23.0
9571;2019 zaterdag 2 november;408;226;182;439;205;234;54;53;0.0;1.0;4.0;3.0;1.0;0.0;0;2637;1557;1080;11;161;0.0
9572;2019 zondag 3 november;391;231;160;394;183;211;4;4;0.0;0.0;0.0;0.0;0.0;0.0;2;1234;673;561;16;131;0.0
9573;2019 maandag 4 november;467;237;230;418;215;203;156;151;3.0;2.0;173.0;167.0;2.0;4.0;127;6211;3571;2640;1018;461;31.0
9574;2019 dinsdag 5 november;500;241;259;431;220;211;128;121;5.0;2.0;125.0;121.0;3.0;1.0;105;3711;2055;1656;959;317;6.0
9575;2019 woensdag 6 november;484;220;264;430;224;206;64;62;0.0;2.0;56.0;55.0;1.0;0.0;117;3563;1980;1583;960;364;2023.0
9576;2019 donderdag 7 november;466;255;211;478;232;246;72;71;0.0;1.0;40.0;37.0;1.0;2.0;83;4082;2339;1743;1078;290;29.0
9577;2019 vrijdag 8 november;526;273;253;448;224;224;181;177;2.0;2.0;40.0;39.0;0.0;1.0;95;4847;2832;2015;732;268;12.0
9578;2019 zaterdag 9 november;414;199;215;422;204;218;59;58;1.0;0.0;3.0;2.0;1.0;0.0;0;2616;1600;1016;14;110;2.0
9579;2019 zondag 10 november;368;172;196;385;196;189;8;8;0.0;0.0;0.0;0.0;0.0;0.0;0;1455;737;718;4;101;1.0
9580;2019 maandag 11 november;472;250;222;434;215;219;204;197;4.0;3.0;187.0;181.0;1.0;5.0;99;5764;3259;2505;924;382;32.0
9581;2019 dinsdag 12 november;515;260;255;439;220;219;133;132;1.0;0.0;105.0;103.0;2.0;0.0;113;3602;2074;1528;986;339;31.0
9582;2019 woensdag 13 november;484;262;222;463;237;226;69;68;0.0;1.0;50.0;48.0;2.0;0.0;133;3477;2000;1477;955;321;440.0
9583;2019 donderdag 14 november;499;250;249;451;215;236;76;74;0.0;2.0;49.0;49.0;0.0;0.0;105;4190;2407;1783;953;280;57.0
9584;2019 vrijdag 15 november;469;246;223;446;217;229;149;149;0.0;0.0;48.0;46.0;1.0;1.0;104;8112;4913;3199;701;402;33.0
9585;2019 zaterdag16 november;383;210;173;435;212;223;32;31;1.0;0.0;0.0;0.0;0.0;0.0;0;2940;1799;1141;24;120;0.0
9586;2019 zondag 17 november;343;187;156;391;195;196;0;0;0.0;0.0;0.0;0.0;0.0;0.0;0;1120;641;479;4;112;0.0
9587;2019 maandag 18 november;439;244;195;431;198;233;179;175;3.0;1.0;169.0;166.0;1.0;2.0;93;5916;3460;2456;916;331;43.0
9588;2019 dinsdag19 november;496;251;245;430;200;230;171;170;1.0;0.0;118.0;113.0;2.0;3.0;124;3229;1875;1354;899;257;55.0
9589;2019 woensdag 20 november;471;241;230;468;212;256;82;80;0.0;2.0;65.0;64.0;1.0;0.0;140;4026;2291;1735;808;305;539.0
9590;2019 donderdag 21 november;473;232;241;460;230;230;66;63;3.0;0.0;43.0;37.0;5.0;1.0;99;3721;2152;1569;1022;264;27.0
9591;2019 vrijdag 22 november;542;279;263;446;216;230;187;180;2.0;5.0;44.0;41.0;1.0;2.0;114;4733;2774;1959;625;358;20.0
9592;2019 zaterdag 23 november;402;213;189;378;183;195;36;36;0.0;0.0;3.0;3.0;0.0;0.0;0;3656;2334;1322;9;128;0.0
9593;2019 zondag 24 november;372;177;195;408;188;220;2;2;0.0;0.0;0.0;0.0;0.0;0.0;0;1221;699;522;6;110;0.0
9594;2019 maandag 25 november;442;240;202;441;214;227;168;163;3.0;2.0;164.0;158.0;2.0;4.0;119;6112;3507;2605;968;357;37.0
9595;2019 dinsdag 26 november;520;266;254;475;256;219;117;117;0.0;0.0;121.0;119.0;2.0;0.0;98;3372;1886;1486;808;376;38.0
9596;2019 woensdag 27 november;500;251;249;431;200;231;69;66;1.0;2.0;74.0;70.0;3.0;1.0;91;3744;2158;1586;774;410;22.0
9597;2019 donderdag 28 november;473;228;245;406;209;197;74;72;2.0;0.0;51.0;48.0;0.0;3.0;140;4595;2684;1911;777;379;171.0
9598;2019 vrijdag 29 november;457;237;220;462;237;225;148;147;1.0;0.0;46.0;41.0;3.0;2.0;133;7204;4360;2844;662;520;21.0
9599;2019 zaterdag 30 november;377;196;181;414;208;206;44;41;3.0;0.0;2.0;1.0;0.0;1.0;2;4119;2561;1558;35;431;1.0
9600;Totaal december 2019;13005;6551;6454;13698;6683;7015;2869;2784;42.0;43.0;1910.0;1862.0;29.0;19.0;2310;146323;85483;60840;15130;11525;2345.0
9601;2019 zondag 1 december;377;193;184;409;180;229;8;8;0.0;0.0;0.0;0.0;0.0;0.0;0;17889;10084;7805;41;491;3.0
9602;2019 maandag 2 december;457;222;235;410;192;218;177;172;1.0;4.0;160.0;157.0;2.0;1.0;113;11279;6799;4480;1076;500;33.0
9603;2019 dinsdag 3 december;453;241;212;398;199;199;123;121;2.0;0.0;103.0;101.0;0.0;2.0;116;4349;2551;1798;885;428;19.0
9604;2019 woensdag 4 december;455;226;229;433;224;209;62;59;3.0;0.0;60.0;58.0;1.0;1.0;114;3887;2270;1617;913;307;936.0
9605;2019 donderdag 5 december;416;212;204;438;205;233;57;53;3.0;1.0;33.0;32.0;0.0;1.0;118;4266;2547;1719;860;306;20.0
9606;2019 vrijdag 6 december;462;233;229;481;239;242;112;107;3.0;2.0;43.0;42.0;1.0;0.0;106;4849;2875;1974;661;312;12.0
9607;2019 zaterdag 7 december;377;191;186;431;218;213;45;44;0.0;1.0;4.0;4.0;0.0;0.0;0;2955;1860;1095;9;118;0.0
9608;2019 zondag 8 december;343;167;176;423;194;229;4;4;0.0;0.0;1.0;1.0;0.0;0.0;0;1326;713;613;12;106;0.0
9609;2019 maandag 9 december;431;222;209;414;217;197;175;173;0.0;2.0;178.0;177.0;0.0;1.0;106;6023;3523;2500;838;455;25.0
9610;2019 dinsdag 10 december;464;254;210;432;223;209;140;134;4.0;2.0;117.0;115.0;1.0;1.0;107;4216;2427;1789;845;347;27.0
9611;2019 woensdag 11 december;449;234;215;458;213;245;83;81;1.0;1.0;62.0;59.0;1.0;2.0;90;3833;2198;1635;736;373;42.0
9612;2019 donderdag 12 december;414;242;172;470;216;254;138;134;2.0;2.0;50.0;47.0;3.0;0.0;81;4679;2695;1984;851;324;603.0
9613;2019 vrijdag 13 december;462;224;238;500;253;247;124;122;1.0;1.0;44.0;41.0;2.0;1.0;88;5254;3204;2050;639;402;10.0
9614;2019 zaterdag 14 december;368;188;180;462;213;249;64;64;0.0;0.0;4.0;4.0;0.0;0.0;0;3654;2292;1362;53;166;0.0
9615;2019 zondag 15 december;362;171;191;422;210;212;4;4;0.0;0.0;0.0;0.0;0.0;0.0;0;2623;1553;1070;8;217;1.0
9616;2019 maandag 16 december;419;208;211;435;226;209;160;155;4.0;1.0;180.0;177.0;0.0;3.0;149;9403;5660;3743;858;502;56.0
9617;2019 dinsdag 17 december;447;231;216;498;246;252;132;129;1.0;2.0;109.0;106.0;1.0;2.0;149;4295;2510;1785;774;405;32.0
9618;2019 woensdag 18 december;468;224;244;453;240;213;101;97;4.0;0.0;66.0;65.0;1.0;0.0;92;4533;2664;1869;749;440;423.0
9619;2019 donderdag 19 december;496;247;249;490;240;250;126;122;0.0;4.0;67.0;61.0;4.0;2.0;174;4071;2244;1827;803;467;17.0
9620;2019 vrijdag 20 december;498;247;251;479;233;246;170;166;2.0;2.0;52.0;51.0;1.0;0.0;104;7203;4256;2947;621;688;15.0
9621;2019 zaterdag 21 december;391;183;208;471;233;238;79;76;2.0;1.0;3.0;3.0;0.0;0.0;0;3485;2078;1407;6;358;0.0
9622;2019 zondag 22 december;367;198;169;417;194;223;3;3;0.0;0.0;1.0;1.0;0.0;0.0;0;1254;710;544;34;269;1.0
9623;2019 maandag 23 december;462;234;228;448;219;229;197;191;0.0;6.0;179.0;173.0;5.0;1.0;150;6860;3976;2884;813;542;29.0
9624;2019 dinsdag 24 december;483;227;256;443;224;219;163;159;2.0;2.0;136.0;133.0;3.0;0.0;142;3396;1906;1490;584;348;11.0
9625;2019 woensdag 25 december;322;163;159;416;208;208;3;3;0.0;0.0;0.0;0.0;0.0;0.0;1;824;438;386;3;87;0.0
9626;2019 donderdag 26 december;280;129;151;434;212;222;6;6;0.0;0.0;0.0;0.0;0.0;0.0;0;781;450;331;3;120;0.0
9627;2019 vrijdag 27 december;429;198;231;432;197;235;73;69;2.0;2.0;20.0;20.0;0.0;0.0;52;4053;2338;1715;295;348;10.0
9628;2019 zaterdag 28 december;399;199;200;418;197;221;36;34;1.0;1.0;2.0;2.0;0.0;0.0;0;2382;1368;1014;13;194;0.0
9629;2019 zondag 29 december;364;198;166;426;207;219;2;2;0.0;0.0;1.0;1.0;0.0;0.0;0;1170;701;469;49;159;0.0
9630;2019 maandag 30 december;479;244;235;437;200;237;160;153;2.0;5.0;152.0;150.0;1.0;1.0;143;6753;3892;2861;657;621;5.0
9631;2019 dinsdag 31 december;411;201;210;420;211;209;142;139;2.0;1.0;83.0;81.0;2.0;0.0;115;4778;2701;2077;441;1125;15.0
9632;Totaal 2019;169680;86893;82787;151885;74432;77453;63565;62146;675.0;744.0;21885.0;21176.0;348.0;361.0;30041;1781269;1023747;757522;269064;139156;34191.0
9633;Totaal op zondag in 2019;19919;10228;9691;20348;9842;10506;631;619;2.0;10.0;8.0;8.0;0.0;0.0;11;108175;58806;49369;1107;10245;15.0
9634;Totaal op maandag in 2019;24780;12682;12098;21137;10457;10680;10858;10577;132.0;149.0;8224.0;8006.0;88.0;130.0;5835;392853;225488;167365;56066;25683;4000.0
9635;Totaal op dinsdag in 2019;26133;13442;12691;22356;11107;11249;8840;8636;100.0;104.0;5843.0;5672.0;90.0;81.0;6136;259654;147011;112643;56614;23904;5326.0
9636;Totaal op woensdag in 2019;25368;12894;12474;21804;10608;11196;6207;6052;78.0;77.0;3016.0;2915.0;62.0;39.0;6186;239396;137840;101556;54178;21554;13273.0
9637;Totaal op donderdag in 2019;25500;12997;12503;22087;10817;11270;7145;6976;76.0;93.0;2275.0;2182.0;46.0;47.0;5685;255429;146049;109380;54997;22315;6286.0
9638;Totaal op vrijdag in 2019;26465;13627;12838;22887;11223;11664;19339;18932;185.0;222.0;2365.0;2253.0;58.0;54.0;5663;353581;205749;147832;44007;23982;3883.0
9639;Totaal op zaterdag in 2019;21327;10935;10392;21179;10322;10857;7712;7538;89.0;85.0;139.0;127.0;3.0;9.0;49;170855;101965;68890;1841;10805;37.0
9640;Overig 2019;188;88;100;87;56;31;2833;2816;13.0;4.0;15.0;13.0;1.0;1.0;476;1326;839;487;254;668;1371.0
9641;Totaal januari 2020;14075;7178;6897;14109;6927;7182;2658;2589;30.0;39.0;1723.0;1669.0;25.0;29.0;2667;155239;87928;67311;22215;14001;3955.0
9642;2020 woensdag 1 januari;321;160;161;439;223;216;7;7;0.0;0.0;1.0;1.0;0.0;0.0;1;22268;11967;10301;126;819;0.0
9643;2020 donderdag 2 januari;450;210;240;411;206;205;65;60;1.0;4.0;44.0;41.0;2.0;1.0;99;7490;4231;3259;947;556;27.0
9644;2020 vrijdag 3 januari;540;279;261;430;198;232;99;91;4.0;4.0;39.0;36.0;1.0;2.0;105;5924;3339;2585;799;413;41.0
9645;2020 zaterdag 4 januari;415;233;182;493;238;255;38;36;2.0;0.0;1.0;1.0;0.0;0.0;2;2493;1425;1068;30;167;1.0
9646;2020 zondag 5 januari;335;167;168;472;227;245;7;7;0.0;0.0;0.0;0.0;0.0;0.0;1;1724;934;790;42;175;0.0
9647;2020 maandag 6 januari;468;258;210;480;229;251;164;162;1.0;1.0;130.0;124.0;3.0;3.0;116;7638;4109;3529;959;505;37.0
9648;2020 dinsdag 7 januari;511;254;257;443;231;212;153;150;0.0;3.0;114.0;111.0;1.0;2.0;123;4130;2233;1897;1121;454;28.0
9649;2020 woensdag 8 januari;481;235;246;453;225;228;83;82;1.0;0.0;74.0;73.0;1.0;0.0;139;4191;2343;1848;850;422;38.0
9650;2020 donderdag 9 januari;498;258;240;542;268;274;67;66;1.0;0.0;40.0;38.0;1.0;1.0;130;3817;2125;1692;1022;338;20.0
9651;2020 vrijdag 10 januari;525;262;263;511;258;253;137;134;1.0;2.0;50.0;50.0;0.0;0.0;124;5622;3370;2252;762;531;30.0
9652;2020 zaterdag 11 januari;379;205;174;488;253;235;35;34;0.0;1.0;4.0;4.0;0.0;0.0;1;2566;1516;1050;8;144;0.0
9653;2020 zondag 12 januari;391;204;187;447;213;234;2;2;0.0;0.0;0.0;0.0;0.0;0.0;0;1375;748;627;7;117;0.0
9654;2020 maandag 13 januari;483;249;234;474;219;255;156;150;2.0;4.0;146.0;136.0;6.0;4.0;153;5864;3277;2587;946;505;35.0
9655;2020 dinsdag 14 januari;467;235;232;449;218;231;126;125;0.0;1.0;119.0;117.0;2.0;0.0;132;3566;2067;1499;1017;359;23.0
9656;2020 woensdag 15 januari;495;252;243;467;231;236;91;91;0.0;0.0;53.0;52.0;1.0;0.0;95;7208;4169;3039;963;460;34.0
9657;2020 donderdag 16 januari;444;237;207;497;244;253;72;72;0.0;0.0;28.0;27.0;0.0;1.0;159;4323;2454;1869;1063;437;39.0
9658;2020 vrijdag 17 januari;507;266;241;458;214;244;98;93;1.0;4.0;46.0;46.0;0.0;0.0;133;4910;2750;2160;908;445;20.0
9659;2020 zaterdag 18 januari;398;202;196;426;213;213;37;37;0.0;0.0;1.0;1.0;0.0;0.0;3;2903;1778;1125;27;156;3.0
9660;2020 zondag 19 januari;383;186;197;386;191;195;7;7;0.0;0.0;0.0;0.0;0.0;0.0;0;1086;581;505;19;144;0.0
9661;2020 maandag 20 januari;487;241;246;404;198;206;271;270;0.0;1.0;176.0;168.0;1.0;7.0;145;6588;3671;2917;915;523;1197.0
9662;2020 dinsdag 21 januari;510;243;267;421;209;212;145;139;3.0;3.0;116.0;114.0;1.0;1.0;102;3605;1994;1611;919;502;38.0
9663;2020 woensdag 22 januari;457;230;227;415;194;221;87;85;0.0;2.0;58.0;57.0;0.0;1.0;107;3561;1955;1606;1018;382;36.0
9664;2020 donderdag 23 januari;494;255;239;472;200;272;62;62;0.0;0.0;29.0;29.0;0.0;0.0;119;3888;2169;1719;917;436;774.0
9665;2020 vrijdag 24 januari;485;237;248;463;232;231;98;93;3.0;2.0;36.0;34.0;1.0;1.0;115;4873;2816;2057;807;469;26.0
9666;2020 zaterdag 25 januari;400;209;191;428;220;208;30;30;0.0;0.0;0.0;0.0;0.0;0.0;2;3977;2515;1462;10;258;0.0
9667;2020 zondag 26 januari;362;179;183;441;215;226;7;7;0.0;0.0;0.0;0.0;0.0;0.0;0;1340;695;645;12;216;0.0
9668;2020 maandag 27 januari;464;233;231;419;212;207;160;156;1.0;3.0;165.0;163.0;0.0;2.0;92;5946;3441;2505;996;694;618.0
9669;2020 dinsdag 28 januari;494;260;234;454;223;231;130;126;3.0;1.0;118.0;115.0;1.0;2.0;116;3730;2148;1582;946;531;32.0
9670;2020 woensdag 29 januari;486;233;253;459;245;214;75;71;3.0;1.0;58.0;57.0;0.0;1.0;118;3900;2214;1686;1900;558;41.0
9671;2020 donderdag 30 januari;447;231;216;468;232;236;61;59;2.0;0.0;38.0;37.0;1.0;0.0;114;4979;2972;2007;1061;669;29.0
9672;2020 vrijdag 31 januari;498;275;223;499;248;251;88;85;1.0;2.0;39.0;37.0;2.0;0.0;121;9754;5922;3832;1098;1616;788.0
9673;Totaal februari 2020;12895;6639;6256;12893;6292;6601;3706;3620;39.0;47.0;1817.0;1758.0;28.0;31.0;2361;144075;82257;61818;21685;10240;2582.0
9674;2020 zaterdag 1 februari;391;208;183;455;229;226;51;51;0.0;0.0;2.0;2.0;0.0;0.0;0;22689;12546;10143;175;885;0.0
9675;2020 zondag 2 februari;397;192;205;410;189;221;78;75;2.0;1.0;3.0;2.0;1.0;0.0;1;1680;887;793;11;280;0.0
9676;2020 maandag 3 februari;490;259;231;455;246;209;171;166;3.0;2.0;149.0;148.0;1.0;0.0;113;8756;5034;3722;1311;565;63.0
9677;2020 dinsdag 4 februari;502;266;236;493;256;237;142;138;0.0;4.0;111.0;109.0;2.0;0.0;146;4067;2310;1757;1514;404;42.0
9678;2020 woensdag 5 februari;484;238;246;423;203;220;80;78;1.0;1.0;53.0;50.0;2.0;1.0;92;3975;2180;1795;1198;418;745.0
9679;2020 donderdag 6 februari;443;209;234;456;221;235;74;69;2.0;3.0;29.0;29.0;0.0;0.0;133;4052;2302;1750;1393;342;16.0
9680;2020 vrijdag 7 februari;459;230;229;499;248;251;114;112;2.0;0.0;46.0;42.0;0.0;4.0;114;4889;2805;2084;1045;413;34.0
9681;2020 zaterdag 8 februari;387;207;180;414;201;213;35;35;0.0;0.0;1.0;1.0;0.0;0.0;2;2859;1642;1217;101;135;1.0
9682;2020 zondag 9 februari;314;158;156;454;217;237;8;8;0.0;0.0;0.0;0.0;0.0;0.0;0;1293;690;603;12;112;1.0
9683;2020 maandag 10 februari;473;249;224;454;209;245;189;187;1.0;1.0;162.0;156.0;4.0;2.0;117;6226;3579;2647;1411;468;40.0
9684;2020 dinsdag 11 februari;462;226;236;442;199;243;134;132;1.0;1.0;113.0;107.0;3.0;3.0;120;3573;2007;1566;1197;344;20.0
9685;2020 woensdag 12 februari;461;226;235;457;215;242;109;104;2.0;3.0;53.0;50.0;0.0;3.0;91;3656;2051;1605;1114;335;739.0
9686;2020 donderdag 13 februari;434;227;207;504;247;257;72;71;0.0;1.0;31.0;29.0;1.0;1.0;122;3678;2086;1592;1410;337;56.0
9687;2020 vrijdag 14 februari;498;247;251;463;221;242;282;277;1.0;4.0;74.0;73.0;1.0;0.0;64;6732;3989;2743;851;375;25.0
9688;2020 zaterdag 15 februari;380;209;171;476;213;263;31;30;1.0;0.0;1.0;1.0;0.0;0.0;1;4485;2749;1736;20;180;1.0
9689;2020 zondag 16 februari;360;182;178;402;202;200;10;10;0.0;0.0;1.0;1.0;0.0;0.0;0;1470;794;676;24;112;0.0
9690;2020 maandag 17 februari;476;237;239;421;210;211;176;172;2.0;2.0;186.0;181.0;1.0;4.0;86;6438;3755;2683;954;353;24.0
9691;2020 dinsdag 18 februari;445;231;214;446;215;231;157;155;0.0;2.0;117.0;115.0;1.0;1.0;124;3858;2086;1772;1177;309;37.0
9692;2020 woensdag 19 februari;445;223;222;415;215;200;84;83;1.0;0.0;59.0;59.0;0.0;0.0;140;3572;2079;1493;1080;279;46.0
9693;2020 donderdag 20 februari;547;301;246;436;211;225;786;758;12.0;16.0;161.0;154.0;4.0;3.0;101;5245;3002;2243;962;385;46.0
9694;2020 vrijdag 21 februari;518;267;251;416;224;192;136;133;2.0;1.0;43.0;40.0;0.0;3.0;147;5170;2994;2176;747;302;449.0
9695;2020 zaterdag 22 februari;404;211;193;390;195;195;87;86;0.0;1.0;4.0;3.0;0.0;1.0;2;3318;2030;1288;7;129;0.0
9696;2020 zondag 23 februari;378;183;195;435;215;220;5;5;0.0;0.0;0.0;0.0;0.0;0.0;0;1201;658;543;29;120;2.0
9697;2020 maandag 24 februari;439;221;218;395;195;200;158;155;2.0;1.0;156.0;154.0;1.0;1.0;103;5314;3088;2226;735;340;50.0
9698;2020 dinsdag 25 februari;484;255;229;461;216;245;126;125;1.0;0.0;110.0;105.0;3.0;2.0;131;3861;2160;1701;710;401;22.0
9699;2020 woensdag 26 februari;470;233;237;463;208;255;89;87;0.0;2.0;60.0;58.0;1.0;1.0;176;4086;2276;1810;873;365;47.0
9700;2020 donderdag 27 februari;490;262;228;445;202;243;85;84;0.0;1.0;44.0;42.0;1.0;1.0;137;5056;2834;2222;858;426;35.0
9701;2020 vrijdag 28 februari;502;269;233;484;252;232;131;130;1.0;0.0;45.0;44.0;1.0;0.0;97;8701;5147;3554;746;548;40.0
9702;2020 zaterdag 29 februari;362;213;149;429;218;211;106;104;2.0;0.0;3.0;3.0;0.0;0.0;1;4175;2497;1678;20;578;1.0
9703;Totaal maart 2020;13552;6976;6576;16235;8288;7947;2713;2644;36.0;33.0;1961.0;1904.0;29.0;28.0;2386;146355;84855;61500;15592;10814;4038.0
9704;2020 zondag 1 maart;342;175;167;421;213;208;7;6;1.0;0.0;0.0;0.0;0.0;0.0;0;19509;10938;8571;56;554;0.0
9705;2020 maandag 2 maart;456;238;218;435;212;223;205;200;4.0;1.0;165.0;159.0;3.0;3.0;103;11077;6644;4433;994;529;33.0
9706;2020 dinsdag 3 maart;524;267;257;483;229;254;205;202;1.0;2.0;130.0;128.0;0.0;2.0;119;4745;2637;2108;984;437;33.0
9707;2020 woensdag 4 maart;492;253;239;444;224;220;77;76;1.0;0.0;66.0;65.0;0.0;1.0;139;4084;2322;1762;960;281;25.0
9708;2020 donderdag 5 maart;461;225;236;456;221;235;85;83;1.0;1.0;38.0;37.0;0.0;1.0;86;4330;2471;1859;1119;352;32.0
9709;2020 vrijdag 6 maart;513;246;267;462;231;231;143;139;3.0;1.0;42.0;39.0;0.0;3.0;128;4856;2847;2009;738;331;2016.0
9710;2020 zaterdag 7 maart;374;204;170;421;208;213;44;43;0.0;1.0;4.0;4.0;0.0;0.0;3;2697;1615;1082;38;112;0.0
9711;2020 zondag 8 maart;382;186;196;405;193;212;4;4;0.0;0.0;0.0;0.0;0.0;0.0;0;1303;733;570;10;114;0.0
9712;2020 maandag 9 maart;503;258;245;442;222;220;168;165;1.0;2.0;178.0;173.0;4.0;1.0;113;5943;3329;2614;951;401;34.0
9713;2020 dinsdag 10 maart;449;229;220;490;246;244;147;145;1.0;1.0;127.0;124.0;1.0;2.0;153;4262;2378;1884;988;327;32.0
9714;2020 woensdag 11 maart;454;239;215;427;209;218;74;71;1.0;2.0;72.0;70.0;1.0;1.0;116;3484;1964;1520;890;322;25.0
9715;2020 donderdag 12 maart;444;233;211;441;211;230;64;60;3.0;1.0;44.0;41.0;2.0;1.0;117;4010;2288;1722;921;336;34.0
9716;2020 vrijdag 13 maart;435;216;219;483;239;244;87;83;3.0;1.0;43.0;42.0;0.0;1.0;92;4426;2622;1804;645;384;11.0
9717;2020 zaterdag 14 maart;355;180;175;471;238;233;34;34;0.0;0.0;1.0;1.0;0.0;0.0;1;2976;1857;1119;19;154;0.0
9718;2020 zondag 15 maart;372;197;175;463;230;233;3;3;0.0;0.0;1.0;1.0;0.0;0.0;0;2367;1382;985;17;221;2.0
9719;2020 maandag 16 maart;423;228;195;458;251;207;174;170;3.0;1.0;159.0;153.0;5.0;1.0;101;7658;4440;3218;640;492;806.0
9720;2020 dinsdag 17 maart;485;251;234;493;268;225;126;122;2.0;2.0;104.0;100.0;2.0;2.0;119;3161;1743;1418;561;446;33.0
9721;2020 woensdag 18 maart;448;231;217;504;257;247;65;65;0.0;0.0;51.0;50.0;1.0;0.0;127;3276;1944;1332;558;421;14.0
9722;2020 donderdag 19 maart;486;265;221;555;284;271;59;59;0.0;0.0;35.0;34.0;0.0;1.0;87;3329;1952;1377;561;364;19.0
9723;2020 vrijdag 20 maart;461;238;223;508;260;248;170;162;4.0;4.0;57.0;53.0;1.0;3.0;133;5135;2953;2182;481;434;15.0
9724;2020 zaterdag 21 maart;359;182;177;546;265;281;13;12;0.0;1.0;2.0;2.0;0.0;0.0;0;3483;2108;1375;10;329;1.0
9725;2020 zondag 22 maart;355;179;176;550;287;263;0;0;0.0;0.0;0.0;0.0;0.0;0.0;0;1315;742;573;7;225;0.0
9726;2020 maandag 23 maart;462;224;238;555;294;261;154;152;1.0;1.0;140.0;138.0;1.0;1.0;115;5420;3187;2233;566;413;10.0
9727;2020 dinsdag 24 maart;494;271;223;589;304;285;121;115;2.0;4.0;112.0;112.0;0.0;0.0;87;3230;1837;1393;498;345;39.0
9728;2020 woensdag 25 maart;462;243;219;663;344;319;68;66;1.0;1.0;55.0;52.0;3.0;0.0;81;3885;2247;1638;452;352;19.0
9729;2020 donderdag 26 maart;473;238;235;635;356;279;50;49;1.0;0.0;30.0;30.0;0.0;0.0;91;3713;2097;1616;514;372;32.0
9730;2020 vrijdag 27 maart;454;238;216;712;355;357;84;81;1.0;2.0;32.0;31.0;1.0;0.0;78;5301;3176;2125;354;338;695.0
9731;2020 zaterdag 28 maart;364;190;174;706;388;318;9;9;0.0;0.0;1.0;0.0;0.0;1.0;0;3862;2413;1449;5;173;1.0
9732;2020 zondag 29 maart;330;169;161;598;325;273;0;0;0.0;0.0;0.0;0.0;0.0;0.0;1;1355;747;608;6;134;0.0
9733;2020 maandag 30 maart;438;213;225;682;345;337;157;156;0.0;1.0;167.0;163.0;2.0;2.0;107;5989;3543;2446;513;386;39.0
9734;2020 dinsdag 31 maart;502;270;232;737;379;358;116;112;1.0;3.0;105.0;102.0;2.0;1.0;89;6174;3699;2475;536;735;38.0
9735;Totaal april 2020;13366;6822;6544;18872;9530;9342;2177;2123;23.0;31.0;1425.0;1383.0;19.0;23.0;2100;137871;81468;56403;9353;7020;4205.0
9736;2020 woensdag 1 april;451;217;234;724;370;354;88;81;1.0;6.0;64.0;62.0;0.0;2.0;105;28784;16771;12013;632;710;12.0
9737;2020 donderdag 2 april;490;248;242;738;397;341;61;60;1.0;0.0;34.0;31.0;2.0;1.0;87;4145;2483;1662;535;323;13.0
9738;2020 vrijdag 3 april;479;244;235;796;434;362;92;90;2.0;0.0;21.0;21.0;0.0;0.0;94;4515;2731;1784;418;356;817.0
9739;2020 zaterdag 4 april;391;193;198;729;392;337;17;17;0.0;0.0;0.0;0.0;0.0;0.0;1;2522;1503;1019;6;106;1.0
9740;2020 zondag 5 april;372;183;189;679;350;329;2;2;0.0;0.0;1.0;1.0;0.0;0.0;2;1266;701;565;8;88;1.0
9741;2020 maandag 6 april;443;224;219;763;390;373;155;149;3.0;3.0;171.0;167.0;3.0;1.0;97;5698;3323;2375;541;298;45.0
9742;2020 dinsdag 7 april;499;268;231;738;380;358;145;141;3.0;1.0;105.0;102.0;3.0;0.0;105;3375;1998;1377;548;263;21.0
9743;2020 woensdag 8 april;504;258;246;730;370;360;77;76;0.0;1.0;54.0;53.0;0.0;1.0;105;3535;2096;1439;431;240;13.0
9744;2020 donderdag 9 april;479;237;242;680;337;343;76;76;0.0;0.0;40.0;39.0;0.0;1.0;85;3894;2307;1587;522;244;35.0
9745;2020 vrijdag 10 april;485;251;234;728;396;332;30;30;0.0;0.0;11.0;10.0;0.0;1.0;48;4380;2646;1734;170;240;1025.0
9746;2020 zaterdag 11 april;358;189;169;687;320;367;5;5;0.0;0.0;0.0;0.0;0.0;0.0;0;2354;1472;882;1;61;1.0
9747;2020 zondag 12 april;382;189;193;655;336;319;0;0;0.0;0.0;0.0;0.0;0.0;0.0;0;942;526;416;6;45;2.0
9748;2020 maandag 13 april;352;164;188;609;291;318;1;1;0.0;0.0;0.0;0.0;0.0;0.0;0;2098;1219;879;7;72;0.0
9749;2020 dinsdag 14 april;447;228;219;627;308;319;136;135;1.0;0.0;128.0;123.0;5.0;0.0;101;4596;2620;1976;520;221;17.0
9750;2020 woensdag 15 april;472;226;246;609;299;310;95;92;0.0;3.0;51.0;49.0;0.0;2.0;119;7236;4338;2898;497;269;33.0
9751;2020 donderdag 16 april;487;237;250;664;323;341;60;59;1.0;0.0;40.0;39.0;0.0;1.0;108;3994;2422;1572;502;252;45.0
9752;2020 vrijdag 17 april;507;286;221;645;327;318;112;109;2.0;1.0;40.0;38.0;1.0;1.0;67;4590;2729;1861;378;270;12.0
9753;2020 zaterdag 18 april;389;198;191;605;283;322;8;7;0.0;1.0;1.0;1.0;0.0;0.0;0;2663;1592;1071;2;65;1.0
9754;2020 zondag 19 april;359;176;183;548;296;252;1;1;0.0;0.0;0.0;0.0;0.0;0.0;0;992;550;442;7;82;0.0
9755;2020 maandag 20 april;488;255;233;526;259;267;311;304;2.0;5.0;196.0;189.0;3.0;4.0;103;6568;3891;2677;494;294;19.0
9756;2020 dinsdag 21 april;432;226;206;601;292;309;130;129;0.0;1.0;123.0;121.0;0.0;2.0;122;3060;1802;1258;446;256;28.0
9757;2020 woensdag 22 april;469;225;244;551;270;281;85;81;3.0;1.0;56.0;53.0;0.0;3.0;107;3161;1847;1314;434;197;35.0
9758;2020 donderdag 23 april;490;249;241;625;320;305;74;72;1.0;1.0;34.0;34.0;0.0;0.0;111;3495;2069;1426;433;252;12.0
9759;2020 vrijdag 24 april;508;255;253;574;281;293;142;137;1.0;4.0;44.0;43.0;0.0;1.0;118;5627;3381;2246;363;312;1950.0
9760;2020 zaterdag 25 april;386;201;185;551;277;274;15;15;0.0;0.0;0.0;0.0;0.0;0.0;0;4077;2488;1589;3;93;1.0
9761;2020 zondag 26 april;356;206;150;480;235;245;1;1;0.0;0.0;0.0;0.0;0.0;0.0;0;1154;680;474;2;93;0.0
9762;2020 maandag 27 april;377;199;178;497;232;265;0;0;0.0;0.0;0.0;0.0;0.0;0.0;1;2536;1492;1044;6;126;0.0
9763;2020 dinsdag 28 april;511;282;229;513;263;250;126;123;1.0;2.0;116.0;115.0;0.0;1.0;137;4922;2956;1966;455;290;20.0
9764;2020 woensdag 29 april;503;253;250;478;232;246;57;55;1.0;1.0;50.0;48.0;1.0;1.0;123;4241;2438;1803;500;280;12.0
9765;2020 donderdag 30 april;500;255;245;522;270;252;75;75;0.0;0.0;45.0;44.0;1.0;0.0;154;7451;4397;3054;486;622;34.0
9766;Totaal mei 2020;13779;7115;6664;12632;6272;6360;2873;2779;41.0;53.0;1582.0;1523.0;20.0;39.0;2327;142390;83214;59176;9052;7208;5281.0
9767;2020 vrijdag 1 mei;529;275;254;486;233;253;123;120;2.0;1.0;35.0;34.0;0.0;1.0;120;30642;17357;13285;431;571;17.0
9768;2020 zaterdag 2 mei;371;200;171;469;236;233;8;7;1.0;0.0;2.0;2.0;0.0;0.0;0;2532;1533;999;10;88;6.0
9769;2020 zondag 3 mei;377;205;172;415;208;207;3;3;0.0;0.0;0.0;0.0;0.0;0.0;0;1113;648;465;0;67;0.0
9770;2020 maandag 4 mei;444;231;213;455;217;238;106;103;2.0;1.0;114.0;114.0;0.0;0.0;100;5455;3151;2304;436;282;17.0
9771;2020 dinsdag 5 mei;420;219;201;391;182;209;10;8;0.0;2.0;3.0;3.0;0.0;0.0;2;2079;1148;931;23;124;1.0
9772;2020 woensdag 6 mei;504;254;250;441;228;213;105;103;2.0;0.0;72.0;68.0;1.0;3.0;126;3787;2272;1515;578;268;31.0
9773;2020 donderdag 7 mei;460;228;232;444;200;244;68;64;3.0;1.0;43.0;42.0;1.0;0.0;110;4076;2377;1699;530;260;8.0
9774;2020 vrijdag 8 mei;469;253;216;483;245;238;114;111;0.0;3.0;45.0;44.0;1.0;0.0;116;5043;2949;2094;453;249;17.0
9775;2020 zaterdag 9 mei;424;218;206;391;200;191;16;16;0.0;0.0;0.0;0.0;0.0;0.0;0;2345;1397;948;4;53;0.0
9776;2020 zondag 10 mei;375;201;174;382;190;192;3;3;0.0;0.0;0.0;0.0;0.0;0.0;0;1607;959;648;4;74;1.0
9777;2020 maandag 11 mei;462;225;237;383;191;192;205;199;3.0;3.0;197.0;192.0;1.0;4.0;127;5684;3240;2444;590;320;915.0
9778;2020 dinsdag 12 mei;458;216;242;404;185;219;145;140;4.0;1.0;113.0;107.0;0.0;6.0;153;3489;2053;1436;422;263;34.0
9779;2020 woensdag 13 mei;490;240;250;412;214;198;64;62;1.0;1.0;48.0;47.0;1.0;0.0;99;3174;1857;1317;509;231;31.0
9780;2020 donderdag 14 mei;442;241;201;413;215;198;87;84;3.0;0.0;36.0;35.0;1.0;0.0;108;3751;2207;1544;437;261;19.0
9781;2020 vrijdag 15 mei;468;232;236;413;229;184;225;217;2.0;6.0;34.0;33.0;1.0;0.0;127;8693;5259;3434;373;344;21.0
9782;2020 zaterdag 16 mei;399;207;192;393;205;188;14;12;0.0;2.0;0.0;0.0;0.0;0.0;1;2723;1590;1133;6;74;0.0
9783;2020 zondag 17 mei;370;192;178;359;180;179;3;3;0.0;0.0;0.0;0.0;0.0;0.0;0;1062;580;482;6;73;0.0
9784;2020 maandag 18 mei;480;244;236;385;193;192;208;201;4.0;3.0;169.0;164.0;2.0;3.0;124;5458;3119;2339;515;270;15.0
9785;2020 dinsdag 19 mei;469;228;241;433;223;210;130;127;0.0;3.0;110.0;103.0;2.0;5.0;146;3084;1803;1281;465;296;12.0
9786;2020 woensdag 20 mei;478;265;213;415;207;208;319;303;9.0;7.0;83.0;79.0;2.0;2.0;159;5007;2956;2051;495;296;2822.0
9787;2020 donderdag 21 mei;421;221;200;384;177;207;1;1;0.0;0.0;1.0;1.0;0.0;0.0;0;1904;1116;788;16;87;2.0
9788;2020 vrijdag 22 mei;520;272;248;409;218;191;113;107;2.0;4.0;28.0;27.0;0.0;1.0;55;3731;2153;1578;201;177;16.0
9789;2020 zaterdag 23 mei;412;222;190;393;193;200;24;24;0.0;0.0;1.0;1.0;0.0;0.0;1;2805;1691;1114;4;91;0.0
9790;2020 zondag 24 mei;371;198;173;350;176;174;3;3;0.0;0.0;0.0;0.0;0.0;0.0;0;1168;691;477;3;70;1.0
9791;2020 maandag 25 mei;443;221;222;401;207;194;264;259;0.0;5.0;174.0;166.0;3.0;5.0;108;6532;3887;2645;513;353;20.0
9792;2020 dinsdag 26 mei;449;235;214;387;165;222;147;144;1.0;2.0;117.0;115.0;1.0;1.0;119;3449;1969;1480;496;285;23.0
9793;2020 woensdag 27 mei;483;265;218;389;195;194;77;74;1.0;2.0;62.0;58.0;1.0;3.0;140;3836;2279;1557;513;322;11.0
9794;2020 donderdag 28 mei;491;259;232;393;193;200;99;96;0.0;3.0;48.0;43.0;1.0;4.0;144;4745;2763;1982;538;356;39.0
9795;2020 vrijdag 29 mei;500;252;248;410;206;204;162;158;1.0;3.0;47.0;45.0;1.0;1.0;141;7961;4909;3052;475;375;1202.0
9796;2020 zaterdag 30 mei;417;207;210;381;195;186;27;27;0.0;0.0;0.0;0.0;0.0;0.0;1;3222;2013;1209;6;191;0.0
9797;2020 zondag 31 mei;383;189;194;368;166;202;0;0;0.0;0.0;0.0;0.0;0.0;0.0;0;2233;1288;945;0;437;0.0
9798;Totaal juni 2020;13916;7214;6702;11475;5714;5761;4358;4248;38.0;72.0;2116.0;2045.0;34.0;37.0;2617;145412;83922;61490;12731;10270;5252.0
9799;2020 maandag 1 juni;402;206;196;348;168;180;2;2;0.0;0.0;0.0;0.0;0.0;0.0;2;23985;13289;10696;52;464;2.0
9800;2020 dinsdag 2 juni;521;246;275;420;222;198;223;219;2.0;2.0;138.0;131.0;5.0;2.0;122;8540;5158;3382;712;387;18.0
9801;2020 woensdag 3 juni;510;240;270;389;211;178;114;110;2.0;2.0;69.0;67.0;0.0;2.0;128;4435;2579;1856;625;265;22.0
9802;2020 donderdag 4 juni;489;252;237;419;214;205;98;96;1.0;1.0;55.0;52.0;3.0;0.0;83;3732;2124;1608;598;300;17.0
9803;2020 vrijdag 5 juni;530;274;256;400;199;201;239;234;2.0;3.0;65.0;64.0;0.0;1.0;128;4839;2782;2057;516;368;1043.0
9804;2020 zaterdag 6 juni;419;212;207;348;178;170;83;81;1.0;1.0;3.0;3.0;0.0;0.0;0;2637;1584;1053;4;108;3.0
9805;2020 zondag 7 juni;414;221;193;357;180;177;3;3;0.0;0.0;0.0;0.0;0.0;0.0;0;1061;596;465;3;90;0.0
9806;2020 maandag 8 juni;464;234;230;372;176;196;232;230;0.0;2.0;191.0;186.0;3.0;2.0;137;5743;3219;2524;601;323;19.0
9807;2020 dinsdag 9 juni;446;230;216;362;171;191;154;153;1.0;0.0;133.0;128.0;2.0;3.0;147;3447;1932;1515;528;324;12.0
9808;2020 woensdag 10 juni;475;259;216;405;222;183;124;118;3.0;3.0;65.0;63.0;1.0;1.0;138;4183;2399;1784;634;297;16.0
9809;2020 donderdag 11 juni;452;224;228;405;185;220;99;96;1.0;2.0;47.0;47.0;0.0;0.0;124;3659;2114;1545;552;320;20.0
9810;2020 vrijdag 12 juni;499;251;248;386;184;202;281;272;1.0;8.0;53.0;51.0;1.0;1.0;101;4664;2851;1813;426;335;1201.0
9811;2020 zaterdag 13 juni;455;248;207;394;196;198;38;38;0.0;0.0;1.0;1.0;0.0;0.0;1;2456;1514;942;1;83;1.0
9812;2020 zondag 14 juni;372;209;163;365;180;185;5;5;0.0;0.0;0.0;0.0;0.0;0.0;1;1196;682;514;6;88;0.0
9813;2020 maandag 15 juni;482;242;240;373;181;192;240;229;5.0;6.0;174.0;171.0;1.0;2.0;118;9900;5630;4270;629;488;21.0
9814;2020 dinsdag 16 juni;489;282;207;420;212;208;167;162;4.0;1.0;127.0;125.0;1.0;1.0;108;3921;2267;1654;616;336;27.0
9815;2020 woensdag 17 juni;473;248;225;416;208;208;119;114;1.0;4.0;61.0;59.0;1.0;1.0;125;3415;1927;1488;622;332;9.0
9816;2020 donderdag 18 juni;509;247;262;387;192;195;108;108;0.0;0.0;44.0;42.0;1.0;1.0;121;3574;2171;1403;598;377;39.0
9817;2020 vrijdag 19 juni;503;266;237;374;188;186;260;253;3.0;4.0;46.0;42.0;1.0;3.0;120;4192;2461;1731;487;407;29.0
9818;2020 zaterdag 20 juni;413;223;190;369;190;179;177;174;0.0;3.0;7.0;7.0;0.0;0.0;1;3697;2273;1424;14;184;1196.0
9819;2020 zondag 21 juni;382;188;194;355;171;184;9;8;0.0;1.0;0.0;0.0;0.0;0.0;1;1112;628;484;2;125;0.0
9820;2020 maandag 22 juni;476;241;235;344;159;185;256;251;2.0;3.0;179.0;171.0;2.0;6.0;115;5807;3282;2525;650;367;20.0
9821;2020 dinsdag 23 juni;497;254;243;346;167;179;175;168;2.0;5.0;127.0;126.0;1.0;0.0;140;3374;1936;1438;536;346;32.0
9822;2020 woensdag 24 juni;509;265;244;380;192;188;125;124;0.0;1.0;68.0;62.0;4.0;2.0;118;3451;1958;1493;639;349;19.0
9823;2020 donderdag 25 juni;496;275;221;413;201;212;127;125;0.0;2.0;61.0;57.0;1.0;3.0;140;4302;2508;1794;632;426;20.0
9824;2020 vrijdag 26 juni;492;263;229;413;198;215;380;372;2.0;6.0;67.0;63.0;3.0;1.0;134;5612;3263;2349;474;487;40.0
9825;2020 zaterdag 27 juni;454;248;206;379;202;177;72;71;0.0;1.0;3.0;3.0;0.0;0.0;1;3818;2355;1463;30;200;2.0
9826;2020 zondag 28 juni;401;227;174;384;198;186;6;6;0.0;0.0;0.0;0.0;0.0;0.0;0;1481;788;693;13;227;0.0
9827;2020 maandag 29 juni;433;213;220;365;185;180;246;240;2.0;4.0;179.0;175.0;1.0;3.0;120;6001;3481;2520;732;481;1397.0
9828;2020 dinsdag 30 juni;459;226;233;387;184;203;196;186;3.0;7.0;153.0;149.0;2.0;2.0;143;7178;4171;3007;799;1386;27.0
9829;Totaal juli 2020;15608;8050;7558;11623;5626;5997;5243;5148;32.0;63.0;2321.0;2234.0;43.0;44.0;2747;171833;96621;75212;18024;15533;2929.0
9830;2020 woensdag 1 juli;530;288;242;418;203;215;166;163;2.0;1.0;76.0;71.0;2.0;3.0;131;34697;19057;15640;925;1255;36.0
9831;2020 donderdag 2 juli;587;269;318;405;203;202;170;164;4.0;2.0;56.0;53.0;0.0;3.0;113;4864;2710;2154;793;421;17.0
9832;2020 vrijdag 3 juli;532;275;257;368;167;201;349;345;0.0;4.0;61.0;59.0;2.0;0.0;102;5482;3116;2366;554;518;24.0
9833;2020 zaterdag 4 juli;432;233;199;357;167;190;143;140;1.0;2.0;4.0;3.0;0.0;1.0;0;3235;1885;1350;6;227;1.0
9834;2020 zondag 5 juli;415;225;190;337;171;166;9;9;0.0;0.0;0.0;0.0;0.0;0.0;0;1394;755;639;21;198;2.0
9835;2020 maandag 6 juli;494;261;233;346;146;200;249;246;0.0;3.0;216.0;212.0;2.0;2.0;141;6218;3487;2731;844;540;20.0
9836;2020 dinsdag 7 juli;532;259;273;390;194;196;308;304;0.0;4.0;161.0;152.0;5.0;4.0;127;4009;2206;1803;730;574;31.0
9837;2020 woensdag 8 juli;513;266;247;380;168;212;119;117;0.0;2.0;76.0;72.0;2.0;2.0;153;4194;2371;1823;854;440;37.0
9838;2020 donderdag 9 juli;523;298;225;394;189;205;139;138;0.0;1.0;52.0;51.0;1.0;0.0;118;3982;2249;1733;838;435;25.0
9839;2020 vrijdag 10 juli;555;289;266;432;209;223;372;366;3.0;3.0;66.0;65.0;1.0;0.0;129;5944;3420;2524;594;590;27.0
9840;2020 zaterdag 11 juli;409;232;177;345;162;183;127;123;2.0;2.0;3.0;3.0;0.0;0.0;0;3072;1834;1238;21;154;0.0
9841;2020 zondag 12 juli;397;223;174;331;149;182;9;9;0.0;0.0;0.0;0.0;0.0;0.0;0;1324;753;571;16;160;3.0
9842;2020 maandag 13 juli;519;282;237;361;194;167;224;220;0.0;4.0;201.0;197.0;2.0;2.0;129;6323;3632;2691;859;523;2360.0
9843;2020 dinsdag 14 juli;531;287;244;378;185;193;217;213;3.0;1.0;135.0;130.0;3.0;2.0;121;4157;2383;1774;938;431;20.0
9844;2020 woensdag 15 juli;570;263;307;348;167;181;110;109;1.0;0.0;79.0;77.0;1.0;1.0;116;8590;4843;3747;836;670;57.0
9845;2020 donderdag 16 juli;534;280;254;369;199;170;120;119;0.0;1.0;47.0;44.0;1.0;2.0;105;4607;2660;1947;778;435;15.0
9846;2020 vrijdag 17 juli;576;298;278;395;178;217;297;292;2.0;3.0;56.0;55.0;1.0;0.0;121;5422;3130;2292;553;514;24.0
9847;2020 zaterdag 18 juli;437;219;218;359;176;183;96;93;2.0;1.0;1.0;1.0;0.0;0.0;1;3196;1888;1308;8;211;0.0
9848;2020 zondag 19 juli;484;250;234;318;136;182;11;11;0.0;0.0;0.0;0.0;0.0;0.0;0;1171;654;517;3;127;0.0
9849;2020 maandag 20 juli;494;259;235;381;185;196;347;342;1.0;4.0;201.0;196.0;1.0;4.0;118;7266;4119;3147;852;595;16.0
9850;2020 dinsdag 21 juli;504;250;254;356;173;183;176;173;2.0;1.0;156.0;151.0;1.0;4.0;116;3745;2038;1707;776;470;24.0
9851;2020 woensdag 22 juli;546;269;277;389;189;200;139;134;1.0;4.0;63.0;59.0;2.0;2.0;110;4112;2277;1835;689;500;17.0
9852;2020 donderdag 23 juli;541;274;267;411;202;209;119;116;2.0;1.0;46.0;44.0;1.0;1.0;134;3821;2083;1738;773;511;25.0
9853;2020 vrijdag 24 juli;538;267;271;389;207;182;243;236;2.0;5.0;74.0;69.0;4.0;1.0;106;5240;2997;2243;544;597;10.0
9854;2020 zaterdag 25 juli;446;226;220;386;187;199;97;96;1.0;0.0;1.0;1.0;0.0;0.0;1;4055;2227;1828;28;243;1.0
9855;2020 zondag 26 juli;382;175;207;359;175;184;12;12;0.0;0.0;0.0;0.0;0.0;0.0;0;1279;643;636;13;226;0.0
9856;2020 maandag 27 juli;531;281;250;348;176;172;246;242;0.0;4.0;190.0;186.0;3.0;1.0;106;6525;3731;2794;802;627;26.0
9857;2020 dinsdag 28 juli;508;259;249;376;192;184;200;197;0.0;3.0;125.0;116.0;2.0;7.0;106;3985;2191;1794;856;585;23.0
9858;2020 woensdag 29 juli;517;275;242;389;183;206;123;117;2.0;4.0;68.0;65.0;3.0;0.0;124;4395;2393;2002;885;558;33.0
9859;2020 donderdag 30 juli;519;257;262;409;208;201;95;93;1.0;1.0;59.0;58.0;1.0;0.0;104;5247;3007;2240;968;661;44.0
9860;2020 vrijdag 31 juli;512;261;251;399;186;213;211;209;0.0;2.0;48.0;44.0;2.0;2.0;115;10282;5882;4400;667;1537;11.0
9861;Totaal augustus 2020;15087;7687;7400;12561;6163;6398;6277;6150;51.0;76.0;2305.0;2240.0;28.0;37.0;2346;166394;89145;77249;26724;14177;509.0
9862;2020 zaterdag 1 augustus;437;200;237;395;179;216;94;94;0.0;0.0;4.0;4.0;0.0;0.0;0;27853;14410;13443;111;889;0.0
9863;2020 zondag 2 augustus;418;222;196;349;174;175;11;11;0.0;0.0;0.0;0.0;0.0;0.0;0;1321;710;611;21;217;0.0
9864;2020 maandag 3 augustus;496;245;251;369;178;191;248;244;1.0;3.0;178.0;174.0;1.0;3.0;126;9466;5350;4116;1066;575;19.0
9865;2020 dinsdag 4 augsutus;513;272;241;359;169;190;194;187;2.0;5.0;137.0;131.0;4.0;2.0;99;4274;2349;1925;1021;561;23.0
9866;2020 woensdag 5 augustus;523;279;244;393;204;189;140;133;2.0;5.0;71.0;70.0;0.0;1.0;139;4489;2456;2033;981;507;28.0
9867;2020 donderdag 6 augustus;512;250;262;389;188;201;112;109;2.0;1.0;50.0;49.0;0.0;1.0;99;3843;2145;1698;971;492;16.0
9868;2020 vrijdag 7 augustus;565;291;274;376;194;182;243;237;1.0;5.0;55.0;54.0;0.0;1.0;121;5103;2771;2332;716;483;18.0
9869;2020 zaterdag 8 augustus;413;201;212;352;182;170;207;197;2.0;8.0;8.0;7.0;1.0;0.0;2;3015;1651;1364;26;206;0.0
9870;2020 zondag 9 augustus;379;187;192;401;205;196;9;8;0.0;1.0;0.0;0.0;0.0;0.0;0;1149;615;534;32;137;0.0
9871;2020 maandag 10 augustus;531;282;249;374;169;205;231;230;1.0;0.0;206.0;200.0;4.0;2.0;85;7304;3934;3370;941;538;21.0
9872;2020 dinsdag 11 augustus;530;264;266;416;204;212;192;190;0.0;2.0;159.0;154.0;2.0;3.0;149;3304;1684;1620;1090;396;19.0
9873;2020 woensdag 12 augustus;525;256;269;480;229;251;158;156;1.0;1.0;90.0;87.0;1.0;2.0;141;3932;2218;1714;1005;398;18.0
9874;2020 donderdag 13 augustus;512;258;254;518;243;275;110;107;2.0;1.0;47.0;47.0;0.0;0.0;110;3974;2142;1832;954;433;20.0
9875;2020 vrijdag 14 augustus;523;264;259;523;252;271;326;317;3.0;6.0;75.0;74.0;0.0;1.0;85;6964;3622;3342;889;479;9.0
9876;2020 zaterdag 15 augustus;407;215;192;457;215;242;120;117;0.0;3.0;2.0;2.0;0.0;0.0;0;5094;2686;2408;118;299;2.0
9877;2020 zondag 16 augustus;417;215;202;441;229;212;12;12;0.0;0.0;0.0;0.0;0.0;0.0;0;1582;742;840;95;163;0.0
9878;2020 maandag 17 augustus;518;255;263;431;202;229;246;243;2.0;1.0;185.0;183.0;0.0;2.0;80;8147;4191;3956;1295;616;18.0
9879;2020 dinsdag 18 augustus;513;253;260;431;195;236;242;235;4.0;3.0;126.0;119.0;6.0;1.0;123;4252;2211;2041;1210;428;22.0
9880;2020 woensdag 19 augustus;530;279;251;362;183;179;136;134;1.0;1.0;70.0;67.0;1.0;2.0;101;3835;2020;1815;1240;413;36.0
9881;2020 donderdag 20 augustus;533;271;262;455;226;229;374;365;1.0;8.0;88.0;87.0;1.0;0.0;112;5151;2941;2210;1421;412;34.0
9882;2020 vrijdag 21 augustus;547;273;274;445;244;201;484;473;7.0;4.0;63.0;61.0;1.0;1.0;114;5455;2974;2481;1103;479;39.0
9883;2020 zaterdag 22 augustus;389;219;170;383;194;189;241;239;2.0;0.0;3.0;3.0;0.0;0.0;0;3592;1969;1623;120;197;0.0
9884;2020 zondag 23 augustus;366;192;174;347;176;171;18;18;0.0;0.0;0.0;0.0;0.0;0.0;0;1516;786;730;110;163;1.0
9885;2020 maandag 24 augustus;487;245;242;421;204;217;280;276;3.0;1.0;177.0;173.0;2.0;2.0;127;7080;3783;3297;1641;599;21.0
9886;2020 dinsdag 25 augustus;518;255;263;368;190;178;212;209;2.0;1.0;145.0;140.0;0.0;5.0;113;4402;2312;2090;1461;490;45.0
9887;2020 woensdag 26 augustus;555;286;269;394;190;204;172;168;2.0;2.0;74.0;73.0;0.0;1.0;135;4128;2203;1925;1696;452;25.0
9888;2020 donderdag 27 augustus;536;295;241;422;215;207;211;207;2.0;2.0;42.0;40.0;0.0;2.0;101;4345;2374;1971;2078;545;34.0
9889;2020 vrijdag 28 augustus;558;299;259;414;208;206;756;746;4.0;6.0;76.0;74.0;2.0;0.0;88;6661;3682;2979;1409;625;21.0
9890;2020 zaterdag 29 augustus;450;220;230;357;166;191;198;195;1.0;2.0;2.0;2.0;0.0;0.0;1;3424;1814;1610;178;297;0.0
9891;2020 zondag 30 augustus;419;200;219;357;174;183;35;33;1.0;1.0;1.0;1.0;0.0;0.0;0;2118;1012;1106;105;360;0.0
9892;2020 maandag 31 augustus;467;244;223;382;182;200;265;260;2.0;3.0;171.0;164.0;2.0;5.0;95;9621;5388;4233;1620;1328;20.0
9893;Totaal september 2020;14948;7596;7352;11898;5936;5962;7216;7067;59.0;90.0;2178.0;2112.0;29.0;37.0;2210;161328;89554;71774;30379;11765;11316.0
9894;2020 dinsdag 1 september;497;239;258;388;200;188;234;229;1.0;4.0;121.0;116.0;2.0;3.0;118;35820;18953;16867;2048;1358;23.0
9895;2020 woensdag 2 september;555;287;268;383;188;195;182;178;1.0;3.0;54.0;51.0;3.0;0.0;93;4734;2594;2140;1638;413;15.0
9896;2020 donderdag 3 september;537;273;264;417;200;217;238;233;2.0;3.0;42.0;41.0;0.0;1.0;104;4262;2381;1881;1732;441;21.0
9897;2020 vrijdag 4 september;540;258;282;400;199;201;732;718;4.0;10.0;58.0;56.0;1.0;1.0;98;4921;2743;2178;1462;388;33.0
9898;2020 zaterdag 5 september;464;258;206;398;194;204;277;269;3.0;5.0;2.0;2.0;0.0;0.0;2;3063;1721;1342;388;180;0.0
9899;2020 zondag 6 september;428;219;209;323;167;156;22;21;1.0;0.0;0.0;0.0;0.0;0.0;0;1382;721;661;44;147;1.0
9900;2020 maandag 7 september;521;245;276;356;199;157;269;264;1.0;4.0;161.0;158.0;2.0;1.0;89;6595;3506;3089;1417;534;19.0
9901;2020 dinsdag 8 september;483;234;249;408;203;205;203;199;0.0;4.0;117.0;113.0;2.0;2.0;103;4058;2176;1882;1534;375;28.0
9902;2020 woensdag 9 september;561;275;286;407;186;221;264;256;4.0;4.0;76.0;74.0;1.0;1.0;94;3652;2034;1618;1488;353;8172.0
9903;2020 donderdag 10 september;533;262;271;405;196;209;276;273;0.0;3.0;43.0;43.0;0.0;0.0;113;4422;2399;2023;1583;407;26.0
9904;2020 vrijdag 11 september;526;279;247;423;204;219;566;555;4.0;7.0;72.0;69.0;2.0;1.0;102;4642;2610;2032;1129;341;12.0
9905;2020 zaterdag 12 september;402;214;188;359;168;191;234;231;0.0;3.0;6.0;6.0;0.0;0.0;0;3027;1773;1254;693;182;1.0
9906;2020 zondag 13 september;382;190;192;380;192;188;18;18;0.0;0.0;0.0;0.0;0.0;0.0;0;1260;668;592;41;139;0.0
9907;2020 maandag 14 september;483;241;242;361;184;177;258;258;0.0;0.0;164.0;160.0;2.0;2.0;95;6797;3779;3018;1321;431;19.0
9908;2020 dinsdag 15 september;515;249;266;399;198;201;202;200;1.0;1.0;122.0;119.0;0.0;3.0;100;7135;3936;3199;1292;442;27.0
9909;2020 woensdag 16 september;582;308;274;431;239;192;144;141;3.0;0.0;67.0;64.0;1.0;2.0;122;4306;2451;1855;1254;324;37.0
9910;2020 donderdag 17 september;512;263;249;393;197;196;198;196;0.0;2.0;44.0;44.0;0.0;0.0;74;3875;2211;1664;1411;334;41.0
9911;2020 vrijdag 18 september;541;289;252;405;202;203;616;597;10.0;9.0;80.0;77.0;2.0;1.0;83;4814;2730;2084;999;371;1494.0
9912;2020 zaterdag 19 september;431;220;211;391;190;201;230;224;3.0;3.0;4.0;4.0;0.0;0.0;2;2885;1706;1179;12;148;0.0
9913;2020 zondag 20 september;467;254;213;340;165;175;39;38;0.0;1.0;1.0;1.0;0.0;0.0;0;1891;1002;889;20;157;1.0
9914;2020 maandag 21 september;476;247;229;409;206;203;249;242;6.0;1.0;194.0;190.0;2.0;2.0;83;6085;3363;2722;1196;415;19.0
9915;2020 dinsdag 22 september;550;276;274;445;216;229;184;173;6.0;5.0;133.0;126.0;3.0;4.0;106;3680;2033;1647;1085;342;25.0
9916;2020 woensdag 23 september;533;268;265;396;202;194;118;116;1.0;1.0;79.0;75.0;2.0;2.0;135;3628;1992;1636;1241;359;17.0
9917;2020 donderdag 24 september;520;276;244;398;194;204;190;187;1.0;2.0;59.0;58.0;1.0;0.0;94;4516;2536;1980;1156;324;1183.0
9918;2020 vrijdag 25 september;520;265;255;452;238;214;559;550;1.0;8.0;76.0;74.0;0.0;2.0;93;6143;3546;2597;856;421;16.0
9919;2020 zaterdag 26 september;456;240;216;389;184;205;177;176;0.0;1.0;5.0;5.0;0.0;0.0;0;4130;2507;1623;33;168;1.0
9920;2020 zondag 27 september;404;203;201;402;197;205;14;14;0.0;0.0;0.0;0.0;0.0;0.0;0;1592;845;747;29;164;0.0
9921;2020 maandag 28 september;498;254;244;402;214;188;212;210;1.0;1.0;188.0;184.0;0.0;4.0;103;6572;3764;2808;1080;558;45.0
9922;2020 dinsdag 29 september;518;255;263;418;201;217;179;176;1.0;2.0;132.0;129.0;2.0;1.0;97;4091;2447;1644;1046;493;24.0
9923;2020 woensdag 30 september;513;255;258;420;213;207;132;125;4.0;3.0;78.0;73.0;1.0;4.0;107;7350;4427;2923;1151;1056;16.0
9924;Totaal oktober 2020;14496;7472;7024;14602;7439;7163;4864;4759;32.0;73.0;2149.0;2091.0;31.0;27.0;2103;164842;92934;71908;20833;11076;5048.0
9925;2020 donderdag 1 oktober;546;296;250;473;236;237;166;160;1.0;5.0;50.0;50.0;0.0;0.0;88;32985;18494;14491;1350;1028;17.0
9926;2020 vrijdag 2 oktober;504;246;258;441;218;223;407;404;2.0;1.0;62.0;61.0;1.0;0.0;115;5912;3300;2612;893;387;18.0
9927;2020 zaterdag 3 oktober;438;220;218;443;227;216;113;113;0.0;0.0;2.0;2.0;0.0;0.0;0;2778;1632;1146;28;201;0.0
9928;2020 zondag 4 oktober;391;201;190;403;192;211;13;13;0.0;0.0;0.0;0.0;0.0;0.0;3;1403;753;650;32;127;0.0
9929;2020 maandag 5 oktober;518;273;245;421;216;205;266;262;0.0;4.0;190.0;185.0;2.0;3.0;85;6794;3750;3044;1046;448;606.0
9930;2020 dinsdag 6 oktober;514;241;273;427;206;221;175;172;1.0;2.0;109.0;105.0;3.0;1.0;92;3665;2009;1656;1164;416;26.0
9931;2020 woensdag 7 oktober;505;220;285;433;235;198;105;101;1.0;3.0;64.0;63.0;0.0;1.0;113;3952;2151;1801;1021;349;24.0
9932;2020 donderdag 8 oktober;468;249;219;429;229;200;126;122;2.0;2.0;39.0;38.0;1.0;0.0;90;4269;2386;1883;1053;411;43.0
9933;2020 vrijdag 9 oktober;508;253;255;485;246;239;293;288;2.0;3.0;49.0;47.0;1.0;1.0;106;4752;2632;2120;827;407;1508.0
9934;2020 zaterdag 10 oktober;439;237;202;405;206;199;496;479;8.0;9.0;22.0;18.0;2.0;2.0;0;4163;2310;1853;16;166;0.0
9935;2020 zondag 11 oktober;404;205;199;421;234;187;9;9;0.0;0.0;0.0;0.0;0.0;0.0;0;1381;772;609;39;123;0.0
9936;2020 maandag 12 oktober;474;259;215;437;229;208;208;203;2.0;3.0;190.0;187.0;2.0;1.0;102;6350;3550;2800;901;398;67.0
9937;2020 dinsdag 13 oktober;491;261;230;445;209;236;166;163;0.0;3.0;117.0;113.0;1.0;3.0;98;3502;1988;1514;881;348;18.0
9938;2020 woensdag 14 oktober;499;261;238;441;232;209;113;113;0.0;0.0;77.0;74.0;3.0;0.0;101;4236;2399;1837;953;295;21.0
9939;2020 donderdag 15 oktober;498;250;248;475;234;241;93;92;0.0;1.0;57.0;54.0;2.0;1.0;67;8265;4742;3523;1026;441;1271.0
9940;2020 vrijdag 16 oktober;524;272;252;477;237;240;218;211;2.0;5.0;58.0;57.0;1.0;0.0;93;5790;3237;2553;779;321;18.0
9941;2020 zaterdag 17 oktober;377;210;167;468;242;226;50;49;1.0;0.0;4.0;4.0;0.0;0.0;0;3227;1867;1360;34;154;0.0
9942;2020 zondag 18 oktober;364;202;162;475;228;247;7;7;0.0;0.0;0.0;0.0;0.0;0.0;0;1399;715;684;26;106;0.0
9943;2020 maandag 19 oktober;444;245;199;447;234;213;192;189;0.0;3.0;206.0;202.0;2.0;2.0;97;6040;3397;2643;860;405;29.0
9944;2020 dinsdag 20 oktober;501;257;244;510;253;257;395;381;2.0;12.0;188.0;184.0;2.0;2.0;104;4322;2418;1904;865;309;17.0
9945;2020 woensdag 21 oktober;483;253;230;505;266;239;100;99;0.0;1.0;57.0;55.0;1.0;1.0;91;3743;1956;1787;1084;312;9.0
9946;2020 donderdag 22 oktober;487;260;227;499;270;229;106;105;0.0;1.0;49.0;46.0;1.0;2.0;105;3904;2204;1700;939;424;29.0
9947;2020 vrijdag 23 oktober;485;261;224;527;283;244;169;167;1.0;1.0;55.0;54.0;1.0;0.0;91;5127;2953;2174;675;363;10.0
9948;2020 zaterdag 24 oktober;381;199;182;493;269;224;53;50;1.0;2.0;4.0;4.0;0.0;0.0;0;3660;2245;1415;18;137;1.0
9949;2020 zondag 25 oktober;383;187;196;465;233;232;4;4;0.0;0.0;0.0;0.0;0.0;0.0;0;1708;986;722;43;130;0.0
9950;2020 maandag 26 oktober;448;218;230;478;250;228;199;197;2.0;0.0;183.0;179.0;3.0;1.0;93;6197;3440;2757;842;498;1202.0
9951;2020 dinsdag 27 oktober;511;276;235;502;258;244;165;160;2.0;3.0;136.0;129.0;1.0;6.0;88;3433;1812;1621;910;412;33.0
9952;2020 woensdag 28 oktober;515;257;258;548;269;279;80;78;0.0;2.0;66.0;66.0;0.0;0.0;107;4197;2461;1736;864;374;23.0
9953;2020 donderdag 29 oktober;489;239;250;500;255;245;83;81;1.0;1.0;43.0;43.0;0.0;0.0;89;4510;2583;1927;935;401;41.0
9954;2020 vrijdag 30 oktober;516;247;269;585;288;297;258;252;1.0;5.0;72.0;71.0;1.0;0.0;85;8612;5094;3518;704;585;17.0
9955;2020 zaterdag 31 oktober;391;217;174;544;255;289;36;35;0.0;1.0;0.0;0.0;0.0;0.0;0;4566;2698;1868;25;600;0.0
9956;Totaal november 2020;13529;6791;6738;14913;7608;7305;2797;2733;28.0;36.0;2229.0;2156.0;30.0;43.0;2254;149283;85694;63589;17766;9378;6162.0
9957;2020 zondag 1 november;405;214;191;526;287;239;7;7;0.0;0.0;0.0;0.0;0.0;0.0;0;21130;11658;9472;120;547;2.0
9958;2020 maandag 2 november;504;244;260;527;287;240;198;196;1.0;1.0;193.0;189.0;2.0;2.0;111;11609;6827;4782;924;449;24.0
9959;2020 dinsdag 3 november;518;273;245;485;250;235;149;144;2.0;3.0;125.0;125.0;0.0;0.0;102;4521;2442;2079;952;433;30.0
9960;2020 woensdag 4 november;447;221;226;509;255;254;85;83;0.0;2.0;64.0;60.0;2.0;2.0;91;3768;2092;1676;926;289;18.0
9961;2020 donderdag 5 november;528;290;238;549;266;283;60;58;0.0;2.0;47.0;46.0;0.0;1.0;129;4123;2255;1868;918;359;33.0
9962;2020 vrijdag 6 november;536;279;257;537;296;241;123;121;0.0;2.0;56.0;55.0;0.0;1.0;114;4821;2722;2099;704;307;2345.0
9963;2020 zaterdag 7 november;427;189;238;511;269;242;23;23;0.0;0.0;2.0;2.0;0.0;0.0;1;3243;1891;1352;50;131;0.0
9964;2020 zondag 8 november;347;169;178;468;231;237;2;2;0.0;0.0;0.0;0.0;0.0;0.0;0;1509;833;676;49;82;0.0
9965;2020 maandag 9 november;491;254;237;501;247;254;158;154;0.0;4.0;201.0;198.0;1.0;2.0;89;6043;3534;2509;872;352;23.0
9966;2020 dinsdag 10 november;502;233;269;528;264;264;160;152;3.0;5.0;134.0;123.0;1.0;10.0;99;3955;2181;1774;872;334;29.0
9967;2020 woensdag 11 november;501;269;232;476;244;232;147;143;3.0;1.0;92.0;87.0;1.0;4.0;127;3792;2156;1636;845;272;34.0
9968;2020 donderdag 12 november;495;246;249;525;269;256;74;72;1.0;1.0;39.0;39.0;0.0;0.0;106;3956;2208;1748;910;288;15.0
9969;2020 vrijdag 13 november;518;255;263;545;273;272;101;99;1.0;1.0;36.0;34.0;1.0;1.0;113;4860;2792;2068;677;291;1161.0
9970;2020 zaterdag 14 november;376;190;186;517;271;246;28;25;2.0;1.0;0.0;0.0;0.0;0.0;0;3152;1832;1320;43;131;2.0
9971;2020 zondag 15 november;383;171;212;487;233;254;3;3;0.0;0.0;1.0;1.0;0.0;0.0;0;2799;1699;1100;50;167;0.0
9972;2020 maandag 16 november;472;227;245;472;248;224;174;170;3.0;1.0;196.0;190.0;1.0;5.0;100;8681;5115;3566;929;390;45.0
9973;2020 dinsdag 17 november;491;246;245;475;247;228;140;140;0.0;0.0;135.0;128.0;5.0;2.0;123;3770;2082;1688;913;286;19.0
9974;2020 woensdag 18 november;464;235;229;523;268;255;69;67;0.0;2.0;76.0;75.0;0.0;1.0;115;3436;1954;1482;917;299;20.0
9975;2020 donderdag 19 november;486;244;242;497;259;238;55;54;1.0;0.0;41.0;40.0;1.0;0.0;123;3479;1960;1519;816;249;24.0
9976;2020 vrijdag 20 november;482;234;248;503;249;254;221;217;3.0;1.0;77.0;70.0;4.0;3.0;102;5472;3185;2287;599;371;1166.0
9977;2020 zaterdag 21 november;371;181;190;447;231;216;20;19;0.0;1.0;2.0;2.0;0.0;0.0;0;3570;2276;1294;30;134;0.0
9978;2020 zondag 22 november;368;192;176;414;199;215;1;1;0.0;0.0;2.0;2.0;0.0;0.0;0;1289;763;526;17;110;0.0
9979;2020 maandag 23 november;443;234;209;500;253;247;176;172;1.0;3.0;188.0;184.0;2.0;2.0;109;5693;3331;2362;814;392;24.0
9980;2020 dinsdag 24 november;466;237;229;498;265;233;146;143;3.0;0.0;122.0;116.0;4.0;2.0;121;3659;2100;1559;756;328;21.0
9981;2020 woensdag 25 november;461;239;222;474;238;236;87;86;1.0;0.0;72.0;69.0;2.0;1.0;122;3883;2260;1623;788;331;26.0
9982;2020 donderdag 26 november;475;225;250;503;264;239;75;73;1.0;1.0;55.0;54.0;0.0;1.0;80;3955;2248;1707;807;408;22.0
9983;2020 vrijdag 27 november;465;256;209;506;255;251;132;128;2.0;2.0;52.0;51.0;1.0;0.0;78;5599;3370;2229;585;441;13.0
9984;2020 zaterdag 28 november;393;186;207;468;224;244;27;27;0.0;0.0;6.0;6.0;0.0;0.0;1;3855;2388;1467;34;210;0.0
9985;2020 zondag 29 november;333;167;166;453;234;219;3;3;0.0;0.0;0.0;0.0;0.0;0.0;0;1427;796;631;38;196;0.0
9986;2020 maandag 30 november;381;191;190;489;232;257;153;151;0.0;2.0;215.0;210.0;2.0;3.0;98;8234;4744;3490;811;801;1066.0
9987;Totaal december 2020;13246;6872;6374;16780;8460;8320;2973;2891;35.0;47.0;2317.0;2238.0;31.0;48.0;2397;153850;88246;65604;16259;10880;3701.0
9988;2020 dinsdag 1 december;421;226;195;525;264;261;168;162;4.0;2.0;174.0;166.0;4.0;4.0;86;30290;17461;12829;1105;805;23.0
9989;2020 woensdag 2 december;485;249;236;517;254;263;110;102;5.0;3.0;62.0;60.0;1.0;1.0;112;4253;2375;1878;799;343;20.0
9990;2020 donderdag 3 december;462;232;230;513;271;242;62;62;0.0;0.0;41.0;40.0;0.0;1.0;112;3786;2107;1679;778;332;19.0
9991;2020 vrijdag 4 december;431;235;196;538;267;271;91;87;2.0;2.0;49.0;48.0;0.0;1.0;111;4599;2617;1982;626;394;1044.0
9992;2020 zaterdag 5 december;367;204;163;458;244;214;8;8;0.0;0.0;1.0;1.0;0.0;0.0;1;2997;1826;1171;35;164;0.0
9993;2020 zondag 6 december;339;178;161;486;235;251;1;1;0.0;0.0;0.0;0.0;0.0;0.0;0;1268;662;606;30;108;1.0
9994;2020 maandag 7 december;467;255;212;486;241;245;164;160;3.0;1.0;207.0;201.0;0.0;6.0;103;5758;3353;2405;820;351;21.0
9995;2020 dinsdag 8 december;407;227;180;528;275;253;152;143;3.0;6.0;133.0;128.0;1.0;4.0;99;3792;2158;1634;804;304;24.0
9996;2020 woensdag 9 december;499;241;258;482;249;233;72;68;0.0;4.0;81.0;77.0;1.0;3.0;100;3548;2012;1536;774;261;21.0
9997;2020 donderdag 10 december;427;226;201;545;291;254;86;81;2.0;3.0;58.0;55.0;1.0;2.0;98;4623;2581;2042;941;405;26.0
9998;2020 vrijdag 11 december;481;268;213;542;281;261;128;123;2.0;3.0;67.0;65.0;0.0;2.0;82;4575;2624;1951;642;376;745.0
9999;2020 zaterdag 12 december;372;183;189;529;264;265;57;55;1.0;1.0;7.0;7.0;0.0;0.0;0;4130;2578;1552;40;152;0.0
