ID;RegioS2007;Perioden;TotaleBevolking_1;k_0Tot20_2;k_20Tot65_3;k_65JaarOfOuder_4;Autochtoon_5;Totaal1eEn2eGeneratie_6;k_1eGeneratie_7;k_2eGeneratie_8;Totaal1eEn2eGeneratie_9;k_1eGeneratie_10;k_2eGeneratie_11;Totaal1eEn2eGeneratie_12;k_1eGeneratie_13;k_2eGeneratie_14;Totaal1eEn2eGeneratie_15;k_1eGeneratie_16;k_2eGeneratie_17;Totaal1eEn2eGeneratie_18;k_1eGeneratie_19;k_2eGeneratie_20;Totaal1eEn2eGeneratie_21;k_1eGeneratie_22;k_2eGeneratie_23;Totaal1eEn2eGeneratie_24;k_1eGeneratie_25;k_2eGeneratie_26;Levendgeborenen_27;Overledenen_28;Immigranten_29;EmigrantenInclusiefCorrecties_30;VestigersUitAndereGemeente_31;VertrekkersNaarAndereGemeente_32;Regiocode_33
0;Nederland;2008;16377048;3935594;10032314;2409140;13178824;1439077;591196;847881;1759147;1014009;745138;334698;184978;149720;130018;78135;51883;372885;194975;177910;335368;167723;167645;586178;388198;197980;179634.0;139290.0;111770.0;128273.0;632987.0;632987.0;1
1;Nederland;2009;16403183;3916072;10025522;2461589;13172678;1448240;597793;850447;1782265;1014856;767409;336505;184164;152341;131719;78478;53241;376862;194749;182113;341521;167742;173779;595658;389723;205935;178210.0;141134.0;116987.0;126757.0;637710.0;637710.0;1
2;Nederland;2010;16432585;3894842;10017308;2520435;13167161;1458894;605868;853026;1806530;1017220;789310;338252;183622;154630;134186;79462;54724;380689;194601;186088;347674;168043;179631;605729;391492;214237;176987.0;143032.0;121134.0;125285.0;639888.0;639888.0;1
3;Nederland;2011;16464309;3866045;10029101;2569163;13161650;1471160;615053;856107;1831499;1020143;811356;340301;183356;156945;136991;80727;56264;384585;194575;190010;353825;168411;185414;615797;393074;222723;175980.0;144921.0;123873.0;123815.0;641699.0;641699.0;1
4;Nederland;2012;16497210;3837579;9979294;2680337;13156282;1484282;624877;859405;1856646;1023460;833186;342531;183340;159191;139781;81980;57801;388384;194594;193790;359910;168846;191064;626040;394700;231340;175310.0;146754.0;125118.0;122336.0;640804.0;640804.0;1
5;Nederland;2013;16530426;3812049;9937517;2780860;13151225;1497840;634987;862853;1881361;1027155;854206;344643;183390;161253;142682;83290;59392;392086;194746;197340;365661;169269;196392;636289;396460;239829;175093.0;148616.0;125384.0;120895.0;640744.0;640744.0;1
6;Nederland;2014;16563236;3788856;9907660;2866720;13146172;1511320;644970;866350;1905744;1031303;874441;346668;183435;163233;145546;84583;60963;395572;194925;200647;371120;169720;201400;646838;398640;248198;175296.0;150524.0;125093.0;119538.0;640022.0;640022.0;1
7;Nederland;2015;16595318;3765847;9886507;2942964;13140696;1524757;654786;869971;1929865;1035785;894080;348584;183471;165113;148476;85881;62595;398905;195129;203776;376305;170183;206122;657595;401121;256474;175793.0;152491.0;124791.0;118319.0;639162.0;639162.0;1
8;Nederland;2016;16626943;3749089;9864703;3013151;13135037;1538212;664485;873727;1953694;1040673;913021;350401;183506;166895;151417;87201;64216;402150;195394;206756;381161;170648;210513;668565;403924;264641;176537.0;154540.0;124484.0;117356.0;641441.0;641441.0;1
9;Nederland;2017;16657862;3733799;9844857;3079206;13128944;1551650;674096;877554;1977268;1045889;931379;352130;183535;168595;154362;88481;65881;405273;195703;209570;385747;171104;214643;679756;407066;272690;177420.0;156443.0;124170.0;116526.0;641074.0;641074.0;1
10;Nederland;2018;16688289;3718256;9820991;3149042;13122499;1565096;683629;881467;2000694;1051444;949250;353759;183526;170233;157373;89810;67563;408301;196035;212266;390091;171588;218503;691170;410485;280685;178519.0;158451.0;123869.0;115698.0;642322.0;642322.0;1
11;Nederland;2019;16718321;3698081;9805009;3215231;13115851;1578676;693191;885485;2023794;1057272;966522;355276;183501;171775;160418;91133;69285;411133;196353;214780;394173;172097;222076;702794;414188;288606;179654.0;160573.0;123561.0;114872.0;642588.0;642588.0;1
12;Nederland;2020;16747844;3677849;9788998;3280997;13108792;1592313;702759;889554;2046739;1063299;983440;356713;183424;173289;163454;92452;71002;413991;196724;217267;397997;172542;225455;714584;418157;296427;180707.0;162768.0;123268.0;114035.0;644658.0;644658.0;1
13;Nederland;2021;16776805;3654572;9775922;3346311;13101239;1606092;712395;893697;2069474;1069552;999922;358106;183351;174755;166478;93734;72744;416758;197098;219660;401582;172986;228596;726550;422383;304167;181683.0;165069.0;122969.0;113211.0;647146.0;647146.0;1
14;Nederland;2022;16804899;3635732;9756303;3412864;13092993;1619960;722064;897896;2091946;1075945;1016001;359359;183218;176141;169540;95016;74524;419404;197432;221972;404922;173418;231504;738721;426861;311860;182522.0;167479.0;122666.0;112372.0;646957.0;646957.0;1
15;Nederland;2023;16832048;3619966;9732599;3479483;13083571;1633994;731826;902168;2114483;1082569;1031914;360561;183039;177522;172601;96292;76309;422035;197801;224234;408102;173853;234249;751184;431584;319600;183234.0;169990.0;122394.0;111516.0;648032.0;648032.0;1
16;Nederland;2024;16857955;3606788;9704614;3546553;13072993;1648150;741644;906506;2136812;1089243;1047569;361649;182795;178854;175723;97581;78142;424580;198137;226443;411075;174248;236827;763785;436482;327303;183819.0;172607.0;122111.0;110660.0;647471.0;647471.0;1
17;Nederland;2025;16882447;3601149;9665517;3615781;13060855;1662476;751556;910920;2159116;1096053;1063063;362701;182537;180164;178843;98854;79989;427062;198437;228625;413907;174641;239266;776603;441584;335019;;;;;;;1
18;Noord-Nederland (LD);2008;1701636;400614;1032162;268860;1531522;96035;36810;59225;74079;44802;29277;11713;6098;5615;7865;4766;3099;9713;5059;4654;6574;3118;3456;38214;25761;12453;18036.0;15619.0;7055.0;9754.0;76405.0;75209.0;1
19;Noord-Nederland (LD);2009;1702772;397906;1030722;274144;1529610;96175;36675;59500;76987;45850;31137;12188;6361;5827;8082;4840;3242;10478;5385;5093;7387;3436;3951;38852;25828;13024;17968.0;15705.0;7480.0;9687.0;75946.0;75073.0;1
20;Noord-Nederland (LD);2010;1703935;395073;1028796;280066;1527412;96589;36830;59759;79934;47007;32927;12629;6611;6018;8437;5058;3379;11266;5745;5521;8119;3718;4401;39483;25875;13608;17886.0;15877.0;7642.0;9550.0;76319.0;75375.0;1
21;Noord-Nederland (LD);2011;1705140;391602;1028043;285495;1525410;96834;36799;60035;82896;48234;34662;13077;6854;6223;8774;5268;3506;12008;6033;5975;8802;3971;4831;40235;26108;14127;17905.0;15968.0;7965.0;9481.0;75616.0;74824.0;1
22;Noord-Nederland (LD);2012;1706473;387995;1021732;296746;1523609;97147;36900;60247;85717;49405;36312;13544;7091;6453;9130;5491;3639;12646;6291;6355;9453;4218;5235;40944;26314;14630;17902.0;16137.0;7952.0;9319.0;75655.0;74843.0;1
23;Noord-Nederland (LD);2013;1707887;385138;1015989;306760;1521753;97576;36998;60578;88558;50508;38050;13968;7322;6646;9400;5632;3768;13506;6634;6872;10143;4480;5663;41541;26440;15101;17992.0;16286.0;7942.0;9188.0;75605.0;74765.0;1
24;Noord-Nederland (LD);2014;1709361;382524;1011836;315001;1520048;97999;37078;60921;91314;51602;39712;14353;7557;6796;9716;5816;3900;14164;6851;7313;10854;4747;6107;42227;26631;15596;18072.0;16369.0;7967.0;9105.0;75599.0;74702.0;1
25;Noord-Nederland (LD);2015;1710964;379925;1008831;322208;1518271;98489;37286;61203;94204;52788;41416;14720;7796;6924;10057;6000;4057;15014;7180;7834;11468;5005;6463;42945;26807;16138;18158.0;16535.0;7906.0;8981.0;75543.0;74670.0;1
26;Noord-Nederland (LD);2016;1712601;377716;1006186;328699;1516572;98924;37455;61469;97105;53951;43154;15196;8043;7153;10418;6208;4210;15666;7469;8197;12099;5234;6865;43726;26997;16729;18270.0;16626.0;7836.0;8955.0;75815.0;74922.0;1
27;Noord-Nederland (LD);2017;1714217;375967;1003077;335173;1514825;99436;37686;61750;99956;55212;44744;15683;8290;7393;10722;6386;4336;16408;7777;8631;12693;5436;7257;44450;27323;17127;18366.0;16795.0;7841.0;8878.0;75366.0;74499.0;1
28;Noord-Nederland (LD);2018;1715805;374242;999256;342307;1513467;99631;37757;61874;102707;56295;46412;16090;8511;7579;11097;6607;4490;17006;8024;8982;13300;5616;7684;45214;27537;17677;18505.0;17021.0;7807.0;8787.0;76130.0;74942.0;1
29;Noord-Nederland (LD);2019;1717656;372177;996213;349266;1512031;100000;37926;62074;105625;57547;48078;16520;8711;7809;11452;6810;4642;17674;8268;9406;13948;5863;8085;46031;27895;18136;18615.0;17219.0;7775.0;8749.0;75983.0;74867.0;1
30;Noord-Nederland (LD);2020;1719353;369942;993364;356047;1510393;100423;38204;62219;108537;58688;49849;16872;8879;7993;11786;6985;4801;18327;8515;9812;14661;6081;8580;46891;28228;18663;18706.0;17441.0;7775.0;8696.0;76492.0;75002.0;1
31;Noord-Nederland (LD);2021;1721381;368115;990336;362930;1509126;100918;38516;62402;111337;59752;51585;17209;9038;8171;12174;7140;5034;18958;8787;10171;15272;6268;9004;47724;28519;19205;18903.0;17656.0;7696.0;8614.0;76176.0;74944.0;1
32;Noord-Nederland (LD);2022;1723079;366460;986942;369677;1507560;101379;38857;62522;114140;60937;53203;17510;9158;8352;12502;7294;5208;19634;9031;10603;15855;6476;9379;48639;28978;19661;18860.0;17922.0;7858.0;8611.0;76052.0;74648.0;1
33;Noord-Nederland (LD);2023;1724886;365516;983037;376333;1506096;101817;39161;62656;116973;62136;54837;17862;9322;8540;12842;7449;5393;20235;9290;10945;16508;6637;9871;49526;29438;20088;18987.0;18182.0;7692.0;8517.0;75879.0;74560.0;1
34;Noord-Nederland (LD);2024;1726361;364978;978354;383029;1504471;102273;39501;62772;119617;63161;56456;18199;9465;8734;13123;7555;5568;20866;9540;11326;17122;6842;10280;50307;29759;20548;19083.0;18409.0;7699.0;8497.0;75793.0;74171.0;1
35;Noord-Nederland (LD);2025;1728021;365482;972787;389752;1502885;102698;39834;62864;122438;64332;58106;18500;9638;8862;13436;7693;5743;21425;9744;11681;17814;7060;10754;51263;30197;21066;;;;;;;1
36;Oost-Nederland (LD);2008;3472343;880183;2097464;494696;2939848;256339;92423;163916;276156;158131;118025;42021;21674;20347;19205;11059;8146;79012;40775;38237;35658;17152;18506;100260;67471;32789;39604.0;28824.0;16880.0;20503.0;124360.0;124647.0;2
37;Oost-Nederland (LD);2009;3479711;875097;2098249;506365;2940132;257204;92992;164212;282375;159742;122633;43242;22142;21100;19703;11322;8381;79647;40743;38904;37341;17596;19745;102442;67939;34503;39220.0;29260.0;17741.0;20230.0;124993.0;125246.0;2
38;Oost-Nederland (LD);2010;3487391;869641;2098460;519290;2940432;258176;93566;164610;288783;161612;127171;44392;22564;21828;20381;11670;8711;80101;40704;39397;39059;18084;20975;104850;68590;36260;38854.0;29720.0;18403.0;19981.0;126669.0;126489.0;2
39;Oost-Nederland (LD);2011;3495552;862491;2102760;530301;2940590;259389;94213;165176;295573;163738;131835;45447;22958;22489;21131;12076;9055;80822;40848;39974;40859;18651;22208;107314;69205;38109;38578.0;30181.0;18834.0;19796.0;125373.0;125819.0;2
40;Oost-Nederland (LD);2012;3502939;855236;2094184;553519;2940127;260533;94967;165566;302279;165872;136407;46735;23549;23186;21770;12391;9379;81381;40880;40501;42474;19105;23369;109919;69947;39972;38239.0;30686.0;19270.0;19482.0;126082.0;126636.0;2
41;Oost-Nederland (LD);2013;3510109;848732;2086527;574850;2939277;261891;96045;165846;308941;167940;141001;47868;24012;23856;22455;12738;9717;81906;40826;41080;44182;19585;24597;112530;70779;41751;38096.0;31127.0;19222.0;19245.0;126138.0;127170.0;2
42;Oost-Nederland (LD);2014;3516447;842145;2081220;593082;2937835;263089;96976;166113;315523;170058;145465;48966;24488;24478;23204;13105;10099;82361;40795;41566;45734;20041;25693;115258;71629;43629;38039.0;31531.0;19104.0;18995.0;125359.0;126463.0;2
43;Oost-Nederland (LD);2015;3522335;835451;2077674;609210;2936088;264182;97734;166448;322065;172399;149666;50085;25002;25083;23852;13457;10395;82893;40881;42012;47217;20399;26818;118018;72660;45358;38126.0;32091.0;19040.0;18801.0;126929.0;127332.0;2
44;Oost-Nederland (LD);2016;3528603;830674;2073769;624160;2934423;265525;98835;166690;328655;174737;153918;51058;25412;25646;24609;13847;10762;83517;40963;42554;48723;20805;27918;120748;73710;47038;38185.0;32616.0;19108.0;18604.0;127547.0;127951.0;2
45;Oost-Nederland (LD);2017;3534653;826083;2069545;639025;2932730;266833;99852;166981;335090;177245;157845;52157;25902;26255;25454;14286;11168;83998;41005;42993;50130;21206;28924;123351;74846;48505;38367.0;32997.0;18939.0;18530.0;127926.0;128478.0;2
46;Oost-Nederland (LD);2018;3540278;821413;2063587;655278;2930829;267872;100796;167076;341577;179737;161840;53198;26357;26841;26222;14647;11575;84324;40977;43347;51483;21596;29887;126350;76160;50190;38551.0;33531.0;18957.0;18357.0;127416.0;128269.0;2
47;Oost-Nederland (LD);2019;3545455;814955;2060114;670386;2928374;269163;101924;167239;347918;182244;165674;54045;26777;27268;27089;15006;12083;84731;41087;43644;52845;21992;30853;129208;77382;51826;38703.0;33969.0;18969.0;18241.0;127381.0;128401.0;2
48;Oost-Nederland (LD);2020;3550314;808576;2056241;685497;2925750;270385;102848;167537;354179;184747;169432;54974;27133;27841;27845;15365;12480;85077;41197;43880;54158;22369;31789;132125;78683;53442;38922.0;34499.0;18974.0;18170.0;127577.0;128847.0;2
49;Oost-Nederland (LD);2021;3554663;801393;2052607;700663;2922824;271388;103791;167597;360451;187120;173331;55890;27503;28387;28667;15738;12929;85556;41235;44321;55423;22730;32693;134915;79914;55001;39118.0;35110.0;18847.0;18017.0;128243.0;128931.0;2
50;Oost-Nederland (LD);2022;3559223;795590;2047464;716169;2920174;272716;104865;167851;366333;189631;176702;56630;27873;28757;29384;16052;13332;85958;41324;44634;56669;23063;33606;137692;81319;56373;39300.0;35489.0;18755.0;17894.0;127653.0;128463.0;2
51;Oost-Nederland (LD);2023;3563474;790328;2041645;731501;2917458;273835;105912;167923;372181;191939;180242;57467;28193;29274;30148;16419;13729;86368;41380;44988;57750;23394;34356;140448;82553;57895;39430.0;36097.0;18735.0;17672.0;127914.0;128504.0;2
52;Oost-Nederland (LD);2024;3567653;785839;2034566;747248;2914362;275021;107049;167972;378270;194278;183992;58184;28493;29691;31003;16788;14215;86782;41376;45406;58762;23714;35048;143539;83907;59632;39500.0;36727.0;18654.0;17591.0;127002.0;128127.0;2
53;Oost-Nederland (LD);2025;3570759;783237;2024501;763021;2910383;276108;108128;167980;384268;196731;187537;58901;28800;30101;31812;17158;14654;87210;41420;45790;59845;24063;35782;146500;85290;61210;;;;;;;2
54;West-Nederland (LD);2008;7663683;1830686;4737307;1095690;5761756;740049;333575;406474;1161878;668816;493062;256642;144392;112250;84422;51467;32955;222740;117062;105678;237996;120404;117592;360078;235491;124587;88018.0;64127.0;66574.0;72569.0;316142.0;312952.0;3
55;West-Nederland (LD);2009;7685860;1826130;4741341;1118389;5766394;749551;339489;410062;1169915;664661;505254;255609;142249;113360;84868;51200;33668;224487;116318;108169;240667;119484;121183;364284;235410;128874;87416.0;64811.0;69555.0;71741.0;318274.0;314873.0;3
56;West-Nederland (LD);2010;7710627;1821301;4743903;1145423;5771847;760035;346422;413613;1178745;661652;517093;254637;140446;114191;85767;51328;34439;226247;115660;110587;243282;118729;124553;368812;235489;133323;86830.0;65588.0;72151.0;71137.0;316824.0;314111.0;3
57;West-Nederland (LD);2011;7736503;1812833;4760025;1163645;5777052;771514;354089;417425;1187937;659106;528831;254038;138974;115064;86878;51660;35218;227870;115061;112809;245933;118081;127852;373218;235330;137888;86345.0;66319.0;73644.0;70228.0;317775.0;315267.0;3
58;West-Nederland (LD);2012;7763312;1804177;4739203;1219932;5782451;783323;362006;421317;1197538;657050;540488;253352;137549;115803;88060;52049;36011;229554;114510;115044;248784;117699;131085;377788;235243;142545;86101.0;67018.0;74231.0;69551.0;316094.0;313613.0;3
59;West-Nederland (LD);2013;7790432;1796701;4724767;1268964;5788171;795397;369929;425468;1206864;655524;551340;252737;136303;116434;89364;52539;36825;231086;114137;116949;251162;117210;133952;382515;235335;147180;85936.0;67749.0;74621.0;69002.0;314647.0;312442.0;3
60;West-Nederland (LD);2014;7817288;1790593;4716600;1310095;5794085;807532;377852;429680;1215671;654052;561619;252104;135044;117060;90545;52924;37621;232544;113877;118667;253397;116711;136686;387081;235496;151585;86066.0;68613.0;74611.0;68337.0;313963.0;311844.0;3
61;West-Nederland (LD);2015;7843975;1784859;4713239;1345877;5799891;819553;385741;433812;1224531;652710;571821;251425;133796;117629;91742;53282;38460;233873;113500;120373;255572;116364;139208;391919;235768;156151;86187.0;69418.0;74554.0;67716.0;311214.0;310200.0;3
62;West-Nederland (LD);2016;7869425;1781035;4708907;1379483;5805141;831492;393269;438223;1232792;651566;581226;250677;132636;118041;92890;53651;39239;235095;113156;121939;257581;116035;141546;396549;236088;160461;86566.0;70307.0;74279.0;67225.0;312798.0;311794.0;3
63;West-Nederland (LD);2017;7894527;1777842;4706199;1410486;5809926;843169;400599;442570;1241432;650942;590490;249878;131478;118400;94033;53947;40086;236281;112887;123394;259341;115743;143598;401899;236887;165012;86932.0;71213.0;74448.0;66747.0;311826.0;311237.0;3
64;West-Nederland (LD);2018;7919365;1774023;4702608;1442734;5813904;855618;408072;447546;1249843;650477;599366;248991;130287;118704;95268;54328;40940;237685;112805;124880;260887;115443;145444;407012;237614;169398;87372.0;72012.0;74237.0;66430.0;312391.0;311954.0;3
65;West-Nederland (LD);2019;7943812;1768383;4701358;1474071;5818375;867474;415366;452108;1257963;650158;607805;248270;129152;119118;96383;54713;41670;238803;112604;126199;262339;115158;147181;412168;238531;173637;88015.0;73037.0;74194.0;66019.0;312761.0;312526.0;3
66;West-Nederland (LD);2020;7968008;1762681;4700104;1505223;5822394;879415;422609;456806;1266199;650172;616027;247496;128067;119429;97685;55189;42496;239955;112422;127533;263438;114818;148620;417625;239676;177949;88483.0;74034.0;74130.0;65507.0;312950.0;313286.0;3
67;West-Nederland (LD);2021;7991549;1755086;4700507;1535956;5825701;891581;430075;461506;1274267;650614;623653;246733;126990;119743;98952;55694;43258;241035;112328;128707;264485;114530;149955;423062;241072;181990;88770.0;75135.0;74213.0;65105.0;315032.0;315758.0;3
68;West-Nederland (LD);2022;8014351;1748534;4698221;1567596;5828139;903578;437310;466268;1282634;651045;631589;246030;125915;120115;100263;56168;44095;242014;112138;129876;265383;114205;151178;428944;242619;186325;89291.0;76255.0;73965.0;64577.0;315116.0;316162.0;3
69;West-Nederland (LD);2023;8036535;1742896;4694105;1599534;5829907;915695;444629;471066;1290933;651709;639224;245227;124871;120356;101567;56613;44954;243166;111972;131194;266088;113950;152138;434885;244303;190582;89503.0;77391.0;73923.0;64197.0;317496.0;318146.0;3
70;West-Nederland (LD);2024;8058542;1737371;4689784;1631387;5831531;927910;451925;475985;1299101;652627;646474;244499;123842;120657;102919;57110;45809;244102;111868;132234;266703;113620;153083;440878;246187;194691;89806.0;78724.0;73748.0;63747.0;317221.0;318361.0;3
71;West-Nederland (LD);2025;8079357;1734861;4679536;1664960;5831989;940184;459229;480955;1307184;653370;653814;243723;122702;121021;104156;57459;46697;244935;111705;133230;267228;113337;153891;447142;248167;198975;;;;;;;3
72;Zuid-Nederland (LD);2008;3539386;824111;2165381;549894;2945698;346654;128388;218266;247034;142260;104774;24322;12814;11508;18526;10843;7683;61420;32079;29341;55140;27049;28091;87626;59475;28151;33976.0;30720.0;21261.0;25447.0;116080.0;120179.0;4
73;Zuid-Nederland (LD);2009;3534840;816939;2155210;562691;2936542;345310;128637;216673;252988;144603;108385;25466;13412;12054;19066;11116;7950;62250;32303;29947;56126;27226;28900;90080;60546;29534;33606.0;31358.0;22211.0;25099.0;118497.0;122518.0;4
74;Zuid-Nederland (LD);2010;3530632;808827;2146149;575656;2927470;344094;129050;215044;259068;146949;112119;26594;14001;12593;19601;11406;8195;63075;32492;30583;57214;27512;29702;92584;61538;31046;33417.0;31847.0;22938.0;24617.0;120076.0;123913.0;4
75;Zuid-Nederland (LD);2011;3527114;799119;2138273;589722;2918598;343423;129952;213471;265093;149065;116028;27739;14570;13169;20208;11723;8485;63885;32633;31252;58231;27708;30523;95030;62431;32599;33152.0;32453.0;23430.0;24310.0;122935.0;125789.0;4
76;Zuid-Nederland (LD);2012;3524486;790171;2124175;610140;2910095;343279;131004;212275;271112;151133;119979;28900;15151;13749;20821;12049;8772;64803;32913;31890;59199;27824;31375;97389;63196;34193;33068.0;32913.0;23665.0;23984.0;122973.0;125712.0;4
77;Zuid-Nederland (LD);2013;3521998;781478;2110234;630286;2902024;342976;132015;210961;276998;153183;123815;30070;15753;14317;21463;12381;9082;65588;33149;32439;60174;27994;32180;99703;63906;35797;33069.0;33454.0;23599.0;23460.0;124354.0;126367.0;4
78;Zuid-Nederland (LD);2014;3520140;773594;2098004;648542;2894204;342700;133064;209636;283236;155591;127645;31245;16346;14899;22081;12738;9343;66503;33402;33101;61135;28221;32914;102272;64884;37388;33119.0;34011.0;23411.0;23101.0;125101.0;127013.0;4
79;Zuid-Nederland (LD);2015;3518044;765612;2086763;665669;2886446;342533;134025;208508;289065;157888;131177;32354;16877;15477;22825;13142;9683;67125;33568;33557;62048;28415;33633;104713;65886;38827;33322.0;34447.0;23291.0;22821.0;125476.0;126960.0;4
80;Zuid-Nederland (LD);2016;3516314;759664;2075841;680809;2878901;342271;134926;207345;295142;160419;134723;33470;17415;16055;23500;13495;10005;67872;33806;34066;62758;28574;34184;107542;67129;40413;33516.0;34991.0;23261.0;22572.0;125281.0;126774.0;4
81;Zuid-Nederland (LD);2017;3514465;753907;2066036;694522;2871463;342212;135959;206253;300790;162490;138300;34412;17865;16547;24153;13862;10291;68586;34034;34552;63583;28719;34864;110056;68010;42046;33755.0;35438.0;22942.0;22371.0;125956.0;126860.0;4
82;Zuid-Nederland (LD);2018;3512841;748578;2055540;708723;2864299;341975;137004;204971;306567;164935;141632;35480;18371;17109;24786;14228;10558;69286;34229;35057;64421;28933;35488;112594;69174;43420;34091.0;35887.0;22868.0;22124.0;126385.0;127157.0;4
83;Zuid-Nederland (LD);2019;3511398;742566;2047324;721508;2857071;342039;137975;204064;312288;167323;144965;36441;18861;17580;25494;14604;10890;69925;34394;35531;65041;29084;35957;115387;70380;45007;34321.0;36348.0;22623.0;21863.0;126463.0;126794.0;4
84;Zuid-Nederland (LD);2020;3510169;736650;2039289;734230;2850255;342090;139098;202992;317824;169692;148132;37371;19345;18026;26138;14913;11225;70632;34590;36042;65740;29274;36466;117943;71570;46373;34596.0;36794.0;22389.0;21662.0;127639.0;127523.0;4
85;Zuid-Nederland (LD);2021;3509212;729978;2032472;746762;2843588;342205;140013;202192;323419;172066;151353;38274;19820;18454;26685;15162;11523;71209;34748;36461;66402;29458;36944;120849;72878;47971;34892.0;37168.0;22213.0;21475.0;127695.0;127513.0;4
86;Zuid-Nederland (LD);2022;3508246;725148;2023676;759422;2837120;342287;141032;201255;328839;174332;154507;39189;20272;18917;27391;15502;11889;71798;34939;36859;67015;29674;37341;123446;73945;49501;35071.0;37813.0;22088.0;21290.0;128136.0;127684.0;4
87;Zuid-Nederland (LD);2023;3507153;721226;2013812;772115;2830110;342647;142124;200523;334396;176785;157611;40005;20653;19352;28044;15811;12233;72266;35159;37107;67756;29872;37884;126325;75290;51035;35314.0;38320.0;22044.0;21130.0;126743.0;126822.0;4
88;Zuid-Nederland (LD);2024;3505399;718600;2001910;784889;2822629;342946;143169;199777;339824;179177;160647;40767;20995;19772;28678;16128;12550;72830;35353;37477;68488;30072;38416;129061;76629;52432;35430.0;38747.0;22010.0;20825.0;127455.0;126812.0;4
89;Zuid-Nederland (LD);2025;3504310;717569;1988693;798048;2815598;343486;144365;199121;345226;181620;163606;41577;21397;20180;29439;16544;12895;73492;35568;37924;69020;30181;38839;131698;77930;53768;;;;;;;4
90;Groningen (PV);2008;571703;126016;359523;86164;499946;38913;16004;22909;32844;20137;12707;6280;3369;2911;4312;2734;1578;5032;2624;2408;2064;949;1115;15156;10461;4695;6056.0;5264.0;3350.0;4535.0;29950.0;29864.0;20
91;Groningen (PV);2009;571448;125414;358604;87430;498942;38834;15945;22889;33672;20383;13289;6398;3439;2959;4319;2701;1618;5232;2693;2539;2382;1086;1296;15341;10464;4877;6048.0;5245.0;3528.0;4502.0;30074.0;29886.0;20
92;Groningen (PV);2010;571527;124933;357588;89006;498245;38817;15937;22880;34465;20657;13808;6448;3488;2960;4418;2767;1651;5465;2793;2672;2633;1176;1457;15501;10433;5068;6109.0;5280.0;3617.0;4433.0;30469.0;29917.0;20
93;Groningen (PV);2011;572111;124316;357238;90557;497870;38941;15987;22954;35300;20919;14381;6575;3546;3029;4496;2820;1676;5713;2891;2822;2880;1275;1605;15636;10387;5249;6152.0;5305.0;3734.0;4374.0;30580.0;29793.0;20
94;Groningen (PV);2012;573088;123572;355329;94187;497990;38996;16028;22968;36102;21237;14865;6667;3606;3061;4611;2897;1714;5890;2950;2940;3104;1338;1766;15830;10446;5384;6217.0;5344.0;3690.0;4305.0;30339.0;29694.0;20
95;Groningen (PV);2013;574070;123264;353531;97275;498082;39059;16015;23044;36929;21522;15407;6751;3652;3099;4655;2913;1742;6143;3059;3084;3354;1423;1931;16026;10475;5551;6261.0;5352.0;3678.0;4244.0;30381.0;29590.0;20
96;Groningen (PV);2014;575255;123064;352475;99716;498290;39192;16038;23154;37773;21824;15949;6839;3706;3133;4764;2994;1770;6342;3116;3226;3596;1491;2105;16232;10517;5715;6319.0;5398.0;3680.0;4190.0;30325.0;29411.0;20
97;Groningen (PV);2015;576598;122730;351942;101926;498648;39319;16170;23149;38631;22146;16485;6910;3764;3146;4854;3026;1828;6613;3238;3375;3785;1569;2216;16469;10549;5920;6364.0;5432.0;3701.0;4149.0;30223.0;29450.0;20
98;Groningen (PV);2016;577947;122518;351587;103842;498865;39454;16265;23189;39628;22552;17076;7064;3826;3238;4963;3096;1867;6812;3342;3470;4041;1665;2376;16748;10623;6125;6429.0;5431.0;3640.0;4101.0;29843.0;29462.0;20
99;Groningen (PV);2017;578932;122581;350539;105812;498919;39591;16325;23266;40422;22889;17533;7153;3873;3280;5036;3147;1889;7033;3432;3601;4242;1736;2506;16958;10701;6257;6468.0;5494.0;3633.0;4092.0;29874.0;29218.0;20
100;Groningen (PV);2018;580170;122574;349477;108119;499273;39625;16315;23310;41272;23190;18082;7256;3923;3333;5190;3220;1970;7267;3536;3731;4433;1803;2630;17126;10708;6418;6503.0;5568.0;3622.0;4001.0;29889.0;29315.0;20
101;Groningen (PV);2019;581339;122425;348613;110301;499539;39699;16348;23351;42101;23592;18509;7391;3999;3392;5272;3272;2000;7440;3612;3828;4631;1887;2744;17367;10822;6545;6532.0;5631.0;3596.0;4009.0;30145.0;29252.0;20
102;Groningen (PV);2020;582753;122440;348021;112292;499983;39817;16383;23434;42953;23866;19087;7477;4043;3434;5338;3325;2013;7649;3684;3965;4891;1970;2921;17598;10844;6754;6549.0;5671.0;3629.0;3993.0;29871.0;29299.0;20
103;Groningen (PV);2021;583907;122400;347136;114371;500127;40000;16512;23488;43780;24184;19596;7555;4089;3466;5431;3364;2067;7823;3774;4049;5119;2025;3094;17852;10932;6920;6575.0;5760.0;3548.0;3923.0;29851.0;29224.0;20
104;Groningen (PV);2022;584999;122194;346400;116405;500121;40171;16639;23532;44707;24596;20111;7631;4110;3521;5505;3386;2119;8069;3876;4193;5339;2108;3231;18163;11116;7047;6552.0;5822.0;3610.0;3938.0;29693.0;29104.0;20
105;Groningen (PV);2023;586082;122308;345280;118494;500312;40261;16709;23552;45509;24943;20566;7694;4132;3562;5579;3405;2174;8235;3948;4287;5554;2164;3390;18447;11294;7153;6570.0;5905.0;3546.0;3883.0;29787.0;29194.0;20
106;Groningen (PV);2024;587062;122534;344001;120527;500294;40452;16813;23639;46316;25234;21082;7781;4150;3631;5653;3414;2239;8406;4030;4376;5745;2223;3522;18731;11417;7314;6609.0;5992.0;3546.0;3878.0;29421.0;29108.0;20
107;Groningen (PV);2025;587706;122881;342252;122573;500014;40541;16907;23634;47151;25614;21537;7840;4176;3664;5724;3421;2303;8541;4094;4447;5985;2303;3682;19061;11620;7441;;;;;;;20
108;Friesland (PV);2008;644163;157883;385973;100307;589394;30284;10952;19332;24485;14926;9559;3292;1688;1604;2243;1304;939;2334;1207;1127;2695;1305;1390;13921;9422;4499;7128.0;5874.0;2159.0;3106.0;26940.0;26581.0;21
109;Friesland (PV);2009;644931;156504;386058;102369;588992;30428;10948;19480;25511;15272;10239;3486;1792;1694;2363;1359;1004;2604;1339;1265;3012;1426;1586;14046;9356;4690;7097.0;5895.0;2251.0;3077.0;25923.0;26267.0;21
110;Friesland (PV);2010;645063;154677;385606;104780;587810;30684;11016;19668;26569;15719;10850;3693;1901;1792;2473;1439;1034;2911;1489;1422;3278;1537;1741;14214;9353;4861;7057.0;5970.0;2318.0;3015.0;26005.0;26339.0;21
111;Friesland (PV);2011;645213;152961;385327;106925;586715;30799;10983;19816;27699;16236;11463;3847;1985;1862;2619;1529;1090;3172;1576;1596;3507;1637;1870;14554;9509;5045;7036.0;6012.0;2432.0;3038.0;25433.0;26100.0;21
112;Friesland (PV);2012;645050;151133;382901;111016;585500;30885;10978;19907;28665;16647;12018;4023;2060;1963;2718;1607;1111;3427;1677;1750;3735;1731;2004;14762;9572;5190;6996.0;6028.0;2440.0;2951.0;25467.0;26102.0;21
113;Friesland (PV);2013;644955;149498;380768;114689;584174;31119;11053;20066;29662;17026;12636;4187;2156;2031;2819;1661;1158;3730;1792;1938;3956;1817;2139;14970;9600;5370;7038.0;6145.0;2403.0;2917.0;25451.0;26084.0;21
114;Friesland (PV);2014;644779;147966;379215;117598;582893;31329;11099;20230;30557;17382;13175;4313;2226;2087;2887;1695;1192;3958;1873;2085;4209;1929;2280;15190;9659;5531;7050.0;6129.0;2450.0;2888.0;25584.0;26146.0;21
115;Friesland (PV);2015;644781;146642;377987;120152;581581;31534;11139;20395;31666;17823;13843;4459;2321;2138;3061;1804;1257;4253;1975;2278;4469;2034;2435;15424;9689;5735;7060.0;6209.0;2408.0;2857.0;25413.0;26112.0;21
116;Friesland (PV);2016;644554;145412;376566;122576;580235;31762;11245;20517;32557;18171;14386;4610;2399;2211;3207;1894;1313;4469;2063;2406;4698;2124;2574;15573;9691;5882;7095.0;6252.0;2365.0;2865.0;25860.0;26346.0;21
117;Friesland (PV);2017;644496;144333;375232;124931;578935;31965;11286;20679;33596;18649;14947;4806;2502;2304;3325;1949;1376;4761;2197;2564;4924;2195;2729;15780;9806;5974;7123.0;6289.0;2412.0;2821.0;25424.0;26076.0;21
118;Friesland (PV);2018;644333;143383;373564;127386;577673;32091;11331;20760;34569;18985;15584;4960;2596;2364;3464;2029;1435;4978;2279;2699;5150;2248;2902;16017;9833;6184;7165.0;6363.0;2362.0;2797.0;26042.0;26473.0;21
119;Friesland (PV);2019;644341;142334;372114;129893;576496;32271;11407;20864;35574;19399;16175;5092;2654;2438;3615;2120;1495;5195;2350;2845;5413;2326;3087;16259;9949;6310;7241.0;6436.0;2366.0;2768.0;25778.0;26324.0;21
120;Friesland (PV);2020;644276;141216;370696;132364;575186;32450;11552;20898;36640;19833;16807;5232;2717;2515;3770;2201;1569;5417;2426;2991;5681;2405;3276;16540;10084;6456;7295.0;6536.0;2364.0;2731.0;25971.0;26437.0;21
121;Friesland (PV);2021;644269;140141;369229;134899;574031;32716;11630;21086;37522;20182;17340;5350;2770;2580;3928;2267;1661;5618;2512;3106;5879;2478;3401;16747;10155;6592;7361.0;6583.0;2348.0;2737.0;25969.0;26292.0;21
122;Friesland (PV);2022;644402;139465;367577;137360;573071;32889;11699;21190;38442;20528;17914;5464;2810;2654;4054;2336;1718;5850;2582;3268;6081;2556;3525;16993;10244;6749;7331.0;6700.0;2426.0;2735.0;25847.0;26165.0;21
123;Friesland (PV);2023;644482;138921;365923;139638;572044;32997;11787;21210;39441;20910;18531;5634;2893;2741;4188;2409;1779;6069;2672;3397;6305;2598;3707;17245;10338;6907;7355.0;6813.0;2353.0;2692.0;25786.0;26044.0;21
124;Friesland (PV);2024;644499;138506;363994;141999;571046;33083;11912;21171;40370;21301;19069;5788;2967;2821;4293;2457;1836;6311;2770;3541;6541;2685;3856;17437;10422;7015;7426.0;6870.0;2339.0;2686.0;25663.0;25857.0;21
125;Friesland (PV);2025;644584;138567;361578;144439;569955;33300;12036;21264;41329;21674;19655;5890;3025;2865;4426;2528;1898;6514;2828;3686;6789;2760;4029;17710;10533;7177;;;;;;;21
126;Drenthe (PV);2008;485770;116715;286666;82389;442182;26838;9854;16984;16750;9739;7011;2141;1041;1100;1310;728;582;2347;1228;1119;1815;864;951;9137;5878;3259;4852.0;4481.0;1546.0;2113.0;19515.0;18764.0;22
127;Drenthe (PV);2009;486393;115988;286060;84345;441676;26913;9782;17131;17804;10195;7609;2304;1130;1174;1400;780;620;2642;1353;1289;1993;924;1069;9465;6008;3457;4823.0;4565.0;1701.0;2108.0;19949.0;18920.0;22
128;Drenthe (PV);2010;487345;115463;285602;86280;441357;27088;9877;17211;18900;10631;8269;2488;1222;1266;1546;852;694;2890;1463;1427;2208;1005;1203;9768;6089;3679;4720.0;4627.0;1707.0;2102.0;19845.0;19119.0;22
129;Drenthe (PV);2011;487816;114325;285478;88013;440825;27094;9829;17265;19897;11079;8818;2655;1323;1332;1659;919;740;3123;1566;1557;2415;1059;1356;10045;6212;3833;4717.0;4651.0;1799.0;2069.0;19603.0;18931.0;22
130;Drenthe (PV);2012;488335;113290;283502;91543;440119;27266;9894;17372;20950;11521;9429;2854;1425;1429;1801;987;814;3329;1664;1665;2614;1149;1465;10352;6296;4056;4689.0;4765.0;1822.0;2063.0;19849.0;19047.0;22
131;Drenthe (PV);2013;488862;112376;281690;94796;439497;27398;9930;17468;21967;11960;10007;3030;1514;1516;1926;1058;868;3633;1783;1850;2833;1240;1593;10545;6365;4180;4693.0;4789.0;1861.0;2027.0;19773.0;19091.0;22
132;Drenthe (PV);2014;489327;111494;280146;97687;438865;27478;9941;17537;22984;12396;10588;3201;1625;1576;2065;1127;938;3864;1862;2002;3049;1327;1722;10805;6455;4350;4703.0;4842.0;1837.0;2027.0;19690.0;19145.0;22
133;Drenthe (PV);2015;489585;110553;278902;100130;438042;27636;9977;17659;23907;12819;11088;3351;1711;1640;2142;1170;972;4148;1967;2181;3214;1402;1812;11052;6569;4483;4734.0;4894.0;1797.0;1975.0;19907.0;19108.0;22
134;Drenthe (PV);2016;490100;109786;278033;102281;437472;27708;9945;17763;24920;13228;11692;3522;1818;1704;2248;1218;1030;4385;2064;2321;3360;1445;1915;11405;6683;4722;4746.0;4943.0;1831.0;1989.0;20112.0;19114.0;22
135;Drenthe (PV);2017;490789;109053;277306;104430;436971;27880;10075;17805;25938;13674;12264;3724;1915;1809;2361;1290;1071;4614;2148;2466;3527;1505;2022;11712;6816;4896;4775.0;5012.0;1796.0;1965.0;20068.0;19205.0;22
136;Drenthe (PV);2018;491302;108285;276215;106802;436521;27915;10111;17804;26866;14120;12746;3874;1992;1882;2443;1358;1085;4761;2209;2552;3717;1565;2152;12071;6996;5075;4837.0;5090.0;1823.0;1989.0;20199.0;19154.0;22
137;Drenthe (PV);2019;491976;107418;275486;109072;435996;28030;10171;17859;27950;14556;13394;4037;2058;1979;2565;1418;1147;5039;2306;2733;3904;1650;2254;12405;7124;5281;4842.0;5152.0;1813.0;1972.0;20060.0;19291.0;22
138;Drenthe (PV);2020;492324;106286;274647;111391;435224;28156;10269;17887;28944;14989;13955;4163;2119;2044;2678;1459;1219;5261;2405;2856;4089;1706;2383;12753;7300;5453;4862.0;5234.0;1782.0;1972.0;20650.0;19266.0;22
139;Drenthe (PV);2021;493205;105574;273971;113660;434968;28202;10374;17828;30035;15386;14649;4304;2179;2125;2815;1509;1306;5517;2501;3016;4274;1765;2509;13125;7432;5693;4967.0;5313.0;1800.0;1954.0;20356.0;19428.0;22
140;Drenthe (PV);2022;493678;104801;272965;115912;434368;28319;10519;17800;30991;15813;15178;4415;2238;2177;2943;1572;1371;5715;2573;3142;4435;1812;2623;13483;7618;5865;4977.0;5400.0;1822.0;1938.0;20512.0;19379.0;22
141;Drenthe (PV);2023;494322;104287;271834;118201;433740;28559;10665;17894;32023;16283;15740;4534;2297;2237;3075;1635;1440;5931;2670;3261;4649;1875;2774;13834;7806;6028;5062.0;5464.0;1793.0;1942.0;20306.0;19322.0;22
142;Drenthe (PV);2024;494800;103938;270359;120503;433131;28738;10776;17962;32931;16626;16305;4630;2348;2282;3177;1684;1493;6149;2740;3409;4836;1934;2902;14139;7920;6219;5048.0;5547.0;1814.0;1933.0;20709.0;19206.0;22
143;Drenthe (PV);2025;495731;104034;268957;122740;432916;28857;10891;17966;33958;17044;16914;4770;2437;2333;3286;1744;1542;6370;2822;3548;5040;1997;3043;14492;8044;6448;;;;;;;22
144;Overijssel (PV);2008;1118525;284696;669309;164520;961012;77414;27456;49958;80099;46226;33873;6070;3103;2967;4399;2569;1830;34092;17429;16663;5316;2434;2882;30222;20691;9531;13330.0;9623.0;5149.0;6416.0;34337.0;35141.0;23
145;Overijssel (PV);2009;1120321;283919;668393;168009;961124;77583;27632;49951;81614;46643;34971;6507;3350;3157;4583;2656;1927;33948;17304;16644;5797;2610;3187;30779;20723;10056;13099.0;9763.0;5319.0;6287.0;34209.0;34948.0;23
146;Overijssel (PV);2010;1122108;282810;667452;171846;961169;77789;27787;50002;83150;47103;36047;6887;3545;3342;4816;2777;2039;33786;17174;16612;6217;2736;3481;31444;20871;10573;12995.0;9901.0;5496.0;6256.0;34166.0;35215.0;23
147;Overijssel (PV);2011;1123539;281155;667421;174963;960763;77900;27878;50022;84876;47690;37186;7285;3745;3540;5040;2917;2123;33715;17111;16604;6730;2882;3848;32106;21035;11071;12832.0;10029.0;5642.0;6124.0;33447.0;34738.0;23
148;Overijssel (PV);2012;1124714;279426;663860;181428;959979;78210;28020;50190;86525;48212;38313;7690;3929;3761;5245;3025;2220;33578;16992;16586;7215;3009;4206;32797;21257;11540;12612.0;10167.0;5713.0;6021.0;34678.0;35252.0;23
149;Overijssel (PV);2013;1126402;278037;660913;187452;959640;78432;28257;50175;88330;48772;39558;8085;4127;3958;5462;3147;2315;33508;16858;16650;7732;3159;4573;33543;21481;12062;12536.0;10318.0;5682.0;5947.0;34290.0;35279.0;23
150;Overijssel (PV);2014;1127502;276192;658685;192625;958910;78628;28500;50128;89964;49402;40562;8467;4338;4129;5734;3294;2440;33329;16699;16630;8167;3296;4871;34267;21775;12492;12452.0;10396.0;5630.0;5800.0;33934.0;34854.0;23
151;Overijssel (PV);2015;1128589;274328;657279;196982;957934;78863;28789;50074;91792;50082;41710;8899;4551;4348;5945;3393;2552;33212;16607;16605;8636;3460;5176;35100;22071;13029;12416.0;10580.0;5673.0;5752.0;34323.0;35223.0;23
152;Overijssel (PV);2016;1129590;273091;655416;201083;956966;79110;29078;50032;93514;50782;42732;9232;4731;4501;6234;3545;2689;33078;16487;16591;9119;3598;5521;35851;22421;13430;12395.0;10736.0;5680.0;5675.0;34879.0;35592.0;23
153;Overijssel (PV);2017;1130676;271633;653924;205119;955943;79371;29315;50056;95362;51570;43792;9622;4911;4711;6499;3699;2800;33010;16385;16625;9547;3715;5832;36684;22860;13824;12368.0;10844.0;5522.0;5671.0;34831.0;35721.0;23
154;Overijssel (PV);2018;1131298;270139;651659;209500;954793;79534;29550;49984;96971;52342;44629;9939;5063;4876;6722;3827;2895;32838;16260;16578;9928;3844;6084;37544;23348;14196;12413.0;10965.0;5556.0;5563.0;35275.0;35688.0;23
155;Overijssel (PV);2019;1132454;268317;650490;213647;953834;79759;29872;49887;98861;53212;45649;10303;5267;5036;7005;3968;3037;32728;16239;16489;10398;4004;6394;38427;23734;14693;12436.0;11059.0;5609.0;5530.0;34885.0;35752.0;23
156;Overijssel (PV);2020;1133171;266183;649391;217597;952443;80152;30253;49899;100576;53999;46577;10679;5420;5259;7238;4110;3128;32576;16183;16393;10825;4142;6683;39258;24144;15114;12486.0;11208.0;5545.0;5516.0;35025.0;35917.0;23
157;Overijssel (PV);2021;1133724;263464;648391;221869;950989;80358;30531;49827;102377;54692;47685;11004;5566;5438;7492;4244;3248;32513;16075;16438;11335;4285;7050;40033;24522;15511;12533.0;11429.0;5541.0;5475.0;35239.0;35995.0;23
158;Overijssel (PV);2022;1134263;261351;646855;226057;949686;80578;30893;49685;103999;55376;48623;11316;5727;5589;7755;4394;3361;32369;15982;16387;11748;4389;7359;40811;24884;15927;12570.0;11527.0;5477.0;5439.0;34870.0;35773.0;23
159;Overijssel (PV);2023;1134582;259255;645057;230270;948096;80858;31135;49723;105628;56069;49559;11635;5859;5776;7955;4514;3441;32305;15905;16400;12133;4510;7623;41600;25281;16319;12607.0;11665.0;5413.0;5344.0;34873.0;35816.0;23
160;Overijssel (PV);2024;1134798;257216;642891;234691;946476;81014;31481;49533;107308;56834;50474;11921;6025;5896;8289;4670;3619;32135;15783;16352;12514;4641;7873;42449;25715;16734;12604.0;11849.0;5358.0;5335.0;34564.0;35712.0;23
161;Overijssel (PV);2025;1134569;255888;639762;238919;944581;81091;31655;49436;108897;57607;51290;12261;6229;6032;8560;4806;3754;32012;15697;16315;12817;4720;8097;43247;26155;17092;;;;;;;23
162;Flevoland (PV);2008;379386;111972;231297;36117;281434;31192;12347;18845;66760;36648;30112;23521;12287;11234;6081;3621;2460;6456;3182;3274;9935;4607;5328;20767;12951;7816;5287.0;2172.0;3102.0;3216.0;15795.0;14489.0;24
163;Flevoland (PV);2009;383741;112446;233198;38097;283657;31794;12600;19194;68290;36771;31519;23598;12138;11460;6071;3580;2491;6900;3302;3598;10440;4750;5690;21281;13001;8280;5292.0;2268.0;3314.0;3237.0;15644.0;14531.0;24
164;Flevoland (PV);2010;388002;112942;234790;40270;285426;32524;12874;19650;70052;37159;32893;23702;12025;11677;6120;3569;2551;7274;3417;3857;11009;4935;6074;21947;13213;8734;5254.0;2380.0;3498.0;3204.0;15837.0;14793.0;24
165;Flevoland (PV);2011;392247;113045;237087;42115;287215;33196;13181;20015;71836;37550;34286;23760;11919;11841;6226;3587;2639;7674;3540;4134;11557;5119;6438;22619;13385;9234;5262.0;2498.0;3577.0;3212.0;15897.0;14816.0;24
166;Flevoland (PV);2012;396489;113121;237988;45380;289064;33864;13493;20371;73561;37884;35677;23947;11932;12015;6295;3575;2720;8003;3623;4380;12064;5274;6790;23252;13480;9772;5206.0;2593.0;3761.0;3177.0;16084.0;14874.0;24
167;Flevoland (PV);2013;400933;113354;239155;48424;290867;34564;13849;20715;75502;38333;37169;24042;11890;12152;6388;3572;2816;8354;3727;4627;12625;5416;7209;24093;13728;10365;5226.0;2668.0;3723.0;3194.0;16595.0;14977.0;24
168;Flevoland (PV);2014;405682;113766;240695;51221;292999;35364;14219;21145;77319;38712;38607;24123;11837;12286;6460;3540;2920;8754;3864;4890;13101;5556;7545;24881;13915;10966;5282.0;2784.0;3787.0;3178.0;16039.0;15005.0;24
169;Flevoland (PV);2015;409857;113832;242095;53930;294763;36050;14587;21463;79044;39089;39955;24208;11794;12414;6569;3541;3028;9097;3970;5127;13615;5687;7928;25555;14097;11458;5309.0;2897.0;3797.0;3168.0;16228.0;14883.0;24
170;Flevoland (PV);2016;414278;114423;243323;56532;296630;36874;14963;21911;80774;39703;41071;24295;11768;12527;6652;3543;3109;9485;4120;5365;14025;5841;8184;26317;14431;11886;5329.0;2983.0;3835.0;3163.0;16573.0;15078.0;24
171;Flevoland (PV);2017;418828;115019;244651;59158;298626;37607;15313;22294;82595;40278;42317;24381;11765;12616;6784;3567;3217;9847;4236;5611;14502;5999;8503;27081;14711;12370;5407.0;3085.0;3884.0;3171.0;16405.0;15258.0;24
172;Flevoland (PV);2018;423046;115423;245525;62098;300299;38365;15683;22682;84382;40819;43563;24531;11807;12724;6922;3570;3352;10170;4342;5828;14951;6124;8827;27808;14976;12832;5459.0;3162.0;3909.0;3178.0;16151.0;15339.0;24
173;Flevoland (PV);2019;426929;115375;246525;65029;301778;39183;16066;23117;85968;41381;44587;24534;11787;12747;7051;3574;3477;10446;4432;6014;15348;6237;9111;28589;15351;13238;5529.0;3278.0;3941.0;3186.0;16525.0;15480.0;24
174;Flevoland (PV);2020;431019;115474;247593;67952;303582;39890;16405;23485;87547;41775;45772;24566;11745;12821;7157;3563;3594;10762;4552;6210;15772;6359;9413;29290;15556;13734;5584.0;3352.0;3984.0;3193.0;16457.0;15727.0;24
175;Flevoland (PV);2021;434814;115405;248533;70876;305167;40650;16783;23867;88997;42187;46810;24589;11687;12902;7252;3573;3679;11071;4624;6447;16066;6468;9598;30019;15835;14184;5681.0;3449.0;4000.0;3211.0;16486.0;15754.0;24
176;Flevoland (PV);2022;438613;115350;249372;73891;306758;41400;17102;24298;90455;42717;47738;24588;11681;12907;7340;3552;3788;11351;4708;6643;16384;6560;9824;30792;16216;14576;5800.0;3555.0;4053.0;3191.0;16527.0;15836.0;24
177;Flevoland (PV);2023;442444;115486;249983;76975;308298;42206;17514;24692;91940;43208;48732;24576;11630;12946;7457;3546;3911;11611;4817;6794;16660;6662;9998;31636;16553;15083;5883.0;3694.0;4122.0;3160.0;16952.0;16065.0;24
178;Flevoland (PV);2024;446516;116027;250481;80008;309919;43101;17902;25199;93496;43638;49858;24592;11575;13017;7589;3548;4041;11865;4871;6994;16927;6734;10193;32523;16910;15613;5976.0;3808.0;4132.0;3171.0;16691.0;15938.0;24
179;Flevoland (PV);2025;450436;116428;250950;83058;311277;43960;18350;25610;95199;44263;50936;24598;11513;13085;7755;3593;4162;12134;4955;7179;17240;6877;10363;33472;17325;16147;;;;;;;24
180;Gelderland (PV);2008;1974432;483515;1196858;294059;1697402;147733;52620;95113;129297;75257;54040;12430;6284;6146;8725;4869;3856;38464;20164;18300;20407;10111;10296;49271;33829;15442;20987.0;17029.0;8629.0;10871.0;74228.0;75017.0;25
181;Gelderland (PV);2009;1975649;478732;1196658;300259;1695351;147827;52760;95067;132471;76328;56143;13137;6654;6483;9049;5086;3963;38799;20137;18662;21104;10236;10868;50382;34215;16167;20829.0;17229.0;9108.0;10706.0;75140.0;75767.0;25
182;Gelderland (PV);2010;1977281;473889;1196218;307174;1693837;147863;52905;94958;135581;77350;58231;13803;6994;6809;9445;5324;4121;39041;20113;18928;21833;10413;11420;51459;34506;16953;20605.0;17439.0;9409.0;10521.0;76666.0;76481.0;25
183;Gelderland (PV);2011;1979766;468291;1198252;313223;1692612;148293;53154;95139;138861;78498;60363;14402;7294;7108;9865;5572;4293;39433;20197;19236;22572;10650;11922;52589;34785;17804;20484.0;17654.0;9615.0;10460.0;76029.0;76265.0;25
184;Gelderland (PV);2012;1981736;462689;1192336;326711;1691084;148459;53454;95005;142193;79776;62417;15098;7688;7410;10230;5791;4439;39800;20265;19535;23195;10822;12373;53870;35210;18660;20421.0;17926.0;9796.0;10284.0;75320.0;76510.0;25
185;Gelderland (PV);2013;1982774;457341;1186459;338974;1688770;148895;53939;94956;145109;80835;64274;15741;7995;7746;10605;6019;4586;40044;20241;19803;23825;11010;12815;54894;35570;19324;20334.0;18141.0;9817.0;10104.0;75253.0;76914.0;25
186;Gelderland (PV);2014;1983263;452187;1181840;349236;1685926;149097;54257;94840;148240;81944;66296;16376;8313;8063;11010;6271;4739;40278;20232;20046;24466;11189;13277;56110;35939;20171;20305.0;18351.0;9687.0;10017.0;75386.0;76604.0;25
187;Gelderland (PV);2015;1983889;447291;1178300;358298;1683391;149269;54358;94911;151229;83228;68001;16978;8657;8321;11338;6523;4815;40584;20304;20280;24966;11252;13714;57363;36492;20871;20401.0;18614.0;9570.0;9881.0;76378.0;77226.0;25
188;Gelderland (PV);2016;1984735;443160;1175030;366545;1680827;149541;54794;94747;154367;84252;70115;17531;8913;8618;11723;6759;4964;40954;20356;20598;25579;11366;14213;58580;36858;21722;20461.0;18897.0;9593.0;9766.0;76095.0;77281.0;25
189;Gelderland (PV);2017;1985149;439431;1170970;374748;1678161;149855;55224;94631;157133;85397;71736;18154;9226;8928;12171;7020;5151;41141;20384;20757;26081;11492;14589;59586;37275;22311;20592.0;19068.0;9533.0;9688.0;76690.0;77499.0;25
190;Gelderland (PV);2018;1985934;435851;1166403;383680;1675737;149973;55563;94410;160224;86576;73648;18728;9487;9241;12578;7250;5328;41316;20375;20941;26604;11628;14976;60998;37836;23162;20679.0;19404.0;9492.0;9616.0;75990.0;77242.0;25
191;Gelderland (PV);2019;1986072;431263;1163099;391710;1672762;150221;55986;94235;163089;87651;75438;19208;9723;9485;13033;7464;5569;41557;20416;21141;27099;11751;15348;62192;38297;23895;20738.0;19632.0;9419.0;9525.0;75971.0;77169.0;25
192;Gelderland (PV);2020;1986124;426919;1159257;399948;1669725;150343;56190;94153;166056;88973;77083;19729;9968;9761;13450;7692;5758;41739;20462;21277;27561;11868;15693;63577;38983;24594;20852.0;19939.0;9445.0;9461.0;76095.0;77203.0;25
193;Gelderland (PV);2021;1986125;422524;1155683;407918;1666668;150380;56477;93903;169077;90241;78836;20297;10250;10047;13923;7921;6002;41972;20536;21436;28022;11977;16045;64863;39557;25306;20904.0;20232.0;9306.0;9331.0;76518.0;77182.0;25
194;Gelderland (PV);2022;1986347;418889;1151237;416221;1663730;150738;56870;93868;171879;91538;80341;20726;10465;10261;14289;8106;6183;42238;20634;21604;28537;12114;16423;66089;40219;25870;20930.0;20407.0;9225.0;9264.0;76256.0;76854.0;25
195;Gelderland (PV);2023;1986448;415587;1146605;424256;1661064;150771;57263;93508;174613;92662;81951;21256;10704;10552;14736;8359;6377;42452;20658;21794;28957;12222;16735;67212;40719;26493;20940.0;20738.0;9200.0;9168.0;76089.0;76623.0;25
196;Gelderland (PV);2024;1986339;412596;1141194;432549;1657967;150906;57666;93240;177466;93806;83660;21671;10893;10778;15125;8570;6555;42782;20722;22060;29321;12339;16982;68567;41282;27285;20920.0;21070.0;9164.0;9085.0;75747.0;76477.0;25
197;Gelderland (PV);2025;1985754;410921;1133789;441044;1654525;151057;58123;92934;180172;94861;85311;22042;11058;10984;15497;8759;6738;43064;20768;22296;29788;12466;17322;69781;41810;27971;;;;;;;25
198;Utrecht (PV);2008;1195923;296476;742843;156604;962147;98077;37146;60931;135699;75307;60392;18572;9806;8766;8029;4329;3700;25698;13295;12403;44486;22476;22010;38914;25401;13513;14653.0;9075.0;7361.0;8233.0;56287.0;54206.0;26
199;Utrecht (PV);2009;1202917;296490;745834;160593;965711;99071;37658;61413;138135;75969;62166;18849;9904;8945;8317;4506;3811;26145;13332;12813;44733;22192;22541;40091;26035;14056;14588.0;9219.0;7703.0;8119.0;57124.0;54814.0;26
200;Utrecht (PV);2010;1210361;296356;748924;165081;969726;100262;38211;62051;140373;76427;63946;19117;9994;9123;8576;4674;3902;26466;13327;13139;45078;21981;23097;41136;26451;14685;14520.0;9419.0;8080.0;8172.0;56982.0;54955.0;26
201;Utrecht (PV);2011;1217561;295958;753210;168393;973359;101493;38904;62589;142709;76960;65749;19415;10079;9336;8881;4902;3979;26832;13367;13465;45356;21760;23596;42225;26852;15373;14514.0;9483.0;8297.0;8085.0;57582.0;55303.0;26
202;Utrecht (PV);2012;1225236;295423;752739;177074;977259;102845;39659;63186;145132;77657;67475;19696;10181;9515;9173;5140;4033;27193;13385;13808;45703;21608;24095;43367;27343;16024;14455.0;9649.0;8353.0;8076.0;57682.0;55415.0;26
203;Utrecht (PV);2013;1232751;295052;752953;184746;981116;104183;40341;63842;147452;78186;69266;19954;10295;9659;9509;5332;4177;27467;13411;14056;45985;21405;24580;44537;27743;16794;14518.0;9787.0;8458.0;8062.0;57857.0;55513.0;26
204;Utrecht (PV);2014;1240387;294984;753805;191598;985092;105536;41176;64360;149759;78820;70939;20157;10374;9783;9836;5548;4288;27800;13450;14350;46290;21264;25026;45676;28184;17492;14585.0;9957.0;8466.0;7996.0;58172.0;55529.0;26
205;Utrecht (PV);2015;1248272;295099;755394;197779;989212;106903;42037;64866;152157;79411;72746;20426;10466;9960;10098;5714;4384;28155;13502;14653;46520;21097;25423;46958;28632;18326;14618.0;10114.0;8519.0;8029.0;57700.0;55562.0;26
206;Utrecht (PV);2016;1255542;295145;756628;203769;993058;108084;42692;65392;154400;80081;74319;20672;10579;10093;10385;5879;4506;28443;13583;14860;46717;20924;25793;48183;29116;19067;14594.0;10267.0;8506.0;7924.0;57383.0;55763.0;26
207;Utrecht (PV);2017;1262213;295035;757798;209380;996423;109296;43392;65904;156494;80753;75741;20895;10677;10218;10611;6048;4563;28637;13592;15045;46919;20826;26093;49432;29610;19822;14668.0;10469.0;8595.0;7916.0;57752.0;55912.0;26
208;Utrecht (PV);2018;1269106;295013;759123;214970;999667;110547;44080;66467;158892;81491;77401;21139;10768;10371;11001;6266;4735;29032;13682;15350;47039;20704;26335;50681;30071;20610;14782.0;10701.0;8568.0;7910.0;58148.0;55798.0;26
209;Utrecht (PV);2019;1276329;294776;760829;220724;1003387;112036;44893;67143;160906;81983;78923;21397;10828;10569;11324;6464;4860;29318;13725;15593;47174;20629;26545;51693;30337;21356;14806.0;10834.0;8571.0;7923.0;58340.0;56219.0;26
210;Utrecht (PV);2020;1283219;294266;762548;226405;1006842;113403;45613;67790;162974;82687;80287;21644;10913;10731;11670;6680;4990;29541;13753;15788;47154;20498;26656;52965;30843;22122;14811.0;11071.0;8592.0;7845.0;58690.0;56674.0;26
211;Utrecht (PV);2021;1289860;293188;764961;231711;1009831;114969;46541;68428;165060;83524;81536;21917;11027;10890;11996;6901;5095;29821;13817;16004;47100;20394;26706;54226;31385;22841;14892.0;11228.0;8573.0;7908.0;59103.0;57110.0;26
212;Utrecht (PV);2022;1296316;292413;766268;237635;1012796;116329;47313;69016;167191;84164;83027;22198;11089;11109;12323;7096;5227;30074;13834;16240;47097;20297;26800;55499;31848;23651;14957.0;11427.0;8678.0;7880.0;59361.0;57486.0;26
213;Utrecht (PV);2023;1302667;291466;767589;243612;1015590;117545;47980;69565;169532;85091;84441;22459;11191;11268;12733;7327;5406;30272;13854;16418;47129;20232;26897;56939;32487;24452;14973.0;11644.0;8651.0;7771.0;60074.0;57832.0;26
214;Utrecht (PV);2024;1309268;290568;768955;249745;1018732;118948;48796;70152;171588;85979;85609;22669;11277;11392;13043;7492;5551;30582;13902;16680;47035;20132;26903;58259;33176;25083;14924.0;11930.0;8639.0;7798.0;60918.0;58010.0;26
215;Utrecht (PV);2025;1316171;290607;769493;256071;1021986;120508;49784;70724;173677;86695;86982;22889;11345;11544;13346;7640;5706;30823;13877;16946;46964;20048;26916;59655;33785;25870;;;;;;;26
216;Noord-Holland (PV);2008;2627137;611881;1643531;371725;1926713;280257;129042;151215;420167;242598;177569;96476;54003;42473;23113;13313;9800;74149;39821;34328;88905;45530;43375;137524;89931;47593;29819.0;21522.0;26462.0;27120.0;108595.0;105489.0;27
217;Noord-Holland (PV);2009;2638226;611573;1646505;380148;1930442;284394;131825;152569;423390;241562;181828;95939;53054;42885;23518;13538;9980;74776;39672;35104;89655;45009;44646;139502;90289;49213;29592.0;21822.0;27701.0;26990.0;109595.0;106715.0;27
218;Noord-Holland (PV);2010;2649920;611398;1648476;390046;1934233;288858;135143;153715;426829;240911;185918;95391;52228;43163;23986;13828;10158;75498;39527;35971;90352;44596;45756;141602;90732;50870;29433.0;22044.0;28751.0;26813.0;109407.0;107267.0;27
219;Noord-Holland (PV);2011;2661704;609556;1655135;397013;1937515;293856;138730;155126;430333;240439;189894;95238;51663;43575;24456;14100;10356;76083;39384;36699;91068;44205;46863;143488;91087;52401;29204.0;22395.0;29472.0;26519.0;109602.0;108169.0;27
220;Noord-Holland (PV);2012;2673196;607613;1649400;416183;1940219;298942;142388;156554;434035;240076;193959;94935;51071;43864;25076;14472;10604;76717;39214;37503;91985;44017;47968;145322;91302;54020;29112.0;22607.0;29640.0;26441.0;110066.0;108208.0;27
221;Noord-Holland (PV);2013;2685070;605870;1645697;433503;1943565;303886;146019;157867;437619;239716;197903;94741;50524;44217;25646;14798;10848;77366;39140;38226;92742;43773;48969;147124;91481;55643;29003.0;22933.0;29872.0;26228.0;110315.0;108474.0;27
222;Noord-Holland (PV);2014;2696908;604578;1644584;447746;1946942;308846;149571;159275;441120;239466;201654;94606;50059;44547;26159;15085;11074;77992;39134;38858;93399;43436;49963;148964;91752;57212;29008.0;23226.0;29835.0;26037.0;109447.0;108161.0;27
223;Noord-Holland (PV);2015;2708076;603354;1644349;460373;1949521;313833;153050;160783;444722;239243;205479;94490;49607;44883;26711;15378;11333;78639;39066;39573;94108;43219;50889;150774;91973;58801;29066.0;23517.0;29867.0;25857.0;108204.0;107635.0;27
224;Noord-Holland (PV);2016;2718480;602277;1643956;472247;1952093;318680;156379;162301;447707;238807;208900;94279;49128;45151;27205;15652;11553;79146;38919;40227;94686;43008;51678;152391;92100;60291;29238.0;23879.0;29739.0;25692.0;109082.0;108455.0;27
225;Noord-Holland (PV);2017;2728785;601516;1644388;482881;1954444;323250;159569;163681;451091;238544;212547;94071;48712;45359;27770;15902;11868;79812;38870;40942;95135;42731;52404;154303;92329;61974;29380.0;24210.0;29923.0;25539.0;108800.0;108203.0;27
226;Noord-Holland (PV);2018;2739212;600459;1644616;494137;1956645;328317;162836;165481;454250;238443;215807;93739;48253;45486;28278;16159;12119;80379;38872;41507;95647;42562;53085;156207;92597;63610;29539.0;24456.0;29853.0;25526.0;108922.0;108517.0;27
227;Noord-Holland (PV);2019;2749324;598801;1645681;504842;1958882;333014;165969;167045;457428;238387;219041;93461;47809;45652;28790;16420;12370;81034;38850;42184;96035;42350;53685;158108;92958;65150;29816.0;24815.0;29797.0;25334.0;109380.0;109085.0;27
228;Noord-Holland (PV);2020;2759372;597095;1646859;515418;1960952;337791;169034;168757;460629;238486;222143;93097;47331;45766;29406;16761;12645;81682;38843;42839;96383;42160;54223;160061;93391;66670;30082.0;25213.0;29899.0;25228.0;109254.0;109228.0;27
229;Noord-Holland (PV);2021;2769225;594775;1648578;525872;1963221;342512;172294;170218;463492;238446;225046;92770;46857;45913;29866;16999;12867;82153;38788;43365;96661;42007;54654;162042;93795;68247;30199.0;25571.0;29968.0;25087.0;109367.0;109665.0;27
230;Noord-Holland (PV);2022;2778722;592476;1649423;536823;1964842;347191;175360;171831;466689;238624;228065;92558;46385;46173;30462;17271;13191;82493;38701;43792;96942;41856;55086;164234;94411;69823;30419.0;26029.0;29735.0;24902.0;109717.0;109942.0;27
231;Noord-Holland (PV);2023;2787990;590877;1649372;547741;1966323;352080;178591;173489;469587;238720;230867;92216;45920;46296;31016;17513;13503;83073;38702;44371;97024;41635;55389;166258;94950;71308;30493.0;26393.0;29849.0;24813.0;110810.0;111083.0;27
232;Noord-Holland (PV);2024;2797129;588996;1649473;558660;1967598;356816;181609;175207;472715;238952;233763;92045;45535;46510;31612;17770;13842;83515;38651;44864;97170;41462;55708;168373;95534;72839;30821.0;26871.0;29640.0;24614.0;109690.0;110750.0;27
233;Noord-Holland (PV);2025;2805352;587904;1646840;570608;1968245;361364;184442;176922;475743;239066;236677;91781;45018;46763;32178;17988;14190;83929;38655;45274;97279;41249;56030;170576;96156;74420;;;;;;;27
234;Zuid-Holland (PV);2008;3459224;831637;2127178;500409;2550809;321819;149122;172697;586596;339916;246680;138801;79169;59632;51382;32782;18600;119215;62122;57093;102079;51203;50876;175119;114640;60479;39492.0;29852.0;30648.0;35049.0;137232.0;139613.0;28
235;Zuid-Holland (PV);2009;3462578;827535;2125732;509311;2548652;325850;151602;174248;588076;335794;252282;137899;77823;60076;51081;32086;18995;119709;61416;58293;103565;51021;52544;175822;113448;62374;39206.0;30071.0;31946.0;34452.0;137331.0;139440.0;28
236;Zuid-Holland (PV);2010;3467483;823329;2123839;520315;2546910;330303;154472;175831;590270;332596;257674;137030;76653;60377;51180;31735;19445;120214;60821;59393;104980;50843;54137;176866;112544;64322;38849.0;30385.0;33044.0;33992.0;136132.0;137860.0;28
237;Zuid-Holland (PV);2011;3473665;817774;2129032;526859;2545763;335190;157673;177517;592712;329678;263034;136172;75599;60573;51433;31523;19910;120702;60278;60424;106464;50750;55714;177941;111528;66413;38643.0;30692.0;33526.0;33458.0;135877.0;137658.0;28
238;Zuid-Holland (PV);2012;3480268;812249;2115662;552357;2544854;340104;160929;179175;595310;326957;268353;135357;74587;60770;51633;31272;20361;121169;59768;61401;107845;50635;57210;179306;110695;68611;38525.0;30953.0;33856.0;32923.0;133986.0;135735.0;28
239;Zuid-Holland (PV);2013;3487387;807497;2106180;573710;2544160;345466;164296;181170;597761;324875;272886;134550;73690;60860;51934;31190;20744;121619;59390;62229;108988;50536;58452;180670;110069;70601;38375.0;31211.0;33899.0;32603.0;131983.0;134287.0;28
240;Zuid-Holland (PV);2014;3493899;803211;2099104;591584;2543060;350895;167604;183291;599944;322725;277219;133729;72767;60962;52178;31030;21148;121925;59037;62888;110080;50437;59643;182032;109454;72578;38451.0;31571.0;33903.0;32229.0;131709.0;133883.0;28
241;Zuid-Holland (PV);2015;3500638;799123;2094897;606618;2542597;356121;170885;185236;601920;320647;281273;132780;71824;60956;52484;30891;21593;122142;58640;63502;111121;50403;60718;183393;108889;74504;38436.0;31866.0;33796.0;31776.0;130537.0;132678.0;28
242;Zuid-Holland (PV);2016;3507455;796587;2090292;620576;2541824;361558;174189;187369;604073;318928;285145;131884;70969;60915;52772;30798;21974;122374;58298;64076;112181;50394;61787;184862;108469;76393;38651.0;32215.0;33666.0;31548.0;131622.0;133232.0;28
243;Zuid-Holland (PV);2017;3514730;794601;2086319;633810;2541315;367027;177461;189566;606388;317465;288923;130994;70094;60900;53057;30641;22416;122529;57970;64559;113098;50397;62701;186710;108363;78347;38785.0;32552.0;33545.0;31219.0;130515.0;132723.0;28
244;Zuid-Holland (PV);2018;3521426;792201;2081545;647680;2540282;372747;180816;191931;608397;316039;292358;130131;69235;60896;53285;30503;22782;122741;57694;65047;113858;50353;63505;188382;108254;80128;38910.0;32847.0;33472.0;30964.0;130448.0;133175.0;28
245;Zuid-Holland (PV);2019;3527650;788863;2077887;660900;2539123;378028;183961;194067;610499;314957;295542;129302;68427;60875;53472;30377;23095;122810;57430;65380;114626;50299;64327;190289;108424;81865;39215.0;33316.0;33436.0;30714.0;130652.0;132789.0;28
246;Zuid-Holland (PV);2020;3534468;785772;2074484;674212;2538232;383499;187246;196253;612737;313866;298871;128538;67672;60866;53730;30281;23449;122952;57160;65792;115201;50221;64980;192316;108532;83784;39403.0;33646.0;33264.0;30414.0;130426.0;132898.0;28
247;Zuid-Holland (PV);2021;3540941;781880;2071432;687629;2536795;389074;190347;198727;615072;313221;301851;127724;66908;60816;54121;30287;23834;123074;56981;66093;115880;50152;65728;194273;108893;85380;39484.0;34184.0;33332.0;30105.0;131690.0;134413.0;28
248;Zuid-Holland (PV);2022;3547089;778663;2067555;700871;2535094;394750;193612;201138;617245;312474;304771;126830;66183;60647;54435;30249;24186;123302;56803;66499;116364;50038;66326;196314;109201;87113;39686.0;34574.0;33270.0;29814.0;131332.0;134177.0;28
249;Zuid-Holland (PV);2023;3553161;775751;2062983;714427;2533185;400432;196849;203583;619544;311781;307763;126048;65470;60578;54675;30178;24497;123535;56578;66957;116788;50005;66783;198498;109550;88948;39767.0;35072.0;33120.0;29615.0;131952.0;134741.0;28
250;Zuid-Holland (PV);2024;3558927;773095;2057968;727864;2530914;406206;200185;206021;621807;311279;310528;125202;64697;60505;55060;30238;24822;123612;56432;67180;117209;49914;67295;200724;109998;90726;39781.0;35567.0;33151.0;29368.0;131737.0;135104.0;28
251;Zuid-Holland (PV);2025;3563931;771557;2050627;741747;2527934;412030;203513;208517;623967;310819;313148;124392;63961;60431;55308;30131;25177;123638;56246;67392;117564;49881;67683;203065;110600;92465;;;;;;;28
252;Zeeland (PV);2008;381399;90692;223755;66952;322087;39896;18265;21631;19416;10995;8421;2793;1414;1379;1898;1043;855;3678;1824;1854;2526;1195;1331;8521;5519;3002;4054.0;3678.0;2103.0;2167.0;14028.0;13644.0;29
253;Zeeland (PV);2009;382139;90532;223270;68337;321589;40236;18404;21832;20314;11336;8978;2922;1468;1454;1952;1070;882;3857;1898;1959;2714;1262;1452;8869;5638;3231;4030.0;3699.0;2205.0;2180.0;14224.0;13904.0;29
254;Zeeland (PV);2010;382863;90218;222664;69981;320978;40612;18596;22016;21273;11718;9555;3099;1571;1528;2025;1091;934;4069;1985;2084;2872;1309;1563;9208;5762;3446;4028.0;3740.0;2276.0;2160.0;14303.0;14029.0;29
255;Zeeland (PV);2011;383573;89545;222648;71380;320415;40975;18782;22193;22183;12029;10154;3213;1633;1580;2108;1135;973;4253;2032;2221;3045;1366;1679;9564;5863;3701;3984.0;3749.0;2349.0;2166.0;14714.0;14137.0;29
256;Zeeland (PV);2012;384612;88892;221402;74318;320119;41432;19030;22402;23061;12360;10701;3364;1710;1654;2178;1165;1013;4475;2143;2332;3251;1439;1812;9793;5903;3890;4009.0;3809.0;2382.0;2111.0;14360.0;14255.0;29
257;Zeeland (PV);2013;385224;88282;219937;77005;319330;41862;19273;22589;24032;12747;11285;3492;1794;1698;2275;1219;1056;4634;2196;2438;3447;1496;1951;10184;6042;4142;4040.0;3818.0;2392.0;2109.0;14492.0;14168.0;29
258;Zeeland (PV);2014;386094;87820;219107;79167;318991;42255;19501;22754;24848;13041;11807;3612;1844;1768;2372;1261;1111;4827;2256;2571;3628;1574;2054;10409;6106;4303;4022.0;3859.0;2407.0;2075.0;14635.0;14271.0;29
259;Zeeland (PV);2015;386989;87283;218599;81107;318561;42696;19769;22927;25732;13409;12323;3729;1899;1830;2449;1299;1150;4937;2292;2645;3823;1645;2178;10794;6274;4520;4067.0;3921.0;2372.0;2054.0;14773.0;14325.0;29
260;Zeeland (PV);2016;387948;87026;218031;82891;318166;43170;20009;23161;26612;13750;12862;3842;1960;1882;2528;1322;1206;5132;2356;2776;3997;1709;2288;11113;6403;4710;4083.0;3946.0;2368.0;2061.0;14711.0;14344.0;29
261;Zeeland (PV);2017;388799;86690;217694;84415;317744;43596;20177;23419;27459;14180;13279;3918;1995;1923;2595;1356;1239;5303;2455;2848;4189;1789;2400;11454;6585;4869;4099.0;3982.0;2385.0;2073.0;14759.0;14399.0;29
262;Zeeland (PV);2018;389621;86350;217324;85947;317310;44007;20340;23667;28304;14504;13800;3982;2031;1951;2704;1400;1304;5533;2557;2976;4343;1824;2519;11742;6692;5050;4141.0;4008.0;2344.0;2030.0;14873.0;14464.0;29
263;Zeeland (PV);2019;390509;85943;216961;87605;316983;44396;20543;23853;29130;14831;14299;4110;2088;2022;2797;1452;1345;5641;2599;3042;4504;1880;2624;12078;6812;5266;4178.0;4072.0;2390.0;2048.0;14389.0;14433.0;29
264;Zeeland (PV);2020;390949;85548;216213;89188;316368;44722;20716;24006;29859;15133;14726;4217;2151;2066;2879;1467;1412;5780;2666;3114;4700;1939;2761;12283;6910;5373;4187.0;4104.0;2375.0;2020.0;14580.0;14486.0;29
265;Zeeland (PV);2021;391523;85243;215536;90744;315854;45026;20893;24133;30643;15423;15220;4322;2198;2124;2969;1507;1462;5987;2742;3245;4844;1977;2867;12521;6999;5522;4195.0;4152.0;2340.0;2005.0;14872.0;14570.0;29
266;Zeeland (PV);2022;392224;84982;214975;92267;315407;45308;21025;24283;31509;15783;15726;4444;2258;2186;3043;1552;1491;6145;2800;3345;4980;2014;2966;12897;7159;5738;4229.0;4225.0;2282.0;1981.0;14706.0;14557.0;29
267;Zeeland (PV);2023;392717;84802;214161;93754;314809;45638;21209;24429;32270;16117;16153;4504;2290;2214;3143;1595;1548;6286;2838;3448;5147;2078;3069;13190;7316;5874;4270.0;4282.0;2303.0;1998.0;14660.0;14490.0;29
268;Zeeland (PV);2024;393218;84712;213388;95118;314287;45940;21335;24605;32991;16417;16574;4583;2333;2250;3204;1610;1594;6393;2883;3510;5289;2112;3177;13522;7479;6043;4280.0;4356.0;2318.0;1967.0;14876.0;14497.0;29
269;Zeeland (PV);2025;393903;84793;212576;96534;313824;46282;21490;24792;33797;16790;17007;4661;2378;2283;3324;1700;1624;6545;2927;3618;5421;2159;3262;13846;7626;6220;;;;;;;29
270;Noord-Brabant (PV);2008;2417378;578534;1479650;359194;2043957;189128;72181;116947;184293;105344;78949;20343;10775;9568;14690;8550;6140;48582;25267;23315;38361;18552;19809;62317;42200;20117;24532.0;19953.0;13939.0;16451.0;76191.0;78511.0;30
271;Noord-Brabant (PV);2009;2417471;574791;1474022;368658;2039252;189898;72888;117010;188321;106940;81381;21020;11092;9928;15020;8694;6326;49049;25395;23654;39165;18745;20420;64067;43014;21053;24281.0;20406.0;14695.0;16237.0;78181.0;80340.0;30
272;Noord-Brabant (PV);2010;2417980;570261;1469389;378330;2034525;190796;73799;116997;192659;108640;84019;21692;11411;10281;15331;8865;6466;49519;25479;24040;40121;19020;21101;65996;43865;22131;24124.0;20815.0;15234.0;16055.0;78998.0;80970.0;30
273;Noord-Brabant (PV);2011;2418803;564583;1465769;388451;2029956;191917;74856;117061;196930;110139;86791;22407;11746;10661;15774;9077;6697;49943;25509;24434;40989;19253;21736;67817;44554;23263;23882.0;21229.0;15674.0;15865.0;81591.0;82972.0;30
274;Noord-Brabant (PV);2012;2420177;559388;1457680;403109;2025528;193511;76019;117492;201138;111641;89497;23140;12085;11055;16200;9312;6888;50453;25687;24766;41850;19438;22412;69495;45119;24376;23758.0;21609.0;15827.0;15687.0;81641.0;82834.0;30
275;Noord-Brabant (PV);2013;2421570;553887;1450101;417582;2021440;194826;77058;117768;205304;113127;92177;23894;12443;11451;16650;9551;7099;50868;25813;25055;42675;19642;23033;71217;45678;25539;23707.0;21977.0;15875.0;15407.0;82778.0;83499.0;30
276;Noord-Brabant (PV);2014;2423330;548941;1443428;430961;2017534;196120;78229;117891;209676;114844;94832;24672;12839;11833;17028;9741;7287;51355;25952;25403;43445;19841;23604;73176;46471;26705;23715.0;22376.0;15736.0;15202.0;83372.0;84026.0;30
277;Noord-Brabant (PV);2015;2424827;543965;1437710;443152;2013605;197546;79372;118174;213676;116427;97249;25430;13172;12258;17512;10016;7496;51671;26002;25669;44187;20036;24151;74876;47201;27675;23834.0;22732.0;15748.0;15040.0;83954.0;84137.0;30
278;Noord-Brabant (PV);2016;2426741;540332;1432487;453922;2009842;198860;80449;118411;218039;118128;99911;26153;13511;12642;17971;10224;7747;52090;26089;26001;44864;20195;24669;76961;48109;28852;23960.0;23125.0;15849.0;14918.0;83450.0;84199.0;30
279;Noord-Brabant (PV);2017;2428056;536477;1427996;463583;2005514;200377;81535;118842;222165;119742;102423;26721;13770;12951;18405;10469;7936;52512;26236;26276;45581;20363;25218;78946;48904;30042;24124.0;23469.0;15740.0;14846.0;84389.0;84364.0;30
280;Noord-Brabant (PV);2018;2429905;532946;1423491;473468;2001816;201709;82701;119008;226380;121528;104852;27393;14064;13329;18832;10715;8117;52965;26368;26597;46259;20521;25738;80931;49860;31071;24306.0;23800.0;15718.0;14729.0;84688.0;84828.0;30
281;Noord-Brabant (PV);2019;2431558;528941;1420286;482331;1997778;203157;83799;119358;230623;123306;107317;28032;14391;13641;19276;10967;8309;53349;26425;26924;46770;20627;26143;83196;50896;32300;24471.0;24117.0;15559.0;14589.0;84981.0;84582.0;30
282;Noord-Brabant (PV);2020;2433532;524839;1417147;491546;1994355;204728;85061;119667;234449;124941;109508;28633;14698;13935;19700;11160;8540;53718;26512;27206;47332;20802;26530;85066;51769;33297;24670.0;24504.0;15458.0;14534.0;86251.0;85365.0;30
283;Noord-Brabant (PV);2021;2435779;520319;1414957;500503;1991209;206108;86152;119956;238462;126625;111837;29214;14996;14218;20047;11311;8736;53993;26555;27438;47952;21022;26930;87256;52741;34515;24951.0;24820.0;15378.0;14404.0;86567.0;85531.0;30
284;Noord-Brabant (PV);2022;2438184;517162;1411586;509436;1988160;207493;87300;120193;242531;128340;114191;29862;15304;14558;20468;11513;8955;54381;26681;27700;48521;21255;27266;89299;53587;35712;25090.0;25243.0;15354.0;14304.0;86654.0;85926.0;30
285;Noord-Brabant (PV);2023;2440095;514318;1407143;518634;1984550;208985;88392;120593;246560;130237;116323;30406;15558;14848;20928;11724;9204;54645;26820;27825;49088;21434;27654;91493;54701;36792;25258.0;25673.0;15381.0;14278.0;85564.0;85339.0;30
286;Noord-Brabant (PV);2024;2441305;512337;1401216;527752;1980457;210294;89496;120798;250554;131975;118579;30922;15775;15147;21369;11948;9421;55010;26923;28087;49729;21612;28117;93524;55717;37807;25315.0;25929.0;15419.0;14096.0;86494.0;85702.0;30
287;Noord-Brabant (PV);2025;2443103;511488;1394405;537210;1976660;211833;90736;121097;254610;133816;120794;31447;16016;15431;21865;12183;9682;55466;27053;28413;50209;21712;28497;95623;56852;38771;;;;;;;30
288;Limburg (PV);2008;1122008;245577;685731;190700;901741;157526;56207;101319;62741;36916;25825;3979;2039;1940;3836;2293;1543;12838;6812;6026;16779;8497;8282;25309;17275;8034;9444.0;10767.0;7322.0;8996.0;39889.0;41668.0;31
289;Limburg (PV);2009;1117369;242148;681188;194033;897290;155412;55749;99663;64667;37663;27004;4446;2320;2126;4046;2422;1624;13201;6908;6293;16961;8481;8480;26013;17532;8481;9325.0;10952.0;7516.0;8862.0;40316.0;42178.0;31
290;Limburg (PV);2010;1112652;238566;676760;197326;892945;153298;55251;98047;66409;38309;28100;4902;2590;2312;4270;2541;1729;13556;7013;6543;17093;8492;8601;26588;17673;8915;9293.0;11032.0;7704.0;8562.0;41078.0;42943.0;31
291;Limburg (PV);2011;1108311;234536;672504;201271;888642;151506;55096;96410;68163;38926;29237;5332;2824;2508;4434;2646;1788;13942;7124;6818;17242;8455;8787;27213;17877;9336;9270.0;11224.0;7756.0;8445.0;41344.0;42817.0;31
292;Limburg (PV);2012;1104309;230783;666495;207031;884567;149768;54985;94783;69974;39492;30482;5760;3066;2694;4621;2737;1884;14350;7226;7124;17349;8386;8963;27894;18077;9817;9310.0;11304.0;7838.0;8297.0;41332.0;42878.0;31
293;Limburg (PV);2013;1100428;227591;660133;212704;880584;148150;54957;93193;71694;40056;31638;6176;3310;2866;4813;2830;1983;14720;7336;7384;17499;8352;9147;28486;18228;10258;9362.0;11477.0;7724.0;8053.0;41576.0;42868.0;31
294;Limburg (PV);2014;1096810;224653;654576;217581;876670;146580;54835;91745;73560;40747;32813;6573;3507;3066;5053;2997;2056;15148;7450;7698;17690;8380;9310;29096;18413;10683;9404.0;11635.0;7675.0;7899.0;41729.0;42987.0;31
295;Limburg (PV);2015;1093217;221647;649053;222517;872841;144987;54653;90334;75389;41461;33928;6924;3705;3219;5313;3126;2187;15454;7566;7888;17861;8379;9482;29837;18685;11152;9488.0;11715.0;7543.0;7781.0;41522.0;42823.0;31
296;Limburg (PV);2016;1089573;219332;643354;226887;869059;143411;54477;88934;77103;42291;34812;7317;3904;3413;5529;3271;2258;15782;7717;8065;17894;8379;9515;30581;19020;11561;9556.0;11866.0;7412.0;7654.0;41831.0;42575.0;31
297;Limburg (PV);2017;1086409;217430;638040;230939;865949;141835;54424;87411;78625;42748;35877;7691;4095;3596;5748;3393;2355;16074;7798;8276;18002;8356;9646;31110;19106;12004;9631.0;11969.0;7202.0;7525.0;41567.0;42496.0;31
298;Limburg (PV);2018;1082936;215632;632049;235255;862483;140266;54303;85963;80187;43407;36780;8087;4307;3780;5954;3513;2441;16321;7861;8460;18162;8412;9750;31663;19314;12349;9785.0;12087.0;7150.0;7395.0;41697.0;42329.0;31
299;Limburg (PV);2019;1079840;213625;627038;239177;859293;138882;54176;84706;81665;44017;37648;8409;4470;3939;6218;3637;2581;16576;7969;8607;18271;8457;9814;32191;19484;12707;9850.0;12231.0;7064.0;7274.0;41482.0;42212.0;31
300;Limburg (PV);2020;1076637;211811;622142;242684;855900;137362;54037;83325;83375;44751;38624;8738;4647;4091;6438;3753;2685;16914;8078;8836;18408;8472;9936;32877;19801;13076;9926.0;12290.0;6931.0;7128.0;41388.0;42158.0;31
301;Limburg (PV);2021;1073433;209659;617515;246259;852379;136097;53861;82236;84957;45441;39516;9060;4824;4236;6638;3851;2787;17216;8193;9023;18450;8436;10014;33593;20137;13456;9941.0;12348.0;6835.0;7071.0;41128.0;41982.0;31
302;Limburg (PV);2022;1070062;207986;612090;249986;848960;134794;53732;81062;86308;45992;40316;9327;4968;4359;6923;3989;2934;17417;8258;9159;18494;8419;10075;34147;20358;13789;9981.0;12570.0;6734.0;6986.0;41482.0;41758.0;31
303;Limburg (PV);2023;1067058;206908;606669;253481;845560;133662;53732;79930;87836;46548;41288;9599;5095;4504;7116;4087;3029;17621;8339;9282;18668;8438;10230;34832;20589;14243;10056.0;12647.0;6663.0;6852.0;41179.0;41483.0;31
304;Limburg (PV);2024;1064094;206263;600694;257137;842172;132652;53673;78979;89270;47202;42068;9845;5220;4625;7309;4180;3129;17820;8430;9390;18759;8460;10299;35537;20912;14625;10115.0;12818.0;6591.0;6729.0;40961.0;41110.0;31
305;Limburg (PV);2025;1061207;206081;594288;260838;838938;131653;53629;78024;90616;47804;42812;10130;5381;4749;7574;4361;3213;18026;8515;9511;18811;8469;10342;36075;21078;14997;;;;;;;31
306;Oost-Groningen (CR);2008;151905;34161;90944;26800;136907;9170;3709;5461;5828;3680;2148;885;462;423;257;151;106;1305;694;611;241;117;124;3140;2256;884;1445.0;1628.0;488.0;993.0;7294.0;7598.0;1
307;Oost-Groningen (CR);2009;150873;33705;90130;27038;135785;9062;3632;5430;6026;3710;2316;931;489;442;305;175;130;1336;717;619;308;142;166;3146;2187;959;1398.0;1602.0;516.0;987.0;7378.0;7555.0;1
308;Oost-Groningen (CR);2010;149992;33271;89316;27405;134753;8990;3592;5398;6249;3771;2478;969;516;453;335;189;146;1401;755;646;360;157;203;3184;2154;1030;1362.0;1613.0;553.0;942.0;7444.0;7547.0;1
309;Oost-Groningen (CR);2011;149180;32808;88646;27726;133752;8934;3549;5385;6494;3880;2614;1006;539;467;394;226;168;1459;787;672;408;179;229;3227;2149;1078;1347.0;1608.0;565.0;937.0;7486.0;7556.0;1
310;Oost-Groningen (CR);2012;148392;32249;87399;28744;132912;8819;3508;5311;6661;3929;2732;1064;557;507;435;250;185;1491;795;696;449;200;249;3222;2127;1095;1338.0;1611.0;530.0;914.0;7417.0;7445.0;1
311;Oost-Groningen (CR);2013;147715;31863;86307;29545;132023;8813;3483;5330;6879;4006;2873;1093;566;527;460;262;198;1573;833;740;491;217;274;3262;2128;1134;1315.0;1608.0;538.0;893.0;7289.0;7417.0;1
312;Oost-Groningen (CR);2014;146915;31407;85448;30060;131004;8816;3458;5358;7095;4071;3024;1136;591;545;511;292;219;1614;842;772;542;229;313;3292;2117;1175;1319.0;1619.0;545.0;883.0;7217.0;7369.0;1
313;Oost-Groningen (CR);2015;146066;30876;84618;30572;129955;8744;3443;5301;7367;4192;3175;1170;620;550;557;313;244;1701;871;830;584;252;332;3355;2136;1219;1302.0;1621.0;530.0;862.0;7271.0;7384.0;1
314;Oost-Groningen (CR);2016;145321;30430;83891;31000;128971;8744;3450;5294;7606;4292;3314;1229;646;583;591;333;258;1729;902;827;655;273;382;3402;2138;1264;1306.0;1602.0;531.0;841.0;7269.0;7283.0;1
315;Oost-Groningen (CR);2017;144690;30096;83130;31464;128157;8720;3462;5258;7813;4344;3469;1306;671;635;615;341;274;1782;932;850;727;301;426;3383;2099;1284;1309.0;1626.0;520.0;848.0;6987.0;7193.0;1
316;Oost-Groningen (CR);2018;143840;29669;82216;31955;127232;8651;3409;5242;7957;4383;3574;1352;695;657;659;369;290;1859;967;892;761;315;446;3326;2037;1289;1305.0;1639.0;524.0;802.0;7022.0;7162.0;1
317;Oost-Groningen (CR);2019;143054;29221;81471;32362;126251;8625;3397;5228;8178;4471;3707;1390;721;669;701;380;321;1885;980;905;811;331;480;3391;2059;1332;1294.0;1644.0;496.0;813.0;7158.0;7045.0;1
318;Oost-Groningen (CR);2020;142467;28899;80752;32816;125501;8607;3384;5223;8359;4529;3830;1411;737;674;747;408;339;1945;991;954;828;342;486;3428;2051;1377;1286.0;1643.0;516.0;818.0;6920.0;7070.0;1
319;Oost-Groningen (CR);2021;141663;28479;79859;33325;124601;8583;3361;5222;8479;4596;3883;1444;768;676;760;417;343;2003;1018;985;855;354;501;3417;2039;1378;1300.0;1677.0;490.0;775.0;7097.0;7034.0;1
320;Oost-Groningen (CR);2022;141010;28096;79172;33742;123777;8545;3367;5178;8688;4718;3970;1473;783;690;815;439;376;2054;1052;1002;878;363;515;3468;2081;1387;1284.0;1686.0;529.0;771.0;6783.0;6894.0;1
321;Oost-Groningen (CR);2023;140275;27842;78287;34146;122851;8550;3391;5159;8874;4810;4064;1511;811;700;845;459;386;2074;1059;1015;940;373;567;3504;2108;1396;1289.0;1707.0;514.0;735.0;6851.0;6858.0;1
322;Oost-Groningen (CR);2024;139623;27620;77474;34529;121954;8613;3433;5180;9056;4912;4144;1550;824;726;880;480;400;2094;1071;1023;973;382;591;3559;2155;1404;1283.0;1724.0;489.0;746.0;6792.0;6846.0;1
323;Oost-Groningen (CR);2025;138854;27410;76542;34902;121041;8587;3457;5130;9226;5015;4211;1557;837;720;900;498;402;2097;1066;1031;1016;403;613;3656;2211;1445;;;;;;;1
324;Delfzijl en omgeving (CR);2008;49739;11274;29492;8973;43071;3552;1464;2088;3116;1933;1183;406;253;153;511;317;194;866;459;407;111;50;61;1222;854;368;473.0;454.0;140.0;226.0;1879.0;2438.0;2
325;Delfzijl en omgeving (CR);2009;49121;11027;29041;9053;42477;3514;1433;2081;3130;1927;1203;408;250;158;497;304;193;854;452;402;127;57;70;1244;864;380;463.0;460.0;151.0;227.0;1895.0;2456.0;2
326;Delfzijl en omgeving (CR);2010;48494;10783;28530;9181;41859;3487;1418;2069;3148;1935;1213;404;256;148;497;308;189;855;449;406;135;58;77;1257;864;393;448.0;453.0;151.0;223.0;1859.0;2409.0;2
327;Delfzijl en omgeving (CR);2011;47876;10448;28131;9297;41223;3491;1429;2062;3162;1933;1229;427;263;164;476;297;179;853;446;407;145;60;85;1261;867;394;453.0;459.0;161.0;209.0;1920.0;2386.0;2
328;Delfzijl en omgeving (CR);2012;47365;10237;27575;9553;40680;3463;1417;2046;3222;1979;1243;426;266;160;483;302;181;829;436;393;178;72;106;1306;903;403;446.0;452.0;159.0;199.0;1808.0;2370.0;2
329;Delfzijl en omgeving (CR);2013;46760;10013;26962;9785;40093;3405;1380;2025;3262;1969;1293;422;259;163;479;297;182;836;430;406;196;82;114;1329;901;428;437.0;451.0;148.0;184.0;1929.0;2326.0;2
330;Delfzijl en omgeving (CR);2014;46320;9796;26564;9960;39610;3400;1390;2010;3310;1968;1342;444;262;182;491;302;189;854;431;423;202;84;118;1319;889;430;438.0;443.0;141.0;179.0;1813.0;2305.0;2
331;Delfzijl en omgeving (CR);2015;45788;9598;26092;10098;39079;3379;1382;1997;3330;1979;1351;466;270;196;478;294;184;836;430;406;207;92;115;1343;893;450;429.0;461.0;138.0;187.0;1849.0;2269.0;2
332;Delfzijl en omgeving (CR);2016;45296;9409;25741;10146;38537;3357;1371;1986;3402;2008;1394;477;276;201;484;300;184;854;434;420;219;98;121;1368;900;468;426.0;454.0;145.0;174.0;1769.0;2267.0;2
333;Delfzijl en omgeving (CR);2017;44748;9242;25280;10226;37962;3325;1352;1973;3461;2034;1427;486;281;205;484;299;185;859;427;432;229;103;126;1403;924;479;429.0;456.0;150.0;177.0;1795.0;2201.0;2
334;Delfzijl en omgeving (CR);2018;44290;9043;24882;10365;37471;3331;1363;1968;3488;2044;1444;493;290;203;482;294;188;852;427;425;241;103;138;1420;930;490;414.0;457.0;144.0;172.0;1780.0;2182.0;2
335;Delfzijl en omgeving (CR);2019;43822;8838;24471;10513;36993;3302;1340;1962;3527;2071;1456;489;288;201;475;288;187;864;440;424;262;108;154;1437;947;490;426.0;456.0;147.0;172.0;1719.0;2160.0;2
336;Delfzijl en omgeving (CR);2020;43329;8682;24073;10574;36466;3283;1329;1954;3580;2094;1486;482;287;195;474;291;183;871;444;427;288;119;169;1465;953;512;418.0;456.0;140.0;163.0;1667.0;2137.0;2
337;Delfzijl en omgeving (CR);2021;42805;8535;23611;10659;35883;3271;1323;1948;3651;2104;1547;488;286;202;477;287;190;881;445;436;308;124;184;1497;962;535;421.0;460.0;146.0;162.0;1718.0;2085.0;2
338;Delfzijl en omgeving (CR);2022;42389;8429;23251;10709;35473;3221;1318;1903;3695;2123;1572;471;276;195;474;277;197;887;448;439;321;131;190;1542;991;551;417.0;462.0;130.0;174.0;1670.0;2058.0;2
339;Delfzijl en omgeving (CR);2023;41918;8335;22787;10796;35011;3184;1301;1883;3723;2137;1586;474;273;201;477;277;200;881;450;431;328;129;199;1563;1008;555;415.0;458.0;130.0;161.0;1733.0;2033.0;2
340;Delfzijl en omgeving (CR);2024;41545;8254;22414;10877;34638;3174;1293;1881;3733;2135;1598;460;265;195;467;265;202;881;441;440;343;139;204;1582;1025;557;424.0;462.0;137.0;157.0;1635.0;2045.0;2
341;Delfzijl en omgeving (CR);2025;41079;8146;21980;10953;34216;3127;1272;1855;3736;2146;1590;461;271;190;457;259;198;881;440;441;346;139;207;1591;1037;554;;;;;;;2
342;Overig Groningen (CR);2008;370059;80581;239087;50391;319968;26191;10831;15360;23900;14524;9376;4989;2654;2335;3544;2266;1278;2861;1471;1390;1712;782;930;10794;7351;3443;4138.0;3182.0;2722.0;3316.0;20777.0;19828.0;3
343;Overig Groningen (CR);2009;371454;80682;239433;51339;320680;26258;10880;15378;24516;14746;9770;5059;2700;2359;3517;2222;1295;3042;1524;1518;1947;887;1060;10951;7413;3538;4187.0;3183.0;2861.0;3288.0;20801.0;19875.0;3
344;Overig Groningen (CR);2010;373041;80879;239742;52420;321633;26340;10927;15413;25068;14951;10117;5075;2716;2359;3586;2270;1316;3209;1589;1620;2138;961;1177;11060;7415;3645;4299.0;3214.0;2913.0;3268.0;21166.0;19961.0;3
345;Overig Groningen (CR);2011;375055;81060;240461;53534;322895;26516;11009;15507;25644;15106;10538;5142;2744;2398;3626;2297;1329;3401;1658;1743;2327;1036;1291;11148;7371;3777;4352.0;3238.0;3008.0;3228.0;21174.0;19851.0;3
346;Overig Groningen (CR);2012;377331;81086;240355;55890;324398;26714;11103;15611;26219;15329;10890;5177;2783;2394;3693;2345;1348;3570;1719;1851;2477;1066;1411;11302;7416;3886;4433.0;3281.0;3001.0;3192.0;21114.0;19879.0;3
347;Overig Groningen (CR);2013;379595;81388;240262;57945;325966;26841;11152;15689;26788;15547;11241;5236;2827;2409;3716;2354;1362;3734;1796;1938;2667;1124;1543;11435;7446;3989;4509.0;3293.0;2992.0;3167.0;21163.0;19847.0;3
348;Overig Groningen (CR);2014;382020;81861;240463;59696;327676;26976;11190;15786;27368;15785;11583;5259;2853;2406;3762;2400;1362;3874;1843;2031;2852;1178;1674;11621;7511;4110;4562.0;3336.0;2994.0;3128.0;21295.0;19737.0;3
349;Overig Groningen (CR);2015;384744;82256;241232;61256;329614;27196;11345;15851;27934;15975;11959;5274;2874;2400;3819;2419;1400;4076;1937;2139;2994;1225;1769;11771;7520;4251;4633.0;3350.0;3033.0;3100.0;21103.0;19797.0;3
350;Overig Groningen (CR);2016;387330;82679;241955;62696;331357;27353;11444;15909;28620;16252;12368;5358;2904;2454;3888;2463;1425;4229;2006;2223;3167;1294;1873;11978;7585;4393;4697.0;3375.0;2964.0;3086.0;20805.0;19912.0;3
351;Overig Groningen (CR);2017;389494;83243;242129;64122;332800;27546;11511;16035;29148;16511;12637;5361;2921;2440;3937;2507;1430;4392;2073;2319;3286;1332;1954;12172;7678;4494;4730.0;3412.0;2963.0;3067.0;21092.0;19824.0;3
352;Overig Groningen (CR);2018;392040;83862;242379;65799;334570;27643;11543;16100;29827;16763;13064;5411;2938;2473;4049;2557;1492;4556;2142;2414;3431;1385;2046;12380;7741;4639;4784.0;3472.0;2954.0;3027.0;21087.0;19971.0;3
353;Overig Groningen (CR);2019;394463;84366;242671;67426;336295;27772;11611;16161;30396;17050;13346;5512;2990;2522;4096;2604;1492;4691;2192;2499;3558;1448;2110;12539;7816;4723;4812.0;3531.0;2953.0;3024.0;21268.0;20047.0;3
354;Overig Groningen (CR);2020;396957;84859;243196;68902;338016;27927;11670;16257;31014;17243;13771;5584;3019;2565;4117;2626;1491;4833;2249;2584;3775;1509;2266;12705;7840;4865;4845.0;3572.0;2973.0;3012.0;21284.0;20092.0;3
355;Overig Groningen (CR);2021;399439;85386;243666;70387;339643;28146;11828;16318;31650;17484;14166;5623;3035;2588;4194;2660;1534;4939;2311;2628;3956;1547;2409;12938;7931;5007;4854.0;3623.0;2912.0;2986.0;21036.0;20105.0;3
356;Overig Groningen (CR);2022;401600;85669;243977;71954;340871;28405;11954;16451;32324;17755;14569;5687;3051;2636;4216;2670;1546;5128;2376;2752;4140;1614;2526;13153;8044;5109;4851.0;3674.0;2951.0;2993.0;21240.0;20152.0;3
357;Overig Groningen (CR);2023;403889;86131;244206;73552;342450;28527;12017;16510;32912;17996;14916;5709;3048;2661;4257;2669;1588;5280;2439;2841;4286;1662;2624;13380;8178;5202;4866.0;3740.0;2902.0;2987.0;21203.0;20303.0;3
358;Overig Groningen (CR);2024;405894;86660;244113;75121;343702;28665;12087;16578;33527;18187;15340;5771;3061;2710;4306;2669;1637;5431;2518;2913;4429;1702;2727;13590;8237;5353;4902.0;3806.0;2920.0;2975.0;20994.0;20217.0;3
359;Overig Groningen (CR);2025;407773;87325;243730;76718;344757;28827;12178;16649;34189;18453;15736;5822;3068;2754;4367;2664;1703;5563;2588;2975;4623;1761;2862;13814;8372;5442;;;;;;;3
360;Noord-Friesland (CR);2008;332781;81018;202516;49247;302889;15559;5737;9822;14333;8980;5353;1984;1029;955;1312;798;514;1064;539;525;1615;767;848;8358;5847;2511;3800.0;2998.0;1331.0;1772.0;13601.0;13588.0;4
361;Noord-Friesland (CR);2009;333208;80322;202706;50180;302666;15647;5729;9918;14895;9144;5751;2095;1095;1000;1405;845;560;1199;606;593;1800;835;965;8396;5763;2633;3829.0;3012.0;1355.0;1759.0;12946.0;13206.0;4
362;Noord-Friesland (CR);2010;333420;79588;202484;51348;302118;15815;5819;9996;15487;9356;6131;2218;1157;1061;1479;893;586;1377;671;706;1951;900;1051;8462;5735;2727;3811.0;3033.0;1366.0;1721.0;13055.0;13201.0;4
363;Noord-Friesland (CR);2011;333749;78930;202498;52321;301724;15893;5815;10078;16132;9593;6539;2296;1191;1105;1555;937;618;1529;711;818;2101;966;1135;8651;5788;2863;3848.0;3048.0;1471.0;1742.0;12617.0;13032.0;4
364;Noord-Friesland (CR);2012;333916;78203;201405;54308;301335;15934;5789;10145;16647;9814;6833;2391;1229;1162;1633;996;637;1647;767;880;2219;1017;1202;8757;5805;2952;3855.0;3053.0;1429.0;1690.0;12553.0;13044.0;4
365;Noord-Friesland (CR);2013;334019;77507;200388;56124;300714;16093;5884;10209;17212;10023;7189;2476;1271;1205;1675;1018;657;1842;847;995;2338;1062;1276;8881;5825;3056;3891.0;3112.0;1449.0;1666.0;12481.0;13064.0;4
366;Noord-Friesland (CR);2014;334045;76839;199652;57554;300093;16270;5922;10348;17682;10166;7516;2551;1306;1245;1700;1027;673;1982;904;1078;2474;1124;1350;8975;5805;3170;3932.0;3092.0;1453.0;1661.0;12675.0;13113.0;4
367;Noord-Friesland (CR);2015;334289;76502;198979;58808;299672;16372;5963;10409;18245;10377;7868;2610;1348;1262;1807;1092;715;2131;952;1179;2638;1191;1447;9059;5794;3265;3952.0;3132.0;1409.0;1645.0;12743.0;13077.0;4
368;Noord-Friesland (CR);2016;334581;76240;198224;60117;299348;16469;5983;10486;18764;10576;8188;2694;1390;1304;1892;1143;749;2255;996;1259;2766;1240;1526;9157;5807;3350;4004.0;3165.0;1388.0;1627.0;12608.0;13223.0;4
369;Noord-Friesland (CR);2017;334613;75931;197414;61268;298694;16599;6010;10589;19320;10832;8488;2794;1456;1338;1964;1177;787;2403;1063;1340;2905;1278;1627;9254;5858;3396;4010.0;3166.0;1438.0;1615.0;12379.0;12980.0;4
370;Noord-Friesland (CR);2018;334719;75811;196477;62431;298166;16676;6039;10637;19877;11013;8864;2875;1503;1372;2073;1240;833;2517;1114;1403;3056;1303;1753;9356;5853;3503;4042.0;3192.0;1410.0;1619.0;12947.0;13334.0;4
371;Noord-Friesland (CR);2019;335010;75687;195630;63693;297830;16754;6047;10707;20426;11234;9192;2936;1527;1409;2155;1295;860;2620;1150;1470;3205;1341;1864;9510;5921;3589;4078.0;3235.0;1420.0;1582.0;12513.0;13181.0;4
372;Noord-Friesland (CR);2020;335066;75454;194746;64866;297217;16841;6129;10712;21008;11454;9554;2986;1544;1442;2258;1349;909;2742;1210;1532;3370;1388;1982;9652;5963;3689;4137.0;3274.0;1387.0;1587.0;12759.0;13342.0;4
373;Noord-Friesland (CR);2021;335177;75193;193882;66102;296721;17022;6177;10845;21434;11611;9823;3029;1565;1464;2358;1393;965;2841;1264;1577;3475;1426;2049;9731;5963;3768;4160.0;3302.0;1383.0;1570.0;12705.0;13244.0;4
374;Noord-Friesland (CR);2022;335346;75147;192847;67352;296386;17027;6180;10847;21933;11736;10197;3071;1568;1503;2438;1439;999;2994;1310;1684;3601;1467;2134;9829;5952;3877;4151.0;3346.0;1405.0;1576.0;12703.0;13132.0;4
375;Noord-Friesland (CR);2023;335590;75058;192072;68460;296060;17060;6195;10865;22470;11888;10582;3146;1595;1551;2513;1485;1028;3117;1350;1767;3734;1490;2244;9960;5968;3992;4163.0;3406.0;1384.0;1544.0;12463.0;13012.0;4
376;Noord-Friesland (CR);2024;335674;75125;190969;69580;295661;17013;6220;10793;23000;12118;10882;3204;1614;1590;2587;1527;1060;3255;1408;1847;3892;1543;2349;10062;6026;4036;4202.0;3432.0;1376.0;1541.0;12391.0;12955.0;4
377;Noord-Friesland (CR);2025;335751;75326;189748;70677;295113;17156;6300;10856;23482;12282;11200;3260;1647;1613;2651;1576;1075;3336;1420;1916;4041;1580;2461;10194;6059;4135;;;;;;;4
378;Zuidwest-Friesland (CR);2008;105678;26639;62143;16896;97300;5297;1832;3465;3081;1723;1358;372;178;194;194;86;108;475;242;233;223;94;129;1817;1123;694;1177.0;971.0;265.0;411.0;4863.0;4558.0;5
379;Zuidwest-Friesland (CR);2009;106062;26438;62242;17382;97505;5268;1824;3444;3289;1804;1485;412;194;218;215;105;110;524;252;272;256;113;143;1882;1140;742;1158.0;970.0;262.0;419.0;4437.0;4551.0;5
380;Zuidwest-Friesland (CR);2010;105993;26030;62085;17878;97267;5270;1794;3476;3456;1912;1544;434;206;228;228;108;120;559;289;270;300;139;161;1935;1170;765;1144.0;992.0;299.0;410.0;4480.0;4605.0;5
381;Zuidwest-Friesland (CR);2011;105927;25639;61921;18367;97024;5301;1791;3510;3602;1992;1610;456;224;232;242;114;128;597;302;295;337;157;180;1970;1195;775;1117.0;1002.0;303.0;402.0;4395.0;4535.0;5
382;Zuidwest-Friesland (CR);2012;105817;25245;61375;19197;96755;5323;1791;3532;3739;2052;1687;476;234;242;254;130;124;645;310;335;375;165;210;1989;1213;776;1093.0;1013.0;325.0;387.0;4348.0;4490.0;5
383;Zuidwest-Friesland (CR);2013;105702;24871;60964;19867;96434;5327;1769;3558;3941;2154;1787;511;256;255;276;139;137;683;324;359;413;178;235;2058;1257;801;1097.0;1034.0;298.0;392.0;4460.0;4544.0;5
384;Zuidwest-Friesland (CR);2014;105595;24505;60705;20385;96171;5334;1776;3558;4090;2230;1860;534;273;261;288;149;139;714;329;385;449;199;250;2105;1280;825;1083.0;1033.0;315.0;381.0;4465.0;4528.0;5
385;Zuidwest-Friesland (CR);2015;105526;24192;60453;20881;95883;5346;1779;3567;4297;2316;1981;574;292;282;315;165;150;758;348;410;500;221;279;2150;1290;860;1065.0;1040.0;322.0;388.0;4305.0;4477.0;5
386;Zuidwest-Friesland (CR);2016;105324;23841;60192;21291;95471;5385;1793;3592;4468;2395;2073;599;306;293;345;188;157;814;369;445;539;236;303;2171;1296;875;1064.0;1060.0;314.0;392.0;4575.0;4575.0;5
387;Zuidwest-Friesland (CR);2017;105267;23558;60039;21670;95211;5394;1787;3607;4662;2474;2188;626;321;305;365;197;168;895;399;496;573;251;322;2203;1306;897;1067.0;1062.0;311.0;375.0;4358.0;4553.0;5
388;Zuidwest-Friesland (CR);2018;105023;23198;59740;22085;94799;5421;1792;3629;4803;2551;2252;654;343;311;381;208;173;935;416;519;605;266;339;2228;1318;910;1061.0;1086.0;299.0;371.0;4447.0;4587.0;5
389;Zuidwest-Friesland (CR);2019;104801;22857;59433;22511;94380;5427;1785;3642;4994;2619;2375;681;353;328;409;215;194;975;428;547;653;278;375;2276;1345;931;1075.0;1091.0;291.0;370.0;4529.0;4561.0;5
390;Zuidwest-Friesland (CR);2020;104684;22499;59306;22879;94074;5445;1804;3641;5165;2698;2467;702;362;340;437;235;202;1020;436;584;694;291;403;2312;1374;938;1071.0;1109.0;324.0;363.0;4554.0;4534.0;5
391;Zuidwest-Friesland (CR);2021;104640;22124;59189;23327;93833;5514;1823;3691;5293;2734;2559;713;367;346;450;232;218;1063;442;621;722;310;412;2345;1383;962;1086.0;1129.0;304.0;373.0;4489.0;4538.0;5
392;Zuidwest-Friesland (CR);2022;104490;21848;58968;23674;93501;5566;1855;3711;5423;2786;2637;739;375;364;467;246;221;1102;448;654;752;322;430;2363;1395;968;1070.0;1156.0;323.0;357.0;4332.0;4533.0;5
393;Zuidwest-Friesland (CR);2023;104175;21585;58553;24037;93060;5544;1859;3685;5571;2864;2707;755;386;369;497;266;231;1126;467;659;779;322;457;2414;1423;991;1082.0;1176.0;301.0;363.0;4401.0;4452.0;5
394;Zuidwest-Friesland (CR);2024;103982;21369;58126;24487;92755;5547;1881;3666;5680;2897;2783;769;405;364;523;273;250;1152;482;670;805;324;481;2431;1413;1018;1082.0;1190.0;307.0;357.0;4485.0;4442.0;5
395;Zuidwest-Friesland (CR);2025;103876;21258;57636;24982;92425;5581;1884;3697;5870;3006;2864;788;415;373;562;291;271;1220;513;707;835;343;492;2465;1444;1021;;;;;;;5
396;Zuidoost-Friesland (CR);2008;205704;50226;121314;34164;189205;9428;3383;6045;7071;4223;2848;936;481;455;737;420;317;795;426;369;857;444;413;3746;2452;1294;2151.0;1905.0;563.0;923.0;8476.0;8435.0;6
397;Zuidoost-Friesland (CR);2009;205661;49744;121110;34807;188821;9513;3395;6118;7327;4324;3003;979;503;476;743;409;334;881;481;400;956;478;478;3768;2453;1315;2110.0;1913.0;634.0;899.0;8540.0;8510.0;6
398;Zuidoost-Friesland (CR);2010;205650;49059;121037;35554;188425;9599;3403;6196;7626;4451;3175;1041;538;503;766;438;328;975;529;446;1027;498;529;3817;2448;1369;2102.0;1945.0;653.0;884.0;8470.0;8533.0;6
399;Zuidoost-Friesland (CR);2011;205537;48392;120908;36237;187967;9605;3377;6228;7965;4651;3314;1095;570;525;822;478;344;1046;563;483;1069;514;555;3933;2526;1407;2071.0;1962.0;658.0;894.0;8421.0;8533.0;6
400;Zuidoost-Friesland (CR);2012;205317;47685;120121;37511;187410;9628;3398;6230;8279;4781;3498;1156;597;559;831;481;350;1135;600;535;1141;549;592;4016;2554;1462;2048.0;1962.0;686.0;874.0;8566.0;8568.0;6
401;Zuidoost-Friesland (CR);2013;205234;47120;119416;38698;187026;9699;3400;6299;8509;4849;3660;1200;629;571;868;504;364;1205;621;584;1205;577;628;4031;2518;1513;2050.0;1999.0;656.0;859.0;8510.0;8476.0;6
402;Zuidoost-Friesland (CR);2014;205139;46622;118858;39659;186629;9725;3401;6324;8785;4986;3799;1228;647;581;899;519;380;1262;640;622;1286;606;680;4110;2574;1536;2035.0;2004.0;682.0;846.0;8444.0;8505.0;6
403;Zuidoost-Friesland (CR);2015;204966;45948;118555;40463;186026;9816;3397;6419;9124;5130;3994;1275;681;594;939;547;392;1364;675;689;1331;622;709;4215;2605;1610;2043.0;2037.0;677.0;824.0;8365.0;8558.0;6
404;Zuidoost-Friesland (CR);2016;204649;45331;118150;41168;185416;9908;3469;6439;9325;5200;4125;1317;703;614;970;563;407;1400;698;702;1393;648;745;4245;2588;1657;2027.0;2027.0;663.0;846.0;8677.0;8548.0;6
405;Zuidoost-Friesland (CR);2017;204616;44844;117779;41993;185030;9972;3489;6483;9614;5343;4271;1386;725;661;996;575;421;1463;735;728;1446;666;780;4323;2642;1681;2046.0;2061.0;663.0;831.0;8687.0;8543.0;6
406;Zuidoost-Friesland (CR);2018;204591;44374;117347;42870;184708;9994;3500;6494;9889;5421;4468;1431;750;681;1010;581;429;1526;749;777;1489;679;810;4433;2662;1771;2062.0;2085.0;653.0;807.0;8648.0;8552.0;6
407;Zuidoost-Friesland (CR);2019;204530;43790;117051;43689;184286;10090;3575;6515;10154;5546;4608;1475;774;701;1051;610;441;1600;772;828;1555;707;848;4473;2683;1790;2088.0;2110.0;655.0;816.0;8736.0;8582.0;6
408;Zuidoost-Friesland (CR);2020;204526;43263;116644;44619;183895;10164;3619;6545;10467;5681;4786;1544;811;733;1075;617;458;1655;780;875;1617;726;891;4576;2747;1829;2087.0;2153.0;653.0;781.0;8658.0;8561.0;6
409;Zuidoost-Friesland (CR);2021;204452;42824;116158;45470;183477;10180;3630;6550;10795;5837;4958;1608;838;770;1120;642;478;1714;806;908;1682;742;940;4671;2809;1862;2115.0;2152.0;661.0;794.0;8775.0;8510.0;6
410;Zuidoost-Friesland (CR);2022;204566;42470;115762;46334;183184;10296;3664;6632;11086;6006;5080;1654;867;787;1149;651;498;1754;824;930;1728;767;961;4801;2897;1904;2110.0;2198.0;698.0;802.0;8812.0;8500.0;6
411;Zuidoost-Friesland (CR);2023;204717;42278;115298;47141;182924;10393;3733;6660;11400;6158;5242;1733;912;821;1178;658;520;1826;855;971;1792;786;1006;4871;2947;1924;2110.0;2231.0;668.0;785.0;8922.0;8580.0;6
412;Zuidoost-Friesland (CR);2024;204843;42012;114899;47932;182630;10523;3811;6712;11690;6286;5404;1815;948;867;1183;657;526;1904;880;1024;1844;818;1026;4944;2983;1961;2142.0;2248.0;656.0;788.0;8787.0;8460.0;6
413;Zuidoost-Friesland (CR);2025;204957;41983;114194;48780;182417;10563;3852;6711;11977;6386;5591;1842;963;879;1213;661;552;1958;895;1063;1913;837;1076;5051;3030;2021;;;;;;;6
414;Noord-Drenthe (CR);2008;186659;45527;109470;31662;169620;10624;3992;6632;6415;3730;2685;908;444;464;587;326;261;715;379;336;522;240;282;3683;2341;1342;1817.0;1671.0;644.0;730.0;8392.0;8223.0;7
415;Noord-Drenthe (CR);2009;186918;45168;109296;32454;169502;10589;3915;6674;6827;3903;2924;987;487;500;628;345;283;807;416;391;581;257;324;3824;2398;1426;1786.0;1699.0;718.0;733.0;8759.0;8352.0;7
416;Noord-Drenthe (CR);2010;187428;44842;109343;33243;169531;10656;3991;6665;7241;4062;3179;1077;525;552;713;392;321;886;453;433;677;284;393;3888;2408;1480;1748.0;1721.0;703.0;741.0;8294.0;8392.0;7
417;Noord-Drenthe (CR);2011;187338;44140;109222;33976;169140;10610;3971;6639;7588;4223;3365;1135;567;568;770;422;348;952;486;466;766;298;468;3965;2450;1515;1758.0;1734.0;776.0;728.0;8466.0;8381.0;7
418;Noord-Drenthe (CR);2012;187518;43581;108519;35418;168890;10717;4012;6705;7911;4341;3570;1200;607;593;836;447;389;1012;516;496;838;326;512;4025;2445;1580;1765.0;1766.0;760.0;722.0;8532.0;8406.0;7
419;Noord-Drenthe (CR);2013;187697;43110;107876;36711;168674;10777;4046;6731;8246;4457;3789;1276;646;630;911;475;436;1142;567;575;895;345;550;4022;2424;1598;1764.0;1789.0;770.0;719.0;8556.0;8466.0;7
420;Noord-Drenthe (CR);2014;187825;42618;107364;37843;168422;10791;4055;6736;8612;4611;4001;1348;690;658;973;509;464;1234;598;636;974;371;603;4083;2443;1640;1776.0;1802.0;771.0;723.0;8345.0;8480.0;7
421;Noord-Drenthe (CR);2015;187733;42108;106779;38846;167951;10843;4077;6766;8939;4776;4163;1410;720;690;1031;550;481;1302;633;669;1030;399;631;4166;2474;1692;1798.0;1831.0;741.0;702.0;8545.0;8485.0;7
422;Noord-Drenthe (CR);2016;187821;41688;106402;39731;167683;10808;4016;6792;9330;4929;4401;1454;766;688;1092;572;520;1392;667;725;1098;415;683;4294;2509;1785;1807.0;1837.0;764.0;700.0;8571.0;8437.0;7
423;Noord-Drenthe (CR);2017;188007;41242;106143;40622;167486;10838;4078;6760;9683;5037;4646;1529;797;732;1136;600;536;1492;698;794;1157;443;714;4369;2499;1870;1828.0;1859.0;753.0;698.0;8500.0;8464.0;7
424;Noord-Drenthe (CR);2018;188102;40918;105667;41517;167298;10807;4068;6739;9997;5183;4814;1559;808;751;1163;627;536;1520;709;811;1249;464;785;4506;2575;1931;1844.0;1900.0;769.0;711.0;8590.0;8441.0;7
425;Noord-Drenthe (CR);2019;188267;40622;105298;42347;167058;10858;4110;6748;10351;5372;4979;1605;826;779;1225;668;557;1616;760;856;1310;504;806;4595;2614;1981;1852.0;1925.0;759.0;698.0;8744.0;8532.0;7
426;Noord-Drenthe (CR);2020;188488;40245;104954;43289;166937;10908;4153;6755;10643;5488;5155;1639;844;795;1269;677;592;1680;787;893;1357;516;841;4698;2664;2034;1867.0;1954.0;752.0;710.0;8801.0;8517.0;7
427;Noord-Drenthe (CR);2021;188751;39964;104561;44226;166823;10906;4192;6714;11022;5637;5385;1694;874;820;1346;704;642;1754;817;937;1426;538;888;4802;2704;2098;1913.0;1975.0;748.0;680.0;8693.0;8580.0;7
428;Noord-Drenthe (CR);2022;188890;39684;104057;45149;166615;10913;4197;6716;11362;5796;5566;1746;915;831;1405;729;676;1806;839;967;1498;559;939;4907;2754;2153;1905.0;2019.0;736.0;676.0;8752.0;8499.0;7
429;Noord-Drenthe (CR);2023;189110;39415;103696;45999;166385;10974;4222;6752;11751;5984;5767;1793;945;848;1468;756;712;1893;876;1017;1603;587;1016;4994;2820;2174;1934.0;2040.0;732.0;688.0;8644.0;8490.0;7
430;Noord-Drenthe (CR);2024;189219;39254;102990;46975;166064;11059;4257;6802;12096;6082;6014;1820;963;857;1533;778;755;1974;905;1069;1677;593;1084;5092;2843;2249;1914.0;2076.0;757.0;689.0;8738.0;8460.0;7
431;Noord-Drenthe (CR);2025;189421;39263;102323;47835;165934;11049;4303;6746;12438;6223;6215;1876;1004;872;1572;801;771;2044;926;1118;1758;612;1146;5188;2880;2308;;;;;;;7
432;Zuidoost-Drenthe (CR);2008;171206;40141;102062;29003;155039;10194;3639;6555;5973;3562;2411;691;337;354;452;256;196;1151;617;534;543;255;288;3136;2097;1039;1687.0;1620.0;619.0;918.0;6013.0;5414.0;8
433;Zuidoost-Drenthe (CR);2009;171595;39974;101847;29774;154890;10276;3661;6615;6429;3771;2658;749;367;382;489;280;209;1283;673;610;632;289;343;3276;2162;1114;1687.0;1666.0;678.0;922.0;5892.0;5421.0;8
434;Zuidoost-Drenthe (CR);2010;171866;39899;101516;30451;154675;10350;3681;6669;6841;3938;2903;802;389;413;522;294;228;1377;716;661;708;329;379;3432;2210;1222;1658.0;1689.0;689.0;908.0;6116.0;5491.0;8
435;Zuidoost-Drenthe (CR);2011;172261;39678;101544;31039;154617;10405;3667;6738;7239;4103;3136;857;414;443;558;314;244;1480;763;717;806;365;441;3538;2247;1291;1654.0;1693.0;696.0;894.0;5738.0;5412.0;8
436;Zuidoost-Drenthe (CR);2012;172365;39355;100805;32205;154235;10448;3682;6766;7682;4303;3379;934;450;484;602;337;265;1577;801;776;906;414;492;3663;2301;1362;1629.0;1733.0;726.0;893.0;5791.0;5423.0;8
437;Zuidoost-Drenthe (CR);2013;172475;39034;100088;33353;153883;10492;3671;6821;8100;4517;3583;980;475;505;633;363;270;1675;845;830;1025;463;562;3787;2371;1416;1635.0;1742.0;734.0;864.0;5694.0;5411.0;8
438;Zuidoost-Drenthe (CR);2014;172539;38790;99334;34415;153516;10522;3668;6854;8501;4699;3802;1042;510;532;679;383;296;1761;876;885;1116;507;609;3903;2423;1480;1620.0;1776.0;724.0;858.0;5858.0;5422.0;8
439;Zuidoost-Drenthe (CR);2015;172695;38541;98853;35301;153250;10573;3682;6891;8872;4879;3993;1083;542;541;689;381;308;1884;921;963;1204;548;656;4012;2487;1525;1641.0;1783.0;717.0;844.0;5855.0;5351.0;8
440;Zuidoost-Drenthe (CR);2016;172949;38324;98514;36111;153043;10652;3728;6924;9254;5027;4227;1162;572;590;719;391;328;1978;966;1012;1262;568;694;4133;2530;1603;1637.0;1813.0;735.0;846.0;5932.0;5378.0;8
441;Zuidoost-Drenthe (CR);2017;173232;38161;98230;36841;152798;10777;3777;7000;9657;5215;4442;1236;615;621;770;419;351;2055;1005;1050;1341;597;744;4255;2579;1676;1651.0;1842.0;705.0;835.0;5968.0;5426.0;8
442;Zuidoost-Drenthe (CR);2018;173464;37908;97829;37727;152596;10802;3796;7006;10066;5394;4672;1304;648;656;806;443;363;2151;1044;1107;1432;634;798;4373;2625;1748;1676.0;1871.0;720.0;846.0;5888.0;5377.0;8
443;Zuidoost-Drenthe (CR);2019;173676;37566;97592;38518;152273;10872;3828;7044;10531;5565;4966;1375;687;688;842;450;392;2267;1077;1190;1529;662;867;4518;2689;1829;1677.0;1872.0;726.0;843.0;5767.0;5399.0;8
444;Zuidoost-Drenthe (CR);2020;173747;37180;97220;39347;151872;10926;3878;7048;10949;5776;5173;1419;708;711;860;460;400;2368;1113;1255;1620;699;921;4682;2796;1886;1686.0;1919.0;698.0;833.0;6076.0;5399.0;8
445;Zuidoost-Drenthe (CR);2021;174075;36976;96985;40114;151744;10962;3927;7035;11369;5906;5463;1461;721;740;882;468;414;2473;1144;1329;1712;727;985;4841;2846;1995;1723.0;1956.0;710.0;844.0;5964.0;5456.0;8
446;Zuidoost-Drenthe (CR);2022;174228;36737;96646;40845;151385;11040;4015;7025;11803;6097;5706;1512;743;769;917;493;424;2580;1174;1406;1786;748;1038;5008;2939;2069;1737.0;1971.0;752.0;836.0;6167.0;5467.0;8
447;Zuidoost-Drenthe (CR);2023;174622;36659;96302;41661;151199;11153;4082;7071;12270;6325;5945;1569;768;801;945;506;439;2662;1214;1448;1884;783;1101;5210;3054;2156;1791.0;2007.0;736.0;829.0;5931.0;5460.0;8
448;Zuidoost-Drenthe (CR);2024;174798;36616;95798;42384;150919;11226;4140;7086;12653;6497;6156;1607;787;820;969;524;445;2758;1239;1519;1981;824;1157;5338;3123;2215;1780.0;2024.0;716.0;814.0;6065.0;5397.0;8
449;Zuidoost-Drenthe (CR);2025;175140;36677;95287;43176;150721;11336;4224;7112;13083;6680;6403;1661;819;842;1004;547;457;2858;1284;1574;2074;854;1220;5486;3176;2310;;;;;;;8
450;Zuidwest-Drenthe (CR);2008;127905;31047;75134;21724;117523;6020;2223;3797;4362;2447;1915;542;260;282;271;146;125;481;232;249;750;369;381;2318;1440;878;1348.0;1190.0;283.0;465.0;5110.0;5127.0;9
451;Zuidwest-Drenthe (CR);2009;127880;30846;74917;22117;117284;6048;2206;3842;4548;2521;2027;568;276;292;283;155;128;552;264;288;780;378;402;2365;1448;917;1350.0;1200.0;305.0;453.0;5298.0;5147.0;9
452;Zuidwest-Drenthe (CR);2010;128051;30722;74743;22586;117151;6082;2205;3877;4818;2631;2187;609;308;301;311;166;145;627;294;333;823;392;431;2448;1471;977;1314.0;1217.0;315.0;453.0;5435.0;5236.0;9
453;Zuidwest-Drenthe (CR);2011;128217;30507;74712;22998;117068;6079;2191;3888;5070;2753;2317;663;342;321;331;183;148;691;317;374;843;396;447;2542;1515;1027;1305.0;1224.0;327.0;447.0;5399.0;5138.0;9
454;Zuidwest-Drenthe (CR);2012;128452;30354;74178;23920;116994;6101;2200;3901;5357;2877;2480;720;368;352;363;203;160;740;347;393;870;409;461;2664;1550;1114;1295.0;1266.0;336.0;448.0;5526.0;5218.0;9
455;Zuidwest-Drenthe (CR);2013;128690;30232;73726;24732;116940;6129;2213;3916;5621;2986;2635;774;393;381;382;220;162;816;371;445;913;432;481;2736;1570;1166;1294.0;1258.0;357.0;444.0;5523.0;5214.0;9
456;Zuidwest-Drenthe (CR);2014;128963;30086;73448;25429;116927;6165;2218;3947;5871;3086;2785;811;425;386;413;235;178;869;388;481;959;449;510;2819;1589;1230;1307.0;1264.0;342.0;446.0;5487.0;5243.0;9
457;Zuidwest-Drenthe (CR);2015;129157;29904;73270;25983;116841;6220;2218;4002;6096;3164;2932;858;449;409;422;239;183;962;413;549;980;455;525;2874;1608;1266;1295.0;1280.0;339.0;429.0;5507.0;5272.0;9
458;Zuidwest-Drenthe (CR);2016;129330;29774;73117;26439;116746;6248;2201;4047;6336;3272;3064;906;480;426;437;255;182;1015;431;584;1000;462;538;2978;1644;1334;1302.0;1293.0;332.0;443.0;5609.0;5299.0;9
459;Zuidwest-Drenthe (CR);2017;129550;29650;72933;26967;116687;6265;2220;4045;6598;3422;3176;959;503;456;455;271;184;1067;445;622;1029;465;564;3088;1738;1350;1296.0;1311.0;338.0;432.0;5600.0;5315.0;9
460;Zuidwest-Drenthe (CR);2018;129736;29459;72719;27558;116627;6306;2247;4059;6803;3543;3260;1011;536;475;474;288;186;1090;456;634;1036;467;569;3192;1796;1396;1317.0;1319.0;334.0;432.0;5721.0;5336.0;9
461;Zuidwest-Drenthe (CR);2019;130033;29230;72596;28207;116665;6300;2233;4067;7068;3619;3449;1057;545;512;498;300;198;1156;469;687;1065;484;581;3292;1821;1471;1313.0;1355.0;328.0;431.0;5549.0;5360.0;9
462;Zuidwest-Drenthe (CR);2020;130089;28861;72473;28755;116415;6322;2238;4084;7352;3725;3627;1105;567;538;549;322;227;1213;505;708;1112;491;621;3373;1840;1533;1309.0;1361.0;332.0;429.0;5773.0;5350.0;9
463;Zuidwest-Drenthe (CR);2021;130379;28634;72425;29320;116401;6334;2255;4079;7644;3843;3801;1149;584;565;587;337;250;1290;540;750;1136;500;636;3482;1882;1600;1331.0;1382.0;342.0;430.0;5699.0;5392.0;9
464;Zuidwest-Drenthe (CR);2022;130560;28380;72262;29918;116368;6366;2307;4059;7826;3920;3906;1157;580;577;621;350;271;1329;560;769;1151;505;646;3568;1925;1643;1335.0;1410.0;334.0;426.0;5593.0;5413.0;9
465;Zuidwest-Drenthe (CR);2023;130590;28213;71836;30541;116156;6432;2361;4071;8002;3974;4028;1172;584;588;662;373;289;1376;580;796;1162;505;657;3630;1932;1698;1337.0;1417.0;325.0;425.0;5731.0;5372.0;9
466;Zuidwest-Drenthe (CR);2024;130783;28068;71571;31144;116148;6453;2379;4074;8182;4047;4135;1203;598;605;675;382;293;1417;596;821;1178;517;661;3709;1954;1755;1354.0;1447.0;341.0;430.0;5906.0;5349.0;9
467;Zuidwest-Drenthe (CR);2025;131170;28094;71347;31729;116261;6472;2364;4108;8437;4141;4296;1233;614;619;710;396;314;1468;612;856;1208;531;677;3818;1988;1830;;;;;;;9
468;Noord-Overijssel (CR);2008;346936;92383;206325;48228;315450;15443;5195;10248;16043;9356;6687;1771;886;885;1729;1044;685;4036;2069;1967;1116;496;620;7391;4861;2530;4586.0;2812.0;1046.0;1382.0;11150.0;11732.0;10
469;Noord-Overijssel (CR);2009;347855;92282;206249;49324;315618;15542;5261;10281;16695;9651;7044;1899;961;938;1766;1045;721;4141;2097;2044;1252;562;690;7637;4986;2651;4498.0;2836.0;1081.0;1362.0;11038.0;11605.0;10
470;Noord-Overijssel (CR);2010;348719;92092;206180;50447;315719;15742;5296;10446;17258;9923;7335;1992;1013;979;1813;1070;743;4219;2126;2093;1366;596;770;7868;5118;2750;4468.0;2872.0;1149.0;1359.0;11198.0;11766.0;10
471;Noord-Overijssel (CR);2011;349598;91675;206363;51560;315830;15902;5355;10547;17866;10138;7728;2102;1060;1042;1844;1086;758;4364;2173;2191;1478;626;852;8078;5193;2885;4411.0;2936.0;1209.0;1347.0;10872.0;11671.0;10
472;Noord-Overijssel (CR);2012;350171;91163;205508;53500;315660;16077;5382;10695;18434;10400;8034;2211;1108;1103;1884;1099;785;4455;2216;2239;1562;669;893;8322;5308;3014;4317.0;2991.0;1208.0;1324.0;11596.0;11783.0;10
473;Noord-Overijssel (CR);2013;351228;90931;204878;55419;315884;16279;5466;10813;19065;10644;8421;2324;1158;1166;1904;1109;795;4529;2224;2305;1714;712;1002;8594;5441;3153;4277.0;3029.0;1272.0;1326.0;11316.0;11803.0;10
474;Noord-Overijssel (CR);2014;351987;90529;204432;57026;315853;16487;5577;10910;19647;10891;8756;2411;1211;1200;1967;1146;821;4599;2228;2371;1846;753;1093;8824;5553;3271;4209.0;3046.0;1214.0;1289.0;11557.0;11698.0;10
475;Noord-Overijssel (CR);2015;352965;90248;204344;58373;316050;16688;5657;11031;20227;11160;9067;2536;1282;1254;1970;1141;829;4665;2256;2409;1972;813;1159;9084;5668;3416;4200.0;3104.0;1243.0;1292.0;11625.0;11722.0;10
476;Noord-Overijssel (CR);2016;353965;90082;204183;59700;316204;16844;5709;11135;20917;11437;9480;2624;1314;1310;2044;1161;883;4755;2311;2444;2135;852;1283;9359;5799;3560;4175.0;3155.0;1275.0;1290.0;11507.0;11821.0;10
477;Noord-Overijssel (CR);2017;354690;89727;203939;61024;316027;16998;5765;11233;21665;11772;9893;2735;1371;1364;2124;1201;923;4871;2356;2515;2281;895;1386;9654;5949;3705;4139.0;3171.0;1241.0;1285.0;11704.0;11899.0;10
478;Noord-Overijssel (CR);2018;355454;89383;203483;62588;316000;17150;5826;11324;22304;12060;10244;2817;1413;1404;2195;1222;973;4936;2374;2562;2397;934;1463;9959;6117;3842;4138.0;3222.0;1208.0;1258.0;11997.0;11898.0;10
479;Noord-Overijssel (CR);2019;356463;88853;203615;63995;316133;17360;5931;11429;22970;12361;10609;2908;1474;1434;2245;1239;1006;5012;2403;2609;2533;977;1556;10272;6268;4004;4137.0;3248.0;1232.0;1259.0;11828.0;11968.0;10
480;Noord-Overijssel (CR);2020;357230;88202;203633;65395;315988;17629;6099;11530;23613;12680;10933;3013;1519;1494;2309;1269;1040;5101;2450;2651;2645;1023;1622;10545;6419;4126;4140.0;3279.0;1244.0;1265.0;11575.0;12021.0;10
481;Noord-Overijssel (CR);2021;357665;87268;203454;66943;315627;17773;6218;11555;24265;12981;11284;3119;1571;1548;2374;1320;1054;5231;2481;2750;2775;1053;1722;10766;6556;4210;4138.0;3373.0;1257.0;1254.0;11961.0;12009.0;10
482;Noord-Overijssel (CR);2022;358424;86561;203402;68461;315520;17954;6341;11613;24950;13284;11666;3227;1622;1605;2451;1369;1082;5315;2503;2812;2898;1078;1820;11059;6712;4347;4137.0;3416.0;1203.0;1267.0;11803.0;11964.0;10
483;Noord-Overijssel (CR);2023;358971;85803;203152;70016;315178;18137;6355;11782;25656;13591;12065;3309;1677;1632;2510;1380;1130;5457;2548;2909;3011;1113;1898;11369;6873;4496;4154.0;3468.0;1229.0;1244.0;11602.0;12034.0;10
484;Noord-Overijssel (CR);2024;359262;85205;202424;71633;314710;18256;6428;11828;26296;13926;12370;3400;1727;1673;2588;1419;1169;5513;2581;2932;3167;1172;1995;11628;7027;4601;4133.0;3529.0;1199.0;1276.0;11828.0;11981.0;10
485;Noord-Overijssel (CR);2025;359689;84824;201793;73072;314410;18422;6506;11916;26857;14207;12650;3481;1790;1691;2644;1442;1202;5597;2600;2997;3252;1200;2052;11883;7175;4708;;;;;;;10
486;Zuidwest-Overijssel (CR);2008;152652;38059;92493;22100;128596;10312;3978;6334;13744;8284;5460;815;408;407;620;355;265;6854;3596;3258;515;238;277;4940;3687;1253;1716.0;1280.0;1020.0;1255.0;5098.0;4557.0;11
487;Zuidwest-Overijssel (CR);2009;153414;37990;92928;22496;129104;10451;3997;6454;13859;8290;5569;882;439;443;657;377;280;6781;3574;3207;578;259;319;4961;3641;1320;1681.0;1298.0;1061.0;1252.0;5303.0;4512.0;11
488;Zuidwest-Overijssel (CR);2010;154413;38061;93339;23013;129757;10550;4037;6513;14106;8350;5756;928;463;465;714;412;302;6755;3545;3210;646;281;365;5063;3649;1414;1680.0;1308.0;1071.0;1228.0;4933.0;4563.0;11
489;Zuidwest-Overijssel (CR);2011;155021;37861;93754;23406;130050;10598;4041;6557;14373;8433;5940;987;497;490;769;441;328;6747;3531;3216;729;315;414;5141;3649;1492;1662.0;1319.0;1067.0;1212.0;4892.0;4545.0;11
490;Zuidwest-Overijssel (CR);2012;155582;37681;93549;24352;130317;10643;4046;6597;14622;8528;6094;1043;523;520;845;488;357;6692;3500;3192;788;323;465;5254;3694;1560;1636.0;1344.0;1129.0;1195.0;4880.0;4533.0;11
491;Zuidwest-Overijssel (CR);2013;156171;37538;93374;25259;130546;10728;4093;6635;14897;8651;6246;1111;554;557;903;527;376;6650;3480;3170;873;361;512;5360;3729;1631;1619.0;1371.0;1088.0;1184.0;4850.0;4565.0;11
492;Zuidwest-Overijssel (CR);2014;156625;37292;93324;26009;130716;10804;4121;6683;15105;8761;6344;1167;592;575;941;545;396;6578;3457;3121;937;380;557;5482;3787;1695;1594.0;1381.0;1081.0;1161.0;4871.0;4526.0;11
493;Zuidwest-Overijssel (CR);2015;157120;37005;93379;26736;130856;10865;4153;6712;15399;8888;6511;1219;620;599;984;566;418;6542;3435;3107;997;401;596;5657;3866;1791;1599.0;1392.0;1108.0;1163.0;4792.0;4553.0;11
494;Zuidwest-Overijssel (CR);2016;157532;36789;93371;27372;130969;10962;4190;6772;15601;8956;6645;1281;646;635;1052;607;445;6493;3408;3085;1059;423;636;5716;3872;1844;1584.0;1421.0;1092.0;1158.0;4821.0;4555.0;11
495;Zuidwest-Overijssel (CR);2017;157904;36523;93383;27998;131078;11023;4213;6810;15803;9042;6761;1316;658;658;1092;630;462;6444;3385;3059;1125;447;678;5826;3922;1904;1581.0;1435.0;1083.0;1148.0;4855.0;4605.0;11
496;Zuidwest-Overijssel (CR);2018;158262;36256;93289;28717;131212;11084;4296;6788;15966;9120;6846;1359;674;685;1117;654;463;6353;3356;2997;1189;456;733;5948;3980;1968;1600.0;1444.0;1075.0;1147.0;4795.0;4612.0;11
497;Zuidwest-Overijssel (CR);2019;158545;35917;93233;29395;131189;11131;4320;6811;16225;9245;6980;1389;694;695;1168;681;487;6316;3337;2979;1280;492;788;6072;4041;2031;1590.0;1465.0;1104.0;1132.0;4649.0;4617.0;11
498;Zuidwest-Overijssel (CR);2020;158692;35620;92998;30074;131062;11163;4344;6819;16467;9350;7117;1451;718;733;1202;701;501;6290;3310;2980;1326;513;813;6198;4108;2090;1606.0;1502.0;1097.0;1149.0;4787.0;4600.0;11
499;Zuidwest-Overijssel (CR);2021;158955;35265;92804;30886;130975;11248;4380;6868;16732;9464;7268;1503;745;758;1267;732;535;6233;3277;2956;1403;539;864;6326;4171;2155;1582.0;1519.0;1115.0;1127.0;4679.0;4618.0;11
500;Zuidwest-Overijssel (CR);2022;159086;34883;92575;31628;130890;11314;4439;6875;16882;9546;7336;1538;763;775;1312;764;548;6172;3260;2912;1435;538;897;6425;4221;2204;1598.0;1538.0;1095.0;1105.0;4758.0;4617.0;11
501;Zuidwest-Overijssel (CR);2023;159295;34514;92407;32374;130798;11416;4518;6898;17081;9649;7432;1578;781;797;1346;792;554;6119;3230;2889;1478;547;931;6560;4299;2261;1617.0;1564.0;1072.0;1109.0;4693.0;4617.0;11
502;Zuidwest-Overijssel (CR);2024;159406;34095;92080;33231;130631;11491;4599;6892;17284;9764;7520;1591;794;797;1398;814;584;6096;3223;2873;1499;559;940;6700;4374;2326;1607.0;1593.0;1082.0;1096.0;4382.0;4564.0;11
503;Zuidwest-Overijssel (CR);2025;159246;33788;91484;33974;130192;11522;4619;6903;17532;9903;7629;1635;829;806;1440;837;603;6053;3201;2852;1545;571;974;6859;4465;2394;;;;;;;11
504;Twente (CR);2008;618937;154254;370491;94192;516966;51659;18283;33376;50312;28586;21726;3484;1809;1675;2050;1170;880;23202;11764;11438;3685;1700;1985;17891;12143;5748;7028.0;5531.0;3083.0;3779.0;18089.0;18852.0;12
505;Twente (CR);2009;619052;153647;369216;96189;516402;51590;18374;33216;51060;28702;22358;3726;1950;1776;2160;1234;926;23026;11633;11393;3967;1789;2178;18181;12096;6085;6920.0;5629.0;3177.0;3673.0;17868.0;18831.0;12
506;Twente (CR);2010;618976;152657;367933;98386;515693;51497;18454;33043;51786;28830;22956;3967;2069;1898;2289;1295;994;22812;11503;11309;4205;1859;2346;18513;12104;6409;6847.0;5721.0;3276.0;3669.0;18035.0;18886.0;12
507;Twente (CR);2011;618920;151619;367304;99997;514883;51400;18482;32918;52637;29119;23518;4196;2188;2008;2427;1390;1037;22604;11407;11197;4523;1941;2582;18887;12193;6694;6759.0;5774.0;3366.0;3565.0;17683.0;18522.0;12
508;Twente (CR);2012;618961;150582;364803;103576;514002;51490;18592;32898;53469;29284;24185;4436;2298;2138;2516;1438;1078;22431;11276;11155;4865;2017;2848;19221;12255;6966;6659.0;5832.0;3376.0;3502.0;18202.0;18936.0;12
509;Twente (CR);2013;619003;149568;362661;106774;513210;51425;18698;32727;54368;29477;24891;4650;2415;2235;2655;1511;1144;22329;11154;11175;5145;2086;3059;19589;12311;7278;6640.0;5918.0;3322.0;3437.0;18124.0;18911.0;12
510;Twente (CR);2014;618890;148371;360929;109590;512341;51337;18802;32535;55212;29750;25462;4889;2535;2354;2826;1603;1223;22152;11014;11138;5384;2163;3221;19961;12435;7526;6649.0;5969.0;3335.0;3350.0;17506.0;18630.0;12
511;Twente (CR);2015;618504;147075;359556;111873;511028;51310;18979;32331;56166;30034;26132;5144;2649;2495;2991;1686;1305;22005;10916;11089;5667;2246;3421;20359;12537;7822;6617.0;6084.0;3322.0;3297.0;17906.0;18948.0;12
512;Twente (CR);2016;618093;146220;357862;114011;509793;51304;19179;32125;56996;30389;26607;5327;2771;2556;3138;1777;1361;21830;10768;11062;5925;2323;3602;20776;12750;8026;6636.0;6160.0;3313.0;3227.0;18551.0;19216.0;12
513;Twente (CR);2017;618082;145383;356602;116097;508838;51350;19337;32013;57894;30756;27138;5571;2882;2689;3283;1868;1415;21695;10644;11051;6141;2373;3768;21204;12989;8215;6648.0;6238.0;3198.0;3238.0;18272.0;19217.0;12
514;Twente (CR);2018;617582;144500;354887;118195;507581;51300;19428;31872;58701;31162;27539;5763;2976;2787;3410;1951;1459;21549;10530;11019;6342;2454;3888;21637;13251;8386;6675.0;6299.0;3273.0;3158.0;18483.0;19178.0;12
515;Twente (CR);2019;617446;143547;353642;120257;506512;51268;19621;31647;59666;31606;28060;6006;3099;2907;3592;2048;1544;21400;10499;10901;6585;2535;4050;22083;13425;8658;6709.0;6346.0;3273.0;3139.0;18408.0;19167.0;12
516;Twente (CR);2020;617249;142361;352760;122128;505393;51360;19810;31550;60496;31969;28527;6215;3183;3032;3727;2140;1587;21185;10423;10762;6854;2606;4248;22515;13617;8898;6740.0;6427.0;3204.0;3102.0;18663.0;19296.0;12
517;Twente (CR);2021;617104;140931;352133;124040;504387;51337;19933;31404;61380;32247;29133;6382;3250;3132;3851;2192;1659;21049;10317;10732;7157;2693;4464;22941;13795;9146;6813.0;6537.0;3169.0;3094.0;18599.0;19368.0;12
518;Twente (CR);2022;616753;139907;350878;125968;503276;51310;20113;31197;62167;32546;29621;6551;3342;3209;3992;2261;1731;20882;10219;10663;7415;2773;4642;23327;13951;9376;6835.0;6573.0;3179.0;3067.0;18309.0;19192.0;12
519;Twente (CR);2023;616316;138938;349498;127880;502120;51305;20262;31043;62891;32829;30062;6748;3401;3347;4099;2342;1757;20729;10127;10602;7644;2850;4794;23671;14109;9562;6836.0;6633.0;3112.0;2991.0;18578.0;19165.0;12
520;Twente (CR);2024;616130;137916;348387;129827;501135;51267;20454;30813;63728;33144;30584;6930;3504;3426;4303;2437;1866;20526;9979;10547;7848;2910;4938;24121;14314;9807;6864.0;6727.0;3077.0;2963.0;18354.0;19167.0;12
521;Twente (CR);2025;615634;137276;346485;131873;499979;51147;20530;30617;64508;33497;31011;7145;3610;3535;4476;2527;1949;20362;9896;10466;8020;2949;5071;24505;14515;9990;;;;;;;12
522;Veluwe (CR);2008;642952;163631;382793;96528;564756;39701;15270;24431;38495;22937;15558;3181;1648;1533;2057;1052;1005;10989;5856;5133;6190;3078;3112;16078;11303;4775;7428.0;5507.0;2917.0;3186.0;20590.0;22701.0;13
523;Veluwe (CR);2009;642588;161719;382347;98522;562955;39995;15314;24681;39638;23387;16251;3402;1756;1646;2183;1147;1036;11159;5872;5287;6391;3119;3272;16503;11493;5010;7361.0;5562.0;3115.0;3152.0;20611.0;22669.0;13
524;Veluwe (CR);2010;642363;160003;381697;100663;561277;40169;15360;24809;40917;24021;16896;3641;1896;1745;2315;1240;1075;11292;5913;5379;6593;3177;3416;17076;11795;5281;7252.0;5629.0;3183.0;3104.0;21341.0;22911.0;13
525;Veluwe (CR);2011;642585;158291;381953;102341;559987;40385;15370;25015;42213;24613;17600;3838;2005;1833;2488;1325;1163;11410;5959;5451;6786;3227;3559;17691;12097;5594;7170.0;5698.0;3286.0;3100.0;22350.0;22755.0;13
526;Veluwe (CR);2012;643916;156845;380298;106773;559634;40695;15519;25176;43587;25322;18265;4067;2152;1915;2596;1391;1205;11548;6064;5484;6997;3299;3698;18379;12416;5963;7136.0;5736.0;3351.0;3076.0;21567.0;23039.0;13
527;Veluwe (CR);2013;644187;155256;378365;110566;558479;41017;15719;25298;44691;25796;18895;4296;2272;2024;2737;1467;1270;11659;6085;5574;7194;3361;3833;18805;12611;6194;7057.0;5801.0;3380.0;3001.0;21596.0;22949.0;13
528;Veluwe (CR);2014;644547;153605;377206;113736;557348;41339;15859;25480;45860;26313;19547;4522;2375;2147;2899;1577;1322;11777;6115;5662;7367;3419;3948;19295;12827;6468;7032.0;5873.0;3315.0;3019.0;21967.0;22816.0;13
529;Veluwe (CR);2015;645219;152411;376347;116461;556544;41682;15945;25737;46993;26790;20203;4752;2483;2269;3010;1654;1356;11869;6117;5752;7518;3430;4088;19844;13106;6738;7024.0;5971.0;3299.0;2959.0;21786.0;23054.0;13
530;Veluwe (CR);2016;645418;151100;375573;118745;555337;41884;16060;25824;48197;27235;20962;4935;2572;2363;3158;1747;1411;12027;6167;5860;7730;3444;4286;20347;13305;7042;6994.0;6041.0;3307.0;2953.0;22227.0;23033.0;13
531;Veluwe (CR);2017;645980;150176;374635;121169;554682;42129;16234;25895;49169;27709;21460;5113;2646;2467;3289;1832;1457;12068;6170;5898;7889;3499;4390;20810;13562;7248;6990.0;6078.0;3277.0;2963.0;22560.0;23093.0;13
532;Veluwe (CR);2018;646728;149077;373818;123833;554051;42399;16399;26000;50278;28239;22039;5311;2710;2601;3402;1892;1510;12085;6192;5893;8075;3554;4521;21405;13891;7514;7023.0;6221.0;3345.0;2918.0;22303.0;23119.0;13
533;Veluwe (CR);2019;647217;147695;373210;126312;553222;42678;16538;26140;51317;28726;22591;5484;2799;2685;3560;1976;1584;12100;6188;5912;8237;3581;4656;21936;14182;7754;7004.0;6267.0;3320.0;2893.0;22528.0;23097.0;13
534;Veluwe (CR);2020;647896;146494;372569;128833;552419;42902;16658;26244;52575;29350;23225;5697;2892;2805;3719;2070;1649;12171;6221;5950;8408;3642;4766;22580;14525;8055;6997.0;6338.0;3310.0;2899.0;22185.0;23146.0;13
535;Veluwe (CR);2021;648076;144970;371774;131332;551501;43037;16805;26232;53538;29822;23716;5886;2997;2889;3864;2120;1744;12281;6278;6003;8530;3677;4853;22977;14750;8227;7006.0;6453.0;3256.0;2887.0;22259.0;23003.0;13
536;Veluwe (CR);2022;648322;143605;370740;133977;550521;43365;16976;26389;54436;30308;24128;6022;3077;2945;3995;2189;1806;12316;6310;6006;8701;3723;4978;23402;15009;8393;6985.0;6510.0;3274.0;2837.0;22292.0;22813.0;13
537;Veluwe (CR);2023;648782;142433;369820;136529;549835;43531;17086;26445;55416;30814;24602;6214;3174;3040;4102;2256;1846;12386;6351;6035;8812;3751;5061;23902;15282;8620;6953.0;6581.0;3246.0;2831.0;22059.0;22825.0;13
538;Veluwe (CR);2024;648855;141357;368263;139235;548738;43686;17224;26462;56431;31324;25107;6367;3255;3112;4236;2324;1912;12483;6408;6075;8907;3781;5126;24438;15556;8882;6888.0;6674.0;3211.0;2793.0;21868.0;22771.0;13
539;Veluwe (CR);2025;648658;140702;365973;141983;547602;43735;17308;26427;57321;31703;25618;6501;3308;3193;4323;2362;1961;12576;6426;6150;9028;3827;5201;24893;15780;9113;;;;;;;13
540;Achterhoek (CR);2008;398419;96910;234883;66626;353604;27340;9067;18273;17475;10039;7436;1280;609;671;868;433;435;7216;3743;3473;1598;776;822;6513;4478;2035;3715.0;3747.0;1085.0;1663.0;13433.0;14092.0;14
541;Achterhoek (CR);2009;397205;95537;233662;68006;351910;27142;9045;18097;18153;10425;7728;1451;707;744;976;504;472;7252;3761;3491;1728;827;901;6746;4626;2120;3613.0;3791.0;1156.0;1630.0;13998.0;14268.0;14
542;Achterhoek (CR);2010;396326;94088;232831;69407;350655;26929;8928;18001;18742;10706;8036;1589;784;805;1076;575;501;7287;3771;3516;1894;894;1000;6896;4682;2214;3544.0;3826.0;1226.0;1588.0;14278.0;14510.0;14
543;Achterhoek (CR);2011;395492;92405;232450;70637;349299;26794;8898;17896;19399;11037;8362;1743;860;883;1168;638;530;7313;3773;3540;2052;957;1095;7123;4809;2314;3510.0;3861.0;1206.0;1564.0;13782.0;14544.0;14
544;Achterhoek (CR);2012;394059;90534;230216;73309;347552;26597;8841;17756;19910;11199;8711;1922;940;982;1234;664;570;7342;3745;3597;2144;1010;1134;7268;4840;2428;3476.0;3963.0;1274.0;1523.0;13978.0;14496.0;14
545;Achterhoek (CR);2013;392840;88771;228357;75712;345933;26516;8884;17632;20391;11430;8961;2042;999;1043;1335;731;604;7307;3712;3595;2265;1069;1196;7442;4919;2523;3421.0;3984.0;1235.0;1514.0;14322.0;14633.0;14
546;Achterhoek (CR);2014;391728;87207;226684;77837;344289;26458;8932;17526;20981;11664;9317;2185;1051;1134;1404;771;633;7290;3704;3586;2413;1125;1288;7689;5013;2676;3410.0;4015.0;1232.0;1497.0;14311.0;14646.0;14
547;Achterhoek (CR);2015;390561;85591;225469;79501;342706;26236;8790;17446;21619;11989;9630;2336;1142;1194;1498;831;667;7279;3703;3576;2545;1153;1392;7961;5160;2801;3422.0;4077.0;1171.0;1485.0;14687.0;14689.0;14
548;Achterhoek (CR);2016;389621;84133;224290;81198;341286;26172;8872;17300;22163;12211;9952;2484;1214;1270;1575;866;709;7290;3713;3577;2677;1202;1475;8137;5216;2921;3426.0;4139.0;1187.0;1439.0;14539.0;14778.0;14
549;Achterhoek (CR);2017;388459;82755;222956;82748;339526;26140;8872;17268;22793;12502;10291;2671;1281;1390;1696;929;767;7306;3723;3583;2784;1243;1541;8336;5326;3010;3461.0;4168.0;1205.0;1435.0;14885.0;14753.0;14
550;Achterhoek (CR);2018;387694;81638;221617;84439;338226;26004;8880;17124;23464;12792;10672;2791;1347;1444;1825;999;826;7329;3732;3597;2888;1270;1618;8631;5444;3187;3529.0;4210.0;1182.0;1414.0;14711.0;14728.0;14
551;Achterhoek (CR);2019;386802;80164;220773;85865;336885;25927;8914;17013;23990;13010;10980;2915;1401;1514;1912;1030;882;7367;3762;3605;2986;1318;1668;8810;5499;3311;3558.0;4274.0;1152.0;1411.0;14655.0;14650.0;14
552;Achterhoek (CR);2020;385869;78795;219687;87387;335480;25801;8891;16910;24588;13272;11316;3034;1456;1578;1994;1054;940;7392;3775;3617;3085;1361;1724;9083;5626;3457;3581.0;4354.0;1188.0;1400.0;14741.0;14682.0;14
553;Achterhoek (CR);2021;384985;77492;218667;88826;334194;25672;8854;16818;25119;13568;11551;3145;1509;1636;2105;1126;979;7365;3788;3577;3184;1392;1792;9320;5753;3567;3616.0;4375.0;1145.0;1363.0;15077.0;14704.0;14
554;Achterhoek (CR);2022;384436;76491;217524;90421;333167;25571;8883;16688;25698;13881;11817;3268;1568;1700;2188;1170;1018;7411;3811;3600;3280;1422;1858;9551;5910;3641;3659.0;4416.0;1168.0;1358.0;15172.0;14701.0;14
555;Achterhoek (CR);2023;383996;75542;216305;92149;332268;25458;8936;16522;26270;14124;12146;3405;1633;1772;2306;1235;1071;7430;3787;3643;3386;1442;1944;9743;6027;3716;3699.0;4499.0;1175.0;1338.0;14715.0;14612.0;14
556;Achterhoek (CR);2024;383174;74796;214779;93599;330971;25442;8983;16459;26761;14366;12395;3502;1696;1806;2395;1303;1092;7439;3783;3656;3486;1477;2009;9939;6107;3832;3698.0;4545.0;1148.0;1333.0;15054.0;14502.0;14
557;Achterhoek (CR);2025;382726;74241;213313;95172;329993;25483;9059;16424;27250;14647;12603;3595;1762;1833;2495;1355;1140;7436;3785;3651;3603;1523;2080;10121;6222;3899;;;;;;;14
558;Arnhem/Nijmegen (CR);2008;701648;160977;439786;100885;573457;67940;24041;43899;60251;35238;25013;6899;3499;3400;5194;3113;2081;17380;9101;8279;7590;3696;3894;23188;15829;7359;7209.0;5991.0;4063.0;5033.0;33199.0;30378.0;15
559;Arnhem/Nijmegen (CR);2009;704827;160142;441955;102730;575486;67957;24162;43795;61384;35432;25952;7154;3619;3535;5248;3144;2104;17472;9041;8431;7962;3787;4175;23548;15841;7707;7277.0;6068.0;4239.0;4970.0;33122.0;30745.0;15
560;Arnhem/Nijmegen (CR);2010;707788;159289;443463;105036;577414;68056;24370;43686;62318;35419;26899;7365;3719;3646;5359;3181;2178;17516;8953;8563;8305;3853;4452;23773;15713;8060;7303.0;6140.0;4394.0;4885.0;33419.0;30925.0;15
561;Arnhem/Nijmegen (CR);2011;711044;158050;445656;107338;579371;68242;24570;43672;63431;35576;27855;7552;3807;3745;5476;3253;2223;17702;8966;8736;8673;3972;4701;24028;15578;8450;7336.0;6207.0;4475.0;4852.0;32196.0;30718.0;15
562;Arnhem/Nijmegen (CR);2012;713359;156687;444748;111924;580574;68218;24716;43502;64567;35837;28730;7756;3939;3817;5634;3360;2274;17839;8935;8904;8960;4015;4945;24378;15588;8790;7368.0;6295.0;4542.0;4778.0;32106.0;30758.0;15
563;Arnhem/Nijmegen (CR);2013;715641;155679;443641;116321;581651;68331;24932;43399;65659;36044;29615;7978;4043;3935;5750;3427;2323;17991;8911;9080;9254;4070;5184;24686;15593;9093;7459.0;6413.0;4582.0;4700.0;31765.0;31032.0;15
564;Arnhem/Nijmegen (CR);2014;717397;154703;442765;119929;582369;68235;25074;43161;66793;36265;30528;8188;4160;4028;5877;3502;2375;18104;8857;9247;9586;4154;5432;25038;15592;9446;7529.0;6496.0;4511.0;4617.0;31395.0;30881.0;15
565;Arnhem/Nijmegen (CR);2015;718928;153583;441985;123360;582935;68281;25253;43028;67712;36614;31098;8335;4284;4051;5960;3580;2380;18260;8909;9351;9858;4190;5668;25299;15651;9648;7610.0;6565.0;4474.0;4559.0;32096.0;31206.0;15
566;Arnhem/Nijmegen (CR);2016;720869;153030;441328;126511;583631;68409;25454;42955;68829;36846;31983;8504;4348;4156;6075;3668;2407;18398;8885;9513;10173;4271;5902;25679;15674;10005;7704.0;6663.0;4465.0;4499.0;31495.0;31142.0;15
567;Arnhem/Nijmegen (CR);2017;722305;152386;440325;129594;583998;68469;25696;42773;69838;37142;32696;8688;4482;4206;6247;3766;2481;18501;8883;9618;10443;4313;6130;25959;15698;10261;7790.0;6744.0;4419.0;4443.0;31659.0;31297.0;15
568;Arnhem/Nijmegen (CR);2018;723787;151942;438858;132987;584405;68415;25814;42601;70967;37433;33534;8882;4590;4292;6374;3842;2532;18588;8832;9756;10726;4384;6342;26397;15785;10612;7784.0;6862.0;4340.0;4448.0;31213.0;31130.0;15
569;Arnhem/Nijmegen (CR);2019;724782;151149;437597;136036;584346;68390;26008;42382;72046;37681;34365;9036;4675;4361;6519;3912;2607;18767;8848;9919;10958;4421;6537;26766;15825;10941;7813.0;6949.0;4308.0;4387.0;31019.0;31103.0;15
570;Arnhem/Nijmegen (CR);2020;725582;150298;436180;139104;584270;68362;26081;42281;72950;38010;34940;9184;4756;4428;6652;3994;2658;18840;8838;10002;11143;4448;6695;27131;15974;11157;7902.0;7058.0;4316.0;4336.0;31417.0;31062.0;15
571;Arnhem/Nijmegen (CR);2021;726832;149597;435232;142003;584224;68392;26238;42154;74216;38389;35827;9375;4848;4527;6831;4093;2738;18957;8837;10120;11449;4521;6928;27604;16090;11514;7916.0;7172.0;4296.0;4268.0;31151.0;31185.0;15
572;Arnhem/Nijmegen (CR);2022;727658;149111;433612;144935;583930;68443;26386;42057;75285;38753;36532;9513;4917;4596;6936;4142;2794;19071;8840;10231;11729;4599;7130;28036;16255;11781;7913.0;7220.0;4205.0;4250.0;30750.0;31067.0;15
573;Arnhem/Nijmegen (CR);2023;728076;148583;431740;147753;583403;68417;26598;41819;76256;39026;37230;9652;4954;4698;7142;4256;2886;19154;8838;10316;11952;4662;7290;28356;16316;12040;7920.0;7351.0;4170.0;4193.0;31291.0;30947.0;15
574;Arnhem/Nijmegen (CR);2024;729047;148064;430118;150865;583276;68425;26817;41608;77346;39292;38054;9801;5002;4799;7251;4306;2945;19296;8821;10475;12167;4728;7439;28831;16435;12396;7936.0;7484.0;4212.0;4168.0;30805.0;30992.0;15
575;Arnhem/Nijmegen (CR);2025;729439;147998;427509;153932;582564;68352;27042;41310;78523;39623;38900;9931;5037;4894;7405;4385;3020;19462;8827;10635;12452;4800;7652;29273;16574;12699;;;;;;;15
576;Zuidwest-Gelderland (CR);2008;231413;61997;139396;30020;205585;12752;4242;8510;13076;7043;6033;1070;528;542;606;271;335;2879;1464;1415;5029;2561;2468;3492;2219;1273;2635.0;1784.0;564.0;989.0;7006.0;7846.0;16
577;Zuidwest-Gelderland (CR);2009;231029;61334;138694;31001;205000;12733;4239;8494;13296;7084;6212;1130;572;558;642;291;351;2916;1463;1453;5023;2503;2520;3585;2255;1330;2578.0;1808.0;598.0;954.0;7409.0;8085.0;16
578;Zuidwest-Gelderland (CR);2010;230804;60509;138227;32068;204491;12709;4247;8462;13604;7204;6400;1208;595;613;695;328;367;2946;1476;1470;5041;2489;2552;3714;2316;1398;2506.0;1844.0;606.0;944.0;7628.0;8135.0;16
579;Zuidwest-Gelderland (CR);2011;230645;59545;138193;32907;203955;12872;4316;8556;13818;7272;6546;1269;622;647;733;356;377;3008;1499;1509;5061;2494;2567;3747;2301;1446;2468.0;1888.0;648.0;944.0;7701.0;8248.0;16
580;Zuidwest-Gelderland (CR);2012;230402;58623;137074;34705;203324;12949;4378;8571;14129;7418;6711;1353;657;696;766;376;390;3071;1521;1550;5094;2498;2596;3845;2366;1479;2441.0;1932.0;629.0;907.0;7669.0;8217.0;16
581;Zuidwest-Gelderland (CR);2013;230106;57635;136096;36375;202707;13031;4404;8627;14368;7565;6803;1425;681;744;783;394;389;3087;1533;1554;5112;2510;2602;3961;2447;1514;2397.0;1943.0;620.0;889.0;7570.0;8300.0;16
582;Zuidwest-Gelderland (CR);2014;229591;56672;135185;37734;201920;13065;4392;8673;14606;7702;6904;1481;727;754;830;421;409;3107;1556;1551;5100;2491;2609;4088;2507;1581;2334.0;1967.0;629.0;884.0;7713.0;8261.0;16
583;Zuidwest-Gelderland (CR);2015;229181;55706;134499;38976;201206;13070;4370;8700;14905;7835;7070;1555;748;807;870;458;412;3176;1575;1601;5045;2479;2566;4259;2575;1684;2345.0;2001.0;626.0;878.0;7809.0;8277.0;16
584;Zuidwest-Gelderland (CR);2016;228827;54897;133839;40091;200573;13076;4408;8668;15178;7960;7218;1608;779;829;915;478;437;3239;1591;1648;4999;2449;2550;4417;2663;1754;2337.0;2054.0;634.0;875.0;7834.0;8328.0;16
585;Zuidwest-Gelderland (CR);2017;228405;54114;133054;41237;199955;13117;4422;8695;15333;8044;7289;1682;817;865;939;493;446;3266;1608;1658;4965;2437;2528;4481;2689;1792;2351.0;2078.0;632.0;847.0;7586.0;8356.0;16
586;Zuidwest-Gelderland (CR);2018;227725;53194;132110;42421;199055;13155;4470;8685;15515;8112;7403;1744;840;904;977;517;460;3314;1619;1695;4915;2420;2495;4565;2716;1849;2343.0;2111.0;625.0;836.0;7763.0;8265.0;16
587;Zuidwest-Gelderland (CR);2019;227271;52255;131519;43497;198309;13226;4526;8700;15736;8234;7502;1773;848;925;1042;546;496;3323;1618;1705;4918;2431;2487;4680;2791;1889;2363.0;2142.0;639.0;834.0;7769.0;8319.0;16
588;Zuidwest-Gelderland (CR);2020;226777;51332;130821;44624;197556;13278;4560;8718;15943;8341;7602;1814;864;950;1085;574;511;3336;1628;1708;4925;2417;2508;4783;2858;1925;2372.0;2189.0;631.0;826.0;7752.0;8313.0;16
589;Zuidwest-Gelderland (CR);2021;226232;50465;130010;45757;196749;13279;4580;8699;16204;8462;7742;1891;896;995;1123;582;541;3369;1633;1736;4859;2387;2472;4962;2964;1998;2366.0;2232.0;609.0;813.0;8031.0;8290.0;16
590;Zuidwest-Gelderland (CR);2022;225931;49682;129361;46888;196112;13359;4625;8734;16460;8596;7864;1923;903;1020;1170;605;565;3440;1673;1767;4827;2370;2457;5100;3045;2055;2373.0;2261.0;578.0;819.0;8042.0;8273.0;16
591;Zuidwest-Gelderland (CR);2023;225594;49029;128740;47825;195558;13365;4643;8722;16671;8698;7973;1985;943;1042;1186;612;574;3482;1682;1800;4807;2367;2440;5211;3094;2117;2368.0;2307.0;609.0;806.0;8024.0;8239.0;16
592;Zuidwest-Gelderland (CR);2024;225263;48379;128034;48850;194982;13353;4642;8711;16928;8824;8104;2001;940;1061;1243;637;606;3564;1710;1854;4761;2353;2408;5359;3184;2175;2398.0;2367.0;593.0;791.0;8020.0;8212.0;16
593;Zuidwest-Gelderland (CR);2025;224931;47980;126994;49957;194366;13487;4714;8773;17078;8888;8190;2015;951;1064;1274;657;617;3590;1730;1860;4705;2316;2389;5494;3234;2260;;;;;;;16
594;Utrecht (CR);2008;1195923;296476;742843;156604;962147;98077;37146;60931;135699;75307;60392;18572;9806;8766;8029;4329;3700;25698;13295;12403;44486;22476;22010;38914;25401;13513;14653.0;9075.0;7361.0;8233.0;56287.0;54206.0;17
595;Utrecht (CR);2009;1202917;296490;745834;160593;965711;99071;37658;61413;138135;75969;62166;18849;9904;8945;8317;4506;3811;26145;13332;12813;44733;22192;22541;40091;26035;14056;14588.0;9219.0;7703.0;8119.0;57124.0;54814.0;17
596;Utrecht (CR);2010;1210361;296356;748924;165081;969726;100262;38211;62051;140373;76427;63946;19117;9994;9123;8576;4674;3902;26466;13327;13139;45078;21981;23097;41136;26451;14685;14520.0;9419.0;8080.0;8172.0;56982.0;54955.0;17
597;Utrecht (CR);2011;1217561;295958;753210;168393;973359;101493;38904;62589;142709;76960;65749;19415;10079;9336;8881;4902;3979;26832;13367;13465;45356;21760;23596;42225;26852;15373;14514.0;9483.0;8297.0;8085.0;57582.0;55303.0;17
598;Utrecht (CR);2012;1225236;295423;752739;177074;977259;102845;39659;63186;145132;77657;67475;19696;10181;9515;9173;5140;4033;27193;13385;13808;45703;21608;24095;43367;27343;16024;14455.0;9649.0;8353.0;8076.0;57682.0;55415.0;17
599;Utrecht (CR);2013;1232751;295052;752953;184746;981116;104183;40341;63842;147452;78186;69266;19954;10295;9659;9509;5332;4177;27467;13411;14056;45985;21405;24580;44537;27743;16794;14518.0;9787.0;8458.0;8062.0;57857.0;55513.0;17
600;Utrecht (CR);2014;1240387;294984;753805;191598;985092;105536;41176;64360;149759;78820;70939;20157;10374;9783;9836;5548;4288;27800;13450;14350;46290;21264;25026;45676;28184;17492;14585.0;9957.0;8466.0;7996.0;58172.0;55529.0;17
601;Utrecht (CR);2015;1248272;295099;755394;197779;989212;106903;42037;64866;152157;79411;72746;20426;10466;9960;10098;5714;4384;28155;13502;14653;46520;21097;25423;46958;28632;18326;14618.0;10114.0;8519.0;8029.0;57700.0;55562.0;17
602;Utrecht (CR);2016;1255542;295145;756628;203769;993058;108084;42692;65392;154400;80081;74319;20672;10579;10093;10385;5879;4506;28443;13583;14860;46717;20924;25793;48183;29116;19067;14594.0;10267.0;8506.0;7924.0;57383.0;55763.0;17
603;Utrecht (CR);2017;1262213;295035;757798;209380;996423;109296;43392;65904;156494;80753;75741;20895;10677;10218;10611;6048;4563;28637;13592;15045;46919;20826;26093;49432;29610;19822;14668.0;10469.0;8595.0;7916.0;57752.0;55912.0;17
604;Utrecht (CR);2018;1269106;295013;759123;214970;999667;110547;44080;66467;158892;81491;77401;21139;10768;10371;11001;6266;4735;29032;13682;15350;47039;20704;26335;50681;30071;20610;14782.0;10701.0;8568.0;7910.0;58148.0;55798.0;17
605;Utrecht (CR);2019;1276329;294776;760829;220724;1003387;112036;44893;67143;160906;81983;78923;21397;10828;10569;11324;6464;4860;29318;13725;15593;47174;20629;26545;51693;30337;21356;14806.0;10834.0;8571.0;7923.0;58340.0;56219.0;17
606;Utrecht (CR);2020;1283219;294266;762548;226405;1006842;113403;45613;67790;162974;82687;80287;21644;10913;10731;11670;6680;4990;29541;13753;15788;47154;20498;26656;52965;30843;22122;14811.0;11071.0;8592.0;7845.0;58690.0;56674.0;17
607;Utrecht (CR);2021;1289860;293188;764961;231711;1009831;114969;46541;68428;165060;83524;81536;21917;11027;10890;11996;6901;5095;29821;13817;16004;47100;20394;26706;54226;31385;22841;14892.0;11228.0;8573.0;7908.0;59103.0;57110.0;17
608;Utrecht (CR);2022;1296316;292413;766268;237635;1012796;116329;47313;69016;167191;84164;83027;22198;11089;11109;12323;7096;5227;30074;13834;16240;47097;20297;26800;55499;31848;23651;14957.0;11427.0;8678.0;7880.0;59361.0;57486.0;17
609;Utrecht (CR);2023;1302667;291466;767589;243612;1015590;117545;47980;69565;169532;85091;84441;22459;11191;11268;12733;7327;5406;30272;13854;16418;47129;20232;26897;56939;32487;24452;14973.0;11644.0;8651.0;7771.0;60074.0;57832.0;17
610;Utrecht (CR);2024;1309268;290568;768955;249745;1018732;118948;48796;70152;171588;85979;85609;22669;11277;11392;13043;7492;5551;30582;13902;16680;47035;20132;26903;58259;33176;25083;14924.0;11930.0;8639.0;7798.0;60918.0;58010.0;17
611;Utrecht (CR);2025;1316171;290607;769493;256071;1021986;120508;49784;70724;173677;86695;86982;22889;11345;11544;13346;7640;5706;30823;13877;16946;46964;20048;26916;59655;33785;25870;;;;;;;17
612;Kop van Noord-Holland (CR);2008;365753;91300;224114;50339;320605;23793;8930;14863;21355;12262;9093;3793;1892;1901;2668;1470;1198;3042;1563;1479;2030;987;1043;9822;6350;3472;3843.0;2918.0;1537.0;2113.0;14519.0;14491.0;18
613;Kop van Noord-Holland (CR);2009;366182;90428;223561;52193;320393;23831;8885;14946;21958;12506;9452;3849;1915;1934;2705;1467;1238;3173;1632;1541;2175;1047;1128;10056;6445;3611;3786.0;2973.0;1605.0;2079.0;14416.0;14656.0;18
614;Kop van Noord-Holland (CR);2010;366329;89368;222691;54270;319870;23894;8880;15014;22565;12754;9811;3933;1945;1988;2730;1478;1252;3311;1701;1610;2324;1108;1216;10267;6522;3745;3747.0;3015.0;1633.0;2035.0;15253.0;14850.0;18
615;Kop van Noord-Holland (CR);2011;367096;88234;222771;56091;319876;24095;8956;15139;23125;13019;10106;4025;1980;2045;2749;1502;1247;3455;1776;1679;2448;1151;1297;10448;6610;3838;3688.0;3079.0;1673.0;2007.0;15572.0;15001.0;18
616;Kop van Noord-Holland (CR);2012;367982;87241;221318;59423;319837;24289;9059;15230;23856;13285;10571;4126;2015;2111;2789;1522;1267;3585;1831;1754;2607;1201;1406;10749;6716;4033;3663.0;3126.0;1660.0;1971.0;15690.0;15039.0;18
617;Kop van Noord-Holland (CR);2013;368898;86230;219898;62770;319874;24570;9212;15358;24454;13524;10930;4237;2066;2171;2816;1556;1260;3726;1867;1859;2720;1238;1482;10955;6797;4158;3680.0;3213.0;1673.0;1937.0;15579.0;14946.0;18
618;Kop van Noord-Holland (CR);2014;369769;85225;218986;65558;319935;24737;9254;15483;25097;13754;11343;4326;2087;2239;2837;1581;1256;3894;1918;1976;2839;1275;1564;11201;6893;4308;3658.0;3280.0;1642.0;1906.0;15537.0;15033.0;18
619;Kop van Noord-Holland (CR);2015;370427;84280;218133;68014;319730;24880;9316;15564;25817;14048;11769;4424;2117;2307;2888;1625;1263;4039;1989;2050;2979;1318;1661;11487;6999;4488;3649.0;3319.0;1623.0;1884.0;15444.0;14998.0;18
620;Kop van Noord-Holland (CR);2016;370984;83460;217317;70207;319639;25075;9450;15625;26270;14224;12046;4456;2153;2303;2937;1635;1302;4183;2037;2146;3054;1342;1712;11640;7057;4583;3652.0;3398.0;1697.0;1874.0;15289.0;15045.0;18
621;Kop van Noord-Holland (CR);2017;371356;82682;216510;72164;319335;25216;9561;15655;26805;14399;12406;4498;2163;2335;2970;1659;1311;4337;2083;2254;3151;1370;1781;11849;7124;4725;3658.0;3452.0;1668.0;1853.0;15571.0;15061.0;18
622;Kop van Noord-Holland (CR);2018;371933;82017;215765;74151;319278;25304;9631;15673;27351;14624;12727;4554;2193;2361;3007;1678;1329;4448;2107;2341;3285;1408;1877;12057;7238;4819;3694.0;3524.0;1622.0;1849.0;15662.0;15024.0;18
623;Kop van Noord-Holland (CR);2019;372556;81307;215105;76144;319146;25416;9708;15708;27994;14840;13154;4609;2209;2400;3032;1668;1364;4657;2193;2464;3416;1452;1964;12280;7318;4962;3739.0;3618.0;1611.0;1807.0;15459.0;15129.0;18
624;Kop van Noord-Holland (CR);2020;372850;80552;214381;77917;318694;25595;9834;15761;28561;15063;13498;4657;2229;2428;3104;1721;1383;4775;2235;2540;3525;1497;2028;12500;7381;5119;3776.0;3685.0;1617.0;1796.0;15680.0;15203.0;18
625;Kop van Noord-Holland (CR);2021;373294;79676;214017;79601;318376;25749;9973;15776;29169;15338;13831;4719;2255;2464;3128;1726;1402;4871;2297;2574;3662;1543;2119;12789;7517;5272;3778.0;3748.0;1664.0;1795.0;15911.0;15148.0;18
626;Kop van Noord-Holland (CR);2022;374000;78968;213646;81386;318149;26019;10160;15859;29832;15630;14202;4797;2291;2506;3172;1749;1423;5015;2357;2658;3763;1581;2182;13085;7652;5433;3831.0;3835.0;1630.0;1784.0;15858.0;15241.0;18
627;Kop van Noord-Holland (CR);2023;374497;78530;213002;82965;317874;26193;10313;15880;30430;15901;14529;4796;2294;2502;3225;1767;1458;5132;2394;2738;3903;1622;2281;13374;7824;5550;3844.0;3893.0;1622.0;1772.0;16068.0;15245.0;18
628;Kop van Noord-Holland (CR);2024;375164;78080;212653;84431;317700;26474;10458;16016;30990;16197;14793;4833;2314;2519;3239;1775;1464;5214;2437;2777;4000;1639;2361;13704;8032;5672;3899.0;3999.0;1558.0;1745.0;15881.0;15144.0;18
629;Kop van Noord-Holland (CR);2025;375661;77870;211647;86144;317471;26677;10590;16087;31513;16431;15082;4886;2341;2545;3278;1790;1488;5273;2488;2785;4114;1667;2447;13962;8145;5817;;;;;;;18
630;Alkmaar en omgeving (CR);2008;228578;55087;140255;33236;191124;19129;7637;11492;18325;10497;7828;2514;1260;1254;1865;1007;858;3719;1932;1787;2674;1392;1282;7553;4906;2647;2364.0;1763.0;1150.0;1498.0;9311.0;9374.0;19
631;Alkmaar en omgeving (CR);2009;228797;54509;140023;34265;191017;19136;7564;11572;18644;10605;8039;2563;1272;1291;1887;1030;857;3761;1941;1820;2784;1435;1349;7649;4927;2722;2318.0;1800.0;1239.0;1475.0;9404.0;9553.0;19
632;Alkmaar en omgeving (CR);2010;228959;54001;139429;35529;190881;19097;7586;11511;18981;10719;8262;2601;1289;1312;1926;1058;868;3842;1965;1877;2830;1439;1391;7782;4968;2814;2266.0;1833.0;1231.0;1424.0;10801.0;9631.0;19
633;Alkmaar en omgeving (CR);2011;230397;53625;140220;36552;191702;19286;7655;11631;19409;10898;8511;2683;1334;1349;1968;1104;864;3899;1983;1916;2897;1450;1447;7962;5027;2935;2242.0;1879.0;1278.0;1435.0;10560.0;9867.0;19
634;Alkmaar en omgeving (CR);2012;231322;53085;139719;38518;192019;19444;7775;11669;19859;11088;8771;2731;1333;1398;2045;1161;884;3976;2003;1973;2998;1497;1501;8109;5094;3015;2241.0;1893.0;1308.0;1409.0;10794.0;9941.0;19
635;Alkmaar en omgeving (CR);2013;232457;52617;139427;40413;192693;19519;7824;11695;20245;11214;9031;2788;1347;1441;2121;1195;926;4040;2035;2005;3042;1512;1530;8254;5125;3129;2254.0;1955.0;1364.0;1386.0;11014.0;10070.0;19
636;Alkmaar en omgeving (CR);2014;233716;52404;139352;41960;193351;19698;7951;11747;20667;11408;9259;2873;1384;1489;2185;1238;947;4118;2076;2042;3141;1540;1601;8350;5170;3180;2248.0;1978.0;1305.0;1359.0;11262.0;10086.0;19
637;Alkmaar en omgeving (CR);2015;235141;52118;139566;43457;194112;19926;8081;11845;21103;11574;9529;2940;1416;1524;2238;1270;968;4203;2097;2106;3214;1549;1665;8508;5242;3266;2282.0;2037.0;1323.0;1346.0;10605.0;10165.0;19
638;Alkmaar en omgeving (CR);2016;235830;51654;139487;44689;194329;20044;8184;11860;21457;11717;9740;3008;1451;1557;2265;1292;973;4225;2095;2130;3328;1588;1740;8631;5291;3340;2303.0;2064.0;1277.0;1343.0;10950.0;10271.0;19
639;Alkmaar en omgeving (CR);2017;236709;51512;139354;45843;194615;20166;8265;11901;21928;11856;10072;3129;1511;1618;2300;1300;1000;4319;2121;2198;3447;1607;1840;8733;5317;3416;2307.0;2099.0;1308.0;1339.0;10762.0;10261.0;19
640;Alkmaar en omgeving (CR);2018;237417;51235;139138;47044;194837;20259;8281;11978;22321;12048;10273;3173;1544;1629;2324;1312;1012;4381;2126;2255;3500;1636;1864;8943;5430;3513;2321.0;2132.0;1265.0;1323.0;10842.0;10227.0;19
641;Alkmaar en omgeving (CR);2019;238195;50929;139119;48147;195129;20341;8350;11991;22725;12192;10533;3256;1574;1682;2376;1355;1021;4452;2133;2319;3561;1647;1914;9080;5483;3597;2363.0;2179.0;1258.0;1303.0;10852.0;10282.0;19
642;Alkmaar en omgeving (CR);2020;238932;50639;139075;49218;195425;20383;8380;12003;23124;12391;10733;3334;1607;1727;2420;1399;1021;4532;2168;2364;3646;1683;1963;9192;5534;3658;2382.0;2216.0;1270.0;1297.0;10843.0;10262.0;19
643;Alkmaar en omgeving (CR);2021;239676;50222;139266;50188;195698;20506;8469;12037;23472;12538;10934;3384;1627;1757;2480;1447;1033;4567;2160;2407;3693;1697;1996;9348;5607;3741;2422.0;2252.0;1247.0;1278.0;11033.0;10283.0;19
644;Alkmaar en omgeving (CR);2022;240590;50024;139345;51221;196175;20600;8566;12034;23815;12650;11165;3423;1630;1793;2517;1451;1066;4577;2156;2421;3758;1702;2056;9540;5711;3829;2434.0;2326.0;1246.0;1254.0;10845.0;10393.0;19
645;Alkmaar en omgeving (CR);2023;241173;49701;139296;52176;196416;20696;8688;12008;24061;12752;11309;3480;1659;1821;2530;1445;1085;4581;2151;2430;3808;1716;2092;9662;5781;3881;2451.0;2356.0;1232.0;1240.0;11097.0;10350.0;19
646;Alkmaar en omgeving (CR);2024;242040;49531;139385;53124;196758;20800;8789;12011;24482;12938;11544;3563;1684;1879;2581;1475;1106;4676;2160;2516;3821;1719;2102;9841;5900;3941;2460.0;2386.0;1277.0;1248.0;10944.0;10277.0;19
647;Alkmaar en omgeving (CR);2025;242839;49532;139203;54104;197018;20895;8896;11999;24926;13149;11777;3640;1697;1943;2646;1507;1139;4740;2196;2544;3903;1751;2152;9997;5998;3999;;;;;;;19
648;IJmond (CR);2008;189096;46304;111229;31563;160358;15531;6018;9513;13207;7485;5722;1291;618;673;630;293;337;4169;2234;1935;1286;634;652;5831;3706;2125;1774.0;1690.0;704.0;730.0;7760.0;7402.0;20
649;IJmond (CR);2009;189540;45935;111602;32003;160223;15561;6015;9546;13756;7715;6041;1350;637;713;671;322;349;4329;2297;2032;1399;683;716;6007;3776;2231;1755.0;1708.0;732.0;722.0;7984.0;7641.0;20
650;IJmond (CR);2010;189967;45576;111927;32464;160051;15653;6053;9600;14263;7891;6372;1457;668;789;722;356;366;4439;2354;2085;1513;718;795;6132;3795;2337;1762.0;1737.0;792.0;728.0;7561.0;7643.0;20
651;IJmond (CR);2011;189986;44826;112419;32741;159551;15720;6134;9586;14715;8105;6610;1528;693;835;744;372;372;4542;2410;2132;1606;757;849;6295;3873;2422;1739.0;1777.0;751.0;703.0;7868.0;7651.0;20
652;IJmond (CR);2012;190233;44227;112002;34004;159274;15821;6206;9615;15138;8307;6831;1613;744;869;778;390;388;4604;2432;2172;1715;807;908;6428;3934;2494;1741.0;1771.0;762.0;697.0;7710.0;7664.0;20
653;IJmond (CR);2013;190338;43719;111565;35054;158809;15956;6300;9656;15573;8483;7090;1704;785;919;808;407;401;4708;2462;2246;1821;848;973;6532;3981;2551;1742.0;1787.0;781.0;698.0;7584.0;7679.0;20
654;IJmond (CR);2014;190296;43027;111461;35808;158310;16017;6389;9628;15969;8665;7304;1783;824;959;855;441;414;4820;2516;2304;1875;858;1017;6636;4026;2610;1748.0;1819.0;788.0;701.0;7297.0;7622.0;20
655;IJmond (CR);2015;190010;42438;111218;36354;157503;16085;6445;9640;16422;8850;7572;1858;856;1002;881;460;421;4894;2536;2358;1970;908;1062;6819;4090;2729;1773.0;1845.0;757.0;665.0;7736.0;7492.0;20
656;IJmond (CR);2016;190284;42008;111344;36932;157371;16111;6540;9571;16802;9005;7797;1923;882;1041;907;479;428;4979;2569;2410;2050;938;1112;6943;4137;2806;1761.0;1839.0;755.0;648.0;7726.0;7658.0;20
657;IJmond (CR);2017;190400;41583;111243;37574;157036;16152;6595;9557;17212;9141;8071;1984;918;1066;966;500;466;5098;2578;2520;2088;964;1124;7076;4181;2895;1796.0;1862.0;766.0;641.0;7830.0;7511.0;20
658;IJmond (CR);2018;190792;41249;111371;38172;156800;16242;6666;9576;17750;9357;8393;2052;951;1101;999;518;481;5240;2621;2619;2203;1001;1202;7256;4266;2990;1824.0;1881.0;762.0;665.0;7651.0;7542.0;20
659;IJmond (CR);2019;190964;40797;111482;38685;156537;16307;6747;9560;18120;9480;8640;2103;971;1132;1037;550;487;5337;2637;2700;2272;1018;1254;7371;4304;3067;1851.0;1887.0;765.0;652.0;8151.0;7709.0;20
660;IJmond (CR);2020;191501;40594;111647;39260;156472;16440;6830;9610;18589;9692;8897;2177;1011;1166;1078;567;511;5484;2691;2793;2356;1051;1305;7494;4372;3122;1891.0;1898.0;752.0;627.0;7749.0;7605.0;20
661;IJmond (CR);2021;191778;40204;111646;39928;156172;16570;6900;9670;19036;9894;9142;2232;1040;1192;1122;594;528;5602;2729;2873;2448;1107;1341;7632;4424;3208;1920.0;1912.0;776.0;637.0;7833.0;7682.0;20
662;IJmond (CR);2022;192086;39885;111548;40653;156007;16689;7014;9675;19390;10050;9340;2293;1083;1210;1174;618;556;5663;2756;2907;2524;1120;1404;7736;4473;3263;1931.0;1938.0;766.0;639.0;8087.0;7725.0;20
663;IJmond (CR);2023;192585;39780;111309;41496;155863;16838;7109;9729;19884;10238;9646;2350;1100;1250;1214;642;572;5809;2813;2996;2623;1146;1477;7888;4537;3351;1947.0;1965.0;762.0;634.0;7808.0;7818.0;20
664;IJmond (CR);2024;192705;39565;110910;42230;155500;16947;7222;9725;20258;10400;9858;2386;1133;1253;1251;663;588;5913;2839;3074;2669;1163;1506;8039;4602;3437;1971.0;1975.0;787.0;605.0;7878.0;7773.0;20
665;IJmond (CR);2025;193013;39441;110356;43216;155207;17066;7254;9812;20740;10606;10134;2429;1157;1272;1313;690;623;6021;2880;3141;2723;1177;1546;8254;4702;3552;;;;;;;20
666;Agglomeratie Haarlem (CR);2008;215409;48213;130513;36683;169043;23808;9345;14463;22558;12729;9829;2573;1280;1293;1230;618;612;6235;3329;2906;4654;2490;2164;7866;5012;2854;2247.0;2125.0;1711.0;1702.0;10226.0;10434.0;21
667;Agglomeratie Haarlem (CR);2009;215365;48092;130409;36864;168433;23987;9477;14510;22945;12835;10110;2665;1294;1371;1271;653;618;6198;3319;2879;4702;2463;2239;8109;5106;3003;2216.0;2139.0;1814.0;1694.0;10463.0;10540.0;21
668;Agglomeratie Haarlem (CR);2010;215509;47935;130400;37174;167997;24150;9660;14490;23362;12993;10369;2732;1318;1414;1313;705;608;6181;3284;2897;4803;2450;2353;8333;5236;3097;2178.0;2121.0;1933.0;1691.0;9932.0;10529.0;21
669;Agglomeratie Haarlem (CR);2011;215235;47497;130527;37211;167244;24330;9862;14468;23661;13099;10562;2802;1343;1459;1361;740;621;6123;3248;2875;4848;2442;2406;8527;5326;3201;2143.0;2127.0;1943.0;1650.0;10274.0;10597.0;21
670;Agglomeratie Haarlem (CR);2012;215250;47209;129557;38484;166722;24525;10043;14482;24003;13177;10826;2851;1352;1499;1406;765;641;6075;3224;2851;4906;2428;2478;8765;5408;3357;2089.0;2107.0;1951.0;1631.0;10113.0;10666.0;21
671;Agglomeratie Haarlem (CR);2013;215029;46840;128536;39653;166023;24658;10255;14403;24348;13325;11023;2944;1386;1558;1477;816;661;6023;3193;2830;4952;2435;2517;8952;5495;3457;2064.0;2135.0;1947.0;1633.0;10169.0;10628.0;21
672;Agglomeratie Haarlem (CR);2014;214839;46342;128015;40482;165341;24808;10442;14366;24690;13441;11249;3011;1424;1587;1517;834;683;6005;3185;2820;5014;2441;2573;9143;5557;3586;2027.0;2121.0;1944.0;1563.0;10115.0;10512.0;21
673;Agglomeratie Haarlem (CR);2015;214755;46099;127369;41287;164769;25062;10669;14393;24924;13524;11400;3041;1444;1597;1559;867;692;5987;3180;2807;5070;2440;2630;9267;5593;3674;2029.0;2123.0;1946.0;1579.0;10423.0;10470.0;21
674;Agglomeratie Haarlem (CR);2016;215007;45871;127244;41892;164448;25303;10874;14429;25256;13638;11618;3114;1459;1655;1597;903;694;5989;3163;2826;5130;2459;2671;9426;5654;3772;2024.0;2139.0;1887.0;1563.0;10654.0;10515.0;21
675;Agglomeratie Haarlem (CR);2017;215377;45765;127234;42378;164116;25668;11191;14477;25593;13709;11884;3153;1470;1683;1675;942;733;5979;3135;2844;5151;2421;2730;9635;5741;3894;2046.0;2156.0;1937.0;1564.0;10399.0;10532.0;21
676;Agglomeratie Haarlem (CR);2018;215525;45517;127162;42846;163693;25940;11434;14506;25892;13866;12026;3197;1490;1707;1756;986;770;5943;3137;2806;5168;2426;2742;9828;5827;4001;2048.0;2147.0;1930.0;1555.0;10625.0;10543.0;21
677;Agglomeratie Haarlem (CR);2019;215907;45319;127222;43366;163423;26329;11704;14625;26155;14008;12147;3215;1500;1715;1826;1035;791;5928;3117;2811;5175;2442;2733;10011;5914;4097;2075.0;2162.0;1913.0;1546.0;10560.0;10731.0;21
678;Agglomeratie Haarlem (CR);2020;216033;44936;127209;43888;163027;26616;11922;14694;26390;14130;12260;3228;1490;1738;1886;1078;808;5923;3111;2812;5162;2435;2727;10191;6016;4175;2077.0;2175.0;1924.0;1523.0;10541.0;10734.0;21
679;Agglomeratie Haarlem (CR);2021;216164;44645;127065;44454;162666;26770;12093;14677;26728;14263;12465;3311;1530;1781;1952;1115;837;5896;3070;2826;5163;2432;2731;10406;6116;4290;2072.0;2176.0;1900.0;1542.0;10628.0;10730.0;21
680;Agglomeratie Haarlem (CR);2022;216338;44302;127082;44954;162431;26986;12235;14751;26921;14337;12584;3346;1526;1820;1990;1131;859;5846;3024;2822;5153;2436;2717;10586;6220;4366;2081.0;2192.0;1873.0;1513.0;10762.0;10728.0;21
681;Agglomeratie Haarlem (CR);2023;216646;44046;127019;45581;162166;27250;12441;14809;27230;14485;12745;3360;1521;1839;2054;1163;891;5862;3031;2831;5187;2446;2741;10767;6324;4443;2058.0;2193.0;1886.0;1529.0;10825.0;10890.0;21
682;Agglomeratie Haarlem (CR);2024;216828;43688;126888;46252;161757;27552;12619;14933;27519;14616;12903;3399;1544;1855;2105;1189;916;5860;3020;2840;5197;2444;2753;10958;6419;4539;2063.0;2222.0;1851.0;1509.0;10512.0;10817.0;21
683;Agglomeratie Haarlem (CR);2025;216733;43344;126403;46986;161299;27778;12782;14996;27656;14680;12976;3435;1560;1875;2168;1224;944;5835;3001;2834;5171;2441;2730;11047;6454;4593;;;;;;;21
684;Zaanstreek (CR);2008;158080;38233;96212;23635;121219;13354;5261;8093;23507;12909;10598;4388;2239;2149;882;473;409;10255;5547;4708;2337;1158;1179;5645;3492;2153;1692.0;1263.0;653.0;886.0;4977.0;4553.0;22
685;Zaanstreek (CR);2009;158719;38299;96039;24381;121106;13607;5405;8202;24006;13051;10955;4470;2231;2239;925;497;428;10187;5494;4693;2582;1273;1309;5842;3556;2286;1686.0;1299.0;714.0;872.0;5490.0;4592.0;22
686;Zaanstreek (CR);2010;159870;38620;96091;25159;121300;13908;5586;8322;24662;13247;11415;4530;2214;2316;988;525;463;10175;5451;4724;2894;1433;1461;6075;3624;2451;1661.0;1316.0;738.0;882.0;5653.0;4586.0;22
687;Zaanstreek (CR);2011;161151;38673;96810;25668;121573;14204;5764;8440;25374;13498;11876;4615;2199;2416;1050;548;502;10130;5404;4726;3177;1565;1612;6402;3782;2620;1649.0;1338.0;814.0;884.0;5548.0;4682.0;22
688;Zaanstreek (CR);2012;162270;38688;96542;27040;121775;14493;5936;8557;26002;13753;12249;4713;2228;2485;1134;588;546;10094;5349;4745;3431;1698;1733;6630;3890;2740;1657.0;1363.0;779.0;865.0;5489.0;4740.0;22
689;Zaanstreek (CR);2013;163243;38663;96498;28082;121796;14794;6107;8687;26653;14023;12630;4804;2225;2579;1190;610;580;10046;5333;4713;3704;1818;1886;6909;4037;2872;1649.0;1370.0;812.0;875.0;5325.0;4781.0;22
690;Zaanstreek (CR);2014;164021;38648;96381;28992;121754;15053;6268;8785;27214;14150;13064;4907;2232;2675;1229;619;610;10002;5281;4721;3928;1915;2013;7148;4103;3045;1624.0;1388.0;820.0;846.0;5589.0;4774.0;22
691;Zaanstreek (CR);2015;165057;38689;96533;29835;121915;15381;6438;8943;27761;14326;13435;4992;2246;2746;1298;641;657;9945;5252;4693;4174;2010;2164;7352;4177;3175;1636.0;1427.0;870.0;867.0;5503.0;4732.0;22
692;Zaanstreek (CR);2016;166060;38767;96730;30563;122085;15635;6568;9067;28340;14529;13811;5078;2245;2833;1384;676;708;9869;5204;4665;4448;2137;2311;7561;4267;3294;1651.0;1460.0;823.0;860.0;5629.0;4788.0;22
693;Zaanstreek (CR);2017;167064;38797;97071;31196;122267;15910;6722;9188;28887;14710;14177;5158;2246;2912;1450;691;759;9804;5177;4627;4671;2245;2426;7804;4351;3453;1665.0;1481.0;818.0;845.0;5693.0;4824.0;22
694;Zaanstreek (CR);2018;168109;38745;97467;31897;122400;16299;6934;9365;29410;14883;14527;5216;2247;2969;1513;729;784;9742;5159;4583;4908;2337;2571;8031;4411;3620;1699.0;1520.0;864.0;859.0;5783.0;4916.0;22
695;Zaanstreek (CR);2019;169168;38613;98022;32533;122634;16598;7103;9495;29936;15065;14871;5257;2222;3035;1576;759;817;9682;5116;4566;5182;2436;2746;8239;4532;3707;1708.0;1518.0;838.0;865.0;5471.0;4966.0;22
696;Zaanstreek (CR);2020;169855;38484;98281;33090;122668;16837;7262;9575;30350;15186;15164;5283;2209;3074;1636;774;862;9566;5060;4506;5380;2544;2836;8485;4599;3886;1722.0;1538.0;850.0;849.0;5501.0;4894.0;22
697;Zaanstreek (CR);2021;170659;38262;98699;33698;122736;17187;7451;9736;30736;15298;15438;5331;2202;3129;1667;792;875;9541;5040;4501;5544;2611;2933;8653;4653;4000;1726.0;1575.0;841.0;868.0;5531.0;4939.0;22
698;Zaanstreek (CR);2022;171391;38110;98956;34325;122692;17502;7609;9893;31197;15460;15737;5391;2192;3199;1690;811;879;9479;4996;4483;5713;2681;3032;8924;4780;4144;1779.0;1607.0;841.0;872.0;5263.0;4879.0;22
699;Zaanstreek (CR);2023;171926;37976;99068;34882;122619;17787;7775;10012;31520;15517;16003;5426;2182;3244;1752;844;908;9390;4932;4458;5898;2743;3155;9054;4816;4238;1788.0;1641.0;835.0;835.0;5546.0;4980.0;22
700;Zaanstreek (CR);2024;172647;37773;99442;35432;122681;18022;7904;10118;31944;15702;16242;5471;2177;3294;1790;870;920;9336;4918;4418;6059;2827;3232;9288;4910;4378;1833.0;1677.0;833.0;858.0;5521.0;4975.0;22
701;Zaanstreek (CR);2025;173338;37770;99633;35935;122675;18290;8041;10249;32373;15869;16504;5539;2186;3353;1827;887;940;9304;4872;4432;6242;2919;3323;9461;5005;4456;;;;;;;22
702;Groot-Amsterdam (CR);2008;1226560;275661;796942;153957;766753;158682;81909;76773;301125;175681;125444;79882;45825;34057;14515;8838;5677;42921;23168;19753;70478;35967;34511;93329;61883;31446;15586.0;9467.0;19008.0;18213.0;48366.0;46311.0;23
703;Groot-Amsterdam (CR);2009;1235678;277540;800432;157706;772013;162229;84417;77812;301436;173666;127770;78840;44754;34086;14683;8922;5761;43233;22930;20303;70482;35221;35261;94198;61839;32359;15563.0;9609.0;19829.0;18202.0;48481.0;46704.0;23
704;Groot-Amsterdam (CR);2010;1245188;279529;803476;162183;777206;166140;87254;78886;301842;171919;129923;77806;43802;34004;14878;9025;5853;43545;22656;20889;70456;34582;35874;95157;61854;33303;15580.0;9729.0;20620.0;18103.0;46461.0;46964.0;23
705;Groot-Amsterdam (CR);2011;1253226;280827;807104;165295;780880;169955;90049;79906;302391;170275;132116;77121;43058;34063;15133;9155;5978;43823;22411;21412;70486;33971;36515;95828;61680;34148;15499.0;9892.0;21137.0;17906.0;46314.0;47175.0;23
706;Groot-Amsterdam (CR);2012;1261348;281775;805986;173587;784344;173977;92947;81030;303027;168710;134317;76294;42262;34032;15405;9305;6100;44178;22192;21986;70658;33516;37142;96492;61435;35057;15478.0;10035.0;21310.0;17961.0;46227.0;46909.0;23
707;Groot-Amsterdam (CR);2013;1269608;282807;805782;181019;788084;177846;95735;82111;303678;167210;136468;75530;41505;34025;15658;9435;6223;44506;22042;22464;70791;33059;37732;97193;61169;36024;15375.0;10176.0;21427.0;17797.0;46373.0;47012.0;23
708;Groot-Amsterdam (CR);2014;1277932;284283;806280;187369;791868;181725;98462;83263;304339;165964;138375;74835;40839;33996;15914;9567;6347;44751;21924;22827;70843;32542;38301;97996;61092;36904;15425.0;10327.0;21441.0;17791.0;46151.0;46798.0;23
709;Groot-Amsterdam (CR);2015;1286173;285564;807644;192965;795420;185606;101188;84418;305147;164714;140433;74268;40217;34051;16150;9662;6488;45109;21773;23336;70882;32113;38769;98738;60949;37789;15418.0;10464.0;21492.0;17686.0;45178.0;46456.0;23
710;Groot-Amsterdam (CR);2016;1293786;286685;808484;198617;798719;189484;103715;85769;305583;163334;142249;73603;39567;34036;16355;9760;6595;45396;21618;23778;70799;31656;39143;99430;60733;38697;15552.0;10650.0;21463.0;17593.0;45256.0;46948.0;23
711;Groot-Amsterdam (CR);2017;1300986;287731;809713;203542;801839;192922;106049;86873;306225;162226;143999;72946;38981;33965;16614;9904;6710;45686;21499;24187;70756;31253;39503;100223;60589;39634;15610.0;10810.0;21560.0;17483.0;44982.0;46829.0;23
712;Groot-Amsterdam (CR);2018;1308145;288454;810747;208944;804705;196852;108604;88248;306588;160981;145607;72241;38370;33871;16823;10003;6820;45937;21397;24540;70675;30870;39805;100912;60341;40571;15617.0;10904.0;21587.0;17462.0;45078.0;47025.0;23
713;Groot-Amsterdam (CR);2019;1315181;289024;812019;214138;807495;200440;110971;89469;307246;160024;147222;71669;37829;33840;17067;10108;6959;46229;21335;24894;70491;30467;40024;101790;60285;41505;15728.0;11094.0;21552.0;17365.0;45541.0;47092.0;23
714;Groot-Amsterdam (CR);2020;1322596;289458;813672;219466;810497;204199;113324;90875;307900;159044;148856;70988;37230;33758;17333;10243;7090;46551;21252;25299;70372;30072;40300;102656;60247;42409;15886.0;11315.0;21625.0;17357.0;45573.0;47262.0;23
715;Groot-Amsterdam (CR);2021;1329877;289695;815452;224730;813691;207813;115706;92107;308373;158046;150327;70297;36615;33682;17545;10318;7227;46802;21165;25637;70179;29734;40445;103550;60214;43336;15934.0;11517.0;21701.0;17198.0;45062.0;47694.0;23
716;Groot-Amsterdam (CR);2022;1336300;289475;816538;230287;815903;211213;117935;93278;309184;157306;151878;69751;36035;33716;17882;10473;7409;46988;21070;25918;70008;29462;40546;104555;60266;44289;16002.0;11702.0;21602.0;17082.0;45343.0;47699.0;23
717;Groot-Amsterdam (CR);2023;1342885;289468;817602;235815;818215;214856;120203;94653;309814;156523;153291;69181;35492;33689;18176;10595;7581;47279;21020;26259;69569;29106;40463;105609;60310;45299;16046.0;11894.0;21710.0;17051.0;45907.0;48388.0;23
718;Groot-Amsterdam (CR);2024;1349341;289373;818534;241434;820309;218369;122378;95991;310663;155756;154907;68708;34970;33738;18527;10742;7785;47474;20917;26557;69386;28818;40568;106568;60309;46259;16223.0;12124.0;21581.0;16931.0;45577.0;48518.0;23
719;Groot-Amsterdam (CR);2025;1355287;289238;818676;247373;822067;221850;124484;97366;311370;154880;156490;68086;34335;33751;18763;10800;7963;47660;20844;26816;69116;28483;40633;107745;60418;47327;;;;;;;23
720;Het Gooi en Vechtstreek (CR);2008;243661;57083;144266;42312;197611;25960;9942;16018;20090;11035;9055;2035;889;1146;1323;614;709;3808;2048;1760;5446;2902;2544;7478;4582;2896;2313.0;2296.0;1699.0;1978.0;13436.0;12924.0;24
721;Het Gooi en Vechtstreek (CR);2009;243945;56770;144439;42736;197257;26043;10062;15981;20645;11184;9461;2202;951;1251;1376;647;729;3895;2059;1836;5531;2887;2644;7641;4640;3001;2268.0;2294.0;1768.0;1946.0;13357.0;13029.0;24
722;Het Gooi en Vechtstreek (CR);2010;244098;56369;144462;43267;196928;26016;10124;15892;21154;11388;9766;2332;992;1340;1429;681;748;4005;2116;1889;5532;2866;2666;7856;4733;3123;2239.0;2293.0;1804.0;1950.0;13746.0;13064.0;24
723;Het Gooi en Vechtstreek (CR);2011;244613;55874;145284;43455;196689;26266;10310;15956;21658;11545;10113;2464;1056;1408;1451;679;772;4111;2152;1959;5606;2869;2737;8026;4789;3237;2244.0;2303.0;1876.0;1934.0;13466.0;13196.0;24
724;Het Gooi en Vechtstreek (CR);2012;244791;55388;144276;45127;196248;26393;10422;15971;22150;11756;10394;2607;1137;1470;1519;741;778;4205;2183;2022;5670;2870;2800;8149;4825;3324;2243.0;2312.0;1870.0;1907.0;14043.0;13249.0;24
725;Het Gooi en Vechtstreek (CR);2013;245497;54994;143991;46512;196286;26543;10586;15957;22668;11937;10731;2734;1210;1524;1576;779;797;4317;2208;2109;5712;2863;2849;8329;4877;3452;2239.0;2297.0;1868.0;1902.0;14271.0;13358.0;24
726;Het Gooi en Vechtstreek (CR);2014;246335;54649;144109;47577;196383;26808;10805;16003;23144;12084;11060;2871;1269;1602;1622;805;817;4402;2234;2168;5759;2865;2894;8490;4911;3579;2278.0;2313.0;1895.0;1871.0;13496.0;13336.0;24
727;Het Gooi en Vechtstreek (CR);2015;246513;54166;143886;48461;196072;26893;10913;15980;23548;12207;11341;2967;1311;1656;1697;853;844;4462;2239;2223;5819;2881;2938;8603;4923;3680;2279.0;2302.0;1856.0;1830.0;13315.0;13322.0;24
728;Het Gooi en Vechtstreek (CR);2016;246529;53832;143350;49347;195502;27028;11048;15980;23999;12360;11639;3097;1371;1726;1760;907;853;4505;2233;2272;5877;2888;2989;8760;4961;3799;2295.0;2329.0;1837.0;1811.0;13578.0;13230.0;24
729;Het Gooi en Vechtstreek (CR);2017;246893;53446;143263;50184;195236;27216;11186;16030;24441;12503;11938;3203;1423;1780;1795;906;889;4589;2277;2312;5871;2871;3000;8983;5026;3957;2298.0;2350.0;1866.0;1814.0;13563.0;13185.0;24
730;Het Gooi en Vechtstreek (CR);2018;247291;53242;142966;51083;194932;27421;11286;16135;24938;12684;12254;3306;1458;1848;1856;933;923;4688;2325;2363;5908;2884;3024;9180;5084;4096;2336.0;2348.0;1823.0;1813.0;13281.0;13240.0;24
731;Het Gooi en Vechtstreek (CR);2019;247353;52812;142712;51829;194518;27583;11386;16197;25252;12778;12474;3352;1504;1848;1876;945;931;4749;2319;2430;5938;2888;3050;9337;5122;4215;2352.0;2357.0;1860.0;1796.0;13346.0;13176.0;24
732;Het Gooi en Vechtstreek (CR);2020;247605;52432;142594;52579;194169;27721;11482;16239;25715;12980;12735;3430;1555;1875;1949;979;970;4851;2326;2525;5942;2878;3064;9543;5242;4301;2348.0;2386.0;1861.0;1779.0;13367.0;13268.0;24
733;Het Gooi en Vechtstreek (CR);2021;247777;52071;142433;53273;193882;27917;11702;16215;25978;13069;12909;3496;1588;1908;1972;1007;965;4874;2327;2547;5972;2883;3089;9664;5264;4400;2347.0;2391.0;1839.0;1769.0;13369.0;13189.0;24
734;Het Gooi en Vechtstreek (CR);2022;248017;51712;142308;53997;193485;28182;11841;16341;26350;13191;13159;3557;1628;1929;2037;1038;999;4925;2342;2583;6023;2874;3149;9808;5309;4499;2361.0;2429.0;1777.0;1758.0;13559.0;13277.0;24
735;Het Gooi en Vechtstreek (CR);2023;248278;51376;142076;54826;193170;28460;12062;16398;26648;13304;13344;3623;1672;1951;2065;1057;1008;5020;2361;2659;6036;2856;3180;9904;5358;4546;2359.0;2451.0;1802.0;1752.0;13559.0;13412.0;24
736;Het Gooi en Vechtstreek (CR);2024;248404;50986;141661;55757;192893;28652;12239;16413;26859;13343;13516;3685;1713;1972;2119;1056;1063;5042;2360;2682;6038;2852;3186;9975;5362;4613;2372.0;2488.0;1753.0;1718.0;13377.0;13246.0;24
737;Het Gooi en Vechtstreek (CR);2025;248481;50709;140922;56850;192508;28808;12395;16413;27165;13451;13714;3766;1742;2024;2183;1090;1093;5096;2374;2722;6010;2811;3199;10110;5434;4676;;;;;;;24
738;Agglomeratie Leiden en Bollenstreek (CR);2008;387575;93053;239263;55259;320817;36054;16904;19150;30704;18099;12605;3988;2100;1888;2170;1172;998;4096;2157;1939;7005;3655;3350;13445;9015;4430;4096.0;3085.0;3553.0;3299.0;15581.0;17482.0;25
739;Agglomeratie Leiden en Bollenstreek (CR);2009;386988;92244;238286;56458;319306;36321;17116;19205;31361;18391;12970;4112;2154;1958;2203;1197;1006;4313;2238;2075;7083;3678;3405;13650;9124;4526;4063.0;3115.0;3668.0;3266.0;15747.0;17511.0;25
740;Agglomeratie Leiden en Bollenstreek (CR);2010;386621;91167;237479;57975;317837;36798;17511;19287;31986;18615;13371;4223;2187;2036;2233;1239;994;4502;2294;2208;7173;3683;3490;13855;9212;4643;4011.0;3160.0;3829.0;3247.0;16077.0;17410.0;25
741;Agglomeratie Leiden en Bollenstreek (CR);2011;386771;90050;237805;58916;316873;37288;17848;19440;32610;18846;13764;4323;2222;2101;2304;1300;1004;4660;2361;2299;7242;3666;3576;14081;9297;4784;3999.0;3202.0;3913.0;3210.0;15521.0;17391.0;25
742;Agglomeratie Leiden en Bollenstreek (CR);2012;386452;88682;235901;61869;315552;37634;18140;19494;33266;19176;14090;4447;2278;2169;2436;1416;1020;4761;2412;2349;7323;3661;3662;14299;9409;4890;3991.0;3219.0;3961.0;3171.0;15613.0;17068.0;25
743;Agglomeratie Leiden en Bollenstreek (CR);2013;386601;87687;234651;64263;314504;38124;18444;19680;33973;19426;14547;4565;2339;2226;2551;1483;1068;4918;2485;2433;7424;3627;3797;14515;9492;5023;3958.0;3272.0;3977.0;3155.0;15630.0;16951.0;25
744;Agglomeratie Leiden en Bollenstreek (CR);2014;386839;86913;233583;66343;313682;38585;18733;19852;34572;19704;14868;4617;2350;2267;2597;1540;1057;5076;2575;2501;7501;3644;3857;14781;9595;5186;3972.0;3340.0;3943.0;3131.0;15283.0;16640.0;25
745;Agglomeratie Leiden en Bollenstreek (CR);2015;386972;86080;232785;68107;312656;39106;19103;20003;35210;19925;15285;4710;2374;2336;2691;1583;1108;5213;2609;2604;7570;3650;3920;15026;9709;5317;3964.0;3381.0;3912.0;3091.0;15803.0;16692.0;25
746;Agglomeratie Leiden en Bollenstreek (CR);2016;387528;85549;232159;69820;312015;39643;19404;20239;35870;20185;15685;4803;2411;2392;2753;1629;1124;5321;2624;2697;7642;3676;3966;15351;9845;5506;4014.0;3417.0;3877.0;3091.0;15805.0;16740.0;25
747;Agglomeratie Leiden en Bollenstreek (CR);2017;388013;85062;231486;71465;311396;40059;19699;20360;36558;20505;16053;4923;2469;2454;2859;1695;1164;5460;2663;2797;7683;3678;4005;15633;10000;5633;4013.0;3485.0;3889.0;3059.0;15845.0;16611.0;25
748;Agglomeratie Leiden en Bollenstreek (CR);2018;388656;84706;230708;73242;310885;40655;20141;20514;37116;20697;16419;4965;2494;2471;2948;1757;1191;5627;2710;2917;7734;3667;4067;15842;10069;5773;4018.0;3552.0;3894.0;3023.0;15751.0;16697.0;25
749;Agglomeratie Leiden en Bollenstreek (CR);2019;389094;84024;230240;74830;310367;41080;20465;20615;37647;20965;16682;5038;2509;2529;3004;1779;1225;5710;2787;2923;7782;3667;4115;16113;10223;5890;4023.0;3568.0;3893.0;2982.0;15974.0;16802.0;25
750;Agglomeratie Leiden en Bollenstreek (CR);2020;389676;83367;229776;76533;309729;41551;20809;20742;38396;21336;17060;5131;2559;2572;3109;1842;1267;5905;2864;3041;7829;3694;4135;16422;10377;6045;4035.0;3620.0;3822.0;2967.0;16030.0;16754.0;25
751;Agglomeratie Leiden en Bollenstreek (CR);2021;390264;82825;229418;78021;309168;42158;21190;20968;38938;21602;17336;5207;2588;2619;3205;1899;1306;6014;2925;3089;7877;3682;4195;16635;10508;6127;4048.0;3714.0;3891.0;2951.0;16117.0;16809.0;25
752;Agglomeratie Leiden en Bollenstreek (CR);2022;390903;82363;228894;79646;308636;42611;21548;21063;39656;21932;17724;5270;2631;2639;3308;1977;1331;6125;2973;3152;7944;3686;4258;17009;10665;6344;4061.0;3755.0;3864.0;2917.0;15856.0;16748.0;25
753;Agglomeratie Leiden en Bollenstreek (CR);2023;391318;81841;228161;81316;307899;43159;21951;21208;40260;22230;18030;5308;2661;2647;3380;2010;1370;6311;3042;3269;7991;3722;4269;17270;10795;6475;4042.0;3813.0;3873.0;2914.0;16448.0;16935.0;25
754;Agglomeratie Leiden en Bollenstreek (CR);2024;392064;81526;227495;83043;307228;43893;22415;21478;40943;22490;18453;5408;2697;2711;3516;2062;1454;6400;3103;3297;8009;3718;4291;17610;10910;6700;4022.0;3873.0;3879.0;2912.0;15877.0;16847.0;25
755;Agglomeratie Leiden en Bollenstreek (CR);2025;392273;81220;226370;84683;306258;44346;22754;21592;41669;22880;18789;5454;2743;2711;3605;2112;1493;6530;3138;3392;8083;3763;4320;17997;11124;6873;;;;;;;25
756;Agglomeratie 's-Gravenhage (CR);2008;788864;185826;489573;113465;495345;103675;52920;50755;189844;114092;75752;56745;33390;23355;14553;9795;4758;34767;19140;15627;29261;14858;14403;54518;36909;17609;9663.0;7067.0;12367.0;11082.0;34303.0;33563.0;26
757;Agglomeratie 's-Gravenhage (CR);2009;793581;186696;491928;114957;496921;106232;54932;51300;190428;112596;77832;56098;32720;23378;14500;9628;4872;34932;18754;16178;29849;14808;15041;55049;36686;18363;9662.0;7060.0;12964.0;10964.0;32717.0;33504.0;26
758;Agglomeratie 's-Gravenhage (CR);2010;797451;187093;493286;117072;497668;108859;56997;51862;190924;111317;79607;55398;32131;23267;14597;9616;4981;35098;18384;16714;30388;14768;15620;55443;36418;19025;9623.0;7157.0;13510.0;10921.0;32432.0;33096.0;26
759;Agglomeratie 's-Gravenhage (CR);2011;801929;187220;496615;118094;498562;111652;59201;52451;191715;110247;81468;54752;31584;23168;14732;9633;5099;35334;18147;17187;31012;14769;16243;55885;36114;19771;9645.0;7231.0;13802.0;10823.0;32649.0;33068.0;26
760;Agglomeratie 's-Gravenhage (CR);2012;806972;187700;495724;123548;499964;114585;61502;53083;192423;109175;83248;54108;31025;23083;14790;9591;5199;35593;17932;17661;31496;14735;16761;56436;35892;20544;9661.0;7240.0;13980.0;10775.0;30372.0;32397.0;26
761;Agglomeratie 's-Gravenhage (CR);2013;810639;187864;494697;128078;500242;117552;63693;53859;192845;108193;84652;53496;30551;22945;14825;9594;5231;35817;17706;18111;31914;14730;17184;56793;35612;21181;9638.0;7264.0;14101.0;10750.0;29471.0;31981.0;26
762;Agglomeratie 's-Gravenhage (CR);2014;813927;187776;494424;131727;500088;120504;65881;54623;193335;107211;86124;52911;30079;22832;14882;9544;5338;35987;17505;18482;32348;14683;17665;57207;35400;21807;9664.0;7321.0;14224.0;10723.0;29025.0;31692.0;26
763;Agglomeratie 's-Gravenhage (CR);2015;817187;187869;494208;135110;500173;123424;67948;55476;193590;106405;87185;52244;29595;22649;14956;9570;5386;36104;17401;18703;32762;14679;18083;57524;35160;22364;9730.0;7404.0;14284.0;10640.0;28608.0;31232.0;26
764;Agglomeratie 's-Gravenhage (CR);2016;820607;188467;493964;138176;500084;126415;69994;56421;194108;105674;88434;51601;29125;22476;15148;9607;5541;36219;17295;18924;33219;14687;18532;57921;34960;22961;9800.0;7438.0;14292.0;10619.0;28066.0;31314.0;26
765;Agglomeratie 's-Gravenhage (CR);2017;823470;188800;493603;141067;499877;129320;72002;57318;194273;104800;89473;50967;28628;22339;15184;9544;5640;36207;17139;19068;33562;14691;18871;58353;34798;23555;9876.0;7480.0;14307.0;10576.0;28441.0;31072.0;26
766;Agglomeratie 's-Gravenhage (CR);2018;827037;189230;493595;144212;499918;132397;74009;58388;194722;104218;90504;50383;28176;22207;15279;9550;5729;36320;17056;19264;33896;14710;19186;58844;34726;24118;9911.0;7507.0;14362.0;10504.0;28222.0;31249.0;26
767;Agglomeratie 's-Gravenhage (CR);2019;830350;189279;493605;147466;500220;135302;75883;59419;194828;103517;91311;49743;27731;22012;15339;9516;5823;36357;16983;19374;34189;14716;19473;59200;34571;24629;10055.0;7596.0;14414.0;10513.0;27550.0;31061.0;26
768;Agglomeratie 's-Gravenhage (CR);2020;833277;189265;493328;150684;500047;138274;77806;60468;194956;102836;92120;49243;27325;21918;15436;9543;5893;36302;16841;19461;34429;14693;19736;59546;34434;25112;10079.0;7687.0;14441.0;10474.0;27430.0;31238.0;26
769;Agglomeratie 's-Gravenhage (CR);2021;835886;188740;493253;153893;499507;141284;79665;61619;195095;102321;92774;48693;26932;21761;15457;9510;5947;36415;16820;19595;34658;14699;19959;59872;34360;25512;10011.0;7823.0;14498.0;10329.0;27849.0;31601.0;26
770;Agglomeratie 's-Gravenhage (CR);2022;838546;188065;493413;157068;499109;144320;81541;62779;195117;101779;93338;48072;26518;21554;15609;9568;6041;36397;16716;19681;34795;14674;20121;60244;34303;25941;10079.0;7876.0;14500.0;10317.0;27939.0;31675.0;26
771;Agglomeratie 's-Gravenhage (CR);2023;841258;187573;493231;160454;498578;147384;83384;64000;195296;101362;93934;47623;26151;21472;15626;9546;6080;36334;16625;19709;34889;14696;20193;60824;34344;26480;10072.0;8010.0;14540.0;10271.0;28351.0;31991.0;26
772;Agglomeratie 's-Gravenhage (CR);2024;844024;186914;493730;163380;498135;150400;85265;65135;195489;100950;94539;47064;25732;21332;15658;9533;6125;36337;16577;19760;35032;14645;20387;61398;34463;26935;10083.0;8101.0;14582.0;10228.0;28459.0;32082.0;26
773;Agglomeratie 's-Gravenhage (CR);2025;846798;186399;493837;166562;497568;153577;87187;66390;195653;100525;95128;46582;25331;21251;15683;9480;6203;36212;16495;19717;35198;14658;20540;61978;34561;27417;;;;;;;26
774;Delft en Westland (CR);2008;212429;50127;132985;29317;174287;17124;7997;9127;21018;13016;8002;3183;1654;1529;1746;1066;680;3250;1732;1518;3016;1532;1484;9823;7032;2791;2259.0;1659.0;2265.0;2434.0;8425.0;8130.0;27
775;Delft en Westland (CR);2009;213190;49939;133181;30070;174194;17486;8168;9318;21510;13008;8502;3289;1663;1626;1762;1055;707;3455;1771;1684;3093;1522;1571;9911;6997;2914;2282.0;1705.0;2350.0;2424.0;8329.0;8061.0;27
776;Delft en Westland (CR);2010;213994;49856;133193;30945;173961;17917;8427;9490;22116;13078;9038;3378;1647;1731;1804;1054;750;3646;1854;1792;3235;1555;1680;10053;6968;3085;2245.0;1721.0;2378.0;2383.0;8699.0;8074.0;27
777;Delft en Westland (CR);2011;215177;49697;133881;31599;173965;18471;8741;9730;22741;13184;9557;3497;1648;1849;1849;1053;796;3815;1910;1905;3357;1600;1757;10223;6973;3250;2232.0;1769.0;2439.0;2380.0;8429.0;7996.0;27
778;Delft en Westland (CR);2012;216156;49565;133294;33297;173841;18932;9029;9903;23383;13261;10122;3625;1653;1972;1890;1058;832;3923;1951;1972;3540;1665;1875;10405;6934;3471;2281.0;1805.0;2463.0;2364.0;8540.0;7865.0;27
779;Delft en Westland (CR);2013;217440;49426;133392;34622;173911;19475;9356;10119;24054;13384;10670;3727;1660;2067;1969;1090;879;4110;2013;2097;3619;1683;1936;10629;6938;3691;2280.0;1837.0;2509.0;2339.0;8454.0;7715.0;27
780;Delft en Westland (CR);2014;218824;49413;133517;35894;174194;20036;9742;10294;24594;13483;11111;3813;1666;2147;1992;1094;898;4283;2101;2182;3694;1703;1991;10812;6919;3893;2282.0;1854.0;2553.0;2335.0;8501.0;7665.0;27
781;Delft en Westland (CR);2015;220331;49361;134065;36905;174516;20599;10105;10494;25216;13611;11605;3861;1643;2218;2022;1090;932;4454;2148;2306;3801;1727;2074;11078;7003;4075;2314.0;1887.0;2533.0;2321.0;8423.0;7626.0;27
782;Delft en Westland (CR);2016;221799;49557;134286;37956;174742;21178;10443;10735;25879;13728;12151;3944;1660;2284;2067;1091;976;4622;2186;2436;3935;1757;2178;11311;7034;4277;2332.0;1937.0;2556.0;2336.0;8630.0;7696.0;27
783;Delft en Westland (CR);2017;223383;49796;134659;38928;175123;21802;10804;10998;26458;13801;12657;4031;1691;2340;2119;1086;1033;4748;2208;2540;4031;1771;2260;11529;7045;4484;2349.0;1960.0;2578.0;2329.0;8030.0;7681.0;27
784;Delft en Westland (CR);2018;224407;49886;134542;39979;175201;22340;11096;11244;26866;13874;12992;4072;1701;2371;2171;1092;1079;4799;2215;2584;4104;1792;2312;11720;7074;4646;2383.0;1969.0;2546.0;2322.0;7976.0;7652.0;27
785;Delft en Westland (CR);2019;225406;50035;134443;40928;175096;22878;11417;11461;27432;14024;13408;4158;1733;2425;2192;1096;1096;4924;2256;2668;4208;1796;2412;11950;7143;4807;2372.0;2016.0;2561.0;2331.0;8015.0;7622.0;27
786;Delft en Westland (CR);2020;226410;50037;134594;41779;175205;23379;11740;11639;27826;14114;13712;4230;1741;2489;2187;1074;1113;4999;2289;2710;4283;1806;2477;12127;7204;4923;2374.0;2039.0;2569.0;2326.0;8209.0;7587.0;27
787;Delft en Westland (CR);2021;227634;50130;134736;42768;175427;23852;12000;11852;28355;14304;14051;4308;1779;2529;2207;1075;1132;5103;2333;2770;4391;1839;2552;12346;7278;5068;2400.0;2080.0;2575.0;2299.0;8238.0;7681.0;27
788;Delft en Westland (CR);2022;228820;50282;134723;43815;175520;24402;12285;12117;28898;14505;14393;4392;1829;2563;2255;1093;1162;5223;2386;2837;4475;1856;2619;12553;7341;5212;2417.0;2122.0;2583.0;2284.0;8257.0;7693.0;27
789;Delft en Westland (CR);2023;230005;50396;134758;44851;175720;24932;12590;12342;29353;14670;14683;4442;1828;2614;2281;1107;1174;5300;2422;2878;4555;1878;2677;12775;7435;5340;2398.0;2162.0;2557.0;2273.0;8141.0;7715.0;27
790;Delft en Westland (CR);2024;230980;50432;134681;45867;175694;25472;12929;12543;29814;14896;14918;4538;1869;2669;2337;1144;1193;5409;2498;2911;4612;1902;2710;12918;7483;5435;2426.0;2182.0;2588.0;2258.0;8329.0;7702.0;27
791;Delft en Westland (CR);2025;232215;50783;134506;46926;175891;26094;13293;12801;30230;15052;15178;4576;1879;2697;2388;1144;1244;5529;2547;2982;4671;1938;2733;13066;7544;5522;;;;;;;27
792;Oost-Zuid-Holland (CR);2008;319347;82618;192889;43840;272503;21348;8101;13247;25496;13889;11607;3122;1581;1541;1586;816;770;2084;1055;1029;11035;5650;5385;7669;4787;2882;3593.0;2326.0;1069.0;1588.0;10251.0;12115.0;28
793;Oost-Zuid-Holland (CR);2009;318290;81365;191714;45211;271008;21419;8166;13253;25863;13986;11877;3216;1621;1595;1618;843;775;2291;1147;1144;10986;5567;5419;7752;4808;2944;3510.0;2386.0;1111.0;1560.0;10724.0;12124.0;28
794;Oost-Zuid-Holland (CR);2010;317602;80275;190574;46753;269844;21561;8209;13352;26197;14076;12121;3335;1670;1665;1656;874;782;2447;1216;1231;10930;5505;5425;7829;4811;3018;3475.0;2434.0;1188.0;1521.0;11654.0;11971.0;28
795;Oost-Zuid-Holland (CR);2011;318031;79408;190642;47981;269506;21775;8338;13437;26750;14204;12546;3417;1705;1712;1687;886;801;2647;1296;1351;10951;5452;5499;8048;4865;3183;3396.0;2474.0;1185.0;1536.0;12035.0;12098.0;28
796;Oost-Zuid-Holland (CR);2012;318577;78381;189388;50808;269277;22033;8478;13555;27267;14334;12933;3540;1747;1793;1742;905;837;2827;1339;1488;10938;5410;5528;8220;4933;3287;3355.0;2536.0;1215.0;1512.0;12032.0;11987.0;28
797;Oost-Zuid-Holland (CR);2013;319180;77529;188336;53315;269180;22307;8579;13728;27693;14477;13216;3619;1772;1847;1809;942;867;2948;1358;1590;10866;5358;5508;8451;5047;3404;3357.0;2587.0;1181.0;1487.0;12041.0;11922.0;28
798;Oost-Zuid-Holland (CR);2014;319793;76693;187550;55550;269054;22529;8709;13820;28210;14611;13599;3726;1808;1918;1884;970;914;3121;1420;1701;10844;5307;5537;8635;5106;3529;3340.0;2647.0;1209.0;1457.0;12303.0;11966.0;28
799;Oost-Zuid-Holland (CR);2015;320609;75900;187216;57493;269101;22855;8855;14000;28653;14764;13889;3841;1843;1998;1945;1003;942;3256;1475;1781;10801;5286;5515;8810;5157;3653;3346.0;2695.0;1211.0;1436.0;11764.0;11859.0;28
800;Oost-Zuid-Holland (CR);2016;320974;75245;186600;59129;268895;23067;8953;14114;29012;14898;14114;3948;1890;2058;2002;1039;963;3381;1525;1856;10727;5256;5471;8954;5188;3766;3378.0;2766.0;1224.0;1414.0;12232.0;11881.0;28
801;Oost-Zuid-Holland (CR);2017;321772;74706;186327;60739;268788;23396;9171;14225;29588;15160;14428;4037;1932;2105;2075;1085;990;3573;1589;1984;10712;5253;5459;9191;5301;3890;3368.0;2832.0;1198.0;1403.0;12402.0;11999.0;28
802;Oost-Zuid-Holland (CR);2018;322534;74148;185861;62525;268807;23683;9279;14404;30044;15307;14737;4117;1943;2174;2150;1100;1050;3729;1636;2093;10663;5235;5428;9385;5393;3992;3387.0;2857.0;1192.0;1411.0;12136.0;12021.0;28
803;Oost-Zuid-Holland (CR);2019;322998;73508;185343;64147;268496;24051;9513;14538;30451;15519;14932;4205;1966;2239;2221;1155;1066;3867;1691;2176;10557;5189;5368;9601;5518;4083;3434.0;2943.0;1192.0;1396.0;12401.0;12031.0;28
804;Oost-Zuid-Holland (CR);2020;323683;72807;185209;65667;268415;24310;9658;14652;30958;15716;15242;4246;1971;2275;2277;1194;1083;4042;1760;2282;10529;5166;5363;9864;5625;4239;3449.0;2969.0;1210.0;1381.0;12536.0;12029.0;28
805;Oost-Zuid-Holland (CR);2021;324540;72195;185166;67179;268487;24642;9811;14831;31411;15907;15504;4341;2010;2331;2380;1243;1137;4161;1802;2359;10423;5115;5308;10106;5737;4369;3491.0;3021.0;1177.0;1362.0;12396.0;12183.0;28
806;Oost-Zuid-Holland (CR);2022;325070;71664;184673;68733;268294;24973;9966;15007;31803;16063;15740;4384;2008;2376;2422;1251;1171;4301;1874;2427;10399;5096;5303;10297;5834;4463;3487.0;3104.0;1212.0;1363.0;12777.0;12259.0;28
807;Oost-Zuid-Holland (CR);2023;325856;71287;184388;70181;268290;25303;10161;15142;32263;16222;16041;4464;2036;2428;2517;1306;1211;4463;1915;2548;10296;5023;5273;10523;5942;4581;3535.0;3166.0;1178.0;1372.0;12287.0;12276.0;28
808;Oost-Zuid-Holland (CR);2024;326076;70830;183546;71700;267927;25490;10293;15197;32659;16437;16222;4558;2091;2467;2579;1329;1250;4603;1976;2627;10214;5013;5201;10705;6028;4677;3521.0;3223.0;1180.0;1357.0;12404.0;12207.0;28
809;Oost-Zuid-Holland (CR);2025;326429;70626;182730;73073;267727;25719;10439;15280;32983;16630;16353;4586;2120;2466;2654;1373;1281;4713;2025;2688;10111;4970;5141;10919;6142;4777;;;;;;;28
810;Groot-Rijnmond (CR);2008;1361201;320586;840377;200238;965634;115221;52037;63184;280346;158960;121386;66881;37826;29055;26936;17222;9714;62594;31784;30810;45423;22370;23053;78512;49758;28754;15303.0;12371.0;9978.0;14723.0;55621.0;54843.0;29
811;Groot-Rijnmond (CR);2009;1360356;318288;838904;203164;965358;115759;51952;63807;279239;155944;123295;66260;37071;29189;26580;16678;9902;62326;31302;31024;45995;22201;23794;78078;48692;29386;15161.0;12444.0;10284.0;14355.0;56653.0;54675.0;29
812;Groot-Rijnmond (CR);2010;1361149;316371;838015;206763;965964;116484;52052;64432;278701;153453;125248;65663;36394;29269;26417;16263;10154;62159;30892;31267;46486;22018;24468;77976;47886;30090;15023.0;12514.0;10542.0;14077.0;54408.0;53951.0;29
813;Groot-Rijnmond (CR);2011;1360723;313544;838669;208510;965580;117166;52216;64950;277977;151009;126968;65024;35805;29219;26370;15955;10415;61909;30406;31503;46946;21865;25081;77728;46978;30750;14980.0;12584.0;10574.0;13704.0;53853.0;53668.0;29
814;Groot-Rijnmond (CR);2012;1360318;310693;831507;218118;964946;117954;52376;65578;277418;148661;128757;64390;35213;29177;26212;15617;10595;61758;29964;31794;47405;21714;25691;77653;46153;31500;14845.0;12652.0;10598.0;13318.0;54327.0;53080.0;29
815;Groot-Rijnmond (CR);2013;1361185;308536;826505;226144;965257;118855;52722;66133;277073;146863;130210;63818;34655;29163;26191;15409;10782;61550;29675;31875;47807;21612;26195;77707;45512;32195;14785.0;12724.0;10490.0;13094.0;53542.0;52560.0;29
816;Groot-Rijnmond (CR);2014;1361756;306581;822409;232766;965407;119837;52941;66896;276512;145005;131507;63256;34125;29131;26175;15200;10975;61213;29297;31916;48149;21480;26669;77719;44903;32816;14871.0;12866.0;10383.0;12820.0;53280.0;52617.0;29
817;Groot-Rijnmond (CR);2015;1362121;304807;819338;237976;965423;120592;53204;67388;276106;143178;132928;62664;33623;29041;26185;14979;11206;60937;28904;32033;48512;21389;27123;77808;44283;33525;14754.0;12907.0;10238.0;12550.0;52863.0;52134.0;29
818;Groot-Rijnmond (CR);2016;1362534;303220;816351;242963;965488;121479;53613;67866;275567;141640;133927;62052;33139;28913;26112;14776;11336;60717;28611;32106;48725;21281;27444;77961;43833;34128;14808.0;13031.0;10150.0;12365.0;54090.0;52448.0;29
819;Groot-Rijnmond (CR);2017;1363869;302300;813950;247619;966012;122422;53893;68529;275435;140321;135114;61435;32608;28827;26058;14567;11491;60444;28329;32115;49065;21226;27839;78433;43591;34842;14865.0;13109.0;9967.0;12145.0;53019.0;52226.0;29
820;Groot-Rijnmond (CR);2018;1364359;300852;811219;252288;965798;123501;54339;69162;275060;138919;136141;60902;32124;28778;25916;14338;11578;60224;28045;32179;49266;21128;28138;78752;43284;35468;14902.0;13221.0;9913.0;12034.0;53276.0;52341.0;29
821;Groot-Rijnmond (CR);2019;1364998;299477;808641;256880;965591;124373;54673;69700;275034;137711;137323;60379;31684;28695;25861;14152;11709;59945;27707;32238;49512;21048;28464;79337;43120;36217;14982.0;13431.0;9840.0;11841.0;54169.0;52113.0;29
822;Groot-Rijnmond (CR);2020;1366723;298516;806601;261606;966010;125529;55121;70408;275184;136541;138643;59883;31255;28628;25837;13960;11877;59776;27423;32353;49694;20956;28738;79994;42947;37047;15140.0;13524.0;9643.0;11626.0;53557.0;52017.0;29
823;Groot-Rijnmond (CR);2021;1368027;297170;804381;266476;965959;126563;55479;71084;275505;135586;139919;59317;30745;28572;25900;13842;12058;59544;27150;32394;49993;20866;29127;80751;42983;37768;15176.0;13669.0;9664.0;11547.0;54131.0;52751.0;29
824;Groot-Rijnmond (CR);2022;1369165;296121;802106;270938;965817;127676;55960;71716;275672;134552;141120;58778;30289;28489;25860;13654;12206;59474;26932;32542;50120;20732;29388;81440;42945;38495;15298.0;13804.0;9565.0;11332.0;53438.0;52492.0;29
825;Groot-Rijnmond (CR);2023;1369968;295222;799253;275493;965325;128760;56412;72348;275883;133530;142353;58195;29856;28339;25857;13507;12350;59431;26709;32722;50348;20678;29670;82052;42780;39272;15341.0;13955.0;9458.0;11201.0;53967.0;52582.0;29
826;Groot-Rijnmond (CR);2024;1371132;294523;796355;280254;965057;129851;56856;72995;276224;132702;143522;57560;29342;28218;25936;13465;12471;59239;26442;32797;50559;20607;29952;82930;42846;40084;15378.0;14163.0;9404.0;11065.0;53243.0;52843.0;29
827;Groot-Rijnmond (CR);2025;1371224;294018;791917;285289;963978;130883;57225;73658;276363;131768;144595;57028;28875;28153;25909;13312;12597;59065;26200;32865;50647;20504;30143;83714;42877;40837;;;;;;;29
828;Zuidoost-Zuid-Holland (CR);2008;389808;99427;232091;58290;322223;28397;11163;17234;39188;21860;17328;4882;2618;2264;4391;2711;1680;12424;6254;6170;6339;3138;3201;11152;7139;4013;4578.0;3344.0;1416.0;1923.0;13051.0;13480.0;30
829;Zuidoost-Zuid-Holland (CR);2009;390173;99003;231719;59451;321865;28633;11268;17365;39675;21869;17806;4924;2594;2330;4418;2685;1733;12392;6204;6188;6559;3245;3314;11382;7141;4241;4528.0;3361.0;1569.0;1883.0;13161.0;13565.0;30
830;Zuidoost-Zuid-Holland (CR);2010;390666;98567;231292;60807;321636;28684;11276;17408;40346;22057;18289;5033;2624;2409;4473;2689;1784;12362;6181;6181;6768;3314;3454;11710;7249;4461;4472.0;3399.0;1597.0;1843.0;12862.0;13358.0;30
831;Zuidoost-Zuid-Holland (CR);2011;391034;97855;231420;61759;321277;28838;11329;17509;40919;22188;18731;5159;2635;2524;4491;2696;1795;12337;6158;6179;6956;3398;3558;11976;7301;4675;4391.0;3432.0;1613.0;1805.0;13390.0;13437.0;30
832;Zuidoost-Zuid-Holland (CR);2012;391793;97228;229848;64717;321274;28966;11404;17562;41553;22350;19203;5247;2671;2576;4563;2685;1878;12307;6170;6137;7143;3450;3693;12293;7374;4919;4392.0;3501.0;1639.0;1783.0;13102.0;13338.0;30
833;Zuidoost-Zuid-Holland (CR);2013;392342;96455;228599;67288;321066;29153;11502;17651;42123;22532;19591;5325;2713;2612;4589;2672;1917;12276;6153;6123;7358;3526;3832;12575;7468;5107;4357.0;3527.0;1641.0;1778.0;12845.0;13158.0;30
834;Zuidoost-Zuid-Holland (CR);2014;392760;95835;227621;69304;320635;29404;11598;17806;42721;22711;20010;5406;2739;2667;4648;2682;1966;12245;6139;6106;7544;3620;3924;12878;7531;5347;4322.0;3543.0;1591.0;1763.0;13317.0;13303.0;30
835;Zuidoost-Zuid-Holland (CR);2015;393418;95106;227285;71027;320728;29545;11670;17875;43145;22764;20381;5460;2746;2714;4685;2666;2019;12178;6103;6075;7675;3672;4003;13147;7577;5570;4328.0;3592.0;1618.0;1738.0;13076.0;13135.0;30
836;Zuidoost-Zuid-Holland (CR);2016;394013;94549;226932;72532;320600;29776;11782;17994;43637;22803;20834;5536;2744;2792;4690;2656;2034;12114;6057;6057;7933;3737;4196;13364;7609;5755;4319.0;3626.0;1567.0;1723.0;12799.0;13153.0;30
837;Zuidoost-Zuid-Holland (CR);2017;394223;93937;226294;73992;320119;30028;11892;18136;44076;22878;21198;5601;2766;2835;4762;2664;2098;12097;6042;6055;8045;3778;4267;13571;7628;5943;4314.0;3686.0;1606.0;1707.0;12778.0;13134.0;30
838;Zuidoost-Zuid-Holland (CR);2018;394433;93379;225620;75434;319673;30171;11952;18219;44589;23024;21565;5692;2797;2895;4821;2666;2155;12042;6032;6010;8195;3821;4374;13839;7708;6131;4309.0;3741.0;1565.0;1670.0;13087.0;13215.0;30
839;Zuidoost-Zuid-Holland (CR);2019;394804;92540;225615;76649;319353;30344;12010;18334;45107;23221;21886;5779;2804;2975;4855;2679;2176;12007;6006;6001;8378;3883;4495;14088;7849;6239;4349.0;3762.0;1536.0;1651.0;12543.0;13160.0;30
840;Zuidoost-Zuid-Holland (CR);2020;394699;91780;224976;77943;318826;30456;12112;18344;45417;23323;22094;5805;2821;2984;4884;2668;2216;11928;5983;5945;8437;3906;4531;14363;7945;6418;4326.0;3807.0;1579.0;1640.0;12664.0;13273.0;30
841;Zuidoost-Zuid-Holland (CR);2021;394590;90820;224478;79292;318247;30575;12202;18373;45768;23501;22267;5858;2854;3004;4972;2718;2254;11837;5951;5886;8538;3951;4587;14563;8027;6536;4358.0;3877.0;1527.0;1617.0;12959.0;13388.0;30
842;Zuidoost-Zuid-Holland (CR);2022;394585;90168;223746;80671;317718;30768;12312;18456;46099;23643;22456;5934;2908;3026;4981;2706;2275;11782;5922;5860;8631;3994;4637;14771;8113;6658;4344.0;3913.0;1546.0;1601.0;13065.0;13310.0;30
843;Zuidoost-Zuid-Holland (CR);2023;394756;89432;223192;82132;317373;30894;12351;18543;46489;23767;22722;6016;2938;3078;5014;2702;2312;11696;5865;5831;8709;4008;4701;15054;8254;6800;4379.0;3966.0;1514.0;1584.0;12758.0;13242.0;30
844;Zuidoost-Zuid-Holland (CR);2024;394651;88870;222161;83620;316873;31100;12427;18673;46678;23804;22874;6074;2966;3108;5034;2705;2329;11624;5836;5788;8783;4029;4754;15163;8268;6895;4351.0;4025.0;1518.0;1548.0;13425.0;13423.0;30
845;Zuidoost-Zuid-Holland (CR);2025;394992;88511;221267;85214;316512;31411;12615;18796;47069;23964;23105;6166;3013;3153;5069;2710;2359;11589;5841;5748;8854;4048;4806;15391;8352;7039;;;;;;;30
846;Zeeuwsch-Vlaanderen (CR);2008;107534;23869;63177;20488;83352;19336;9461;9875;4846;2682;2164;480;245;235;565;335;230;1516;698;818;483;222;261;1802;1182;620;1034.0;1138.0;897.0;971.0;2872.0;2537.0;31
847;Zeeuwsch-Vlaanderen (CR);2009;107701;23894;62929;20878;83209;19407;9538;9869;5085;2758;2327;522;266;256;571;337;234;1539;704;835;555;237;318;1898;1214;684;1019.0;1132.0;965.0;979.0;2829.0;2628.0;31
848;Zeeuwsch-Vlaanderen (CR);2010;107790;23877;62535;21378;82976;19455;9570;9885;5359;2863;2496;584;306;278;587;336;251;1560;710;850;620;257;363;2008;1254;754;1016.0;1156.0;987.0;970.0;2724.0;2664.0;31
849;Zeeuwsch-Vlaanderen (CR);2011;107735;23677;62172;21886;82665;19468;9603;9865;5602;2933;2669;614;323;291;607;330;277;1573;706;867;677;279;398;2131;1295;836;997.0;1150.0;1009.0;969.0;2860.0;2674.0;31
850;Zeeuwsch-Vlaanderen (CR);2012;107817;23457;61649;22711;82442;19535;9679;9856;5840;3030;2810;668;348;320;615;336;279;1592;720;872;762;309;453;2203;1317;886;1017.0;1190.0;1016.0;932.0;2764.0;2687.0;31
851;Zeeuwsch-Vlaanderen (CR);2013;107815;23247;61120;23448;82115;19619;9762;9857;6081;3122;2959;721;384;337;644;354;290;1594;715;879;825;328;497;2297;1341;956;1019.0;1182.0;996.0;952.0;2713.0;2684.0;31
852;Zeeuwsch-Vlaanderen (CR);2014;107737;23089;60604;24044;81808;19667;9819;9848;6262;3195;3067;773;405;368;667;365;302;1607;718;889;886;363;523;2329;1344;985;1010.0;1182.0;1008.0;915.0;2693.0;2722.0;31
853;Zeeuwsch-Vlaanderen (CR);2015;107642;22883;60207;24552;81392;19725;9869;9856;6525;3297;3228;818;419;399;696;376;320;1625;720;905;960;393;567;2426;1389;1037;1027.0;1198.0;985.0;909.0;2916.0;2744.0;31
854;Zeeuwsch-Vlaanderen (CR);2016;107728;22778;59946;25004;81089;19839;9950;9889;6800;3387;3413;855;434;421;718;380;338;1671;729;942;1043;427;616;2513;1417;1096;1038.0;1224.0;993.0;908.0;2923.0;2761.0;31
855;Zeeuwsch-Vlaanderen (CR);2017;107794;22672;59677;25445;80846;19922;10006;9916;7026;3486;3540;884;446;438;731;382;349;1700;739;961;1125;457;668;2586;1462;1124;1033.0;1239.0;998.0;919.0;2882.0;2811.0;31
856;Zeeuwsch-Vlaanderen (CR);2018;107752;22488;59472;25792;80476;20000;10043;9957;7276;3573;3703;886;448;438;755;393;362;1751;767;984;1197;468;729;2687;1497;1190;1052.0;1230.0;967.0;891.0;2898.0;2800.0;31
857;Zeeuwsch-Vlaanderen (CR);2019;107752;22298;59236;26218;80239;20023;10045;9978;7490;3652;3838;917;464;453;791;412;379;1756;759;997;1261;486;775;2765;1531;1234;1081.0;1251.0;965.0;895.0;2807.0;2760.0;31
858;Zeeuwsch-Vlaanderen (CR);2020;107704;22161;58935;26608;80023;20010;10078;9932;7671;3714;3957;948;479;469;813;408;405;1793;766;1027;1321;514;807;2796;1547;1249;1074.0;1268.0;965.0;878.0;2742.0;2794.0;31
859;Zeeuwsch-Vlaanderen (CR);2021;107561;22014;58573;26974;79669;20047;10089;9958;7845;3763;4082;983;497;486;828;411;417;1835;775;1060;1365;530;835;2834;1550;1284;1091.0;1275.0;945.0;878.0;3002.0;2781.0;31
860;Zeeuwsch-Vlaanderen (CR);2022;107667;21994;58301;27372;79488;20069;10107;9962;8110;3866;4244;1018;513;505;842;429;413;1868;773;1095;1436;550;886;2946;1601;1345;1095.0;1299.0;923.0;859.0;3018.0;2818.0;31
861;Zeeuwsch-Vlaanderen (CR);2023;107737;21959;58012;27766;79301;20136;10143;9993;8300;3919;4381;1052;523;529;875;438;437;1883;778;1105;1505;572;933;2985;1608;1377;1109.0;1306.0;933.0;875.0;3033.0;2821.0;31
862;Zeeuwsch-Vlaanderen (CR);2024;107818;21976;57726;28116;79202;20131;10109;10022;8485;3991;4494;1079;538;541;871;431;440;1903;773;1130;1554;592;962;3078;1657;1421;1134.0;1324.0;930.0;844.0;2920.0;2814.0;31
863;Zeeuwsch-Vlaanderen (CR);2025;107830;21976;57439;28415;78920;20186;10065;10121;8724;4110;4614;1113;559;554;893;451;442;1931;768;1163;1604;613;991;3183;1719;1464;;;;;;;31
864;Overig Zeeland (CR);2008;273865;66823;160578;46464;238735;20560;8804;11756;14570;8313;6257;2313;1169;1144;1333;708;625;2162;1126;1036;2043;973;1070;6719;4337;2382;3020.0;2540.0;1206.0;1196.0;11156.0;11107.0;32
865;Overig Zeeland (CR);2009;274438;66638;160341;47459;238380;20829;8866;11963;15229;8578;6651;2400;1202;1198;1381;733;648;2318;1194;1124;2159;1025;1134;6971;4424;2547;3011.0;2567.0;1240.0;1201.0;11395.0;11276.0;32
866;Overig Zeeland (CR);2010;275073;66341;160129;48603;238002;21157;9026;12131;15914;8855;7059;2515;1265;1250;1438;755;683;2509;1275;1234;2252;1052;1200;7200;4508;2692;3012.0;2584.0;1289.0;1190.0;11579.0;11365.0;32
867;Overig Zeeland (CR);2011;275838;65868;160476;49494;237750;21507;9179;12328;16581;9096;7485;2599;1310;1289;1501;805;696;2680;1326;1354;2368;1087;1281;7433;4568;2865;2987.0;2599.0;1340.0;1197.0;11854.0;11463.0;32
868;Overig Zeeland (CR);2012;276795;65435;159753;51607;237677;21897;9351;12546;17221;9330;7891;2696;1362;1334;1563;829;734;2883;1423;1460;2489;1130;1359;7590;4586;3004;2992.0;2619.0;1366.0;1179.0;11596.0;11568.0;32
869;Overig Zeeland (CR);2013;277409;65035;158817;53557;237215;22243;9511;12732;17951;9625;8326;2771;1410;1361;1631;865;766;3040;1481;1559;2622;1168;1454;7887;4701;3186;3021.0;2636.0;1396.0;1157.0;11779.0;11484.0;32
870;Overig Zeeland (CR);2014;278357;64731;158503;55123;237183;22588;9682;12906;18586;9846;8740;2839;1439;1400;1705;896;809;3220;1538;1682;2742;1211;1531;8080;4762;3318;3012.0;2677.0;1399.0;1160.0;11942.0;11549.0;32
871;Overig Zeeland (CR);2015;279347;64400;158392;56555;237169;22971;9900;13071;19207;10112;9095;2911;1480;1431;1753;923;830;3312;1572;1740;2863;1252;1611;8368;4885;3483;3040.0;2723.0;1387.0;1145.0;11857.0;11581.0;32
872;Overig Zeeland (CR);2016;280220;64248;158085;57887;237077;23331;10059;13272;19812;10363;9449;2987;1526;1461;1810;942;868;3461;1627;1834;2954;1282;1672;8600;4986;3614;3045.0;2722.0;1375.0;1153.0;11788.0;11583.0;32
873;Overig Zeeland (CR);2017;281005;64018;158017;58970;236898;23674;10171;13503;20433;10694;9739;3034;1549;1485;1864;974;890;3603;1716;1887;3064;1332;1732;8868;5123;3745;3066.0;2743.0;1387.0;1154.0;11877.0;11588.0;32
874;Overig Zeeland (CR);2018;281869;63862;157852;60155;236834;24007;10297;13710;21028;10931;10097;3096;1583;1513;1949;1007;942;3782;1790;1992;3146;1356;1790;9055;5195;3860;3089.0;2778.0;1377.0;1139.0;11975.0;11664.0;32
875;Overig Zeeland (CR);2019;282757;63645;157725;61387;236744;24373;10498;13875;21640;11179;10461;3193;1624;1569;2006;1040;966;3885;1840;2045;3243;1394;1849;9313;5281;4032;3097.0;2821.0;1425.0;1153.0;11582.0;11673.0;32
876;Overig Zeeland (CR);2020;283245;63387;157278;62580;236345;24712;10638;14074;22188;11419;10769;3269;1672;1597;2066;1059;1007;3987;1900;2087;3379;1425;1954;9487;5363;4124;3113.0;2836.0;1410.0;1142.0;11838.0;11692.0;32
877;Overig Zeeland (CR);2021;283962;63229;156963;63770;236185;24979;10804;14175;22798;11660;11138;3339;1701;1638;2141;1096;1045;4152;1967;2185;3479;1447;2032;9687;5449;4238;3104.0;2877.0;1395.0;1127.0;11870.0;11789.0;32
878;Overig Zeeland (CR);2022;284557;62988;156674;64895;235919;25239;10918;14321;23399;11917;11482;3426;1745;1681;2201;1123;1078;4277;2027;2250;3544;1464;2080;9951;5558;4393;3134.0;2926.0;1359.0;1122.0;11688.0;11739.0;32
879;Overig Zeeland (CR);2023;284980;62843;156149;65988;235508;25502;11066;14436;23970;12198;11772;3452;1767;1685;2268;1157;1111;4403;2060;2343;3642;1506;2136;10205;5708;4497;3161.0;2976.0;1370.0;1123.0;11627.0;11669.0;32
880;Overig Zeeland (CR);2024;285400;62736;155662;67002;235085;25809;11226;14583;24506;12426;12080;3504;1795;1709;2333;1179;1154;4490;2110;2380;3735;1520;2215;10444;5822;4622;3146.0;3032.0;1388.0;1123.0;11956.0;11683.0;32
881;Overig Zeeland (CR);2025;286073;62817;155137;68119;234904;26096;11425;14671;25073;12680;12393;3548;1819;1729;2431;1249;1182;4614;2159;2455;3817;1546;2271;10663;5907;4756;;;;;;;32
882;West-Noord-Brabant (CR);2008;607802;141655;372794;93353;506468;51112;19935;31177;50222;27732;22490;4812;2496;2316;3550;1937;1613;11676;6081;5595;14775;7049;7726;15409;10169;5240;6005.0;5428.0;3623.0;4477.0;17192.0;17171.0;33
883;West-Noord-Brabant (CR);2009;607626;140874;371205;95547;505372;51205;20038;31167;51049;27943;23106;5013;2596;2417;3685;2027;1658;11812;6110;5702;14891;7032;7859;15648;10178;5470;5964.0;5518.0;3754.0;4398.0;17509.0;17544.0;33
884;West-Noord-Brabant (CR);2010;607474;139899;369479;98096;504162;51291;20114;31177;52021;28342;23679;5249;2719;2530;3809;2113;1696;11908;6155;5753;15055;7075;7980;16000;10280;5720;5911.0;5593.0;3912.0;4319.0;17588.0;17460.0;33
885;West-Noord-Brabant (CR);2011;607585;138780;368233;100572;503039;51536;20338;31198;53010;28650;24360;5482;2828;2654;3995;2210;1785;12076;6193;5883;15161;7095;8066;16296;10324;5972;5865.0;5697.0;3993.0;4286.0;18546.0;18200.0;33
886;West-Noord-Brabant (CR);2012;607867;137638;365749;104480;502125;51896;20529;31367;53846;28831;25015;5693;2891;2802;4131;2292;1839;12222;6224;5998;15271;7099;8172;16529;10325;6204;5870.0;5782.0;4071.0;4249.0;18191.0;17986.0;33
887;West-Noord-Brabant (CR);2013;608049;136342;363455;108252;501085;52263;20759;31504;54701;29046;25655;5905;2981;2924;4267;2367;1900;12344;6277;6067;15406;7115;8291;16779;10306;6473;5785.0;5834.0;4033.0;4158.0;18341.0;18084.0;33
888;West-Noord-Brabant (CR);2014;608196;135030;361530;111636;499897;52659;21051;31608;55640;29353;26287;6102;3067;3035;4381;2438;1943;12545;6371;6174;15548;7145;8403;17064;10332;6732;5811.0;5908.0;4004.0;4090.0;18622.0;18210.0;33
889;West-Noord-Brabant (CR);2015;608502;133944;359998;114560;498917;53002;21253;31749;56583;29746;26837;6343;3164;3179;4544;2564;1980;12626;6431;6195;15676;7156;8520;17394;10431;6963;5827.0;5999.0;4018.0;3992.0;18628.0;18066.0;33
890;West-Noord-Brabant (CR);2016;608989;133250;358532;117207;498115;53321;21427;31894;57553;30030;27523;6553;3243;3310;4688;2615;2073;12749;6463;6286;15797;7169;8628;17766;10540;7226;5838.0;6100.0;4089.0;3998.0;18354.0;18155.0;33
891;West-Noord-Brabant (CR);2017;609099;132513;357076;119510;496883;53683;21645;32038;58533;30368;28165;6746;3306;3440;4833;2698;2135;12903;6515;6388;15905;7173;8732;18146;10676;7470;5905.0;6153.0;4029.0;3966.0;18546.0;18132.0;33
892;West-Noord-Brabant (CR);2018;609392;131804;355677;121911;495809;54070;21925;32145;59513;30752;28761;6935;3372;3563;4984;2782;2202;13002;6549;6453;16008;7201;8807;18584;10848;7736;5902.0;6243.0;3986.0;3953.0;19133.0;18267.0;33
893;West-Noord-Brabant (CR);2019;610041;130963;355060;124018;495097;54487;22197;32290;60457;31127;29330;7123;3472;3651;5124;2866;2258;13149;6577;6572;16056;7202;8854;19005;11010;7995;5944.0;6338.0;3916.0;3886.0;18682.0;18070.0;33
894;West-Noord-Brabant (CR);2020;610347;130004;354171;126172;494221;54806;22444;32362;61320;31450;29870;7288;3551;3737;5303;2948;2355;13247;6590;6657;16081;7216;8865;19401;11145;8256;5950.0;6408.0;3865.0;3918.0;19561.0;18388.0;33
895;West-Noord-Brabant (CR);2021;611074;129108;353738;128228;493720;55173;22619;32554;62181;31780;30401;7499;3650;3849;5383;3005;2378;13320;6565;6755;16175;7269;8906;19804;11291;8513;5975.0;6485.0;3868.0;3828.0;19301.0;18596.0;33
896;West-Noord-Brabant (CR);2022;611379;128306;352613;130460;492927;55499;22841;32658;62953;32077;30876;7705;3757;3948;5497;3062;2435;13399;6600;6799;16205;7266;8939;20147;11392;8755;5966.0;6570.0;3884.0;3812.0;19755.0;18697.0;33
897;West-Noord-Brabant (CR);2023;611970;127559;351886;132525;492451;55779;23117;32662;63740;32503;31237;7871;3842;4029;5606;3125;2481;13450;6639;6811;16199;7262;8937;20614;11635;8979;5984.0;6713.0;3895.0;3818.0;19044.0;18385.0;33
898;West-Noord-Brabant (CR);2024;612064;127122;350315;134627;491431;56028;23262;32766;64605;32898;31707;8035;3927;4108;5748;3198;2550;13581;6692;6889;16282;7282;9000;20959;11799;9160;5950.0;6785.0;3798.0;3748.0;19577.0;18688.0;33
899;West-Noord-Brabant (CR);2025;612250;126827;348657;136766;490361;56443;23496;32947;65446;33277;32169;8201;3988;4213;5933;3284;2649;13694;6732;6962;16281;7262;9019;21337;12011;9326;;;;;;;33
900;Midden-Noord-Brabant (CR);2008;453307;108038;280218;65051;382541;32541;12226;20315;38225;22050;16175;4476;2454;2022;4576;2886;1690;11133;5673;5460;6025;2923;3102;12015;8114;3901;4708.0;3668.0;2671.0;3085.0;13664.0;14176.0;34
901;Midden-Noord-Brabant (CR);2009;453491;107564;278860;67067;381870;32627;12282;20345;38994;22258;16736;4597;2512;2085;4592;2862;1730;11175;5627;5548;6244;2972;3272;12386;8285;4101;4654.0;3767.0;2856.0;3041.0;13977.0;14563.0;34
902;Midden-Noord-Brabant (CR);2010;453687;106928;277763;68996;380966;32817;12408;20409;39904;22514;17390;4771;2576;2195;4584;2842;1742;11277;5595;5682;6487;3046;3441;12785;8455;4330;4638.0;3853.0;2923.0;3013.0;13964.0;14456.0;34
903;Midden-Noord-Brabant (CR);2011;453953;105883;276974;71096;380284;33030;12571;20459;40639;22661;17978;4902;2632;2270;4637;2845;1792;11299;5535;5764;6672;3072;3600;13129;8577;4552;4607.0;3944.0;3030.0;2963.0;14495.0;14988.0;34
904;Midden-Noord-Brabant (CR);2012;454244;105078;275193;73973;379516;33308;12751;20557;41420;22889;18531;5077;2736;2341;4663;2839;1824;11351;5542;5809;6902;3122;3780;13427;8650;4777;4580.0;4006.0;3020.0;2928.0;14666.0;14867.0;34
905;Midden-Noord-Brabant (CR);2013;454762;104483;273500;76779;378860;33608;12948;20660;42294;23176;19118;5226;2791;2435;4763;2892;1871;11448;5531;5917;7089;3189;3900;13768;8773;4995;4591.0;4083.0;3112.0;2889.0;14585.0;15043.0;34
906;Midden-Noord-Brabant (CR);2014;455095;103893;271724;79478;378189;33796;13052;20744;43110;23408;19702;5376;2870;2506;4791;2888;1903;11471;5489;5982;7276;3233;4043;14196;8928;5268;4597.0;4153.0;3034.0;2840.0;14909.0;15172.0;34
907;Midden-Noord-Brabant (CR);2015;455511;103156;270295;82060;377584;34044;13206;20838;43883;23689;20194;5535;2966;2569;4834;2897;1937;11503;5454;6049;7490;3296;4194;14521;9076;5445;4597.0;4212.0;3070.0;2833.0;15100.0;15221.0;34
908;Midden-Noord-Brabant (CR);2016;456061;102750;269110;84201;377094;34262;13373;20889;44705;23962;20743;5649;3025;2624;4911;2923;1988;11592;5462;6130;7628;3320;4308;14925;9232;5693;4627.0;4306.0;3031.0;2770.0;15179.0;15154.0;34
909;Midden-Noord-Brabant (CR);2017;456722;102399;268184;86139;376721;34524;13518;21006;45477;24229;21248;5739;3077;2662;4957;2937;2020;11623;5450;6173;7838;3375;4463;15320;9390;5930;4642.0;4365.0;3066.0;2790.0;15240.0;15264.0;34
910;Midden-Noord-Brabant (CR);2018;457314;102048;267266;88000;376369;34714;13683;21031;46231;24524;21707;5860;3127;2733;4994;2938;2056;11736;5457;6279;7953;3395;4558;15688;9607;6081;4687.0;4442.0;3095.0;2747.0;15366.0;15352.0;34
911;Midden-Noord-Brabant (CR);2019;457971;101545;266513;89913;375941;34915;13868;21047;47115;24901;22214;5968;3185;2783;5064;2978;2086;11770;5475;6295;8063;3418;4645;16250;9845;6405;4708.0;4497.0;3026.0;2717.0;15318.0;15430.0;34
912;Midden-Noord-Brabant (CR);2020;458432;101078;265518;91836;375354;35248;14046;21202;47830;25175;22655;6075;3248;2827;5090;2980;2110;11827;5479;6348;8199;3430;4769;16639;10038;6601;4750.0;4600.0;3008.0;2726.0;15551.0;15492.0;34
913;Midden-Noord-Brabant (CR);2021;458983;100462;265096;93425;374853;35534;14268;21266;48596;25480;23116;6186;3304;2882;5105;2972;2133;11864;5466;6398;8349;3456;4893;17092;10282;6810;4788.0;4662.0;2991.0;2696.0;15735.0;15573.0;34
914;Midden-Noord-Brabant (CR);2022;459617;99966;264593;95058;374445;35791;14472;21319;49381;25758;23623;6268;3338;2930;5139;2976;2163;11937;5479;6458;8506;3524;4982;17531;10441;7090;4822.0;4740.0;2943.0;2699.0;15505.0;15657.0;34
915;Midden-Noord-Brabant (CR);2023;459853;99659;263450;96744;373595;36041;14623;21418;50217;26143;24074;6367;3391;2976;5199;2986;2213;11997;5497;6500;8604;3557;5047;18050;10712;7338;4858.0;4853.0;2962.0;2656.0;15850.0;15532.0;34
916;Midden-Noord-Brabant (CR);2024;460530;99441;262652;98437;373162;36262;14816;21446;51106;26524;24582;6463;3429;3034;5276;3020;2256;12044;5496;6548;8765;3618;5147;18558;10961;7597;4882.0;4884.0;3019.0;2661.0;15631.0;15661.0;34
917;Midden-Noord-Brabant (CR);2025;460915;99300;261591;100024;372518;36487;14962;21525;51910;26837;25073;6544;3469;3075;5306;3005;2301;12066;5490;6576;8890;3662;5228;19104;11211;7893;;;;;;;34
918;Noordoost-Noord-Brabant (CR);2008;626908;156214;380776;89918;545880;41589;15267;26322;39439;22312;17127;4842;2555;2287;2383;1290;1093;12228;6380;5848;7324;3587;3737;12662;8500;4162;6390.0;4974.0;2256.0;3288.0;20278.0;21323.0;35
919;Noordoost-Noord-Brabant (CR);2009;626338;154731;379327;92280;544236;41738;15366;26372;40364;22752;17612;5020;2631;2389;2466;1338;1128;12303;6412;5891;7513;3669;3844;13062;8702;4360;6299.0;5084.0;2404.0;3236.0;21215.0;21937.0;35
920;Noordoost-Noord-Brabant (CR);2010;626063;153113;378259;94691;542836;41983;15560;26423;41244;23131;18113;5121;2688;2433;2543;1377;1166;12404;6454;5950;7766;3748;4018;13410;8864;4546;6217.0;5181.0;2526.0;3227.0;21786.0;22359.0;35
921;Noordoost-Noord-Brabant (CR);2011;625899;151266;377211;97422;541579;42172;15693;26479;42148;23509;18639;5259;2753;2506;2634;1418;1216;12454;6463;5991;7996;3827;4169;13805;9048;4757;6076.0;5310.0;2567.0;3176.0;22745.0;22650.0;35
922;Noordoost-Noord-Brabant (CR);2012;626233;149517;375452;101264;540580;42522;15940;26582;43131;23898;19233;5368;2807;2561;2756;1484;1272;12515;6486;6029;8225;3889;4336;14267;9232;5035;6103.0;5395.0;2649.0;3136.0;22633.0;22843.0;35
923;Noordoost-Noord-Brabant (CR);2013;626334;147706;373373;105255;539511;42806;16127;26679;44017;24278;19739;5557;2913;2644;2829;1512;1317;12512;6492;6020;8428;3946;4482;14691;9415;5276;6046.0;5529.0;2631.0;3088.0;23181.0;22953.0;35
924;Noordoost-Noord-Brabant (CR);2014;626695;146237;371633;108825;538490;43093;16373;26720;45112;24830;20282;5733;3006;2727;2908;1572;1336;12606;6571;6035;8636;4003;4633;15229;9678;5551;6024.0;5637.0;2607.0;3061.0;23424.0;23123.0;35
925;Noordoost-Noord-Brabant (CR);2015;627004;144705;370142;112157;537553;43430;16604;26826;46021;25177;20844;5885;3047;2838;3048;1638;1410;12661;6563;6098;8838;4084;4754;15589;9845;5744;6084.0;5736.0;2592.0;3015.0;23607.0;23252.0;35
926;Noordoost-Noord-Brabant (CR);2016;627362;143139;368981;115242;536608;43761;16843;26918;46993;25554;21439;6076;3140;2936;3103;1660;1443;12714;6576;6138;9041;4154;4887;16059;10024;6035;6122.0;5830.0;2618.0;3002.0;24015.0;23262.0;35
927;Noordoost-Noord-Brabant (CR);2017;628091;141825;368115;118151;535985;44109;17099;27010;47997;26027;21970;6238;3222;3016;3250;1763;1487;12773;6596;6177;9194;4206;4988;16542;10240;6302;6176.0;5958.0;2584.0;3003.0;24357.0;23436.0;35
928;Noordoost-Noord-Brabant (CR);2018;628883;140491;367310;121082;535451;44400;17355;27045;49032;26517;22515;6397;3321;3076;3360;1836;1524;12843;6639;6204;9427;4269;5158;17005;10452;6553;6219.0;6043.0;2559.0;2937.0;24221.0;23596.0;35
929;Noordoost-Noord-Brabant (CR);2019;629370;139137;366643;123590;534397;44844;17580;27264;50129;26974;23155;6574;3408;3166;3451;1878;1573;12904;6612;6292;9619;4321;5298;17581;10755;6826;6288.0;6124.0;2523.0;2951.0;24551.0;23579.0;35
930;Noordoost-Noord-Brabant (CR);2020;630138;137666;366232;126240;533979;45160;17831;27329;50999;27365;23634;6685;3457;3228;3552;1929;1623;12960;6615;6345;9825;4409;5416;17977;10955;7022;6357.0;6206.0;2598.0;2909.0;24552.0;23810.0;35
931;Noordoost-Noord-Brabant (CR);2021;630793;136098;365698;128997;533309;45475;18087;27388;52009;27823;24186;6789;3531;3258;3653;1962;1691;13019;6657;6362;10042;4489;5553;18506;11184;7322;6452.0;6336.0;2496.0;2938.0;24987.0;23767.0;35
932;Noordoost-Noord-Brabant (CR);2022;631746;134976;365294;131476;532937;45768;18339;27429;53041;28287;24754;6957;3593;3364;3808;2042;1766;13080;6668;6412;10199;4554;5645;18997;11430;7567;6515.0;6416.0;2540.0;2910.0;25132.0;23896.0;35
933;Noordoost-Noord-Brabant (CR);2023;632784;134038;364539;134207;532450;46270;18623;27647;54064;28757;25307;7099;3642;3457;3953;2115;1838;13130;6704;6426;10429;4619;5810;19453;11677;7776;6573.0;6507.0;2505.0;2892.0;24806.0;23904.0;35
934;Noordoost-Noord-Brabant (CR);2024;633441;133313;363234;136894;531852;46566;18917;27649;55023;29125;25898;7219;3699;3520;4044;2142;1902;13178;6720;6458;10633;4666;5967;19949;11898;8051;6605.0;6618.0;2630.0;2841.0;25098.0;23838.0;35
935;Noordoost-Noord-Brabant (CR);2025;634543;133063;361803;139677;531502;46920;19252;27668;56121;29652;26469;7359;3775;3584;4154;2202;1952;13314;6774;6540;10827;4708;6119;20467;12193;8274;;;;;;;35
936;Zuidoost-Noord-Brabant (CR);2008;729361;172627;445862;110872;609068;63886;24753;39133;56407;33250;23157;6213;3270;2943;4181;2437;1744;13545;7133;6412;10237;4993;5244;22231;15417;6814;7429.0;5883.0;5389.0;5601.0;25057.0;25841.0;36
937;Zuidoost-Noord-Brabant (CR);2009;730016;171622;444630;113764;607774;64328;25202;39126;57914;33987;23927;6390;3353;3037;4277;2467;1810;13759;7246;6513;10517;5072;5445;22971;15849;7122;7364.0;6037.0;5681.0;5562.0;25480.0;26296.0;36
938;Zuidoost-Noord-Brabant (CR);2010;730756;170321;443888;116547;606561;64705;25717;38988;59490;34653;24837;6551;3428;3123;4395;2533;1862;13930;7275;6655;10813;5151;5662;23801;16266;7535;7358.0;6188.0;5873.0;5496.0;25660.0;26695.0;36
939;Zuidoost-Noord-Brabant (CR);2011;731366;168654;443351;119361;605054;65179;26254;38925;61133;35319;25814;6764;3533;3231;4508;2604;1904;14114;7318;6796;11160;5259;5901;24587;16605;7982;7334.0;6278.0;6084.0;5440.0;25805.0;27134.0;36
940;Zuidoost-Noord-Brabant (CR);2012;731833;167155;441286;123392;603307;65785;26799;38986;62741;36023;26718;7002;3651;3351;4650;2697;1953;14365;7435;6930;11452;5328;6124;25272;16912;8360;7205.0;6426.0;6087.0;5374.0;26151.0;27138.0;36
941;Zuidoost-Noord-Brabant (CR);2013;732425;165356;439773;127296;601984;66149;27224;38925;64292;36627;27665;7206;3758;3448;4791;2780;2011;14564;7513;7051;11752;5392;6360;25979;17184;8795;7285.0;6531.0;6099.0;5272.0;26671.0;27419.0;36
942;Zuidoost-Noord-Brabant (CR);2014;733344;163781;438541;131022;600958;66572;27753;38819;65814;37253;28561;7461;3896;3565;4948;2843;2105;14733;7521;7212;11985;5460;6525;26687;17533;9154;7283.0;6678.0;6091.0;5211.0;26417.0;27521.0;36
943;Zuidoost-Noord-Brabant (CR);2015;733810;162160;437275;134375;599551;67070;28309;38761;67189;37815;29374;7667;3995;3672;5086;2917;2169;14881;7554;7327;12183;5500;6683;27372;17849;9523;7326.0;6785.0;6068.0;5200.0;26619.0;27598.0;36
944;Zuidoost-Noord-Brabant (CR);2016;734329;161193;435864;137272;598025;67516;28806;38710;68788;38582;30206;7875;4103;3772;5269;3026;2243;15035;7588;7447;12398;5552;6846;28211;18313;9898;7373.0;6889.0;6111.0;5148.0;25902.0;27628.0;36
945;Zuidoost-Noord-Brabant (CR);2017;734144;159740;434621;139783;595925;68061;29273;38788;70158;39118;31040;7998;4165;3833;5365;3071;2294;15213;7675;7538;12644;5609;7035;28938;18598;10340;7401.0;6993.0;6061.0;5087.0;26246.0;27532.0;36
946;Zuidoost-Noord-Brabant (CR);2018;734316;158603;433238;142475;594187;68525;29738;38787;71604;39735;31869;8201;4244;3957;5494;3159;2335;15384;7723;7661;12871;5656;7215;29654;18953;10701;7498.0;7072.0;6078.0;5092.0;25968.0;27613.0;36
947;Zuidoost-Noord-Brabant (CR);2019;734176;157296;432070;144810;592343;68911;30154;38757;72922;40304;32618;8367;4326;4041;5637;3245;2392;15526;7761;7765;13032;5686;7346;30360;19286;11074;7531.0;7158.0;6094.0;5035.0;26430.0;27503.0;36
948;Zuidoost-Noord-Brabant (CR);2020;734615;156091;431226;147298;590801;69514;30740;38774;74300;40951;33349;8585;4442;4143;5755;3303;2452;15684;7828;7856;13227;5747;7480;31049;19631;11418;7613.0;7290.0;5987.0;4981.0;26587.0;27675.0;36
949;Zuidoost-Noord-Brabant (CR);2021;734929;154651;430425;149853;589327;69926;31178;38748;75676;41542;34134;8740;4511;4229;5906;3372;2534;15790;7867;7923;13386;5808;7578;31854;19984;11870;7736.0;7337.0;6023.0;4942.0;26544.0;27595.0;36
950;Zuidoost-Noord-Brabant (CR);2022;735442;153914;429086;152442;587851;70435;31648;38787;77156;42218;34938;8932;4616;4316;6024;3433;2591;15965;7934;8031;13611;5911;7700;32624;20324;12300;7787.0;7517.0;5987.0;4883.0;26262.0;27676.0;36
951;Zuidoost-Noord-Brabant (CR);2023;735488;153062;427268;155158;586054;70895;32029;38866;78539;42834;35705;9069;4683;4386;6170;3498;2672;16068;7980;8088;13856;5996;7860;33376;20677;12699;7843.0;7600.0;6019.0;4912.0;25864.0;27518.0;36
952;Zuidoost-Noord-Brabant (CR);2024;735270;152461;425015;157794;584012;71438;32501;38937;79820;43428;36392;9205;4720;4485;6301;3588;2713;16207;8015;8192;14049;6046;8003;34058;21059;12999;7878.0;7642.0;5972.0;4846.0;26188.0;27515.0;36
953;Zuidoost-Noord-Brabant (CR);2025;735395;152298;422354;160743;582279;71983;33026;38957;81133;44050;37083;9343;4784;4559;6472;3692;2780;16392;8057;8335;14211;6080;8131;34715;21437;13278;;;;;;;36
954;Noord-Limburg (CR);2008;277781;67321;168045;42415;230768;28656;10655;18001;18357;10440;7917;1166;605;561;637;363;274;5776;3041;2735;4739;2396;2343;6039;4035;2004;2663.0;2384.0;1259.0;1297.0;7530.0;8518.0;37
955;Noord-Limburg (CR);2009;277067;66614;167008;43445;229575;28583;10629;17954;18909;10654;8255;1272;672;600;693;402;291;5803;3033;2770;4785;2391;2394;6356;4156;2200;2597.0;2444.0;1349.0;1282.0;7865.0;8636.0;37
956;Noord-Limburg (CR);2010;276558;65822;166290;44446;228594;28497;10611;17886;19467;10864;8603;1382;744;638;781;440;341;5846;3048;2798;4795;2365;2430;6663;4267;2396;2583.0;2483.0;1344.0;1254.0;8351.0;8949.0;37
957;Noord-Limburg (CR);2011;276184;64959;165865;45360;227622;28483;10633;17850;20079;11107;8972;1492;810;682;841;484;357;5936;3061;2875;4848;2369;2479;6962;4383;2579;2561.0;2553.0;1365.0;1259.0;8649.0;9047.0;37
958;Noord-Limburg (CR);2012;275928;64235;164502;47191;226779;28505;10736;17769;20644;11273;9371;1581;856;725;881;509;372;6002;3051;2951;4892;2348;2544;7288;4509;2779;2569.0;2577.0;1389.0;1252.0;8719.0;9141.0;37
959;Noord-Limburg (CR);2013;275663;63316;163469;48878;225892;28606;10816;17790;21165;11483;9682;1706;929;777;940;535;405;6040;3057;2983;4916;2336;2580;7563;4626;2937;2582.0;2641.0;1389.0;1221.0;8756.0;9139.0;37
960;Noord-Limburg (CR);2014;275425;62604;162532;50289;224955;28655;10923;17732;21815;11776;10039;1795;979;816;1009;584;425;6117;3081;3036;4996;2355;2641;7898;4777;3121;2569.0;2686.0;1438.0;1222.0;8826.0;9192.0;37
961;Noord-Limburg (CR);2015;275193;61738;161702;51753;224089;28660;11019;17641;22444;12021;10423;1886;1033;853;1061;613;448;6177;3099;3078;5072;2367;2705;8248;4909;3339;2597.0;2709.0;1409.0;1207.0;8842.0;9252.0;37
962;Noord-Limburg (CR);2016;274895;61096;160631;53168;223292;28654;11090;17564;22949;12349;10600;1984;1082;902;1126;674;452;6214;3117;3097;5041;2366;2675;8584;5110;3474;2640.0;2771.0;1405.0;1171.0;9056.0;9243.0;37
963;Noord-Limburg (CR);2017;274842;60651;159785;54406;222819;28649;11202;17447;23374;12494;10880;2045;1122;923;1202;720;482;6223;3099;3124;5058;2358;2700;8846;5195;3651;2654.0;2812.0;1380.0;1191.0;9140.0;9238.0;37
964;Noord-Limburg (CR);2018;274804;60267;158860;55677;222292;28681;11323;17358;23831;12719;11112;2137;1177;960;1267;767;500;6235;3107;3128;5088;2382;2706;9104;5286;3818;2727.0;2859.0;1347.0;1166.0;9134.0;9247.0;37
965;Noord-Limburg (CR);2019;274764;59787;158169;56808;221813;28694;11406;17288;24257;12910;11347;2208;1215;993;1362;828;534;6231;3104;3127;5090;2373;2717;9366;5390;3976;2744.0;2910.0;1388.0;1150.0;9118.0;9192.0;37
966;Noord-Limburg (CR);2020;274790;59294;157536;57960;221295;28667;11498;17169;24828;13216;11612;2285;1266;1019;1452;890;562;6294;3127;3167;5105;2396;2709;9692;5537;4155;2778.0;2946.0;1340.0;1123.0;9265.0;9310.0;37
967;Noord-Limburg (CR);2021;274822;58733;157037;59052;220765;28713;11556;17157;25344;13480;11864;2370;1319;1051;1519;936;583;6344;3140;3204;5114;2384;2730;9997;5701;4296;2823.0;2971.0;1322.0;1133.0;9103.0;9269.0;37
968;Noord-Limburg (CR);2022;274726;58290;156327;60109;220165;28746;11647;17099;25815;13683;12132;2445;1362;1083;1618;995;623;6352;3146;3206;5132;2382;2750;10268;5798;4470;2896.0;3027.0;1341.0;1127.0;9275.0;9248.0;37
969;Noord-Limburg (CR);2023;274861;58064;155543;61254;219723;28759;11724;17035;26379;13941;12438;2530;1402;1128;1679;1037;642;6363;3148;3215;5179;2377;2802;10628;5977;4651;2916.0;3052.0;1350.0;1138.0;9284.0;9252.0;37
970;Noord-Limburg (CR);2024;274999;58019;154557;62423;219263;28913;11857;17056;26823;14143;12680;2601;1428;1173;1734;1074;660;6366;3155;3211;5207;2381;2826;10915;6105;4810;2950.0;3141.0;1317.0;1125.0;9337.0;9180.0;37
971;Noord-Limburg (CR);2025;275183;58084;153507;63592;218982;28971;11937;17034;27230;14298;12932;2651;1465;1186;1837;1151;686;6349;3141;3208;5205;2358;2847;11188;6183;5005;;;;;;;37
972;Midden-Limburg (CR);2008;231654;52465;140481;38708;191662;26293;9201;17092;13699;7922;5777;803;420;383;946;534;412;2939;1561;1378;4129;2078;2051;4882;3329;1553;1961.0;1946.0;1217.0;1561.0;7879.0;8223.0;38
973;Midden-Limburg (CR);2009;231004;51699;139480;39825;190784;26121;9161;16960;14099;8142;5957;891;472;419;968;558;410;3032;1589;1443;4147;2086;2061;5061;3437;1624;1937.0;2006.0;1243.0;1549.0;7903.0;8403.0;38
974;Midden-Limburg (CR);2010;230119;51047;138288;40784;189750;25943;9143;16800;14426;8294;6132;981;520;461;1018;587;431;3092;1592;1500;4145;2091;2054;5190;3504;1686;1912.0;2026.0;1297.0;1514.0;7900.0;8544.0;38
975;Midden-Limburg (CR);2011;229153;50159;137233;41761;188601;25845;9216;16629;14707;8410;6297;1042;557;485;1028;595;433;3117;1596;1521;4152;2069;2083;5368;3593;1775;1880.0;2058.0;1331.0;1473.0;8211.0;8505.0;38
976;Midden-Limburg (CR);2012;228543;49352;135854;43337;187746;25740;9282;16458;15057;8559;6498;1130;614;516;1073;622;451;3186;1622;1564;4124;2052;2072;5544;3649;1895;1867.0;2099.0;1349.0;1492.0;8043.0;8579.0;38
977;Midden-Limburg (CR);2013;227649;48572;134312;44765;186661;25674;9432;16242;15314;8663;6651;1198;650;548;1099;641;458;3207;1614;1593;4115;2055;2060;5695;3703;1992;1863.0;2145.0;1339.0;1404.0;8406.0;8548.0;38
978;Midden-Limburg (CR);2014;227182;47955;133193;46034;185893;25611;9467;16144;15678;8785;6893;1282;700;582;1149;666;483;3270;1624;1646;4116;2043;2073;5861;3752;2109;1865.0;2196.0;1330.0;1395.0;8481.0;8566.0;38
979;Midden-Limburg (CR);2015;226712;47341;131882;47489;185173;25521;9514;16007;16018;8934;7084;1361;747;614;1185;674;511;3275;1637;1638;4144;2052;2092;6053;3824;2229;1891.0;2225.0;1306.0;1377.0;8241.0;8606.0;38
980;Midden-Limburg (CR);2016;225965;46721;130645;48599;184095;25468;9608;15860;16402;9128;7274;1439;787;652;1244;701;543;3302;1649;1653;4139;2054;2085;6278;3937;2341;1880.0;2270.0;1321.0;1395.0;8503.0;8481.0;38
981;Midden-Limburg (CR);2017;225547;46280;129502;49765;183474;25400;9658;15742;16673;9188;7485;1508;817;691;1284;729;555;3341;1667;1674;4150;2039;2111;6390;3936;2454;1900.0;2301.0;1258.0;1328.0;8308.0;8548.0;38
982;Midden-Limburg (CR);2018;224852;45736;128252;50864;182642;25254;9688;15566;16956;9329;7627;1590;851;739;1341;754;587;3334;1664;1670;4186;2066;2120;6505;3994;2511;1919.0;2327.0;1254.0;1330.0;8555.0;8540.0;38
983;Midden-Limburg (CR);2019;224368;45230;127240;51898;181867;25217;9772;15445;17284;9526;7758;1660;887;773;1377;777;600;3369;1696;1673;4205;2094;2111;6673;4072;2601;1924.0;2369.0;1250.0;1339.0;8432.0;8516.0;38
984;Midden-Limburg (CR);2020;223772;44658;126285;52829;181007;25154;9779;15375;17611;9640;7971;1728;922;806;1433;807;626;3400;1695;1705;4196;2075;2121;6854;4141;2713;1969.0;2376.0;1254.0;1300.0;8160.0;8500.0;38
985;Midden-Limburg (CR);2021;223003;44095;125073;53835;180063;24957;9713;15244;17983;9791;8192;1798;950;848;1471;817;654;3439;1709;1730;4237;2087;2150;7038;4228;2810;1956.0;2416.0;1241.0;1293.0;8287.0;8484.0;38
986;Midden-Limburg (CR);2022;222322;43647;123923;54752;179293;24881;9771;15110;18148;9865;8283;1864;982;882;1518;833;685;3444;1716;1728;4175;2059;2116;7147;4275;2872;1967.0;2476.0;1201.0;1270.0;8491.0;8448.0;38
987;Midden-Limburg (CR);2023;221812;43238;122993;55581;178624;24826;9852;14974;18362;9958;8404;1900;1004;896;1555;850;705;3466;1725;1741;4133;2049;2084;7308;4330;2978;1992.0;2492.0;1182.0;1263.0;8407.0;8422.0;38
988;Midden-Limburg (CR);2024;221239;43042;121718;56479;177885;24821;9882;14939;18533;10086;8447;1944;1039;905;1586;868;718;3467;1726;1741;4073;2040;2033;7463;4413;3050;2004.0;2531.0;1220.0;1257.0;8323.0;8281.0;38
989;Midden-Limburg (CR);2025;220742;42981;120287;57474;177134;24789;9919;14870;18819;10255;8564;2001;1050;951;1662;914;748;3469;1746;1723;4081;2069;2012;7606;4476;3130;;;;;;;38
990;Zuid-Limburg (CR);2008;612573;125791;377205;109577;479311;102577;36351;66226;30685;18554;12131;2010;1014;996;2253;1396;857;4123;2210;1913;7911;4023;3888;14388;9911;4477;4820.0;6437.0;4846.0;6138.0;24480.0;24927.0;39
991;Zuid-Limburg (CR);2009;609298;123835;374700;110763;476931;100708;35959;64749;31659;18867;12792;2283;1176;1107;2385;1462;923;4366;2286;2080;8029;4004;4025;14596;9939;4657;4791.0;6502.0;4924.0;6031.0;24548.0;25139.0;39
992;Zuid-Limburg (CR);2010;605975;121697;372182;112096;474601;98858;35497;63361;32516;19151;13365;2539;1326;1213;2471;1514;957;4618;2373;2245;8153;4036;4117;14735;9902;4833;4798.0;6523.0;5063.0;5794.0;24827.0;25450.0;39
993;Zuid-Limburg (CR);2011;602974;119418;369406;114150;472419;97178;35247;61931;33377;19409;13968;2798;1457;1341;2565;1567;998;4889;2467;2422;8242;4017;4225;14883;9901;4982;4829.0;6613.0;5060.0;5713.0;24484.0;25265.0;39
994;Zuid-Limburg (CR);2012;599838;117196;366139;116503;470042;95523;34967;60556;34273;19660;14613;3049;1596;1453;2667;1606;1061;5162;2553;2609;8333;3986;4347;15062;9919;5143;4874.0;6628.0;5100.0;5553.0;24570.0;25158.0;39
995;Zuid-Limburg (CR);2013;597116;115703;362352;119061;468031;93870;34709;59161;35215;19910;15305;3272;1731;1541;2774;1654;1120;5473;2665;2808;8468;3961;4507;15228;9899;5329;4917.0;6691.0;4996.0;5428.0;24414.0;25181.0;39
996;Zuid-Limburg (CR);2014;594203;114094;358851;121258;465822;92314;34445;57869;36067;20186;15881;3496;1828;1668;2895;1747;1148;5761;2745;3016;8578;3982;4596;15337;9884;5453;4970.0;6753.0;4907.0;5282.0;24422.0;25229.0;39
997;Zuid-Limburg (CR);2015;591312;112568;355469;123275;463579;90806;34120;56686;36927;20506;16421;3677;1925;1752;3067;1839;1228;6002;2830;3172;8645;3960;4685;15536;9952;5584;5000.0;6781.0;4828.0;5197.0;24439.0;24965.0;39
998;Zuid-Limburg (CR);2016;588713;111515;352078;125120;461672;89289;33779;55510;37752;20814;16938;3894;2035;1859;3159;1896;1263;6266;2951;3315;8714;3959;4755;15719;9973;5746;5036.0;6825.0;4686.0;5088.0;24272.0;24851.0;39
999;Zuid-Limburg (CR);2017;586020;110499;348753;126768;459656;87786;33564;54222;38578;21066;17512;4138;2156;1982;3262;1944;1318;6510;3032;3478;8794;3959;4835;15874;9975;5899;5077.0;6856.0;4564.0;5006.0;24119.0;24710.0;39
1000;Zuid-Limburg (CR);2018;583280;109629;344937;128714;457549;86331;33292;53039;39400;21359;18041;4360;2279;2081;3346;1992;1354;6752;3090;3662;8888;3964;4924;16054;10034;6020;5139.0;6901.0;4549.0;4899.0;24008.0;24542.0;39
1001;Zuid-Limburg (CR);2019;580708;108608;341629;130471;455613;84971;32998;51973;40124;21581;18543;4541;2368;2173;3479;2032;1447;6976;3169;3807;8976;3990;4986;16152;10022;6130;5182.0;6952.0;4426.0;4785.0;23932.0;24504.0;39
1002;Zuid-Limburg (CR);2020;578075;107859;338321;131895;453598;83541;32760;50781;40936;21895;19041;4725;2459;2266;3553;2056;1497;7220;3256;3964;9107;4001;5106;16331;10123;6208;5179.0;6968.0;4337.0;4705.0;23963.0;24348.0;39
1003;Zuid-Limburg (CR);2021;575608;106831;335405;133372;451551;82427;32592;49835;41630;22170;19460;4892;2555;2337;3648;2098;1550;7433;3344;4089;9099;3965;5134;16558;10208;6350;5162.0;6961.0;4272.0;4645.0;23738.0;24229.0;39
1004;Zuid-Limburg (CR);2022;573014;106049;331840;135125;449502;81167;32314;48853;42345;22444;19901;5018;2624;2394;3787;2161;1626;7621;3396;4225;9187;3978;5209;16732;10285;6447;5118.0;7067.0;4192.0;4589.0;23716.0;24062.0;39
1005;Zuid-Limburg (CR);2023;570385;105606;328133;136646;447213;80077;32156;47921;43095;22649;20446;5169;2689;2480;3882;2200;1682;7792;3466;4326;9356;4012;5344;16896;10282;6614;5148.0;7103.0;4131.0;4451.0;23488.0;23809.0;39
1006;Zuid-Limburg (CR);2024;567856;105202;324419;138235;445024;78918;31934;46984;43914;22973;20941;5300;2753;2547;3989;2238;1751;7987;3549;4438;9479;4039;5440;17159;10394;6765;5161.0;7146.0;4054.0;4347.0;23301.0;23649.0;39
1007;Zuid-Limburg (CR);2025;565282;105016;320494;139772;442822;77893;31773;46120;44567;23251;21316;5478;2866;2612;4075;2296;1779;8208;3628;4580;9525;4042;5483;17281;10419;6862;;;;;;;39
1008;Flevoland (CR);2008;379386;111972;231297;36117;281434;31192;12347;18845;66760;36648;30112;23521;12287;11234;6081;3621;2460;6456;3182;3274;9935;4607;5328;20767;12951;7816;5287.0;2172.0;3102.0;3216.0;15795.0;14489.0;40
1009;Flevoland (CR);2009;383741;112446;233198;38097;283657;31794;12600;19194;68290;36771;31519;23598;12138;11460;6071;3580;2491;6900;3302;3598;10440;4750;5690;21281;13001;8280;5292.0;2268.0;3314.0;3237.0;15644.0;14531.0;40
1010;Flevoland (CR);2010;388002;112942;234790;40270;285426;32524;12874;19650;70052;37159;32893;23702;12025;11677;6120;3569;2551;7274;3417;3857;11009;4935;6074;21947;13213;8734;5254.0;2380.0;3498.0;3204.0;15837.0;14793.0;40
1011;Flevoland (CR);2011;392247;113045;237087;42115;287215;33196;13181;20015;71836;37550;34286;23760;11919;11841;6226;3587;2639;7674;3540;4134;11557;5119;6438;22619;13385;9234;5262.0;2498.0;3577.0;3212.0;15897.0;14816.0;40
1012;Flevoland (CR);2012;396489;113121;237988;45380;289064;33864;13493;20371;73561;37884;35677;23947;11932;12015;6295;3575;2720;8003;3623;4380;12064;5274;6790;23252;13480;9772;5206.0;2593.0;3761.0;3177.0;16084.0;14874.0;40
1013;Flevoland (CR);2013;400933;113354;239155;48424;290867;34564;13849;20715;75502;38333;37169;24042;11890;12152;6388;3572;2816;8354;3727;4627;12625;5416;7209;24093;13728;10365;5226.0;2668.0;3723.0;3194.0;16595.0;14977.0;40
1014;Flevoland (CR);2014;405682;113766;240695;51221;292999;35364;14219;21145;77319;38712;38607;24123;11837;12286;6460;3540;2920;8754;3864;4890;13101;5556;7545;24881;13915;10966;5282.0;2784.0;3787.0;3178.0;16039.0;15005.0;40
1015;Flevoland (CR);2015;409857;113832;242095;53930;294763;36050;14587;21463;79044;39089;39955;24208;11794;12414;6569;3541;3028;9097;3970;5127;13615;5687;7928;25555;14097;11458;5309.0;2897.0;3797.0;3168.0;16228.0;14883.0;40
1016;Flevoland (CR);2016;414278;114423;243323;56532;296630;36874;14963;21911;80774;39703;41071;24295;11768;12527;6652;3543;3109;9485;4120;5365;14025;5841;8184;26317;14431;11886;5329.0;2983.0;3835.0;3163.0;16573.0;15078.0;40
1017;Flevoland (CR);2017;418828;115019;244651;59158;298626;37607;15313;22294;82595;40278;42317;24381;11765;12616;6784;3567;3217;9847;4236;5611;14502;5999;8503;27081;14711;12370;5407.0;3085.0;3884.0;3171.0;16405.0;15258.0;40
1018;Flevoland (CR);2018;423046;115423;245525;62098;300299;38365;15683;22682;84382;40819;43563;24531;11807;12724;6922;3570;3352;10170;4342;5828;14951;6124;8827;27808;14976;12832;5459.0;3162.0;3909.0;3178.0;16151.0;15339.0;40
1019;Flevoland (CR);2019;426929;115375;246525;65029;301778;39183;16066;23117;85968;41381;44587;24534;11787;12747;7051;3574;3477;10446;4432;6014;15348;6237;9111;28589;15351;13238;5529.0;3278.0;3941.0;3186.0;16525.0;15480.0;40
1020;Flevoland (CR);2020;431019;115474;247593;67952;303582;39890;16405;23485;87547;41775;45772;24566;11745;12821;7157;3563;3594;10762;4552;6210;15772;6359;9413;29290;15556;13734;5584.0;3352.0;3984.0;3193.0;16457.0;15727.0;40
1021;Flevoland (CR);2021;434814;115405;248533;70876;305167;40650;16783;23867;88997;42187;46810;24589;11687;12902;7252;3573;3679;11071;4624;6447;16066;6468;9598;30019;15835;14184;5681.0;3449.0;4000.0;3211.0;16486.0;15754.0;40
1022;Flevoland (CR);2022;438613;115350;249372;73891;306758;41400;17102;24298;90455;42717;47738;24588;11681;12907;7340;3552;3788;11351;4708;6643;16384;6560;9824;30792;16216;14576;5800.0;3555.0;4053.0;3191.0;16527.0;15836.0;40
1023;Flevoland (CR);2023;442444;115486;249983;76975;308298;42206;17514;24692;91940;43208;48732;24576;11630;12946;7457;3546;3911;11611;4817;6794;16660;6662;9998;31636;16553;15083;5883.0;3694.0;4122.0;3160.0;16952.0;16065.0;40
1024;Flevoland (CR);2024;446516;116027;250481;80008;309919;43101;17902;25199;93496;43638;49858;24592;11575;13017;7589;3548;4041;11865;4871;6994;16927;6734;10193;32523;16910;15613;5976.0;3808.0;4132.0;3171.0;16691.0;15938.0;40
1025;Flevoland (CR);2025;450436;116428;250950;83058;311277;43960;18350;25610;95199;44263;50936;24598;11513;13085;7755;3593;4162;12134;4955;7179;17240;6877;10363;33472;17325;16147;;;;;;;40
1026;Groningen (SG);2008;343556;73559;221488;48509;298225;24619;10195;14424;20712;12619;8093;3809;1934;1875;3208;2063;1145;1838;948;890;1503;672;831;10354;7002;3352;3671.0;2939.0;2602.0;3133.0;20087.0;19208.0;1
1027;Groningen (SG);2009;344717;73452;221831;49434;298755;24608;10195;14413;21354;12842;8512;3888;1984;1904;3190;2023;1167;2028;1010;1018;1714;752;962;10534;7073;3461;3712.0;2941.0;2756.0;3116.0;19941.0;19252.0;1
1028;Groningen (SG);2010;345901;73408;221977;50516;299328;24629;10261;14368;21944;13051;8893;3944;2017;1927;3240;2061;1179;2213;1077;1136;1910;816;1094;10637;7080;3557;3828.0;2955.0;2795.0;3099.0;20483.0;19309.0;1
1029;Groningen (SG);2011;347717;73477;222733;51507;300474;24695;10298;14397;22548;13231;9317;4031;2065;1966;3267;2059;1208;2410;1157;1253;2092;879;1213;10748;7071;3677;3890.0;2986.0;2903.0;3056.0;20355.0;19274.0;1
1030;Groningen (SG);2012;349606;73425;222587;53594;301680;24828;10344;14484;23098;13398;9700;4089;2121;1968;3334;2109;1225;2586;1219;1367;2239;907;1332;10850;7042;3808;3981.0;3019.0;2866.0;3021.0;20161.0;19245.0;1
1031;Groningen (SG);2013;351391;73578;222370;55443;302825;24933;10396;14537;23633;13582;10051;4167;2177;1990;3353;2109;1244;2776;1303;1473;2401;954;1447;10936;7039;3897;4061.0;3038.0;2867.0;3002.0;20464.0;19166.0;1
1032;Groningen (SG);2014;353639;73921;222692;57026;304390;25021;10455;14566;24228;13812;10416;4218;2218;2000;3413;2167;1246;2927;1350;1577;2581;997;1584;11089;7080;4009;4119.0;3078.0;2858.0;2966.0;20594.0;19152.0;1
1033;Groningen (SG);2015;356088;74281;223387;58420;306102;25209;10612;14597;24777;13968;10809;4266;2251;2015;3459;2186;1273;3116;1428;1688;2726;1047;1679;11210;7056;4154;4199.0;3098.0;2897.0;2933.0;20421.0;19246.0;1
1034;Groningen (SG);2016;358390;74671;224053;59666;307580;25346;10717;14629;25464;14216;11248;4380;2312;2068;3526;2218;1308;3261;1480;1781;2874;1104;1770;11423;7102;4321;4258.0;3111.0;2832.0;2917.0;20280.0;19280.0;1
1035;Groningen (SG);2017;360520;75199;224355;60966;309088;25481;10780;14701;25951;14400;11551;4418;2339;2079;3559;2254;1305;3414;1535;1879;2983;1130;1853;11577;7142;4435;4308.0;3151.0;2833.0;2903.0;20530.0;19237.0;1
1036;Groningen (SG);2018;362967;75837;224662;62468;310714;25608;10814;14794;26645;14648;11997;4491;2367;2124;3626;2285;1341;3573;1592;1981;3140;1164;1976;11815;7240;4575;4376.0;3193.0;2809.0;2865.0;20438.0;19377.0;1
1037;Groningen (SG);2019;365220;76356;224941;63923;312243;25732;10861;14871;27245;14916;12329;4590;2412;2178;3664;2318;1346;3713;1640;2073;3267;1230;2037;12011;7316;4695;4401.0;3251.0;2822.0;2866.0;20688.0;19367.0;1
1038;Groningen (SG);2020;367704;76874;225484;65346;313978;25914;10952;14962;27812;15082;12730;4672;2446;2226;3663;2317;1346;3851;1690;2161;3464;1283;2181;12162;7346;4816;4433.0;3285.0;2845.0;2869.0;20690.0;19459.0;1
1039;Groningen (SG);2021;370114;77440;225933;66741;315583;26032;11059;14973;28499;15363;13136;4727;2471;2256;3760;2357;1403;3968;1753;2215;3639;1322;2317;12405;7460;4945;4449.0;3324.0;2782.0;2827.0;20445.0;19530.0;1
1040;Groningen (SG);2022;372176;77756;226243;68177;316803;26225;11191;15034;29148;15622;13526;4804;2511;2293;3801;2378;1423;4114;1827;2287;3813;1366;2447;12616;7540;5076;4446.0;3376.0;2803.0;2838.0;20632.0;19528.0;1
1041;Groningen (SG);2023;374374;78246;226422;69706;318284;26320;11260;15060;29770;15873;13897;4846;2525;2321;3856;2390;1466;4263;1880;2383;3956;1407;2549;12849;7671;5178;4469.0;3431.0;2756.0;2847.0;20773.0;19600.0;1
1042;Groningen (SG);2024;376548;78876;226442;71230;319625;26498;11331;15167;30425;16072;14353;4932;2556;2376;3899;2389;1510;4423;1952;2471;4083;1430;2653;13088;7745;5343;4488.0;3485.0;2780.0;2822.0;20524.0;19613.0;1
1043;Groningen (SG);2025;378478;79540;226246;72692;320733;26674;11453;15221;31071;16321;14750;4983;2569;2414;3947;2392;1555;4541;2002;2539;4289;1499;2790;13311;7859;5452;;;;;;;1
1044;Leeuwarden (SG);2008;162436;37653;101136;23647;143090;9060;3404;5656;10286;6496;3790;1562;811;751;1013;645;368;735;376;359;1203;571;632;5773;4093;1680;1844.0;1510.0;908.0;1124.0;6862.0;5919.0;2
1045;Leeuwarden (SG);2009;163530;37516;102012;24002;143796;9148;3433;5715;10586;6532;4054;1636;852;784;1077;665;412;802;409;393;1308;603;705;5763;4003;1760;1915.0;1518.0;930.0;1106.0;6303.0;5753.0;2
1046;Leeuwarden (SG);2010;164331;37524;102359;24448;144170;9262;3508;5754;10899;6617;4282;1685;881;804;1121;688;433;905;447;458;1393;638;755;5795;3963;1832;1933.0;1525.0;911.0;1095.0;6067.0;5765.0;2
1047;Leeuwarden (SG);2011;164884;37451;102673;24760;144352;9290;3473;5817;11242;6740;4502;1695;880;815;1171;728;443;988;467;521;1483;679;804;5905;3986;1919;1995.0;1525.0;973.0;1101.0;5911.0;5694.0;2
1048;Leeuwarden (SG);2012;165464;37372;102519;25573;144666;9328;3461;5867;11470;6817;4653;1729;888;841;1213;757;456;1059;503;556;1539;697;842;5930;3972;1958;2034.0;1515.0;961.0;1075.0;5912.0;5688.0;2
1049;Leeuwarden (SG);2013;166121;37363;102392;26366;144940;9383;3505;5878;11798;6949;4849;1768;908;860;1232;768;464;1193;562;631;1610;723;887;5995;3988;2007;2080.0;1543.0;965.0;1042.0;5765.0;5764.0;2
1050;Leeuwarden (SG);2014;166614;37317;102277;27020;145121;9486;3533;5953;12007;6974;5033;1797;918;879;1232;753;479;1289;601;688;1692;770;922;5997;3932;2065;2142.0;1526.0;980.0;1042.0;5852.0;5766.0;2
1051;Leeuwarden (SG);2015;167284;37541;102209;27534;145427;9558;3588;5970;12299;7076;5223;1822;941;881;1287;788;499;1396;631;765;1782;810;972;6012;3906;2106;2166.0;1561.0;942.0;1034.0;5812.0;5803.0;2
1052;Leeuwarden (SG);2016;167826;37653;102100;28073;145668;9592;3592;6000;12566;7164;5402;1845;946;899;1336;814;522;1477;657;820;1853;839;1014;6055;3908;2147;2227.0;1551.0;942.0;1016.0;5836.0;5834.0;2
1053;Leeuwarden (SG);2017;168455;37924;101900;28631;145924;9687;3637;6050;12844;7272;5572;1893;974;919;1381;836;545;1568;706;862;1942;865;1077;6060;3891;2169;2237.0;1563.0;979.0;1003.0;5811.0;5743.0;2
1054;Leeuwarden (SG);2018;169194;38301;101763;29130;146271;9751;3673;6078;13172;7371;5801;1937;999;938;1460;874;586;1642;740;902;2025;881;1144;6108;3877;2231;2276.0;1570.0;960.0;1009.0;5885.0;5947.0;2
1055;Leeuwarden (SG);2019;169815;38631;101592;29592;146604;9776;3670;6106;13435;7460;5975;1960;1005;955;1514;904;610;1683;751;932;2104;900;1204;6174;3900;2274;2313.0;1587.0;953.0;979.0;5809.0;5847.0;2
1056;Leeuwarden (SG);2020;170498;38954;101477;30067;146864;9852;3726;6126;13782;7580;6202;1999;1017;982;1582;940;642;1743;787;956;2218;927;1291;6240;3909;2331;2359.0;1588.0;926.0;986.0;5935.0;5916.0;2
1057;Leeuwarden (SG);2021;171247;39391;101272;30584;147335;9919;3738;6181;13993;7647;6346;1997;1021;976;1638;955;683;1796;822;974;2296;963;1333;6266;3886;2380;2373.0;1607.0;936.0;963.0;5813.0;5920.0;2
1058;Leeuwarden (SG);2022;171902;39790;100973;31139;147684;9959;3753;6206;14259;7688;6571;2011;1013;998;1689;991;698;1902;844;1058;2352;979;1373;6305;3861;2444;2386.0;1632.0;922.0;988.0;5861.0;5851.0;2
1059;Leeuwarden (SG);2023;172617;40158;100819;31640;148098;9998;3765;6233;14521;7719;6802;2055;1018;1037;1736;1019;717;1970;869;1101;2431;997;1434;6329;3816;2513;2405.0;1652.0;920.0;956.0;5766.0;5811.0;2
1060;Leeuwarden (SG);2024;173312;40574;100615;32123;148479;10007;3804;6203;14826;7863;6963;2073;1022;1051;1786;1055;731;2092;918;1174;2531;1032;1499;6344;3836;2508;2436.0;1659.0;901.0;951.0;5720.0;5789.0;2
1061;Leeuwarden (SG);2025;173988;41035;100378;32575;148800;10084;3841;6243;15104;7955;7149;2127;1054;1073;1818;1072;746;2145;933;1212;2598;1048;1550;6416;3848;2568;;;;;;;2
1062;Zwolle (SG);2008;171470;42806;104924;23740;150708;9460;3340;6120;11302;6698;4604;1323;667;656;1353;845;508;2673;1391;1282;832;378;454;5121;3417;1704;2265.0;1461.0;667.0;835.0;7047.0;6939.0;3
1063;Zwolle (SG);2009;172247;42857;105244;24146;151203;9506;3390;6116;11538;6790;4748;1378;706;672;1352;828;524;2693;1387;1306;908;418;490;5207;3451;1756;2231.0;1455.0;707.0;838.0;7019.0;6867.0;3
1064;Zwolle (SG);2010;173067;42994;105476;24597;151683;9626;3426;6200;11758;6867;4891;1432;729;703;1366;834;532;2715;1400;1315;963;429;534;5282;3475;1807;2229.0;1479.0;730.0;831.0;7008.0;6966.0;3
1065;Zwolle (SG);2011;173788;43020;105782;24986;152048;9714;3497;6217;12026;6948;5078;1492;754;738;1364;831;533;2767;1410;1357;1027;448;579;5376;3505;1871;2193.0;1502.0;754.0;816.0;7056.0;6872.0;3
1066;Zwolle (SG);2012;174629;43017;105725;25887;152469;9857;3550;6307;12303;7065;5238;1533;770;763;1380;836;544;2815;1445;1370;1069;467;602;5506;3547;1959;2167.0;1518.0;766.0;801.0;7193.0;6951.0;3
1067;Zwolle (SG);2013;175502;43026;105699;26777;152925;9965;3589;6376;12612;7200;5412;1600;795;805;1394;841;553;2847;1452;1395;1115;478;637;5656;3634;2022;2140.0;1539.0;785.0;795.0;7198.0;6905.0;3
1068;Zwolle (SG);2014;176408;43042;105907;27459;153415;10091;3707;6384;12902;7295;5607;1624;811;813;1416;859;557;2902;1457;1445;1178;501;677;5782;3667;2115;2113.0;1539.0;788.0;771.0;7157.0;6920.0;3
1069;Zwolle (SG);2015;177260;43117;106089;28054;153825;10203;3762;6441;13232;7447;5785;1680;841;839;1411;843;568;2911;1468;1443;1261;530;731;5969;3765;2204;2089.0;1568.0;752.0;772.0;7297.0;6916.0;3
1070;Zwolle (SG);2016;178169;43149;106337;28683;154320;10312;3802;6510;13537;7582;5955;1715;858;857;1440;845;595;2956;1498;1458;1333;544;789;6093;3837;2256;2090.0;1595.0;806.0;771.0;7154.0;7003.0;3
1071;Zwolle (SG);2017;178868;43177;106483;29208;154617;10365;3845;6520;13886;7748;6138;1770;881;889;1469;859;610;2992;1513;1479;1423;571;852;6232;3924;2308;2044.0;1598.0;784.0;769.0;7232.0;7016.0;3
1072;Zwolle (SG);2018;179563;43244;106422;29897;155002;10464;3881;6583;14097;7854;6243;1775;885;890;1487;866;621;2989;1508;1481;1464;582;882;6382;4013;2369;2066.0;1621.0;769.0;755.0;7261.0;7056.0;3
1073;Zwolle (SG);2019;180247;43130;106621;30496;155322;10556;3965;6591;14369;7991;6378;1815;908;907;1502;868;634;3035;1524;1511;1519;610;909;6498;4081;2417;2055.0;1621.0;768.0;739.0;7202.0;7026.0;3
1074;Zwolle (SG);2020;180911;43042;106785;31084;155542;10697;4036;6661;14672;8151;6521;1850;925;925;1543;895;648;3058;1535;1523;1598;634;964;6623;4162;2461;2053.0;1638.0;777.0;760.0;7033.0;7059.0;3
1075;Zwolle (SG);2021;181335;42779;106765;31791;155647;10775;4114;6661;14913;8254;6659;1879;936;943;1568;911;657;3081;1543;1538;1639;648;991;6746;4216;2530;2047.0;1663.0;783.0;742.0;7183.0;7074.0;3
1076;Zwolle (SG);2022;181888;42521;106923;32444;155827;10866;4177;6689;15195;8389;6806;1925;961;964;1598;928;670;3092;1538;1554;1692;656;1036;6888;4306;2582;2041.0;1690.0;739.0;741.0;7249.0;7031.0;3
1077;Zwolle (SG);2023;182471;42265;107026;33180;156060;10938;4172;6766;15473;8532;6941;1929;959;970;1602;917;685;3156;1566;1590;1731;675;1056;7055;4415;2640;2037.0;1720.0;733.0;728.0;7088.0;7081.0;3
1078;Zwolle (SG);2024;182824;42012;106928;33884;156111;10977;4207;6770;15736;8647;7089;1969;974;995;1651;942;709;3176;1584;1592;1800;682;1118;7140;4465;2675;2037.0;1746.0;728.0;752.0;6905.0;7041.0;3
1079;Zwolle (SG);2025;182981;41861;106520;34600;156013;11013;4228;6785;15955;8748;7207;1990;1004;986;1680;955;725;3197;1577;1620;1841;689;1152;7247;4523;2724;;;;;;;3
1080;Enschede (SG);2008;313006;74076;192146;46784;244880;33853;12388;21465;34273;19521;14752;2708;1437;1271;1541;904;637;15016;7595;7421;2761;1271;1490;12247;8314;3933;3527.0;2896.0;2250.0;2661.0;11220.0;10113.0;4
1081;Enschede (SG);2009;314377;74191;192381;47805;246062;33808;12466;21342;34507;19378;15129;2838;1513;1325;1587;930;657;14883;7488;7395;2911;1309;1602;12288;8138;4150;3511.0;2946.0;2265.0;2579.0;10426.0;10020.0;4
1082;Enschede (SG);2010;315084;74045;192249;48790;246662;33712;12514;21198;34710;19285;15425;2963;1564;1399;1640;954;686;14726;7398;7328;3060;1356;1704;12321;8013;4308;3504.0;2982.0;2381.0;2587.0;10149.0;9937.0;4
1083;Enschede (SG);2011;315646;73835;192267;49544;247014;33619;12564;21055;35013;19302;15711;3069;1614;1455;1716;1007;709;14567;7319;7248;3242;1385;1857;12419;7977;4442;3504.0;3007.0;2374.0;2484.0;9890.0;9726.0;4
1084;Enschede (SG);2012;316245;73537;191340;51368;247303;33608;12613;20995;35334;19273;16061;3181;1669;1512;1783;1040;743;14414;7220;7194;3456;1440;2016;12500;7904;4596;3460.0;3031.0;2395.0;2475.0;9945.0;9884.0;4
1085;Enschede (SG);2013;316697;73395;190369;52933;247513;33502;12633;20869;35682;19213;16469;3288;1725;1563;1873;1079;794;14322;7124;7198;3621;1483;2138;12578;7802;4776;3476.0;3061.0;2345.0;2413.0;9664.0;9846.0;4
1086;Enschede (SG);2014;316903;73087;189549;54267;247516;33398;12734;20664;35989;19256;16733;3387;1791;1596;1973;1126;847;14212;7038;7174;3765;1524;2241;12652;7777;4875;3468.0;3088.0;2371.0;2327.0;9481.0;9645.0;4
1087;Enschede (SG);2015;317203;72847;188957;55399;247518;33335;12817;20518;36350;19323;17027;3518;1852;1666;2070;1173;897;14088;6971;7117;3925;1573;2352;12749;7754;4995;3451.0;3139.0;2330.0;2306.0;9399.0;9870.0;4
1088;Enschede (SG);2016;317106;72655;188033;56418;247239;33222;12906;20316;36645;19414;17231;3581;1909;1672;2148;1224;924;13951;6859;7092;4092;1620;2472;12873;7802;5071;3495.0;3162.0;2334.0;2256.0;9588.0;9961.0;4
1089;Enschede (SG);2017;317189;72507;187350;57332;247089;33233;13042;20191;36867;19481;17386;3687;1963;1724;2203;1257;946;13821;6761;7060;4194;1642;2552;12962;7858;5104;3467.0;3190.0;2235.0;2245.0;9634.0;9853.0;4
1090;Enschede (SG);2018;317276;72358;186626;58292;246994;33150;13044;20106;37132;19601;17531;3763;1987;1776;2277;1304;973;13692;6674;7018;4296;1686;2610;13104;7950;5154;3482.0;3222.0;2259.0;2181.0;9508.0;9897.0;4
1091;Enschede (SG);2019;317264;72177;185813;59274;246700;33099;13177;19922;37465;19686;17779;3880;2036;1844;2369;1346;1023;13538;6618;6920;4429;1726;2703;13249;7960;5289;3490.0;3240.0;2238.0;2162.0;9388.0;9806.0;4
1092;Enschede (SG);2020;317210;71825;185266;60119;246396;33053;13243;19810;37761;19756;18005;3974;2067;1907;2449;1392;1057;13415;6550;6865;4560;1769;2791;13363;7978;5385;3505.0;3265.0;2170.0;2124.0;9653.0;9864.0;4
1093;Enschede (SG);2021;317318;71433;184870;61015;246280;32955;13286;19669;38083;19801;18282;4049;2097;1952;2508;1418;1090;13296;6471;6825;4732;1803;2929;13498;8012;5486;3520.0;3334.0;2181.0;2111.0;9683.0;9884.0;4
1094;Enschede (SG);2022;317408;71218;184231;61959;246180;32884;13403;19481;38344;19856;18488;4124;2137;1987;2586;1457;1129;13151;6399;6752;4875;1834;3041;13608;8029;5579;3534.0;3343.0;2202.0;2113.0;9615.0;9848.0;4
1095;Enschede (SG);2023;317495;71127;183543;62825;246052;32804;13482;19322;38639;19909;18730;4226;2161;2065;2645;1490;1155;13035;6324;6711;5035;1893;3142;13698;8041;5657;3503.0;3394.0;2124.0;2032.0;9809.0;9839.0;4
1096;Enschede (SG);2024;317705;70889;183167;63649;245983;32790;13603;19187;38932;20030;18902;4300;2205;2095;2752;1547;1205;12866;6223;6643;5144;1921;3223;13870;8134;5736;3523.0;3427.0;2110.0;2023.0;9552.0;9893.0;4
1097;Enschede (SG);2025;317581;70693;182278;64610;245704;32701;13673;19028;39176;20162;19014;4427;2266;2161;2841;1597;1244;12688;6142;6546;5210;1929;3281;14010;8228;5782;;;;;;;4
1098;Apeldoorn (SG);2008;210596;49913;125988;34695;181633;15412;5563;9849;13551;7807;5744;1198;631;567;1173;636;537;5226;2776;2450;1046;512;534;4908;3252;1656;2113.0;2092.0;672.0;956.0;6523.0;6886.0;5
1099;Apeldoorn (SG);2009;209997;49332;125552;35113;180654;15445;5574;9871;13898;7893;6005;1261;657;604;1205;658;547;5264;2761;2503;1167;561;606;5001;3256;1745;2075.0;2108.0;708.0;910.0;6475.0;6927.0;5
1100;Apeldoorn (SG);2010;209331;48679;124967;35685;179647;15434;5569;9865;14250;8063;6187;1343;715;628;1215;658;557;5303;2779;2524;1257;596;661;5132;3315;1817;2029.0;2117.0;729.0;896.0;6451.0;6965.0;5
1101;Apeldoorn (SG);2011;208583;48031;124510;36042;178560;15421;5521;9900;14602;8214;6388;1407;755;652;1256;674;582;5306;2787;2519;1354;621;733;5279;3377;1902;1980.0;2119.0;756.0;892.0;7586.0;6957.0;5
1102;Apeldoorn (SG);2012;208954;47563;123830;37561;178503;15409;5533;9876;15042;8469;6573;1495;799;696;1269;682;587;5340;2842;2498;1461;664;797;5477;3482;1995;1950.0;2117.0;763.0;886.0;7106.0;7099.0;5
1103;Apeldoorn (SG);2013;208697;46962;122974;38761;177875;15466;5589;9877;15356;8603;6753;1580;842;738;1301;703;598;5339;2836;2503;1536;696;840;5600;3526;2074;1942.0;2135.0;777.0;856.0;7606.0;7139.0;5
1104;Apeldoorn (SG);2014;208910;46458;122665;39787;177609;15530;5590;9940;15771;8828;6943;1677;882;795;1345;737;608;5350;2838;2512;1641;744;897;5758;3627;2131;1934.0;2155.0;767.0;875.0;7666.0;7153.0;5
1105;Apeldoorn (SG);2015;209116;46038;122411;40667;177342;15596;5592;10004;16178;8970;7208;1761;912;849;1366;749;617;5382;2840;2542;1760;785;975;5909;3684;2225;1947.0;2180.0;783.0;841.0;7659.0;7246.0;5
1106;Apeldoorn (SG);2016;209265;45732;122137;41396;177056;15625;5634;9991;16584;9089;7495;1824;945;879;1401;779;622;5438;2846;2592;1858;802;1056;6063;3717;2346;1948.0;2191.0;759.0;842.0;7691.0;7268.0;5
1107;Apeldoorn (SG);2017;209385;45365;121878;42142;176838;15617;5692;9925;16930;9237;7693;1873;963;910;1447;797;650;5437;2840;2597;1933;827;1106;6240;3810;2430;1963.0;2200.0;747.0;841.0;7728.0;7349.0;5
1108;Apeldoorn (SG);2018;209452;45103;121457;42892;176548;15613;5739;9874;17291;9392;7899;1958;997;961;1478;806;672;5407;2835;2572;2034;863;1171;6414;3891;2523;1969.0;2248.0;740.0;816.0;7495.0;7315.0;5
1109;Apeldoorn (SG);2019;209307;44582;121189;43536;176094;15648;5757;9891;17565;9507;8058;2009;1029;980;1504;813;691;5367;2816;2551;2138;883;1255;6547;3966;2581;1985.0;2247.0;745.0;819.0;7427.0;7321.0;5
1110;Apeldoorn (SG);2020;209099;44160;120676;44263;175466;15665;5776;9889;17968;9706;8262;2078;1052;1026;1542;839;703;5356;2811;2545;2247;929;1318;6745;4075;2670;1975.0;2265.0;746.0;835.0;7236.0;7291.0;5
1111;Apeldoorn (SG);2021;208689;43670;120079;44940;174845;15608;5791;9817;18236;9832;8404;2145;1085;1060;1568;847;721;5341;2804;2537;2325;959;1366;6857;4137;2720;1976.0;2307.0;725.0;819.0;7233.0;7206.0;5
1112;Apeldoorn (SG);2022;208311;43209;119515;45587;174118;15681;5845;9836;18512;9955;8557;2188;1113;1075;1586;846;740;5339;2809;2530;2414;983;1431;6985;4204;2781;1961.0;2313.0;745.0;809.0;7064.0;7204.0;5
1113;Apeldoorn (SG);2023;207783;42632;118921;46230;173438;15655;5899;9756;18690;10060;8630;2252;1140;1112;1600;862;738;5323;2814;2509;2467;1006;1461;7048;4238;2810;1945.0;2334.0;723.0;806.0;7140.0;7184.0;5
1114;Apeldoorn (SG);2024;207283;42159;118137;46987;172702;15617;5922;9695;18964;10193;8771;2298;1166;1132;1619;872;747;5347;2842;2505;2511;1020;1491;7189;4293;2896;1920.0;2354.0;744.0;798.0;7340.0;7133.0;5
1115;Apeldoorn (SG);2025;207020;42015;117263;47742;172136;15634;5958;9676;19250;10315;8935;2335;1179;1156;1647;881;766;5364;2840;2524;2560;1035;1525;7344;4380;2964;;;;;;;5
1116;Arnhem (SG);2008;351579;82641;217132;51806;285589;32607;11486;21121;33383;19583;13800;4204;2148;2056;2571;1558;1013;9990;5212;4778;3718;1787;1931;12900;8878;4022;3738.0;3099.0;1915.0;2510.0;17756.0;15734.0;6
1117;Arnhem (SG);2009;353695;82442;218625;52628;286975;32668;11568;21100;34052;19683;14369;4341;2211;2130;2611;1581;1030;10043;5179;4864;3988;1876;2112;13069;8836;4233;3744.0;3117.0;2003.0;2471.0;17533.0;16005.0;6
1118;Arnhem (SG);2010;355430;82212;219620;53598;288114;32700;11619;21081;34616;19653;14963;4411;2245;2166;2656;1578;1078;10075;5127;4948;4252;1953;2299;13222;8750;4472;3731.0;3145.0;2046.0;2421.0;17700.0;15998.0;6
1119;Arnhem (SG);2011;357380;81775;221092;54513;289213;32856;11710;21146;35311;19679;15632;4493;2276;2217;2726;1603;1123;10189;5115;5074;4463;2014;2449;13440;8671;4769;3741.0;3167.0;2130.0;2402.0;16651.0;15803.0;6
1120;Arnhem (SG);2012;358578;81155;220732;56691;289799;32842;11750;21092;35937;19740;16197;4564;2320;2244;2798;1653;1145;10265;5073;5192;4674;2060;2614;13636;8634;5002;3742.0;3188.0;2156.0;2363.0;16481.0;15756.0;6
1121;Arnhem (SG);2013;359698;80772;220047;58879;290248;32888;11850;21038;36562;19850;16712;4642;2357;2285;2897;1716;1181;10333;5053;5280;4900;2115;2785;13790;8609;5181;3753.0;3249.0;2185.0;2332.0;16432.0;15874.0;6
1122;Arnhem (SG);2014;360660;80391;219727;60542;290573;32865;11908;20957;37222;19926;17296;4745;2403;2342;2963;1753;1210;10400;5011;5389;5135;2188;2947;13979;8571;5408;3782.0;3284.0;2141.0;2282.0;16284.0;15761.0;6
1123;Arnhem (SG);2015;361578;80005;219299;62274;290842;32941;11974;20967;37795;20131;17664;4819;2453;2366;2983;1772;1211;10499;5045;5454;5329;2239;3090;14165;8622;5543;3817.0;3328.0;2099.0;2268.0;16203.0;15996.0;6
1124;Arnhem (SG);2016;362146;79584;218790;63772;290812;32986;12056;20930;38348;20204;18144;4892;2484;2408;3072;1821;1251;10528;4993;5535;5511;2319;3192;14345;8587;5758;3850.0;3348.0;2112.0;2234.0;15499.0;15959.0;6
1125;Arnhem (SG);2017;362102;79162;217797;65143;290269;32914;12059;20855;38919;20377;18542;4999;2552;2447;3179;1859;1320;10560;4988;5572;5686;2367;3319;14495;8611;5884;3909.0;3385.0;2079.0;2181.0;15703.0;15975.0;6
1126;Arnhem (SG);2018;362295;78899;216762;66634;289976;32852;12050;20802;39467;20450;19017;5085;2612;2473;3213;1875;1338;10613;4959;5654;5852;2404;3448;14704;8600;6104;3872.0;3439.0;2051.0;2197.0;15340.0;15791.0;6
1127;Arnhem (SG);2019;362179;78332;215759;68088;289401;32753;12098;20655;40025;20543;19482;5142;2638;2504;3291;1916;1375;10683;4944;5739;6002;2443;3559;14907;8602;6305;3849.0;3444.0;2031.0;2153.0;15357.0;15699.0;6
1128;Arnhem (SG);2020;362168;77700;214988;69480;288930;32740;12092;20648;40498;20769;19729;5190;2668;2522;3374;1966;1408;10680;4934;5746;6115;2476;3639;15139;8725;6414;3927.0;3508.0;2038.0;2128.0;15554.0;15755.0;6
1129;Arnhem (SG);2021;362332;77269;214217;70846;288451;32693;12088;20605;41188;20981;20207;5274;2725;2549;3462;2014;1448;10722;4913;5809;6298;2528;3770;15432;8801;6631;3927.0;3555.0;2010.0;2112.0;15416.0;15796.0;6
1130;Arnhem (SG);2022;362267;76996;213094;72177;287951;32617;12068;20549;41699;21134;20565;5317;2743;2574;3523;2045;1478;10766;4917;5849;6495;2576;3919;15598;8853;6745;3912.0;3549.0;1940.0;2059.0;15242.0;15753.0;6
1131;Arnhem (SG);2023;362042;76512;211954;73576;287246;32557;12068;20489;42239;21290;20949;5354;2744;2610;3660;2107;1553;10797;4928;5869;6621;2610;4011;15807;8901;6906;3915.0;3628.0;1940.0;2031.0;15526.0;15632.0;6
1132;Arnhem (SG);2024;362174;76080;211036;75058;286894;32501;12142;20359;42779;21392;21387;5459;2787;2672;3685;2106;1579;10855;4895;5960;6773;2665;4108;16007;8939;7068;3938.0;3708.0;1961.0;2040.0;15065.0;15679.0;6
1133;Arnhem (SG);2025;361749;75968;209293;76488;285979;32396;12170;20226;43374;21505;21869;5521;2815;2706;3754;2138;1616;10943;4890;6053;6931;2707;4224;16225;8955;7270;;;;;;;6
1134;Nijmegen (SG);2008;280210;61747;179542;38921;227797;29041;10607;18434;23372;13681;9691;2194;1101;1093;2431;1449;982;5668;2947;2721;3691;1830;1861;9388;6354;3034;2822.0;2346.0;1915.0;2193.0;13200.0;12237.0;7
1135;Nijmegen (SG);2009;281419;61287;180491;39641;228548;29128;10683;18445;23743;13731;10012;2296;1154;1142;2433;1448;985;5705;2922;2783;3777;1826;1951;9532;6381;3151;2885.0;2382.0;2008.0;2178.0;13278.0;12271.0;7
1136;Nijmegen (SG);2010;282806;60948;181242;40616;229457;29278;10869;18409;24071;13752;10319;2428;1215;1213;2483;1476;1007;5733;2917;2816;3839;1804;2035;9588;6340;3248;2946.0;2431.0;2093.0;2151.0;13234.0;12414.0;7
1137;Nijmegen (SG);2011;284128;60477;182013;41638;230382;29358;10961;18397;24388;13820;10568;2532;1263;1269;2519;1515;1004;5792;2931;2861;3947;1837;2110;9598;6274;3324;2976.0;2450.0;2093.0;2136.0;13020.0;12442.0;7
1138;Nijmegen (SG);2012;285220;60023;181862;43335;231073;29397;11096;18301;24750;13911;10839;2644;1327;1317;2594;1567;1027;5820;2919;2901;3993;1816;2177;9699;6282;3417;3014.0;2500.0;2134.0;2100.0;13029.0;12492.0;7
1139;Nijmegen (SG);2013;286347;59646;181683;45018;231748;29497;11231;18266;25102;13953;11149;2754;1376;1378;2597;1558;1039;5923;2923;3000;4021;1804;2217;9807;6292;3515;3110.0;2542.0;2118.0;2062.0;12705.0;12644.0;7
1140;Nijmegen (SG);2014;287073;59303;181385;46385;232095;29489;11322;18167;25489;14064;11425;2853;1429;1424;2652;1594;1058;5985;2930;3055;4079;1808;2271;9920;6303;3617;3148.0;2584.0;2125.0;2032.0;12748.0;12595.0;7
1141;Nijmegen (SG);2015;287922;58936;181285;47701;232580;29557;11459;18098;25785;14174;11611;2910;1486;1424;2697;1634;1063;6045;2946;3099;4148;1795;2353;9985;6313;3672;3191.0;2595.0;2112.0;2003.0;13118.0;12588.0;7
1142;Nijmegen (SG);2016;289202;58990;181230;48982;233279;29719;11611;18108;26204;14272;11932;2985;1512;1473;2717;1672;1045;6143;2977;3166;4246;1785;2461;10113;6326;3787;3251.0;2649.0;2106.0;1971.0;13298.0;12593.0;7
1143;Nijmegen (SG);2017;290679;59060;181279;50340;234202;29900;11815;18085;26577;14369;12208;3061;1574;1487;2759;1710;1049;6226;2986;3240;4313;1769;2544;10218;6330;3888;3264.0;2683.0;2097.0;1971.0;13251.0;12691.0;7
1144;Nijmegen (SG);2018;291993;59071;181117;51805;234998;29969;11959;18010;27026;14542;12484;3153;1617;1536;2830;1757;1073;6260;2980;3280;4403;1792;2611;10380;6396;3984;3300.0;2729.0;2051.0;1974.0;13054.0;12730.0;7
1145;Nijmegen (SG);2019;293008;59080;180876;53052;235495;30061;12100;17961;27452;14610;12842;3226;1647;1579;2877;1773;1104;6361;3000;3361;4458;1780;2678;10530;6410;4120;3337.0;2793.0;2035.0;1950.0;12941.0;12748.0;7
1146;Nijmegen (SG);2020;293876;59090;180420;54366;235998;30097;12183;17914;27781;14684;13097;3315;1683;1632;2919;1802;1117;6397;2995;3402;4512;1772;2740;10638;6432;4206;3324.0;2819.0;2039.0;1945.0;13137.0;12675.0;7
1147;Nijmegen (SG);2021;294967;59051;180287;55629;236453;30206;12320;17886;28308;14835;13473;3403;1714;1689;2996;1845;1151;6496;3011;3485;4596;1788;2808;10817;6477;4340;3330.0;2873.0;2043.0;1894.0;13016.0;12728.0;7
1148;Nijmegen (SG);2022;295900;59061;179946;56893;236822;30313;12452;17861;28765;14999;13766;3490;1760;1730;3039;1868;1171;6544;3006;3538;4676;1813;2863;11016;6552;4464;3333.0;2920.0;2044.0;1912.0;12756.0;12684.0;7
1149;Nijmegen (SG);2023;296553;59103;179374;58076;237027;30353;12682;17671;29173;15116;14057;3588;1790;1798;3083;1909;1174;6618;3000;3618;4746;1827;2919;11138;6590;4548;3332.0;2962.0;2007.0;1889.0;12998.0;12684.0;7
1150;Nijmegen (SG);2024;297387;59092;178879;59416;237270;30468;12831;17637;29649;15265;14384;3649;1809;1840;3151;1952;1199;6707;3013;3694;4795;1834;2961;11347;6657;4690;3319.0;3002.0;2007.0;1873.0;12909.0;12712.0;7
1151;Nijmegen (SG);2025;298066;59060;178234;60772;237435;30529;13017;17512;30102;15470;14632;3717;1830;1887;3212;1988;1224;6758;3026;3732;4899;1857;3042;11516;6769;4747;;;;;;;7
1152;Amersfoort (SG);2008;272223;71631;164922;35670;224355;20604;7486;13118;27264;15659;11605;2447;1219;1228;2030;1139;891;8263;4458;3805;5485;2791;2694;9039;6052;2987;3287.0;2049.0;1390.0;1618.0;11171.0;10410.0;8
1153;Amersfoort (SG);2009;274039;71592;165649;36798;225554;20817;7580;13237;27668;15753;11915;2535;1262;1273;2063;1153;910;8270;4436;3834;5519;2767;2752;9281;6135;3146;3264.0;2073.0;1456.0;1588.0;11586.0;10524.0;8
1154;Amersfoort (SG);2010;276199;71530;166687;37982;227018;21048;7662;13386;28133;15885;12248;2650;1308;1342;2105;1194;911;8288;4415;3873;5620;2761;2859;9470;6207;3263;3176.0;2117.0;1464.0;1597.0;11768.0;10711.0;8
1155;Amersfoort (SG);2011;278213;71376;167923;38914;228338;21357;7798;13559;28518;16014;12504;2719;1340;1379;2147;1225;922;8298;4397;3901;5685;2766;2919;9669;6286;3383;3160.0;2155.0;1515.0;1579.0;11884.0;10842.0;8
1156;Amersfoort (SG);2012;280237;71135;167960;41142;229689;21607;7898;13709;28941;16134;12807;2827;1391;1436;2179;1253;926;8309;4379;3930;5748;2760;2988;9878;6351;3527;3134.0;2177.0;1523.0;1543.0;11723.0;10877.0;8
1157;Amersfoort (SG);2013;282055;70834;168160;43061;230845;21879;8030;13849;29331;16246;13085;2890;1421;1469;2235;1282;953;8255;4351;3904;5820;2773;3047;10131;6419;3712;3089.0;2244.0;1556.0;1536.0;11670.0;10946.0;8
1158;Amersfoort (SG);2014;283681;70553;168412;44716;231832;22130;8158;13972;29719;16400;13319;2950;1456;1494;2311;1320;991;8245;4348;3897;5908;2776;3132;10305;6500;3805;3099.0;2277.0;1511.0;1534.0;11851.0;10922.0;8
1159;Amersfoort (SG);2015;285450;70306;169004;46140;232896;22431;8349;14082;30123;16559;13564;3032;1484;1548;2333;1345;988;8239;4340;3899;5971;2779;3192;10548;6611;3937;3068.0;2306.0;1514.0;1520.0;11805.0;10937.0;8
1160;Amersfoort (SG);2016;287100;69883;169547;47670;233953;22662;8429;14233;30485;16742;13743;3129;1541;1588;2357;1341;1016;8198;4311;3887;6026;2791;3235;10775;6758;4017;3049.0;2346.0;1519.0;1500.0;11280.0;10962.0;8
1161;Amersfoort (SG);2017;288171;69483;169687;49001;234577;22844;8533;14311;30750;16905;13845;3218;1594;1624;2350;1368;982;8144;4280;3864;6045;2799;3246;10993;6864;4129;3050.0;2410.0;1513.0;1483.0;11403.0;11037.0;8
1162;Amersfoort (SG);2018;289247;68983;169962;50302;235090;23004;8665;14339;31153;17016;14137;3296;1620;1676;2431;1394;1037;8173;4281;3892;6026;2776;3250;11227;6945;4282;3054.0;2482.0;1536.0;1494.0;11510.0;10970.0;8
1163;Amersfoort (SG);2019;290428;68368;170309;51751;235677;23243;8777;14466;31508;17185;14323;3371;1659;1712;2473;1419;1054;8142;4267;3875;6069;2803;3266;11453;7037;4416;3059.0;2506.0;1466.0;1482.0;11411.0;11007.0;8
1164;Amersfoort (SG);2020;291398;67740;170548;53110;236231;23454;8880;14574;31713;17349;14364;3429;1697;1732;2521;1457;1064;8098;4247;3851;6018;2777;3241;11647;7171;4476;3055.0;2549.0;1478.0;1442.0;11364.0;11051.0;8
1165;Amersfoort (SG);2021;292296;67107;170758;54431;236574;23741;9079;14662;31981;17506;14475;3481;1731;1750;2562;1482;1080;8106;4269;3837;6021;2781;3240;11811;7243;4568;3056.0;2593.0;1490.0;1463.0;11462.0;11177.0;8
1166;Amersfoort (SG);2022;293099;66444;170794;55861;237012;23835;9132;14703;32252;17654;14598;3534;1761;1773;2623;1529;1094;8037;4249;3788;5998;2768;3230;12060;7347;4713;3081.0;2647.0;1411.0;1444.0;11876.0;11209.0;8
1167;Amersfoort (SG);2023;294193;65914;170945;57334;237459;24069;9295;14774;32665;17850;14815;3579;1795;1784;2682;1541;1141;8031;4236;3795;6045;2778;3267;12328;7500;4828;3077.0;2703.0;1458.0;1409.0;11902.0;11245.0;8
1168;Amersfoort (SG);2024;295306;65332;171223;58751;237907;24323;9459;14864;33076;18035;15041;3664;1829;1835;2741;1561;1180;8026;4234;3792;6089;2769;3320;12556;7642;4914;3065.0;2750.0;1461.0;1443.0;11525.0;11182.0;8
1169;Amersfoort (SG);2025;296020;64964;170802;60254;238134;24562;9629;14933;33324;18157;15167;3723;1865;1858;2785;1586;1199;8026;4218;3808;6061;2771;3290;12729;7717;5012;;;;;;;8
1170;Utrecht (SG);2008;592221;138310;381412;72499;449511;54694;21750;32944;88016;48483;39533;13897;7478;6419;4543;2477;2066;15138;7696;7442;32519;16499;16020;21919;14333;7586;7879.0;4305.0;4910.0;5167.0;32765.0;30383.0;9
1171;Utrecht (SG);2009;598041;139484;384288;74269;453173;55505;22167;33338;89363;48704;40659;13996;7494;6502;4748;2614;2134;15385;7660;7725;32655;16223;16432;22579;14713;7866;7905.0;4399.0;5146.0;5120.0;32383.0;30764.0;9
1172;Utrecht (SG);2010;603291;140370;386784;76137;456598;56242;22528;33714;90451;48792;41659;14041;7481;6560;4883;2699;2184;15540;7623;7917;32798;15991;16807;23189;14998;8191;7952.0;4487.0;5436.0;5172.0;32482.0;30593.0;9
1173;Utrecht (SG);2011;609010;141488;389973;77549;460199;57120;23058;34062;91691;48888;42803;14120;7463;6657;5061;2832;2229;15780;7636;8144;32933;15756;17177;23797;15201;8596;8019.0;4524.0;5569.0;5153.0;32724.0;30783.0;9
1174;Utrecht (SG);2012;614944;142476;390921;81547;463931;58030;23605;34425;92983;49143;43840;14148;7454;6694;5266;2993;2273;15979;7616;8363;33134;15598;17536;24456;15482;8974;8024.0;4595.0;5637.0;5167.0;32913.0;30827.0;9
1175;Utrecht (SG);2013;621014;143628;392180;85206;467886;58918;24069;34849;94210;49304;44906;14219;7465;6754;5480;3129;2351;16155;7622;8533;33274;15376;17898;25082;15712;9370;8104.0;4649.0;5684.0;5154.0;33066.0;30956.0;9
1176;Utrecht (SG);2014;627200;144918;393857;88425;471826;59876;24694;35182;95498;49531;45967;14265;7449;6816;5675;3260;2415;16378;7635;8743;33468;15236;18232;25712;15951;9761;8191.0;4747.0;5739.0;5150.0;33201.0;30924.0;9
1177;Utrecht (SG);2015;633575;146403;395633;91539;476050;60740;25240;35500;96785;49684;47101;14335;7464;6871;5877;3380;2497;16573;7630;8943;33584;15071;18513;26416;16139;10277;8235.0;4825.0;5788.0;5168.0;32748.0;30920.0;9
1178;Utrecht (SG);2016;639514;147930;397095;94489;479865;61614;25769;35845;98035;49919;48116;14375;7464;6911;6052;3504;2548;16799;7684;9115;33680;14888;18792;27129;16379;10750;8257.0;4907.0;5788.0;5111.0;32804.0;31133.0;9
1179;Utrecht (SG);2017;645293;149235;398776;97282;483535;62506;26281;36225;99252;50114;49138;14444;7468;6976;6238;3627;2611;16950;7671;9279;33769;14746;19023;27851;16602;11249;8304.0;5015.0;5887.0;5166.0;33301.0;31191.0;9
1180;Utrecht (SG);2018;651505;150796;400547;100162;487482;63393;26727;36666;100630;50478;50152;14509;7481;7028;6464;3759;2705;17195;7704;9491;33867;14651;19216;28595;16883;11712;8368.0;5131.0;5877.0;5139.0;33387.0;31275.0;9
1181;Utrecht (SG);2019;657672;152176;402456;103040;491377;64474;27297;37177;101821;50665;51156;14611;7479;7132;6683;3897;2786;17429;7730;9699;33890;14542;19348;29208;17017;12191;8387.0;5197.0;5894.0;5191.0;33432.0;31595.0;9
1182;Utrecht (SG);2020;663486;153168;404370;105948;495097;65384;27750;37634;103005;50953;52052;14709;7468;7241;6900;4022;2878;17555;7733;9822;33825;14432;19393;30016;17298;12718;8332.0;5332.0;5896.0;5171.0;33997.0;31887.0;9
1183;Utrecht (SG);2021;669396;153925;406650;108821;498631;66447;28342;38105;104318;51364;52954;14834;7490;7344;7119;4169;2950;17771;7757;10014;33742;14310;19432;30852;17638;13214;8407.0;5408.0;5879.0;5201.0;34272.0;32169.0;9
1184;Utrecht (SG);2022;675261;154731;408598;111932;502081;67532;28895;38637;105648;51622;54026;14987;7493;7494;7322;4272;3050;17969;7770;10199;33723;14216;19507;31647;17871;13776;8425.0;5516.0;6060.0;5208.0;34163.0;32479.0;9
1185;Utrecht (SG);2023;680785;155055;410566;115164;505322;68407;29320;39087;107056;52156;54900;15112;7520;7592;7595;4444;3151;18085;7761;10324;33712;14164;19548;32552;18267;14285;8417.0;5634.0;5991.0;5163.0;34698.0;32744.0;9
1186;Utrecht (SG);2024;686436;155429;412591;118416;508805;69426;29919;39507;108205;52542;55663;15182;7530;7652;7808;4581;3227;18303;7761;10542;33600;14039;19561;33312;18631;14681;8367.0;5803.0;5996.0;5148.0;35127.0;33055.0;9
1187;Utrecht (SG);2025;692011;155901;414432;121678;512150;70422;30545;39877;109439;52848;56591;15251;7522;7729;7973;4664;3309;18489;7741;10748;33520;13935;19585;34206;18986;15220;;;;;;;9
1188;Amsterdam (SG);2008;1486392;348456;957725;180211;935054;184579;91815;92764;366759;211326;155433;102155;57481;44674;19284;11676;7608;56419;30181;26238;78203;39545;38658;110698;72443;38255;18896.0;11050.0;20892.0;20548.0;58519.0;55275.0;10
1189;Amsterdam (SG);2009;1498012;350571;962274;185167;941188;188682;94621;94061;368142;209228;158914;101134;56227;44907;19439;11740;7699;56930;29957;26973;78867;39041;39826;111772;72263;39509;18908.0;11256.0;21792.0;20520.0;59060.0;55775.0;10
1190;Amsterdam (SG);2010;1510413;353119;966331;190963;947453;193201;97722;95479;369759;207496;162263;100090;55099;44991;19698;11840;7858;57432;29683;27749;79556;38688;40868;112983;72186;40797;18860.0;11425.0;22699.0;20422.0;57328.0;56074.0;10
1191;Amsterdam (SG);2011;1521571;354535;971921;195115;952315;197618;100804;96814;371638;205999;165639;99398;54205;45193;20035;11981;8054;57869;29437;28432;80208;38325;41883;114128;72051;42077;18822.0;11683.0;23289.0;20215.0;57104.0;56361.0;10
1192;Amsterdam (SG);2012;1532693;355570;971472;205651;957018;202117;103953;98164;373558;204657;168901;98725;53437;45288;20400;12132;8268;58321;29169;29152;80980;38125;42855;115132;71794;43338;18797.0;11892.0;23403.0;20211.0;57171.0;56173.0;10
1193;Amsterdam (SG);2013;1543946;356708;972310;214928;961873;206528;107023;99505;375545;203338;172207;98024;52622;45402;20723;12250;8473;58775;29043;29732;81818;37882;43936;116205;71541;44664;18728.0;12066.0;23531.0;20056.0;57374.0;56445.0;10
1194;Amsterdam (SG);2014;1555173;358358;973788;223027;966886;210943;110057;100886;377344;202141;175203;97382;51901;45481;21011;12354;8657;59173;28928;30245;82366;37524;44842;117412;71434;45978;18766.0;12293.0;23533.0;20010.0;57069.0;56130.0;10
1195;Amsterdam (SG);2015;1566268;359763;976095;230410;971562;215468;113092;102376;379238;200933;178305;96822;51210;45612;21336;12430;8906;59644;28792;30852;83002;37256;45746;118434;71245;47189;18820.0;12496.0;23647.0;19898.0;56908.0;55763.0;10
1196;Amsterdam (SG);2016;1577649;361517;978407;237725;976792;220025;115946;104079;380832;199810;181022;96186;50485;45701;21672;12551;9121;60016;28634;31382;83457;37023;46434;119501;71117;48384;18983.0;12753.0;23561.0;19781.0;56954.0;56383.0;10
1197;Amsterdam (SG);2017;1588367;363069;981022;244276;981617;224090;118610;105480;382660;198909;183751;95543;49831;45712;22003;12674;9329;60410;28543;31867;83977;36852;47125;120727;71009;49718;19106.0;12975.0;23666.0;19654.0;56849.0;56388.0;10
1198;Amsterdam (SG);2018;1599134;364232;983333;251569;986073;228757;121542;107215;384304;197948;186356;94946;49212;45734;22306;12787;9519;60760;28476;32284;84436;36659;47777;121856;70814;51042;19195.0;13157.0;23723.0;19677.0;56964.0;56747.0;10
1199;Amsterdam (SG);2019;1609603;364948;985945;258710;990576;233028;124256;108772;385999;197211;188788;94337;48578;45759;22636;12895;9741;61109;28377;32732;84788;36434;48354;123129;70927;52202;19383.0;13359.0;23701.0;19571.0;57009.0;56996.0;10
1200;Amsterdam (SG);2020;1619945;365686;988365;265894;994907;237325;126877;110448;387713;196335;191378;93658;47929;45729;22962;12991;9971;61511;28293;33218;85178;36226;48952;124404;70896;53508;19598.0;13635.0;23756.0;19532.0;57269.0;57181.0;10
1201;Amsterdam (SG);2021;1630374;366008;991270;273096;999618;241665;129579;112086;389091;195432;193659;92966;47243;45723;23213;13060;10153;61869;28208;33661;85382;36018;49364;125661;70903;54758;19722.0;13924.0;23768.0;19420.0;56864.0;57625.0;10
1202;Amsterdam (SG);2022;1639923;365883;993315;280725;1003345;245825;132106;113719;390753;194850;195903;92385;46588;45797;23575;13192;10383;62070;28067;34003;85583;35884;49699;127140;71119;56021;19918.0;14179.0;23704.0;19272.0;57010.0;57706.0;10
1203;Amsterdam (SG);2023;1649537;366171;995040;288326;1007115;250280;134736;115544;392142;194116;198026;91756;45961;45795;23960;13303;10657;62383;27987;34396;85520;35653;49867;128523;71212;57311;20000.0;14470.0;23873.0;19189.0;58137.0;58758.0;10
1204;Amsterdam (SG);2024;1659269;366338;997008;295923;1010761;254551;137257;117294;393957;193520;200437;91253;45330;45923;24393;13446;10947;62660;27899;34761;85678;35482;50196;129973;71363;58610;20301.0;14777.0;23738.0;19090.0;57748.0;58808.0;10
1205;Amsterdam (SG);2025;1668546;366869;997855;303822;1013965;258787;139785;119002;395794;193019;202775;90637;44661;45976;24784;13560;11224;62946;27811;35135;85817;35341;50476;131610;71646;59964;;;;;;;10
1206;Haarlem (SG);2008;404505;94517;241742;68246;329401;39339;15363;23976;35765;20214;15551;3864;1898;1966;1860;911;949;10404;5563;4841;5940;3124;2816;13697;8718;4979;4021.0;3815.0;2415.0;2432.0;17986.0;17836.0;11
1207;Haarlem (SG);2009;404905;94027;242011;68867;328656;39548;15492;24056;36701;20550;16151;4015;1931;2084;1942;975;967;10527;5616;4911;6101;3146;2955;14116;8882;5234;3971.0;3847.0;2546.0;2416.0;18447.0;18181.0;11
1208;Haarlem (SG);2010;405476;93511;242327;69638;328048;39803;15713;24090;37625;20884;16741;4189;1986;2203;2035;1061;974;10620;5638;4982;6316;3168;3148;14465;9031;5434;3940.0;3858.0;2725.0;2419.0;17493.0;18172.0;11
1209;Haarlem (SG);2011;405221;92323;242946;69952;326795;40050;15996;24054;38376;21204;17172;4330;2036;2294;2105;1112;993;10665;5658;5007;6454;3199;3255;14822;9199;5623;3882.0;3904.0;2694.0;2353.0;18142.0;18248.0;11
1210;Haarlem (SG);2012;405483;91436;241559;72488;325996;40346;16249;24097;39141;21484;17657;4464;2096;2368;2184;1155;1029;10679;5656;5023;6621;3235;3386;15193;9342;5851;3830.0;3878.0;2713.0;2328.0;17823.0;18330.0;11
1211;Haarlem (SG);2013;405367;90559;240101;74707;324832;40614;16555;24059;39921;21808;18113;4648;2171;2477;2285;1223;1062;10731;5655;5076;6773;3283;3490;15484;9476;6008;3806.0;3922.0;2728.0;2331.0;17753.0;18307.0;11
1212;Haarlem (SG);2014;405135;89369;239476;76290;323651;40825;16831;23994;40659;22106;18553;4794;2248;2546;2372;1275;1097;10825;5701;5124;6889;3299;3590;15779;9583;6196;3775.0;3940.0;2732.0;2264.0;17412.0;18134.0;11
1213;Haarlem (SG);2015;404765;88537;238587;77641;322272;41147;17114;24033;41346;22374;18972;4899;2300;2599;2440;1327;1113;10881;5716;5165;7040;3348;3692;16086;9683;6403;3802.0;3968.0;2703.0;2244.0;18159.0;17962.0;11
1214;Haarlem (SG);2016;405291;87879;238588;78824;321819;41414;17414;24000;42058;22643;19415;5037;2341;2696;2504;1382;1122;10968;5732;5236;7180;3397;3783;16369;9791;6578;3785.0;3978.0;2642.0;2211.0;18380.0;18173.0;11
1215;Haarlem (SG);2017;405777;87348;238477;79952;321152;41820;17786;24034;42805;22850;19955;5137;2388;2749;2641;1442;1199;11077;5713;5364;7239;3385;3854;16711;9922;6789;3842.0;4018.0;2703.0;2205.0;18229.0;18043.0;11
1216;Haarlem (SG);2018;406317;86766;238533;81018;320493;42182;18100;24082;43642;23223;20419;5249;2441;2808;2755;1504;1251;11183;5758;5425;7371;3427;3944;17084;10093;6991;3872.0;4028.0;2692.0;2220.0;18276.0;18085.0;11
1217;Haarlem (SG);2019;406871;86116;238704;82051;319960;42636;18451;24185;44275;23488;20787;5318;2471;2847;2863;1585;1278;11265;5754;5511;7447;3460;3987;17382;10218;7164;3926.0;4049.0;2678.0;2198.0;18711.0;18440.0;11
1218;Haarlem (SG);2020;407534;85530;238856;83148;319499;43056;18752;24304;44979;23822;21157;5405;2501;2904;2964;1645;1319;11407;5802;5605;7518;3486;4032;17685;10388;7297;3968.0;4073.0;2676.0;2150.0;18290.0;18339.0;11
1219;Haarlem (SG);2021;407942;84849;238711;84382;318838;43340;18993;24347;45764;24157;21607;5543;2570;2973;3074;1709;1365;11498;5799;5699;7611;3539;4072;18038;10540;7498;3992.0;4088.0;2676.0;2179.0;18461.0;18412.0;11
1220;Haarlem (SG);2022;408424;84187;238630;85607;318438;43675;19249;24426;46311;24387;21924;5639;2609;3030;3164;1749;1415;11509;5780;5729;7677;3556;4121;18322;10693;7629;4012.0;4130.0;2639.0;2152.0;18849.0;18453.0;11
1221;Haarlem (SG);2023;409231;83826;238328;87077;318029;44088;19550;24538;47114;24723;22391;5710;2621;3089;3268;1805;1463;11671;5844;5827;7810;3592;4218;18655;10861;7794;4005.0;4158.0;2648.0;2163.0;18633.0;18708.0;11
1222;Haarlem (SG);2024;409533;83253;237798;88482;317257;44499;19841;24658;47777;25016;22761;5785;2677;3108;3356;1852;1504;11773;5859;5914;7866;3607;4259;18997;11021;7976;4034.0;4197.0;2638.0;2114.0;18390.0;18590.0;11
1223;Haarlem (SG);2025;409746;82785;236759;90202;316506;44844;20036;24808;48396;25286;23110;5864;2717;3147;3481;1914;1567;11856;5881;5975;7894;3618;4276;19301;11156;8145;;;;;;;11
1224;Leiden (SG);2008;331137;79269;205191;46677;270635;32149;15161;16988;28353;16751;11602;3707;1974;1733;2015;1104;911;3871;2051;1820;6615;3449;3166;12145;8173;3972;3559.0;2595.0;3231.0;2974.0;13399.0;15196.0;12
1225;Leiden (SG);2009;330605;78571;204323;47711;269361;32354;15342;17012;28890;16970;11920;3815;2018;1797;2033;1114;919;4055;2114;1941;6676;3466;3210;12311;8258;4053;3535.0;2621.0;3334.0;2949.0;13438.0;15225.0;12
1226;Leiden (SG);2010;330158;77634;203496;49028;268089;32730;15678;17052;29339;17105;12234;3882;2037;1845;2040;1139;901;4205;2150;2055;6731;3462;3269;12481;8317;4164;3495.0;2662.0;3465.0;2929.0;13841.0;15105.0;12
1227;Leiden (SG);2011;330305;76721;203797;49787;267327;33154;15952;17202;29824;17282;12542;3969;2069;1900;2088;1184;904;4340;2209;2131;6766;3432;3334;12661;8388;4273;3496.0;2693.0;3545.0;2889.0;13166.0;15077.0;12
1228;Leiden (SG);2012;329895;75615;201963;52317;266132;33414;16196;17218;30349;17548;12801;4067;2112;1955;2198;1278;920;4418;2250;2168;6829;3427;3402;12837;8481;4356;3481.0;2713.0;3581.0;2857.0;13239.0;14761.0;12
1229;Leiden (SG);2013;329900;74802;200788;54310;265174;33763;16439;17324;30963;17769;13194;4164;2160;2004;2303;1337;966;4547;2315;2232;6902;3392;3510;13047;8565;4482;3447.0;2754.0;3604.0;2839.0;13554.0;14656.0;12
1230;Leiden (SG);2014;330300;74267;199904;56129;264617;34173;16698;17475;31510;18010;13500;4214;2172;2042;2339;1383;956;4694;2393;2301;6979;3401;3578;13284;8661;4623;3456.0;2814.0;3570.0;2820.0;13184.0;14379.0;12
1231;Leiden (SG);2015;330536;73614;199298;57624;263856;34626;17021;17605;32054;18196;13858;4286;2182;2104;2432;1426;1006;4793;2419;2374;7042;3404;3638;13501;8765;4736;3442.0;2850.0;3539.0;2783.0;13636.0;14477.0;12
1232;Leiden (SG);2016;331076;73151;198885;59040;263373;35074;17292;17782;32629;18418;14211;4359;2200;2159;2492;1469;1023;4872;2428;2444;7110;3423;3687;13796;8898;4898;3496.0;2872.0;3510.0;2775.0;13603.0;14494.0;12
1233;Leiden (SG);2017;331578;72788;198368;60422;262913;35459;17541;17918;33206;18699;14507;4451;2250;2201;2586;1532;1054;4993;2459;2534;7137;3425;3712;14039;9033;5006;3490.0;2922.0;3510.0;2755.0;13599.0;14403.0;12
1234;Leiden (SG);2018;332141;72490;197729;61922;262587;35925;17910;18015;33629;18839;14790;4486;2271;2215;2649;1579;1070;5135;2499;2636;7175;3412;3763;14184;9078;5106;3485.0;2991.0;3527.0;2713.0;13534.0;14471.0;12
1235;Leiden (SG);2019;332549;71903;197359;63287;262217;36305;18202;18103;34027;19013;15014;4545;2274;2271;2694;1593;1101;5184;2552;2632;7200;3395;3805;14404;9199;5205;3489.0;3012.0;3512.0;2678.0;13730.0;14551.0;12
1236;Leiden (SG);2020;333078;71377;196997;64704;261736;36702;18487;18215;34640;19326;15314;4609;2314;2295;2790;1651;1139;5353;2620;2733;7215;3409;3806;14673;9332;5341;3495.0;3051.0;3461.0;2670.0;13714.0;14533.0;12
1237;Leiden (SG);2021;333533;70944;196614;65975;261260;37183;18817;18366;35090;19554;15536;4671;2336;2335;2860;1691;1169;5446;2681;2765;7253;3398;3855;14860;9448;5412;3503.0;3132.0;3516.0;2648.0;13786.0;14534.0;12
1238;Leiden (SG);2022;334079;70535;196138;67406;260882;37562;19123;18439;35635;19790;15845;4717;2365;2352;2949;1759;1190;5519;2707;2812;7304;3396;3908;15146;9563;5583;3515.0;3165.0;3484.0;2614.0;13665.0;14503.0;12
1239;Leiden (SG);2023;334510;70127;195582;68801;260327;38028;19453;18575;36155;20023;16132;4745;2388;2357;3014;1783;1231;5691;2764;2927;7336;3418;3918;15369;9670;5699;3495.0;3217.0;3506.0;2608.0;14191.0;14672.0;12
1240;Leiden (SG);2024;335252;69875;195120;70257;259853;38686;19881;18805;36713;20232;16481;4833;2418;2415;3134;1836;1298;5750;2811;2939;7342;3409;3933;15654;9758;5896;3474.0;3263.0;3493.0;2601.0;13656.0;14599.0;12
1241;Leiden (SG);2025;335472;69640;194200;71632;259009;39132;20208;18924;37331;20564;16767;4875;2468;2407;3197;1867;1330;5874;2851;3023;7411;3453;3958;15974;9925;6049;;;;;;;12
1242;'s-Gravenhage (SG);2008;1001293;235953;622558;142782;669632;120799;60917;59882;210862;127108;83754;59928;35044;24884;16299;10861;5438;38017;20872;17145;32277;16390;15887;64341;43941;20400;11922.0;8726.0;14632.0;13516.0;42728.0;41693.0;13
1243;'s-Gravenhage (SG);2009;1006771;236635;625109;145027;671115;123718;63100;60618;211938;125604;86334;59387;34383;25004;16262;10683;5579;38387;20525;17862;32942;16330;16612;64960;43683;21277;11944.0;8765.0;15314.0;13388.0;41046.0;41565.0;13
1244;'s-Gravenhage (SG);2010;1011445;236949;626479;148017;671629;126776;65424;61352;213040;124395;88645;58776;33778;24998;16401;10670;5731;38744;20238;18506;33623;16323;17300;65496;43386;22110;11868.0;8878.0;15888.0;13304.0;41131.0;41170.0;13
1245;'s-Gravenhage (SG);2011;1017106;236917;630496;149693;672527;130123;67942;62181;214456;123431;91025;58249;33232;25017;16581;10686;5895;39149;20057;19092;34369;16369;18000;66108;43087;23021;11877.0;9000.0;16241.0;13203.0;41078.0;41064.0;13
1246;'s-Gravenhage (SG);2012;1023128;237265;629018;156845;673805;133517;70531;62986;215806;122436;93370;57733;32678;25055;16680;10649;6031;39516;19883;19633;35036;16400;18636;66841;42826;24015;11942.0;9045.0;16443.0;13139.0;38912.0;40262.0;13
1247;'s-Gravenhage (SG);2013;1028079;237290;628089;162700;674153;137027;73049;63978;216899;121577;95322;57223;32211;25012;16794;10684;6110;39927;19719;20208;35533;16413;19120;67422;42550;24872;11918.0;9101.0;16610.0;13089.0;37925.0;39696.0;13
1248;'s-Gravenhage (SG);2014;1032751;237189;627941;167621;674282;140540;75623;64917;217929;120694;97235;56724;31745;24979;16874;10638;6236;40270;19606;20664;36042;16386;19656;68019;42319;25700;11946.0;9175.0;16777.0;13058.0;37526.0;39357.0;13
1249;'s-Gravenhage (SG);2015;1037518;237230;628273;172015;674689;144023;78053;65970;218806;120016;98790;56105;31238;24867;16978;10660;6318;40558;19549;21009;36563;16406;20157;68602;42163;26439;12044.0;9291.0;16817.0;12961.0;37031.0;38858.0;13
1250;'s-Gravenhage (SG);2016;1042406;238024;628250;176132;674826;147593;80437;67156;219987;119402;100585;55545;30785;24760;17215;10698;6517;40841;19481;21360;37154;16444;20710;69232;41994;27238;12132.0;9375.0;16848.0;12955.0;36696.0;39010.0;13
1251;'s-Gravenhage (SG);2017;1046853;238596;628262;179995;675000;151122;82806;68316;220731;118601;102130;54998;30319;24679;17303;10630;6673;40955;19347;21608;37593;16462;21131;69882;41843;28039;12225.0;9440.0;16885.0;12905.0;36471.0;38753.0;13
1252;'s-Gravenhage (SG);2018;1051444;239116;628137;184191;675119;154737;85105;69632;221588;118092;103496;54455;29877;24578;17450;10642;6808;41119;19271;21848;38000;16502;21498;70564;41800;28764;12294.0;9476.0;16908.0;12826.0;36198.0;38901.0;13
1253;'s-Gravenhage (SG);2019;1055756;239314;628048;188394;675316;158180;87300;70880;222260;117541;104719;53901;29464;24437;17531;10612;6919;41281;19239;22042;38397;16512;21885;71150;41714;29436;12427.0;9612.0;16975.0;12844.0;35565.0;38683.0;13
1254;'s-Gravenhage (SG);2020;1059687;239302;627922;192463;675252;161653;89546;72107;222782;116950;105832;53473;29066;24407;17623;10617;7006;41301;19130;22171;38712;16499;22213;71673;41638;30035;12453.0;9726.0;17010.0;12800.0;35639.0;38825.0;13
1255;'s-Gravenhage (SG);2021;1063520;238870;627989;196661;674934;165136;91665;73471;223450;116625;106825;53001;28711;24290;17664;10585;7079;41518;19153;22365;39049;16538;22511;72218;41638;30580;12411.0;9903.0;17073.0;12628.0;36087.0;39282.0;13
1256;'s-Gravenhage (SG);2022;1067366;238347;628136;200883;674629;168722;93826;74896;224015;116284;107731;52464;28347;24117;17864;10661;7203;41620;19102;22518;39270;16530;22740;72797;41644;31153;12496.0;9998.0;17083.0;12601.0;36196.0;39368.0;13
1257;'s-Gravenhage (SG);2023;1071263;237969;627989;205305;674298;172316;95974;76342;224649;116032;108617;52065;27979;24086;17907;10653;7254;41634;19047;22587;39444;16574;22870;73599;41779;31820;12470.0;10172.0;17097.0;12544.0;36492.0;39706.0;13
1258;'s-Gravenhage (SG);2024;1075004;237346;628411;209247;673829;175872;98194;77678;225303;115846;109457;51602;27601;24001;17995;10677;7318;41746;19075;22671;39644;16547;23097;74316;41946;32370;12509.0;10283.0;17170.0;12486.0;36788.0;39784.0;13
1259;'s-Gravenhage (SG);2025;1079013;237182;628343;213488;673459;179671;100480;79191;225883;115577;110306;51158;27210;23948;18071;10624;7447;41741;19042;22699;39869;16596;23273;75044;42105;32939;;;;;;;13
1260;Rotterdam (SG);2008;1172397;272118;726498;173781;793750;105713;48655;57058;272934;154972;117962;65282;37078;28204;26389;16995;9394;61899;31475;30424;44299;21811;22488;75065;47613;27452;13254.0;10830.0;9556.0;14034.0;47805.0;47847.0;14
1261;Rotterdam (SG);2009;1170461;270122;724505;175834;793249;106001;48477;57524;271211;151727;119484;64563;36300;28263;25996;16435;9561;61481;30929;30552;44745;21601;23144;74426;46462;27964;13135.0;10899.0;9803.0;13666.0;48755.0;47506.0;14
1262;Rotterdam (SG);2010;1170232;268485;723372;178375;793711;106467;48449;58018;270054;149009;121045;63847;35592;28255;25788;16015;9773;61168;30460;30708;45110;21362;23748;74141;45580;28561;13028.0;10929.0;10049.0;13394.0;47261.0;46898.0;14
1263;Rotterdam (SG);2011;1169470;266219;723778;179473;793687;106960;48544;58416;268823;146342;122481;63162;34991;28171;25685;15674;10011;60818;29918;30900;45455;21164;24291;73703;44595;29108;13008.0;10985.0;10042.0;13025.0;46428.0;46562.0;14
1264;Rotterdam (SG);2012;1168506;263926;717387;187193;793235;107533;48631;58902;267738;143821;123917;62452;34385;28067;25486;15317;10169;60538;29429;31109;45842;20993;24849;73420;43697;29723;12901.0;11023.0;10032.0;12646.0;47082.0;46146.0;14
1265;Rotterdam (SG);2013;1168824;262134;712982;193708;793741;108194;48871;59323;266889;141806;125083;61782;33792;27990;25416;15082;10334;60230;29085;31145;46172;20865;25307;73289;42982;30307;12845.0;11066.0;9941.0;12441.0;46233.0;45707.0;14
1266;Rotterdam (SG);2014;1168738;260566;709207;198965;793996;108872;48961;59911;265870;139779;126091;61120;33213;27907;25356;14859;10497;59817;28689;31128;46417;20696;25721;73160;42322;30838;12926.0;11166.0;9841.0;12175.0;46625.0;45727.0;14
1267;Rotterdam (SG);2015;1169182;259399;706679;203104;794597;109494;49189;60305;265091;137831;127260;60511;32711;27800;25314;14603;10711;59428;28246;31182;46701;20582;26119;73137;41689;31448;12836.0;11185.0;9687.0;11901.0;46036.0;45355.0;14
1268;Rotterdam (SG);2016;1169420;258286;704186;206948;794987;110251;49505;60746;264182;136168;128014;59849;32219;27630;25204;14396;10808;59093;27909;31184;46856;20439;26417;73180;41205;31975;12903.0;11265.0;9605.0;11698.0;47098.0;45635.0;14
1269;Rotterdam (SG);2017;1170536;257869;702039;210628;795847;110997;49706;61291;263692;134702;128990;59194;31666;27528;25123;14174;10949;58740;27598;31142;47103;20358;26745;73532;40906;32626;12961.0;11329.0;9406.0;11500.0;46287.0;45454.0;14
1270;Rotterdam (SG);2018;1171012;256930;699686;214396;796202;111887;50059;61828;262923;133150;129773;58586;31162;27424;24953;13943;11010;58410;27275;31135;47263;20247;27016;73711;40523;33188;12991.0;11404.0;9400.0;11394.0;46436.0;45543.0;14
1271;Rotterdam (SG);2019;1171622;256139;697466;218017;796483;112618;50357;62261;262521;131809;130712;58023;30707;27316;24870;13748;11122;58020;26910;31110;47467;20153;27314;74141;40291;33850;13073.0;11570.0;9315.0;11202.0;46943.0;45297.0;14
1272;Rotterdam (SG);2020;1172980;255628;695560;221792;797162;113552;50708;62844;262266;130494;131772;57488;30263;27225;24797;13537;11260;57770;26612;31158;47588;20032;27556;74623;40050;34573;13215.0;11631.0;9114.0;10991.0;46795.0;45230.0;14
1273;Rotterdam (SG);2021;1174363;254878;693705;225780;797689;114413;51008;63405;262261;129373;132888;56888;29736;27152;24829;13399;11430;57462;26296;31166;47807;19928;27879;75275;40014;35261;13236.0;11721.0;9129.0;10905.0;47043.0;45909.0;14
1274;Rotterdam (SG);2022;1175346;254309;691728;229309;797899;115394;51421;63973;262053;128166;133887;56306;29255;27051;24751;13186;11565;57308;26043;31265;47865;19766;28099;75823;39916;35907;13359.0;11843.0;9025.0;10692.0;46667.0;45638.0;14
1275;Rotterdam (SG);2023;1176337;253849;689501;232987;798006;116352;51817;64535;261979;127032;134947;55694;28807;26887;24719;13026;11693;57187;25802;31385;48026;19700;28326;76353;39697;36656;13412.0;11958.0;8934.0;10594.0;47032.0;45817.0;14
1276;Rotterdam (SG);2024;1177463;253535;687020;236908;798208;117315;52201;65114;261940;126050;135890;55016;28284;26732;24759;12962;11797;56911;25506;31405;48167;19604;28563;77087;39694;37393;13436.0;12128.0;8853.0;10448.0;46512.0;46026.0;14
1277;Rotterdam (SG);2025;1177779;253494;683272;241013;797699;118242;52522;65720;261838;125001;136837;54477;27814;26663;24723;12805;11918;56668;25233;31435;48213;19470;28743;77757;39679;38078;;;;;;;14
1278;Dordrecht (SG);2008;279422;69575;166909;42938;226593;21868;8659;13209;30961;17370;13591;4300;2328;1972;4088;2560;1528;8961;4472;4489;4359;2122;2237;9253;5888;3365;3211.0;2437.0;1129.0;1510.0;10002.0;9698.0;15
1279;Dordrecht (SG);2009;280167;69487;166945;43735;226739;22062;8737;13325;31366;17374;13992;4333;2303;2030;4094;2527;1567;8986;4461;4525;4536;2205;2331;9417;5878;3539;3196.0;2449.0;1249.0;1477.0;9783.0;9739.0;15
1280;Dordrecht (SG);2010;280757;69242;166826;44689;226777;22141;8778;13363;31839;17471;14368;4400;2311;2089;4132;2517;1615;8971;4448;4523;4703;2256;2447;9633;5939;3694;3173.0;2481.0;1283.0;1455.0;9484.0;9581.0;15
1281;Dordrecht (SG);2011;281208;68875;167048;45285;226684;22252;8829;13423;32272;17546;14726;4494;2307;2187;4125;2501;1624;8956;4435;4521;4868;2336;2532;9829;5967;3862;3110.0;2513.0;1304.0;1433.0;9934.0;9576.0;15
1282;Dordrecht (SG);2012;282063;68570;166099;47394;226990;22303;8847;13456;32770;17660;15110;4553;2325;2228;4180;2485;1695;8983;4460;4523;5017;2380;2637;10037;6010;4027;3112.0;2556.0;1319.0;1404.0;9714.0;9534.0;15
1283;Dordrecht (SG);2013;282744;68151;165360;49233;227042;22485;8953;13532;33217;17773;15444;4602;2344;2258;4185;2468;1717;9019;4477;4542;5214;2446;2768;10197;6038;4159;3099.0;2580.0;1298.0;1403.0;9355.0;9388.0;15
1284;Dordrecht (SG);2014;283150;67827;164712;50611;226810;22697;9031;13666;33643;17866;15777;4646;2351;2295;4224;2468;1756;9016;4467;4549;5350;2515;2835;10407;6065;4342;3075.0;2574.0;1270.0;1391.0;9612.0;9467.0;15
1285;Dordrecht (SG);2015;283707;67420;164510;51777;226945;22807;9100;13707;33955;17880;16075;4685;2352;2333;4239;2441;1798;8970;4452;4518;5453;2548;2905;10608;6087;4521;3064.0;2613.0;1302.0;1371.0;9482.0;9318.0;15
1286;Dordrecht (SG);2016;284278;67116;164324;52838;226949;22984;9183;13801;34345;17883;16462;4739;2330;2409;4242;2424;1818;8931;4423;4508;5660;2600;3060;10773;6106;4667;3074.0;2635.0;1253.0;1354.0;9247.0;9345.0;15
1287;Dordrecht (SG);2017;284540;66864;163860;53816;226719;23175;9270;13905;34646;17883;16763;4774;2327;2447;4297;2429;1868;8937;4416;4521;5753;2625;3128;10885;6086;4799;3088.0;2681.0;1300.0;1340.0;9075.0;9326.0;15
1288;Dordrecht (SG);2018;284688;66590;163305;54793;226316;23324;9328;13996;35048;17972;17076;4821;2338;2483;4319;2406;1913;8936;4417;4519;5873;2666;3207;11099;6145;4954;3079.0;2714.0;1239.0;1311.0;9476.0;9348.0;15
1289;Dordrecht (SG);2019;285139;66089;163424;55626;226241;23462;9388;14074;35436;18083;17353;4864;2334;2530;4335;2406;1929;8933;4387;4546;6014;2715;3299;11290;6241;5049;3111.0;2728.0;1227.0;1282.0;8932.0;9325.0;15
1290;Dordrecht (SG);2020;285105;65655;162926;56524;225914;23564;9471;14093;35627;18116;17511;4861;2327;2534;4339;2384;1955;8888;4371;4517;6064;2727;3337;11475;6307;5168;3091.0;2770.0;1244.0;1282.0;8991.0;9411.0;15
1291;Dordrecht (SG);2021;284998;65026;162541;57431;225468;23641;9540;14101;35889;18233;17656;4879;2342;2537;4381;2404;1977;8829;4350;4479;6170;2768;3402;11630;6369;5261;3114.0;2798.0;1234.0;1265.0;9370.0;9527.0;15
1292;Dordrecht (SG);2022;285152;64619;162133;58400;225206;23769;9616;14153;36177;18358;17819;4928;2379;2549;4377;2381;1996;8814;4342;4472;6265;2822;3443;11793;6434;5359;3125.0;2832.0;1251.0;1246.0;9188.0;9408.0;15
1293;Dordrecht (SG);2023;285257;64117;161774;59366;224936;23840;9657;14183;36481;18458;18023;4960;2381;2579;4400;2383;2017;8791;4317;4474;6331;2847;3484;11999;6530;5469;3141.0;2855.0;1208.0;1239.0;9054.0;9380.0;15
1294;Dordrecht (SG);2024;285211;63704;161103;60404;224589;24006;9727;14279;36616;18455;18161;5003;2400;2603;4399;2373;2026;8768;4291;4477;6376;2867;3509;12070;6524;5546;3127.0;2900.0;1221.0;1213.0;9425.0;9505.0;15
1295;Dordrecht (SG);2025;285400;63461;160453;61486;224299;24209;9864;14345;36892;18586;18306;5065;2437;2628;4425;2377;2048;8759;4304;4455;6428;2899;3529;12215;6569;5646;;;;;;;15
1296;Breda (SG);2008;313371;73579;192628;47164;257849;28379;10904;17475;27143;14966;12177;2926;1517;1409;2635;1452;1183;5427;2727;2700;7327;3441;3886;8828;5829;2999;3337.0;2733.0;2196.0;2569.0;8924.0;8118.0;16
1297;Breda (SG);2009;314450;73538;192752;48160;258264;28501;10996;17505;27685;15106;12579;3034;1577;1457;2683;1489;1194;5533;2749;2784;7485;3444;4041;8950;5847;3103;3342.0;2770.0;2290.0;2551.0;8987.0;8349.0;16
1298;Breda (SG);2010;315447;73403;192734;49310;258542;28677;11113;17564;28228;15358;12870;3150;1652;1498;2728;1531;1197;5585;2781;2804;7625;3468;4157;9140;5926;3214;3338.0;2827.0;2377.0;2500.0;9188.0;8384.0;16
1299;Breda (SG);2011;316671;73150;193061;50460;258897;28897;11285;17612;28877;15545;13332;3295;1714;1581;2857;1594;1263;5734;2824;2910;7709;3471;4238;9282;5942;3340;3343.0;2882.0;2447.0;2500.0;9441.0;8838.0;16
1300;Breda (SG);2012;317719;72887;192555;52277;259115;29149;11406;17743;29455;15671;13784;3405;1739;1666;2937;1645;1292;5852;2846;3006;7813;3480;4333;9448;5961;3487;3345.0;2928.0;2488.0;2486.0;9077.0;8780.0;16
1301;Breda (SG);2013;318468;72448;192037;53983;259097;29433;11590;17843;29938;15773;14165;3509;1787;1722;2998;1674;1324;5946;2878;3068;7912;3490;4422;9573;5944;3629;3336.0;2932.0;2472.0;2441.0;9231.0;8779.0;16
1302;Breda (SG);2014;319390;72143;191747;55500;259168;29733;11799;17934;30489;15928;14561;3634;1841;1793;3061;1721;1340;6069;2918;3151;8018;3494;4524;9707;5954;3753;3373.0;2980.0;2464.0;2386.0;9317.0;8857.0;16
1303;Breda (SG);2015;320366;71894;191629;56843;259298;29954;11918;18036;31114;16173;14941;3766;1893;1873;3135;1784;1351;6156;2954;3202;8145;3499;4646;9912;6043;3869;3383.0;3025.0;2483.0;2344.0;9361.0;8821.0;16
1304;Breda (SG);2016;321445;71866;191358;58221;259602;30111;12057;18054;31732;16328;15404;3906;1947;1959;3223;1810;1413;6258;2976;3282;8206;3491;4715;10139;6104;4035;3400.0;3056.0;2512.0;2347.0;9041.0;8927.0;16
1305;Breda (SG);2017;322108;71883;190899;59326;259433;30382;12207;18175;32293;16505;15788;4018;1980;2038;3294;1857;1437;6375;3008;3367;8269;3491;4778;10337;6169;4168;3442.0;3085.0;2504.0;2328.0;9173.0;8879.0;16
1306;Breda (SG);2018;322975;71878;190599;60498;259426;30661;12405;18256;32888;16722;16166;4142;2024;2118;3377;1900;1477;6441;3013;3428;8340;3495;4845;10588;6290;4298;3432.0;3130.0;2474.0;2326.0;9558.0;8983.0;16
1307;Breda (SG);2019;324069;71884;190627;61558;259724;30912;12586;18326;33433;16919;16514;4239;2083;2156;3472;1950;1522;6533;3023;3510;8400;3500;4900;10789;6363;4426;3447.0;3174.0;2409.0;2302.0;9472.0;8950.0;16
1308;Breda (SG);2020;325006;71680;190705;62621;259918;31133;12756;18377;33955;17090;16865;4344;2135;2209;3551;1994;1557;6607;3039;3568;8459;3489;4970;10994;6433;4561;3448.0;3209.0;2374.0;2306.0;9580.0;9107.0;16
1309;Breda (SG);2021;325818;71463;190696;63659;260070;31317;12848;18469;34431;17276;17155;4470;2191;2279;3587;2025;1562;6636;3043;3593;8541;3512;5029;11197;6505;4692;3434.0;3244.0;2369.0;2275.0;9438.0;9187.0;16
1310;Breda (SG);2022;326387;71188;190455;64744;260041;31484;12975;18509;34862;17478;17384;4584;2260;2324;3657;2065;1592;6682;3086;3596;8580;3512;5068;11359;6555;4804;3413.0;3277.0;2409.0;2253.0;9864.0;9280.0;16
1311;Breda (SG);2023;327296;71004;190471;65821;260195;31727;13192;18535;35374;17711;17663;4702;2309;2393;3717;2110;1607;6744;3113;3631;8637;3513;5124;11574;6666;4908;3412.0;3349.0;2417.0;2265.0;9218.0;9152.0;16
1312;Breda (SG);2024;327627;70889;189769;66969;259880;31916;13294;18622;35831;17920;17911;4792;2368;2424;3765;2137;1628;6833;3156;3677;8700;3532;5168;11741;6727;5014;3370.0;3385.0;2313.0;2221.0;9617.0;9256.0;16
1313;Breda (SG);2025;328108;70794;189175;68139;259684;32147;13410;18737;36277;18119;18158;4869;2391;2478;3833;2163;1670;6889;3168;3721;8725;3531;5194;11961;6866;5095;;;;;;;16
1314;Tilburg (SG);2008;290853;68125;181986;40742;237204;22475;8500;13975;31174;17910;13264;3670;2007;1663;4145;2652;1493;8527;4332;4195;5563;2725;2838;9269;6194;3075;3103.0;2362.0;2046.0;2274.0;9216.0;9112.0;17
1315;Tilburg (SG);2009;291520;68130;181400;41990;237329;22595;8572;14023;31596;17922;13674;3739;2031;1708;4138;2615;1523;8554;4288;4266;5718;2741;2977;9447;6247;3200;3084.0;2430.0;2195.0;2245.0;9098.0;9287.0;17
1316;Tilburg (SG);2010;291990;68004;180784;43202;237080;22773;8675;14098;32137;18010;14127;3869;2084;1785;4101;2586;1515;8598;4240;4358;5873;2776;3097;9696;6324;3372;3092.0;2493.0;2232.0;2212.0;9154.0;9196.0;17
1317;Tilburg (SG);2011;292607;67631;180445;44531;237089;22979;8829;14150;32539;17974;14565;3944;2117;1827;4128;2570;1558;8609;4179;4430;6007;2775;3232;9851;6333;3518;3069.0;2552.0;2306.0;2172.0;9206.0;9470.0;17
1318;Tilburg (SG);2012;293031;67384;179439;46208;236815;23187;8949;14238;33029;18044;14985;4065;2182;1883;4129;2550;1579;8628;4164;4464;6161;2804;3357;10046;6344;3702;3065.0;2594.0;2307.0;2152.0;9366.0;9365.0;17
1319;Tilburg (SG);2013;293695;67398;178455;47842;236730;23439;9118;14321;33526;18162;15364;4154;2213;1941;4180;2578;1602;8678;4144;4534;6250;2833;3417;10264;6394;3870;3080.0;2643.0;2369.0;2103.0;9430.0;9518.0;17
1320;Tilburg (SG);2014;294355;67392;177494;49469;236736;23576;9211;14365;34043;18270;15773;4241;2258;1983;4199;2573;1626;8683;4096;4587;6367;2850;3517;10553;6493;4060;3096.0;2677.0;2315.0;2071.0;9404.0;9608.0;17
1321;Tilburg (SG);2015;294841;67164;176621;51056;236636;23753;9353;14400;34452;18378;16074;4348;2307;2041;4213;2574;1639;8674;4054;4620;6506;2896;3610;10711;6547;4164;3084.0;2717.0;2327.0;2072.0;9665.0;9680.0;17
1322;Tilburg (SG);2016;295481;67238;175932;52311;236683;23878;9461;14417;34920;18459;16461;4423;2344;2079;4251;2575;1676;8729;4047;4682;6587;2899;3688;10930;6594;4336;3109.0;2779.0;2308.0;2014.0;9652.0;9585.0;17
1323;Tilburg (SG);2017;296209;67291;175467;53451;236743;24128;9621;14507;35338;18575;16763;4460;2368;2092;4265;2576;1689;8738;4025;4713;6705;2924;3781;11170;6682;4488;3123.0;2810.0;2317.0;2040.0;9624.0;9658.0;17
1324;Tilburg (SG);2018;296811;67232;175050;54529;236703;24290;9752;14538;35818;18742;17076;4541;2405;2136;4291;2572;1719;8803;4020;4783;6743;2920;3823;11440;6825;4615;3145.0;2859.0;2362.0;2000.0;9737.0;9682.0;17
1325;Tilburg (SG);2019;297552;67202;174655;55695;236777;24443;9883;14560;36332;18918;17414;4616;2447;2169;4336;2602;1734;8814;4011;4803;6806;2938;3868;11760;6920;4840;3157.0;2874.0;2281.0;1969.0;9589.0;9827.0;17
1326;Tilburg (SG);2020;297946;67074;174054;56818;236535;24655;10005;14650;36756;19083;17673;4702;2504;2198;4338;2593;1745;8834;4015;4819;6888;2934;3954;11994;7037;4957;3175.0;2953.0;2266.0;1979.0;9808.0;9797.0;17
1327;Tilburg (SG);2021;298506;66813;173961;57732;236489;24830;10135;14695;37187;19247;17940;4770;2547;2223;4349;2587;1762;8835;4003;4832;6982;2944;4038;12251;7166;5085;3192.0;2985.0;2258.0;1959.0;9903.0;9828.0;17
1328;Tilburg (SG);2022;299122;66674;173647;58801;236401;25067;10313;14754;37654;19430;18224;4819;2560;2259;4362;2583;1779;8857;3996;4861;7067;2987;4080;12549;7304;5245;3207.0;3045.0;2211.0;1952.0;9896.0;9895.0;17
1329;Tilburg (SG);2023;299583;66679;173025;59879;236193;25266;10438;14828;38124;19663;18461;4872;2595;2277;4386;2576;1810;8870;4003;4867;7098;3015;4083;12898;7474;5424;3229.0;3106.0;2244.0;1937.0;9936.0;9829.0;17
1330;Tilburg (SG);2024;300153;66658;172535;60960;236066;25440;10566;14874;38647;19849;18798;4921;2604;2317;4442;2600;1842;8883;3988;4895;7200;3048;4152;13201;7609;5592;3230.0;3119.0;2283.0;1926.0;9718.0;9949.0;17
1331;Tilburg (SG);2025;300435;66610;171866;61959;235712;25564;10662;14902;39159;20052;19107;4969;2616;2353;4458;2577;1881;8905;3994;4911;7277;3079;4198;13550;7786;5764;;;;;;;17
1332;'s-Hertogenbosch (SG);2008;189345;45014;117203;27128;158820;15085;5623;9462;15440;8692;6748;2173;1116;1057;1080;592;488;2949;1546;1403;4305;2137;2168;4933;3301;1632;2120.0;1618.0;920.0;1242.0;7625.0;6896.0;18
1333;'s-Hertogenbosch (SG);2009;190283;45107;117566;27610;159257;15230;5723;9507;15796;8803;6993;2233;1127;1106;1113;605;508;3036;1572;1464;4337;2159;2178;5077;3340;1737;2111.0;1665.0;974.0;1227.0;7871.0;7052.0;18
1334;'s-Hertogenbosch (SG);2010;191312;45233;117912;28167;159707;15433;5854;9579;16172;8962;7210;2264;1143;1121;1120;602;518;3128;1613;1515;4417;2170;2247;5243;3434;1809;2091.0;1680.0;1035.0;1238.0;8286.0;7180.0;18
1335;'s-Hertogenbosch (SG);2011;192655;45314;118477;28864;160401;15666;5979;9687;16588;9115;7473;2323;1157;1166;1151;619;532;3185;1634;1551;4507;2201;2306;5422;3504;1918;2054.0;1703.0;1082.0;1230.0;8343.0;7386.0;18
1336;'s-Hertogenbosch (SG);2012;193835;45385;118536;29914;161060;15831;6119;9712;16944;9238;7706;2355;1175;1180;1181;639;542;3260;1665;1595;4554;2202;2352;5594;3557;2037;2069.0;1722.0;1089.0;1210.0;7743.0;7419.0;18
1337;'s-Hertogenbosch (SG);2013;194406;45268;118119;31019;161210;15940;6178;9762;17256;9379;7877;2416;1221;1195;1194;637;557;3266;1674;1592;4619;2221;2398;5761;3626;2135;2063.0;1763.0;1067.0;1187.0;7897.0;7361.0;18
1338;'s-Hertogenbosch (SG);2014;195141;45185;117894;32062;161453;16047;6260;9787;17641;9517;8124;2477;1254;1223;1203;640;563;3340;1713;1627;4674;2218;2456;5947;3692;2255;2014.0;1809.0;1066.0;1206.0;7972.0;7385.0;18
1339;'s-Hertogenbosch (SG);2015;195813;45081;117898;32834;161698;16196;6340;9856;17919;9615;8304;2493;1267;1226;1221;637;584;3384;1709;1675;4714;2231;2483;6107;3771;2336;2038.0;1822.0;1082.0;1183.0;7748.0;7372.0;18
1340;'s-Hertogenbosch (SG);2016;196325;44972;117670;33683;161679;16398;6514;9884;18248;9747;8501;2550;1298;1252;1244;646;598;3434;1730;1704;4763;2246;2517;6257;3827;2430;2036.0;1843.0;1070.0;1177.0;7978.0;7350.0;18
1341;'s-Hertogenbosch (SG);2017;197057;44864;117729;34464;161911;16594;6692;9902;18552;9898;8654;2588;1309;1279;1297;688;609;3448;1747;1701;4782;2252;2530;6437;3902;2535;2027.0;1884.0;1053.0;1175.0;7909.0;7429.0;18
1342;'s-Hertogenbosch (SG);2018;197587;44784;117483;35320;161975;16760;6808;9952;18852;10095;8757;2638;1344;1294;1330;710;620;3467;1757;1710;4823;2286;2537;6594;3998;2596;2017.0;1903.0;1053.0;1161.0;7916.0;7466.0;18
1343;'s-Hertogenbosch (SG);2019;198068;44674;117381;36013;161978;16943;6865;10078;19147;10221;8926;2690;1379;1311;1349;709;640;3520;1755;1765;4843;2291;2552;6745;4087;2658;2024.0;1925.0;1041.0;1154.0;7975.0;7465.0;18
1344;'s-Hertogenbosch (SG);2020;198587;44409;117421;36757;162029;17128;6986;10142;19430;10352;9078;2733;1397;1336;1355;712;643;3541;1757;1784;4892;2322;2570;6909;4164;2745;2025.0;1945.0;1055.0;1150.0;8087.0;7533.0;18
1345;'s-Hertogenbosch (SG);2021;199151;44114;117529;37508;162168;17313;7121;10192;19670;10476;9194;2760;1420;1340;1392;722;670;3571;1783;1788;4922;2340;2582;7025;4211;2814;2027.0;1995.0;1027.0;1141.0;8270.0;7522.0;18
1346;'s-Hertogenbosch (SG);2022;199838;43928;117732;38178;162405;17440;7237;10203;19993;10646;9347;2800;1426;1374;1426;727;699;3612;1805;1807;4918;2352;2566;7237;4336;2901;2054.0;1986.0;1045.0;1150.0;7964.0;7601.0;18
1347;'s-Hertogenbosch (SG);2023;200192;43706;117539;38947;162247;17617;7338;10279;20328;10802;9526;2832;1437;1395;1457;751;706;3655;1825;1830;4999;2377;2622;7385;4412;2973;2022.0;2029.0;1022.0;1147.0;8089.0;7578.0;18
1348;'s-Hertogenbosch (SG);2024;200590;43459;117398;39733;162211;17736;7454;10282;20643;10922;9721;2888;1458;1430;1476;756;720;3681;1832;1849;5008;2359;2649;7590;4517;3073;2025.0;2055.0;1064.0;1126.0;7778.0;7603.0;18
1349;'s-Hertogenbosch (SG);2025;200696;43183;116928;40585;161987;17903;7602;10301;20806;11051;9755;2935;1484;1451;1496;773;723;3719;1853;1866;4978;2339;2639;7678;4602;3076;;;;;;;18
1350;Eindhoven (SG);2008;407737;92050;251215;64472;324684;41967;16679;25288;41086;24466;16620;4835;2590;2245;3146;1886;1260;10746;5672;5074;6273;3008;3265;16086;11310;4776;4197.0;3446.0;3942.0;3756.0;15922.0;15866.0;19
1351;Eindhoven (SG);2009;408789;91924;251007;65858;324511;42371;17095;25276;41907;24885;17022;4908;2626;2282;3193;1896;1297;10832;5745;5087;6470;3064;3406;16504;11554;4950;4209.0;3520.0;4145.0;3756.0;15950.0;16023.0;19
1352;Eindhoven (SG);2010;409858;91528;251141;67189;324309;42792;17608;25184;42757;25202;17555;4995;2660;2335;3258;1930;1328;10896;5737;5159;6657;3133;3524;16951;11742;5209;4245.0;3604.0;4278.0;3711.0;15892.0;16098.0;19
1353;Eindhoven (SG);2011;410917;91019;251424;68474;324006;43244;18090;25154;43667;25530;18137;5093;2707;2386;3302;1952;1350;10946;5744;5202;6904;3222;3682;17422;11905;5517;4257.0;3629.0;4407.0;3666.0;15712.0;16394.0;19
1354;Eindhoven (SG);2012;411665;90572;250599;70494;323330;43677;18515;25162;44658;25930;18728;5227;2763;2464;3374;2011;1363;11095;5808;5287;7077;3252;3825;17885;12096;5789;4182.0;3709.0;4427.0;3646.0;15596.0;16352.0;19
1355;Eindhoven (SG);2013;412219;89876;250009;72334;322664;44029;18898;25131;45526;26204;19322;5320;2821;2499;3471;2058;1413;11183;5842;5341;7290;3308;3982;18262;12175;6087;4238.0;3743.0;4442.0;3564.0;15709.0;16452.0;19
1356;Eindhoven (SG);2014;412902;89387;249580;73935;322117;44473;19404;25069;46312;26471;19841;5444;2900;2544;3570;2098;1472;11267;5835;5432;7446;3353;4093;18585;12285;6300;4228.0;3816.0;4416.0;3527.0;15516.0;16482.0;19
1357;Eindhoven (SG);2015;413287;88795;249121;75371;321310;44907;19879;25028;47070;26725;20345;5550;2950;2600;3647;2154;1493;11322;5828;5494;7599;3387;4212;18952;12406;6546;4252.0;3843.0;4416.0;3522.0;15694.0;16526.0;19
1358;Eindhoven (SG);2016;413810;88542;248583;76685;320572;45264;20286;24978;47974;27127;20847;5648;3007;2641;3746;2222;1524;11399;5839;5560;7742;3413;4329;19439;12646;6793;4274.0;3898.0;4452.0;3501.0;14828.0;16491.0;19
1359;Eindhoven (SG);2017;413533;87991;247822;77720;319173;45648;20653;24995;48712;27402;21310;5684;3032;2652;3821;2252;1569;11418;5873;5545;7914;3439;4475;19875;12806;7069;4264.0;3962.0;4391.0;3451.0;15230.0;16419.0;19
1360;Eindhoven (SG);2018;413637;87612;247161;78864;318173;46024;21053;24971;49440;27651;21789;5777;3061;2716;3877;2289;1588;11465;5882;5583;8070;3466;4604;20251;12953;7298;4323.0;3984.0;4406.0;3464.0;14791.0;16473.0;19
1361;Eindhoven (SG);2019;413284;87000;246465;79819;316890;46346;21390;24956;50048;27882;22166;5836;3076;2760;3933;2327;1606;11478;5864;5614;8166;3491;4675;20635;13124;7511;4324.0;4007.0;4403.0;3420.0;14774.0;16322.0;19
1362;Eindhoven (SG);2020;413085;86476;245736;80873;315554;46802;21848;24954;50729;28146;22583;5937;3132;2805;4004;2361;1643;11505;5875;5630;8283;3504;4779;21000;13274;7726;4356.0;4056.0;4346.0;3374.0;15077.0;16299.0;19
1363;Eindhoven (SG);2021;413173;85868;245409;81896;314505;47179;22192;24987;51489;28426;23063;6023;3157;2866;4090;2391;1699;11553;5909;5644;8366;3531;4835;21457;13438;8019;4417.0;4071.0;4370.0;3357.0;15144.0;16324.0;19
1364;Eindhoven (SG);2022;413400;85489;244855;83056;313605;47541;22517;25024;52254;28745;23509;6093;3205;2888;4180;2429;1751;11619;5924;5695;8489;3589;4900;21873;13598;8275;4453.0;4170.0;4342.0;3298.0;14856.0;16396.0;19
1365;Eindhoven (SG);2023;413238;85117;244025;84096;312274;47872;22819;25053;53092;29122;23970;6162;3239;2923;4241;2455;1786;11648;5954;5694;8667;3657;5010;22374;13817;8557;4437.0;4202.0;4355.0;3329.0;14645.0;16275.0;19
1366;Eindhoven (SG);2024;412922;84831;242837;85254;310884;48262;23149;25113;53776;29435;24341;6209;3241;2968;4335;2508;1827;11709;5973;5736;8773;3695;5078;22750;14018;8732;4475.0;4195.0;4315.0;3270.0;14640.0;16236.0;19
1367;Eindhoven (SG);2025;412702;84666;241365;86671;309624;48662;23545;25117;54416;29738;24678;6257;3264;2993;4447;2581;1866;11777;5994;5783;8858;3716;5142;23077;14183;8894;;;;;;;19
1368;Geleen/Sittard (SG);2008;152473;33024;92851;26598;123990;21195;6182;15013;7288;4366;2922;483;243;240;425;238;187;791;464;327;2352;1227;1125;3237;2194;1043;1275.0;1484.0;816.0;1162.0;5472.0;5348.0;20
1369;Geleen/Sittard (SG);2009;152064;32627;92423;27014;123624;20873;6135;14738;7567;4460;3107;569;295;274;461;251;210;861;479;382;2356;1205;1151;3320;2230;1090;1254.0;1500.0;855.0;1148.0;5434.0;5466.0;20
1370;Geleen/Sittard (SG);2010;151513;32055;91994;27464;123192;20513;6068;14445;7808;4583;3225;614;318;296;488;265;223;933;519;414;2384;1219;1165;3389;2262;1127;1250.0;1516.0;892.0;1098.0;5471.0;5524.0;20
1371;Geleen/Sittard (SG);2011;151004;31463;91465;28076;122826;20128;6005;14123;8050;4664;3386;679;355;324;527;302;225;991;526;465;2409;1205;1204;3444;2276;1168;1236.0;1556.0;895.0;1066.0;5279.0;5490.0;20
1372;Geleen/Sittard (SG);2012;150322;30826;90711;28785;122255;19744;5982;13762;8323;4787;3536;730;385;345;560;320;240;1079;565;514;2418;1195;1223;3536;2322;1214;1221.0;1568.0;893.0;1048.0;5359.0;5537.0;20
1373;Geleen/Sittard (SG);2013;149660;30301;89802;29557;121817;19313;5906;13407;8530;4824;3706;777;407;370;581;328;253;1170;588;582;2421;1168;1253;3581;2333;1248;1241.0;1589.0;880.0;1018.0;5264.0;5537.0;20
1374;Geleen/Sittard (SG);2014;148911;29827;88938;30146;121172;18959;5881;13078;8780;4910;3870;834;425;409;600;344;256;1239;601;638;2466;1165;1301;3641;2375;1266;1243.0;1612.0;850.0;1003.0;5243.0;5551.0;20
1375;Geleen/Sittard (SG);2015;148096;29350;87940;30806;120519;18607;5844;12763;8970;4991;3979;874;452;422;635;363;272;1300;600;700;2459;1161;1298;3702;2415;1287;1245.0;1618.0;865.0;966.0;5269.0;5475.0;20
1376;Geleen/Sittard (SG);2016;147434;28897;87095;31442;119979;18236;5797;12439;9219;5083;4136;915;482;433;664;385;279;1375;620;755;2511;1180;1331;3754;2416;1338;1252.0;1634.0;817.0;962.0;5324.0;5437.0;20
1377;Geleen/Sittard (SG);2017;146809;28435;86364;32010;119425;17922;5787;12135;9462;5201;4261;984;520;464;702;401;301;1436;649;787;2543;1186;1357;3797;2445;1352;1256.0;1648.0;789.0;942.0;5163.0;5393.0;20
1378;Geleen/Sittard (SG);2018;146051;28050;85346;32655;118783;17569;5746;11823;9699;5275;4424;1040;546;494;717;414;303;1499;658;841;2580;1190;1390;3863;2467;1396;1262.0;1673.0;800.0;913.0;5279.0;5437.0;20
1379;Geleen/Sittard (SG);2019;145380;27625;84612;33143;118241;17256;5710;11546;9883;5324;4559;1063;553;510;748;419;329;1552;678;874;2607;1195;1412;3913;2479;1434;1283.0;1690.0;795.0;894.0;5222.0;5432.0;20
1380;Geleen/Sittard (SG);2020;144680;27344;83785;33551;117600;16937;5696;11241;10143;5425;4718;1111;588;523;792;430;362;1616;702;914;2647;1188;1459;3977;2517;1460;1287.0;1706.0;761.0;890.0;5155.0;5384.0;20
1381;Geleen/Sittard (SG);2021;143925;26992;82925;34008;116933;16707;5683;11024;10285;5483;4802;1137;603;534;835;445;390;1636;709;927;2627;1168;1459;4050;2558;1492;1285.0;1688.0;759.0;882.0;5127.0;5376.0;20
1382;Geleen/Sittard (SG);2022;143166;26588;82032;34546;116356;16364;5632;10732;10446;5539;4907;1154;619;535;866;463;403;1694;728;966;2651;1165;1486;4081;2564;1517;1261.0;1719.0;760.0;866.0;5097.0;5252.0;20
1383;Geleen/Sittard (SG);2023;142466;26421;81009;35036;115720;16148;5650;10498;10598;5589;5009;1187;631;556;890;482;408;1735;753;982;2695;1171;1524;4091;2552;1539;1269.0;1741.0;743.0;842.0;5073.0;5189.0;20
1384;Geleen/Sittard (SG);2024;141790;26219;80053;35518;115039;15880;5621;10259;10871;5687;5184;1236;664;572;938;493;445;1785;768;1017;2752;1169;1583;4160;2593;1567;1241.0;1750.0;711.0;827.0;5018.0;5179.0;20
1385;Geleen/Sittard (SG);2025;141017;26195;78837;35985;114317;15676;5647;10029;11024;5736;5288;1282;693;589;952;504;448;1835;779;1056;2751;1155;1596;4204;2605;1599;;;;;;;20
1386;Heerlen (SG);2008;256019;52028;157328;46663;191522;51997;17605;34392;12500;7410;5090;881;459;422;1128;710;418;1460;771;689;3488;1758;1730;5543;3712;1831;2068.0;2796.0;1614.0;2125.0;11195.0;11411.0;21
1387;Heerlen (SG);2009;254593;51212;156312;47069;190767;50824;17341;33483;13002;7627;5375;983;521;462;1180;735;445;1577;808;769;3515;1753;1762;5747;3810;1937;2067.0;2822.0;1584.0;2105.0;11337.0;11486.0;21
1388;Heerlen (SG);2010;253198;50365;155314;47519;190130;49724;17030;32694;13344;7754;5590;1076;581;495;1198;737;461;1677;833;844;3542;1763;1779;5851;3840;2011;2067.0;2827.0;1664.0;2010.0;11641.0;11693.0;21
1389;Heerlen (SG);2011;252069;49613;154182;48274;189635;48671;16793;31878;13763;7912;5851;1200;649;551;1219;744;475;1804;891;913;3552;1749;1803;5988;3879;2109;2074.0;2849.0;1607.0;1988.0;11472.0;11570.0;21
1390;Heerlen (SG);2012;250842;48827;152874;49141;189037;47627;16552;31075;14178;8019;6159;1290;697;593;1247;748;499;1948;919;1029;3598;1743;1855;6095;3912;2183;2088.0;2853.0;1641.0;1925.0;11615.0;11501.0;21
1391;Heerlen (SG);2013;249936;48384;151462;50090;188583;46696;16358;30338;14657;8241;6416;1381;760;621;1282;772;510;2095;989;1106;3663;1754;1909;6236;3966;2270;2094.0;2897.0;1594.0;1884.0;11506.0;11497.0;21
1392;Heerlen (SG);2014;248878;47819;150053;51006;188080;45734;16151;29583;15064;8404;6660;1464;807;657;1343;817;526;2249;1039;1210;3684;1760;1924;6324;3981;2343;2112.0;2890.0;1574.0;1834.0;11520.0;11482.0;21
1393;Heerlen (SG);2015;247906;47298;148708;51900;187523;44852;15931;28921;15531;8588;6943;1556;850;706;1401;844;557;2392;1096;1296;3731;1753;1978;6451;4045;2406;2115.0;2929.0;1555.0;1812.0;11514.0;11347.0;21
1394;Heerlen (SG);2016;247033;47108;147318;52607;187118;43991;15737;28254;15924;8747;7177;1654;897;757;1441;864;577;2517;1155;1362;3728;1727;2001;6584;4104;2480;2127.0;2931.0;1501.0;1763.0;11477.0;11380.0;21
1395;Heerlen (SG);2017;246095;46881;145968;53246;186742;43055;15555;27500;16298;8842;7456;1749;939;810;1476;875;601;2649;1195;1454;3753;1720;2033;6671;4113;2558;2140.0;2947.0;1439.0;1744.0;11460.0;11271.0;21
1396;Heerlen (SG);2018;245200;46588;144494;54118;186346;42190;15350;26840;16664;8974;7690;1841;983;858;1519;890;629;2774;1234;1540;3753;1706;2047;6777;4161;2616;2172.0;2976.0;1429.0;1708.0;11237.0;11114.0;21
1397;Heerlen (SG);2019;244276;46314;143064;54898;185915;41333;15134;26199;17028;9124;7904;1926;1022;904;1590;916;674;2896;1290;1606;3763;1710;2053;6853;4186;2667;2201.0;2987.0;1403.0;1652.0;11306.0;11110.0;21
1398;Heerlen (SG);2020;243463;46176;141757;55530;185527;40514;14969;25545;17422;9263;8159;2021;1056;965;1609;928;681;3032;1333;1699;3796;1720;2076;6964;4226;2738;2189.0;2987.0;1380.0;1620.0;11373.0;11071.0;21
1399;Heerlen (SG);2021;242752;45915;140633;56204;185187;39757;14810;24947;17808;9447;8361;2106;1110;996;1642;955;687;3161;1380;1781;3795;1713;2082;7104;4289;2815;2191.0;3007.0;1331.0;1611.0;11272.0;11030.0;21
1400;Heerlen (SG);2022;241923;45784;139096;57043;184680;39063;14656;24407;18180;9564;8616;2155;1128;1027;1738;994;744;3285;1419;1866;3802;1711;2091;7200;4312;2888;2192.0;3057.0;1325.0;1583.0;11298.0;10995.0;21
1401;Heerlen (SG);2023;241128;45705;137659;57764;184160;38401;14518;23883;18567;9703;8864;2201;1159;1042;1774;992;782;3381;1458;1923;3870;1729;2141;7341;4365;2976;2208.0;3050.0;1295.0;1518.0;11113.0;10885.0;21
1402;Heerlen (SG);2024;240323;45575;136202;58546;183678;37774;14417;23357;18871;9824;9047;2230;1151;1079;1812;1015;797;3491;1502;1989;3898;1755;2143;7440;4401;3039;2225.0;3081.0;1286.0;1495.0;11122.0;10807.0;21
1403;Heerlen (SG);2025;239595;45578;134724;59293;183260;37129;14256;22873;19206;9986;9220;2289;1206;1083;1845;1041;804;3625;1565;2060;3937;1761;2176;7510;4413;3097;;;;;;;21
1404;Maastricht (SG);2008;179613;35754;112145;31714;146152;23234;9116;14118;10227;6322;3905;590;284;306;674;435;239;1789;929;860;2002;1000;1002;5172;3674;1498;1320.0;1902.0;2171.0;2536.0;6996.0;7266.0;22
1405;Maastricht (SG);2009;178423;35132;111321;31970;144994;23064;9160;13904;10365;6310;4055;673;331;342;705;457;248;1832;947;885;2066;1001;1065;5089;3574;1515;1318.0;1923.0;2244.0;2475.0;6921.0;7285.0;22
1406;Maastricht (SG);2010;177257;34535;110421;32301;143819;22858;9200;13658;10580;6317;4263;771;386;385;742;487;255;1903;964;939;2122;1004;1118;5042;3476;1566;1330.0;1921.0;2263.0;2388.0;6878.0;7296.0;22
1407;Maastricht (SG);2011;176153;33739;109547;32867;142651;22767;9349;13418;10735;6318;4417;835;410;425;771;497;274;1964;982;982;2173;1014;1159;4992;3415;1577;1374.0;1948.0;2319.0;2376.0;6901.0;7282.0;22
1408;Maastricht (SG);2012;175172;33099;108556;33517;141604;22692;9409;13283;10876;6295;4581;926;463;463;805;510;295;1997;996;1001;2202;998;1204;4946;3328;1618;1411.0;1939.0;2317.0;2296.0;6790.0;7210.0;22
1409;Maastricht (SG);2013;174269;32697;107362;34210;140615;22553;9511;13042;11101;6275;4826;1006;504;502;857;527;330;2060;1009;1051;2258;983;1275;4920;3252;1668;1436.0;1950.0;2280.0;2256.0;6863.0;7236.0;22
1410;Maastricht (SG);2014;173427;32255;106398;34774;139724;22439;9562;12877;11264;6297;4967;1070;529;541;897;557;340;2108;1020;1088;2294;997;1297;4895;3194;1701;1471.0;1977.0;2250.0;2190.0;6806.0;7279.0;22
1411;Maastricht (SG);2015;172537;31852;105573;35112;138793;22304;9592;12712;11440;6352;5088;1121;553;568;969;599;370;2136;1052;1084;2317;991;1326;4897;3157;1740;1493.0;1955.0;2195.0;2168.0;6865.0;7229.0;22
1412;Maastricht (SG);2016;171763;31567;104667;35529;138031;22155;9585;12570;11577;6390;5187;1184;578;606;984;610;374;2183;1090;1093;2332;995;1337;4894;3117;1777;1512.0;1980.0;2146.0;2122.0;6704.0;7148.0;22
1413;Maastricht (SG);2017;170903;31368;103648;35887;137108;22013;9628;12385;11782;6428;5354;1260;617;643;1017;631;386;2231;1103;1128;2363;999;1364;4911;3078;1833;1527.0;1982.0;2130.0;2081.0;6700.0;7160.0;22
1414;Maastricht (SG);2018;170060;31233;102564;36263;136185;21926;9693;12233;11949;6497;5452;1319;666;653;1037;642;395;2282;1115;1167;2417;1019;1398;4894;3055;1839;1551.0;1973.0;2108.0;2044.0;6761.0;7138.0;22
1415;Maastricht (SG);2019;169349;30990;101672;36687;135408;21837;9724;12113;12104;6521;5583;1388;706;682;1064;651;413;2328;1119;1209;2453;1032;1421;4871;3013;1858;1545.0;1999.0;2041.0;2015.0;6629.0;7121.0;22
1416;Maastricht (SG);2020;168451;30730;100712;37009;134545;21674;9735;11939;12232;6582;5650;1424;726;698;1076;654;422;2368;1133;1235;2503;1036;1467;4861;3033;1828;1551.0;1996.0;2021.0;1972.0;6728.0;7031.0;22
1417;Maastricht (SG);2021;167778;30441;100031;37306;133705;21691;9844;11847;12382;6617;5765;1471;748;723;1098;660;438;2415;1161;1254;2520;1023;1497;4878;3025;1853;1534.0;1983.0;2001.0;1945.0;6636.0;7012.0;22
1418;Maastricht (SG);2022;167034;30306;99127;37601;132929;21576;9834;11742;12529;6699;5830;1514;774;740;1109;667;442;2411;1150;1261;2576;1044;1532;4919;3064;1855;1518.0;2002.0;1934.0;1930.0;6635.0;7016.0;22
1419;Maastricht (SG);2023;166189;30152;98158;37879;132002;21456;9867;11589;12731;6722;6009;1577;794;783;1133;681;452;2445;1160;1285;2616;1049;1567;4960;3038;1922;1523.0;2024.0;1934.0;1891.0;6615.0;6932.0;22
1420;Maastricht (SG);2024;165434;30144;97136;38154;131186;21324;9867;11457;12924;6797;6127;1626;828;798;1151;682;469;2480;1188;1292;2648;1051;1597;5019;3048;1971;1539.0;2020.0;1894.0;1834.0;6468.0;6887.0;22
1421;Maastricht (SG);2025;164609;30061;96091;38457;130287;21242;9896;11346;13080;6860;6220;1697;859;838;1186;703;483;2512;1192;1320;2667;1064;1603;5018;3042;1976;;;;;;;22
1422;Groningen (GA);2008;201393;38075;137955;25363;165745;18334;7983;10351;17314;10693;6621;3229;1665;1564;2863;1876;987;1519;790;729;1289;583;706;8414;5779;2635;2328.0;1742.0;2248.0;2603.0;13002.0;11802.0;1
1423;Groningen (GA);2009;202887;38717;138539;25631;167000;18337;7983;10354;17550;10731;6819;3254;1684;1570;2813;1813;1000;1619;819;800;1428;640;788;8436;5775;2661;2401.0;1727.0;2343.0;2576.0;12945.0;11738.0;1
1424;Groningen (GA);2010;204592;39472;139088;26032;168396;18376;8035;10341;17820;10796;7024;3244;1688;1556;2822;1824;998;1754;866;888;1554;680;874;8446;5738;2708;2505.0;1740.0;2374.0;2551.0;13466.0;11679.0;1
1425;Groningen (GA);2011;207028;40375;140195;26458;170393;18479;8090;10389;18156;10838;7318;3265;1695;1570;2820;1811;1009;1904;914;990;1675;724;951;8492;5694;2798;2563.0;1761.0;2454.0;2535.0;13189.0;11675.0;1
1426;Groningen (GA);2012;209305;41050;140750;27505;172273;18596;8151;10445;18436;10903;7533;3282;1721;1561;2853;1842;1011;2034;961;1073;1758;724;1034;8509;5655;2854;2647.0;1781.0;2443.0;2492.0;13099.0;11634.0;1
1427;Groningen (GA);2013;211635;41921;141306;28408;174203;18665;8212;10453;18767;11019;7748;3303;1752;1551;2843;1829;1014;2162;1018;1144;1872;759;1113;8587;5661;2926;2714.0;1785.0;2428.0;2474.0;13360.0;11602.0;1
1428;Groningen (GA);2014;214323;42833;142242;29248;176531;18743;8247;10496;19049;11124;7925;3306;1760;1546;2862;1856;1006;2253;1051;1202;1982;787;1195;8646;5670;2976;2762.0;1810.0;2389.0;2450.0;13444.0;11592.0;1
1429;Groningen (GA);2015;217115;43773;143304;30038;178898;18850;8336;10514;19367;11190;8177;3315;1774;1541;2885;1858;1027;2397;1108;1289;2065;818;1247;8705;5632;3073;2834.0;1825.0;2468.0;2422.0;13256.0;11670.0;1
1430;Groningen (GA);2016;219803;44725;144311;30767;180999;19002;8427;10575;19802;11350;8452;3394;1811;1583;2920;1882;1038;2505;1143;1362;2164;867;1297;8819;5647;3172;2861.0;1823.0;2415.0;2409.0;13079.0;11784.0;1
1431;Groningen (GA);2017;222198;45667;145018;31513;182948;19129;8491;10638;20121;11492;8629;3386;1814;1572;2945;1905;1040;2637;1192;1445;2230;885;1345;8923;5696;3227;2899.0;1857.0;2406.0;2403.0;13259.0;11738.0;1
1432;Groningen (GA);2018;224814;46639;145760;32415;185075;19203;8530;10673;20536;11619;8917;3401;1824;1577;2981;1909;1072;2770;1241;1529;2326;911;1415;9058;5734;3324;2944.0;1870.0;2385.0;2357.0;13296.0;11844.0;1
1433;Groningen (GA);2019;227420;47465;146666;33289;187192;19316;8584;10732;20912;11788;9124;3483;1852;1631;2993;1930;1063;2830;1256;1574;2407;953;1454;9199;5797;3402;2963.0;1911.0;2385.0;2370.0;13389.0;11868.0;1
1434;Groningen (GA);2020;230054;48306;147588;34160;189372;19418;8642;10776;21264;11868;9396;3534;1865;1669;2981;1941;1040;2925;1285;1640;2555;995;1560;9269;5782;3487;2981.0;1929.0;2412.0;2366.0;13360.0;11977.0;1
1435;Groningen (GA);2021;232577;49091;148506;34980;191324;19561;8724;10837;21692;12070;9622;3576;1885;1691;3024;1972;1052;2993;1327;1666;2676;1028;1648;9423;5858;3565;2978.0;1958.0;2361.0;2345.0;13319.0;11986.0;1
1436;Groningen (GA);2022;234996;49720;149466;35810;193167;19722;8855;10867;22107;12201;9906;3619;1895;1724;3024;1970;1054;3118;1388;1730;2819;1069;1750;9527;5879;3648;3007.0;1995.0;2373.0;2340.0;13313.0;12079.0;1
1437;Groningen (GA);2023;237324;50420;150216;36688;195029;19809;8893;10916;22486;12362;10124;3639;1902;1737;3042;1964;1078;3215;1431;1784;2918;1087;1831;9672;5978;3694;3015.0;2027.0;2344.0;2346.0;13374.0;12163.0;1
1438;Groningen (GA);2024;239569;51080;150910;37579;196621;19966;8963;11003;22982;12491;10491;3684;1905;1779;3047;1933;1114;3349;1495;1854;3017;1109;1908;9885;6049;3836;3038.0;2050.0;2384.0;2336.0;13277.0;12235.0;1
1439;Groningen (GA);2025;241689;51762;151411;38516;198156;20130;9068;11062;23403;12654;10749;3720;1906;1814;3079;1931;1148;3396;1517;1879;3165;1152;2013;10043;6148;3895;;;;;;;1
1440;Leeuwarden (GA);2008;95098;20437;61178;13483;80108;6579;2511;4068;8411;5284;3127;1373;722;651;888;583;305;595;303;292;1086;517;569;4469;3159;1310;1152.0;907.0;732.0;875.0;4198.0;2960.0;2
1441;Leeuwarden (GA);2009;96459;20659;62230;13570;81277;6627;2526;4101;8555;5260;3295;1413;746;667;927;585;342;639;328;311;1163;542;621;4413;3059;1354;1214.0;907.0;734.0;864.0;3623.0;2920.0;2
1442;Leeuwarden (GA);2010;97358;20873;62768;13717;81931;6698;2572;4126;8729;5266;3463;1445;765;680;963;605;358;726;354;372;1230;568;662;4365;2974;1391;1241.0;900.0;724.0;848.0;3411.0;2934.0;2
1443;Leeuwarden (GA);2011;98072;21096;63163;13813;82498;6689;2527;4162;8885;5294;3591;1445;762;683;1001;637;364;781;366;415;1291;597;694;4367;2932;1435;1306.0;895.0;762.0;858.0;3244.0;2972.0;2
1444;Leeuwarden (GA);2012;98673;21278;63218;14177;83010;6703;2514;4189;8960;5285;3675;1449;754;695;1022;656;366;825;380;445;1337;606;731;4327;2889;1438;1345.0;887.0;751.0;817.0;3253.0;2954.0;2
1445;Leeuwarden (GA);2013;99386;21577;63255;14554;83540;6723;2541;4182;9123;5322;3801;1460;754;706;1038;661;377;917;416;501;1388;629;759;4320;2862;1458;1378.0;907.0;746.0;807.0;3234.0;2948.0;2
1446;Leeuwarden (GA);2014;100102;21834;63452;14816;84123;6765;2543;4222;9214;5299;3915;1472;754;718;1030;642;388;986;441;545;1452;665;787;4274;2797;1477;1440.0;888.0;762.0;793.0;3237.0;2942.0;2
1447;Leeuwarden (GA);2015;100944;22251;63690;15003;84764;6824;2570;4254;9356;5318;4038;1488;765;723;1055;661;394;1061;460;601;1518;690;828;4234;2742;1492;1459.0;905.0;725.0;789.0;3196.0;2947.0;2
1448;Leeuwarden (GA);2016;101697;22636;63793;15268;85346;6836;2572;4264;9515;5365;4150;1486;764;722;1098;683;415;1117;481;636;1563;703;860;4251;2734;1517;1504.0;897.0;717.0;765.0;3233.0;2945.0;2
1449;Leeuwarden (GA);2017;102565;23126;63937;15502;85987;6899;2599;4300;9679;5439;4240;1515;784;731;1131;700;431;1182;518;664;1604;709;895;4247;2728;1519;1518.0;902.0;753.0;764.0;3231.0;2969.0;2
1450;Leeuwarden (GA);2018;103443;23659;64030;15754;86610;6946;2636;4310;9887;5489;4398;1540;798;742;1186;719;467;1219;538;681;1655;722;933;4287;2712;1575;1544.0;903.0;736.0;761.0;3268.0;2981.0;2
1451;Leeuwarden (GA);2019;104366;24222;64167;15977;87369;6971;2641;4330;10026;5507;4519;1554;796;758;1215;737;478;1243;533;710;1697;730;967;4317;2711;1606;1583.0;917.0;736.0;746.0;3286.0;3005.0;2
1452;Leeuwarden (GA);2020;105320;24747;64337;16236;88090;7007;2664;4343;10223;5570;4653;1568;795;773;1261;765;496;1270;559;711;1778;745;1033;4346;2706;1640;1609.0;904.0;704.0;759.0;3301.0;3040.0;2
1453;Leeuwarden (GA);2021;106246;25289;64471;16486;88854;7050;2664;4386;10342;5594;4748;1563;788;775;1305;776;529;1295;574;721;1827;761;1066;4352;2695;1657;1617.0;912.0;717.0;736.0;3300.0;3031.0;2
1454;Leeuwarden (GA);2022;107221;25862;64597;16762;89639;7057;2644;4413;10525;5626;4899;1553;777;776;1351;809;542;1375;592;783;1863;766;1097;4383;2682;1701;1646.0;924.0;715.0;752.0;3292.0;3004.0;2
1455;Leeuwarden (GA);2023;108208;26358;64795;17055;90408;7093;2670;4423;10707;5632;5075;1587;778;809;1379;822;557;1423;606;817;1923;778;1145;4395;2648;1747;1649.0;933.0;709.0;735.0;3261.0;2998.0;2
1456;Leeuwarden (GA);2024;109177;26875;64966;17336;91177;7093;2688;4405;10907;5722;5185;1610;784;826;1411;844;567;1499;647;852;1986;793;1193;4401;2654;1747;1672.0;932.0;689.0;725.0;3238.0;3038.0;2
1457;Leeuwarden (GA);2025;110093;27376;65098;17619;91823;7151;2706;4445;11119;5780;5339;1650;807;843;1417;845;572;1544;660;884;2047;802;1245;4461;2666;1795;;;;;;;2
1458;Zwolle (GA);2008;115006;28505;71807;14694;97547;7584;2666;4918;9875;5765;4110;1219;618;601;1294;810;484;2472;1289;1183;769;347;422;4121;2701;1420;1687.0;975.0;503.0;625.0;4882.0;4478.0;3
1459;Zwolle (GA);2009;116026;28931;72210;14885;98400;7604;2704;4900;10022;5816;4206;1262;650;612;1282;787;495;2473;1278;1195;827;375;452;4178;2726;1452;1650.0;962.0;524.0;618.0;4742.0;4416.0;3
1460;Zwolle (GA);2010;116963;29322;72488;15153;99152;7677;2734;4943;10134;5847;4287;1280;655;625;1279;784;495;2483;1286;1197;857;379;478;4235;2743;1492;1649.0;975.0;552.0;627.0;4728.0;4466.0;3
1461;Zwolle (GA);2011;117847;29644;72769;15434;99825;7752;2779;4973;10270;5879;4391;1310;670;640;1266;780;486;2505;1284;1221;898;390;508;4291;2755;1536;1616.0;998.0;575.0;617.0;4731.0;4437.0;3
1462;Zwolle (GA);2012;118735;29871;72923;15941;100462;7843;2824;5019;10430;5951;4479;1330;671;659;1268;780;488;2522;1304;1218;927;400;527;4383;2796;1587;1589.0;1007.0;566.0;601.0;4863.0;4447.0;3
1463;Zwolle (GA);2013;119710;30189;73005;16516;101184;7916;2851;5065;10610;6041;4569;1373;682;691;1265;778;487;2527;1305;1222;958;409;549;4487;2867;1620;1552.0;1017.0;597.0;593.0;4852.0;4442.0;3
1464;Zwolle (GA);2014;120676;30428;73310;16938;101911;7994;2928;5066;10771;6079;4692;1369;683;686;1278;792;486;2553;1298;1255;1007;419;588;4564;2887;1677;1523.0;1026.0;596.0;577.0;4884.0;4444.0;3
1465;Zwolle (GA);2015;121651;30683;73608;17360;102606;8077;2974;5103;10968;6182;4786;1412;705;707;1255;767;488;2540;1301;1239;1062;441;621;4699;2968;1731;1504.0;1041.0;565.0;576.0;4918.0;4439.0;3
1466;Zwolle (GA);2016;122603;30889;73916;17798;103280;8173;3018;5155;11150;6253;4897;1420;708;712;1275;766;509;2556;1317;1239;1127;459;668;4772;3003;1769;1504.0;1058.0;600.0;574.0;4860.0;4491.0;3
1467;Zwolle (GA);2017;123458;31061;74176;18221;103832;8238;3060;5178;11388;6346;5042;1459;720;739;1294;772;522;2561;1314;1247;1209;486;723;4865;3054;1811;1457.0;1066.0;602.0;573.0;5019.0;4524.0;3
1468;Zwolle (GA);2018;124387;31316;74379;18692;104525;8308;3101;5207;11554;6436;5118;1462;727;735;1308;778;530;2547;1307;1240;1234;492;742;5003;3132;1871;1477.0;1087.0;572.0;560.0;4951.0;4574.0;3
1469;Zwolle (GA);2019;125182;31405;74627;19150;105072;8375;3171;5204;11735;6533;5202;1487;741;746;1312;777;535;2581;1322;1259;1273;514;759;5082;3179;1903;1456.0;1083.0;579.0;551.0;4948.0;4592.0;3
1470;Zwolle (GA);2020;125956;31438;74901;19617;105507;8503;3236;5267;11946;6656;5290;1506;746;760;1340;795;545;2580;1329;1251;1329;530;799;5191;3256;1935;1454.0;1091.0;589.0;566.0;4795.0;4590.0;3
1471;Zwolle (GA);2021;126561;31378;75097;20086;105896;8558;3308;5250;12107;6734;5373;1522;752;770;1360;807;553;2588;1330;1258;1357;538;819;5280;3307;1973;1441.0;1114.0;597.0;546.0;4888.0;4621.0;3
1472;Zwolle (GA);2022;127218;31256;75389;20573;106277;8645;3369;5276;12296;6820;5476;1564;774;790;1377;814;563;2579;1314;1265;1405;545;860;5371;3373;1998;1442.0;1132.0;551.0;549.0;4932.0;4606.0;3
1473;Zwolle (GA);2023;127868;31133;75645;21090;106672;8703;3364;5339;12493;6948;5545;1563;777;786;1378;804;574;2615;1336;1279;1431;563;868;5506;3468;2038;1444.0;1159.0;544.0;541.0;4831.0;4698.0;3
1474;Zwolle (GA);2024;128308;30963;75759;21586;106930;8719;3379;5340;12659;7028;5631;1580;783;797;1408;820;588;2622;1344;1278;1479;567;912;5570;3514;2056;1448.0;1184.0;551.0;562.0;4811.0;4664.0;3
1475;Zwolle (GA);2025;128729;30895;75746;22088;107153;8737;3409;5328;12839;7108;5731;1597;799;798;1429;825;604;2630;1333;1297;1518;577;941;5665;3574;2091;;;;;;;3
1476;Enschede (GA);2008;156346;35831;98234;22281;115199;19196;7552;11644;21951;12510;9441;2032;1082;950;911;553;358;8710;4334;4376;2334;1078;1256;7964;5463;2501;1790.0;1488.0;1682.0;1884.0;5483.0;4628.0;4
1477;Enschede (GA);2009;157327;36125;98396;22806;116139;19231;7606;11625;21957;12258;9699;2092;1125;967;941;562;379;8685;4259;4426;2427;1102;1325;7812;5210;2602;1801.0;1524.0;1721.0;1809.0;4915.0;4582.0;4
1478;Enschede (GA);2010;157877;36271;98335;23271;116630;19273;7685;11588;21974;12082;9892;2145;1142;1003;971;567;404;8659;4243;4416;2501;1124;1377;7698;5006;2692;1818.0;1528.0;1787.0;1800.0;4414.0;4525.0;4
1479;Enschede (GA);2011;158061;36395;98067;23599;116718;19293;7763;11530;22050;11948;10102;2182;1151;1031;1039;610;429;8590;4191;4399;2613;1127;1486;7626;4869;2757;1829.0;1545.0;1788.0;1745.0;4294.0;4438.0;4
1480;Enschede (GA);2012;158272;36419;97385;24468;116851;19322;7807;11515;22099;11816;10283;2214;1164;1050;1079;635;444;8511;4135;4376;2737;1152;1585;7558;4730;2828;1816.0;1545.0;1785.0;1724.0;4231.0;4388.0;4
1481;Enschede (GA);2013;158471;36581;96631;25259;117035;19276;7812;11464;22160;11653;10507;2262;1186;1076;1130;660;470;8469;4059;4410;2783;1152;1631;7516;4596;2920;1838.0;1558.0;1749.0;1686.0;4154.0;4380.0;4
1482;Enschede (GA);2014;158607;36661;96109;25837;117178;19240;7875;11365;22189;11552;10637;2300;1214;1086;1191;690;501;8407;3991;4416;2848;1174;1674;7443;4483;2960;1832.0;1584.0;1763.0;1633.0;4004.0;4312.0;4
1483;Enschede (GA);2015;158698;36724;95685;26289;117156;19261;7957;11304;22281;11503;10778;2368;1244;1124;1254;718;536;8338;3960;4378;2913;1197;1716;7408;4384;3024;1819.0;1605.0;1724.0;1609.0;3916.0;4299.0;4
1484;Enschede (GA);2016;158659;36870;95075;26714;117139;19228;8012;11216;22292;11432;10860;2384;1266;1118;1305;754;551;8263;3887;4376;2997;1210;1787;7343;4315;3028;1863.0;1606.0;1710.0;1574.0;4017.0;4277.0;4
1485;Enschede (GA);2017;158814;37054;94726;27034;117223;19255;8115;11140;22336;11428;10908;2426;1297;1129;1340;770;570;8195;3846;4349;3059;1226;1833;7316;4289;3027;1836.0;1628.0;1654.0;1568.0;4102.0;4297.0;4
1486;Enschede (GA);2018;158936;37209;94375;27352;117326;19217;8137;11080;22393;11430;10963;2468;1314;1154;1382;792;590;8107;3776;4331;3121;1255;1866;7315;4293;3022;1856.0;1638.0;1664.0;1518.0;3980.0;4255.0;4
1487;Enschede (GA);2019;159048;37414;93945;27689;117321;19280;8248;11032;22447;11383;11064;2525;1330;1195;1426;815;611;8000;3744;4256;3199;1278;1921;7297;4216;3081;1863.0;1647.0;1630.0;1495.0;3852.0;4245.0;4
1488;Enschede (GA);2020;159023;37499;93593;27931;117254;19269;8299;10970;22500;11344;11156;2584;1346;1238;1471;840;631;7891;3685;4206;3246;1286;1960;7308;4187;3121;1869.0;1654.0;1588.0;1468.0;4033.0;4229.0;4
1489;Enschede (GA);2021;159177;37512;93482;28183;117350;19239;8322;10917;22588;11326;11262;2612;1359;1253;1515;866;649;7812;3643;4169;3340;1310;2030;7309;4148;3161;1882.0;1684.0;1609.0;1456.0;3911.0;4265.0;4
1490;Enschede (GA);2022;159194;37587;93119;28488;117356;19227;8419;10808;22611;11273;11338;2641;1381;1260;1557;883;674;7708;3594;4114;3409;1314;2095;7296;4101;3195;1884.0;1693.0;1599.0;1441.0;4051.0;4239.0;4
1491;Enschede (GA);2023;159373;37762;92852;28759;117463;19216;8485;10731;22694;11242;11452;2671;1379;1292;1601;914;687;7651;3557;4094;3489;1341;2148;7282;4051;3231;1886.0;1717.0;1557.0;1413.0;4140.0;4211.0;4
1492;Enschede (GA);2024;159637;37822;92762;29053;117572;19233;8553;10680;22832;11253;11579;2696;1386;1310;1653;941;712;7588;3502;4086;3555;1360;2195;7340;4064;3276;1909.0;1722.0;1543.0;1392.0;3897.0;4273.0;4
1493;Enschede (GA);2025;159619;37879;92306;29434;117483;19205;8599;10606;22931;11304;11627;2770;1422;1348;1708;972;736;7495;3469;4026;3577;1353;2224;7381;4088;3293;;;;;;;4
1494;Apeldoorn (GA);2008;154986;37232;93190;24564;131553;12182;4348;7834;11251;6516;4735;1052;554;498;1039;580;459;4015;2136;1879;933;465;468;4212;2781;1431;1644.0;1533.0;464.0;757.0;4758.0;4924.0;5
1495;Apeldoorn (GA);2009;154659;36945;92842;24872;130979;12155;4321;7834;11525;6564;4961;1094;572;522;1062;595;467;4054;2130;1924;1038;501;537;4277;2766;1511;1630.0;1549.0;494.0;715.0;4803.0;4950.0;5
1496;Apeldoorn (GA);2010;154390;36653;92461;25276;130475;12135;4324;7811;11780;6689;5091;1144;610;534;1068;599;469;4098;2159;1939;1097;521;576;4373;2800;1573;1594.0;1554.0;500.0;711.0;4810.0;5024.0;5
1497;Apeldoorn (GA);2011;154023;36393;92136;25494;129880;12112;4272;7840;12031;6770;5261;1181;632;549;1087;603;484;4125;2172;1953;1177;541;636;4461;2822;1639;1543.0;1561.0;514.0;697.0;5659.0;5007.0;5
1498;Apeldoorn (GA);2012;154485;36200;91686;26599;130080;12085;4263;7822;12320;6931;5389;1240;656;584;1084;602;482;4139;2212;1927;1262;577;685;4595;2884;1711;1520.0;1557.0;535.0;692.0;5471.0;5102.0;5
1499;Apeldoorn (GA);2013;154681;35897;91295;27489;129988;12148;4331;7817;12545;7004;5541;1297;681;616;1121;615;506;4164;2215;1949;1312;599;713;4651;2894;1757;1512.0;1566.0;538.0;667.0;5804.0;5182.0;5
1500;Apeldoorn (GA);2014;155132;35635;91216;28281;130043;12215;4340;7875;12874;7175;5699;1370;713;657;1153;644;509;4186;2221;1965;1402;639;763;4763;2958;1805;1502.0;1590.0;527.0;692.0;5895.0;5217.0;5
1501;Apeldoorn (GA);2015;155573;35479;91127;28967;130133;12278;4346;7932;13162;7263;5899;1439;736;703;1157;644;513;4218;2237;1981;1490;662;828;4858;2984;1874;1503.0;1604.0;542.0;663.0;5836.0;5304.0;5
1502;Apeldoorn (GA);2016;155904;35393;91014;29497;130123;12327;4379;7948;13454;7340;6114;1494;761;733;1189;677;512;4270;2251;2019;1561;668;893;4940;2983;1957;1507.0;1617.0;514.0;664.0;5849.0;5303.0;5
1503;Apeldoorn (GA);2017;156205;35234;90899;30072;130194;12311;4420;7891;13700;7449;6251;1525;772;753;1231;694;537;4258;2249;2009;1627;686;941;5059;3048;2011;1515.0;1622.0;511.0;650.0;5785.0;5354.0;5
1504;Apeldoorn (GA);2018;156409;35094;90717;30598;130127;12325;4459;7866;13957;7562;6395;1590;804;786;1251;696;555;4260;2267;1993;1700;716;984;5156;3079;2077;1506.0;1664.0;504.0;639.0;5634.0;5348.0;5
1505;Apeldoorn (GA);2019;156425;34748;90580;31097;129964;12332;4470;7862;14129;7615;6514;1615;817;798;1262;692;570;4213;2240;1973;1789;735;1054;5250;3131;2119;1529.0;1656.0;509.0;640.0;5477.0;5354.0;5
1506;Apeldoorn (GA);2020;156307;34473;90229;31605;129552;12324;4476;7848;14431;7763;6668;1674;831;843;1297;716;581;4184;2231;1953;1878;771;1107;5398;3214;2184;1511.0;1671.0;518.0;654.0;5331.0;5321.0;5
1507;Apeldoorn (GA);2021;156042;34171;89720;32151;129162;12280;4486;7794;14600;7845;6755;1720;860;860;1299;709;590;4171;2234;1937;1934;788;1146;5476;3254;2222;1506.0;1700.0;490.0;637.0;5321.0;5269.0;5
1508;Apeldoorn (GA);2022;155765;33815;89324;32626;128647;12302;4496;7806;14816;7944;6872;1756;885;871;1308;705;603;4172;2242;1930;2014;811;1203;5566;3301;2265;1486.0;1713.0;499.0;623.0;5276.0;5274.0;5
1509;Apeldoorn (GA);2023;155438;33378;89000;33060;128247;12276;4551;7725;14915;7997;6918;1790;895;895;1312;712;600;4173;2256;1917;2050;824;1226;5590;3310;2280;1469.0;1730.0;491.0;621.0;5117.0;5282.0;5
1510;Apeldoorn (GA);2024;154895;32940;88418;33537;127586;12225;4559;7666;15084;8105;6979;1828;917;911;1323;728;595;4175;2277;1898;2092;839;1253;5666;3344;2322;1438.0;1739.0;502.0;615.0;5342.0;5184.0;5
1511;Apeldoorn (GA);2025;154654;32775;87780;34099;127163;12217;4589;7628;15274;8163;7111;1853;919;934;1338;729;609;4189;2274;1915;2133;845;1288;5761;3396;2365;;;;;;;5
1512;Arnhem (GA);2008;146406;32273;95305;18828;105745;16272;6303;9969;24389;14473;9916;3098;1654;1444;1943;1260;683;7728;4079;3649;2978;1444;1534;8642;6036;2606;1824.0;1328.0;1251.0;1536.0;8022.0;6681.0;6
1513;Arnhem (GA);2009;147983;32683;96185;19115;107204;16298;6310;9988;24481;14316;10165;3134;1683;1451;1915;1235;680;7653;3991;3662;3125;1478;1647;8654;5929;2725;1839.0;1325.0;1280.0;1501.0;7945.0;6734.0;6
1514;Arnhem (GA);2010;149511;33153;96912;19446;108613;16339;6362;9977;24559;14152;10407;3124;1685;1439;1913;1220;693;7594;3914;3680;3268;1513;1755;8660;5820;2840;1831.0;1341.0;1292.0;1470.0;8119.0;6689.0;6
1515;Arnhem (GA);2011;151275;33491;97989;19795;110120;16421;6390;10031;24734;14004;10730;3159;1696;1463;1919;1201;718;7556;3842;3714;3378;1538;1840;8722;5727;2995;1844.0;1346.0;1359.0;1451.0;7268.0;6710.0;6
1516;Arnhem (GA);2012;152266;33658;97967;20641;110946;16428;6425;10003;24892;13865;11027;3190;1710;1480;1924;1215;709;7548;3779;3769;3486;1548;1938;8744;5613;3131;1825.0;1351.0;1356.0;1421.0;7314.0;6631.0;6
1517;Arnhem (GA);2013;153378;33888;97999;21491;111869;16516;6496;10020;24993;13767;11226;3188;1706;1482;1961;1242;719;7522;3731;3791;3581;1564;2017;8741;5524;3217;1860.0;1392.0;1347.0;1419.0;7163.0;6695.0;6
1518;Arnhem (GA);2014;154266;34129;98088;22049;112684;16467;6539;9928;25115;13628;11487;3217;1711;1506;1957;1240;717;7481;3659;3822;3680;1587;2093;8780;5431;3349;1873.0;1397.0;1322.0;1357.0;7118.0;6624.0;6
1519;Arnhem (GA);2015;155223;34362;98235;22626;113458;16527;6584;9943;25238;13609;11629;3226;1719;1507;1934;1225;709;7495;3647;3848;3791;1625;2166;8792;5393;3399;1895.0;1417.0;1301.0;1364.0;6872.0;6733.0;6
1520;Arnhem (GA);2016;155793;34538;98047;23208;113927;16509;6617;9892;25357;13543;11814;3237;1717;1520;1974;1259;715;7432;3586;3846;3878;1654;2224;8836;5327;3509;1887.0;1419.0;1323.0;1326.0;6353.0;6722.0;6
1521;Arnhem (GA);2017;155908;34657;97487;23764;114040;16399;6578;9821;25469;13518;11951;3255;1737;1518;2023;1288;735;7396;3543;3853;3948;1665;2283;8847;5285;3562;1909.0;1414.0;1267.0;1293.0;6466.0;6700.0;6
1522;Arnhem (GA);2018;156166;34852;97004;24310;114281;16316;6533;9783;25569;13444;12125;3279;1762;1517;2006;1273;733;7342;3490;3852;4007;1670;2337;8935;5249;3686;1871.0;1442.0;1254.0;1293.0;6098.0;6650.0;6
1523;Arnhem (GA);2019;156028;34774;96420;24834;114177;16264;6564;9700;25587;13353;12234;3270;1767;1503;2020;1275;745;7316;3450;3866;4024;1672;2352;8957;5189;3768;1851.0;1442.0;1235.0;1272.0;6187.0;6610.0;6
1524;Arnhem (GA);2020;155999;34739;95938;25322;114138;16232;6574;9658;25629;13326;12303;3249;1745;1504;2027;1280;747;7246;3411;3835;4065;1672;2393;9042;5218;3824;1888.0;1485.0;1229.0;1265.0;6481.0;6568.0;6
1525;Arnhem (GA);2021;156295;34795;95720;25780;114259;16208;6570;9638;25828;13360;12468;3292;1773;1519;2059;1299;760;7191;3370;3821;4142;1687;2455;9144;5231;3913;1869.0;1507.0;1223.0;1238.0;6108.0;6626.0;6
1526;Arnhem (GA);2022;156144;34774;95085;26285;114105;16153;6545;9608;25886;13330;12556;3286;1769;1517;2070;1305;765;7157;3349;3808;4210;1690;2520;9163;5217;3946;1857.0;1482.0;1166.0;1204.0;6032.0;6585.0;6
1527;Arnhem (GA);2023;155947;34698;94471;26778;113888;16100;6516;9584;25959;13298;12661;3257;1735;1522;2137;1336;801;7133;3326;3807;4219;1693;2526;9213;5208;4005;1842.0;1519.0;1189.0;1181.0;6224.0;6532.0;6
1528;Arnhem (GA);2024;155993;34613;94103;27277;113813;16072;6545;9527;26108;13257;12851;3269;1739;1530;2133;1320;813;7128;3274;3854;4301;1719;2582;9277;5205;4072;1844.0;1556.0;1143.0;1192.0;6055.0;6545.0;6
1529;Arnhem (GA);2025;155760;34547;93374;27839;113549;15967;6530;9437;26244;13204;13040;3277;1717;1560;2126;1318;808;7095;3236;3859;4375;1735;2640;9371;5198;4173;;;;;;;6
1530;Nijmegen (GA);2008;162474;32365;108456;21653;124000;19224;7684;11540;19250;11399;7851;1615;817;798;1945;1205;740;5045;2660;2385;3304;1653;1651;7341;5064;2277;1780.0;1382.0;1545.0;1655.0;7940.0;6982.0;7
1531;Nijmegen (GA);2009;163753;32511;109194;22048;125085;19307;7739;11568;19361;11288;8073;1669;842;827;1948;1185;763;5040;2611;2429;3337;1626;1711;7367;5024;2343;1848.0;1413.0;1601.0;1635.0;8084.0;6993.0;7
1532;Nijmegen (GA);2010;165280;32767;109985;22528;126385;19428;7881;11547;19467;11165;8302;1760;881;879;1961;1192;769;5028;2572;2456;3341;1577;1764;7377;4943;2434;1915.0;1439.0;1681.0;1615.0;7766.0;7060.0;7
1533;Nijmegen (GA);2011;166563;32991;110531;23041;127434;19550;7956;11594;19579;11128;8451;1831;910;921;1992;1225;767;5016;2553;2463;3382;1577;1805;7358;4863;2495;1954.0;1449.0;1678.0;1609.0;7494.0;7029.0;7
1534;Nijmegen (GA);2012;167624;33227;110371;24026;128333;19623;8063;11560;19668;11072;8596;1917;957;960;2034;1260;774;4979;2509;2470;3397;1552;1845;7341;4794;2547;1999.0;1488.0;1692.0;1577.0;7522.0;6967.0;7
1535;Nijmegen (GA);2013;168834;33498;110385;24951;129343;19727;8170;11557;19764;10997;8767;1982;990;992;2018;1234;784;4987;2486;2501;3406;1527;1879;7371;4760;2611;2069.0;1507.0;1688.0;1547.0;7294.0;7079.0;7
1536;Nijmegen (GA);2014;169780;33794;110346;25640;130109;19762;8232;11530;19909;10978;8931;2039;1014;1025;2055;1253;802;4977;2465;2512;3429;1520;1909;7409;4726;2683;2105.0;1531.0;1681.0;1537.0;7319.0;7033.0;7
1537;Nijmegen (GA);2015;170813;34041;110373;26399;130916;19872;8348;11524;20025;10992;9033;2076;1051;1025;2067;1273;794;4980;2450;2530;3471;1502;1969;7431;4716;2715;2127.0;1544.0;1672.0;1502.0;7748.0;6977.0;7
1538;Nijmegen (GA);2016;172365;34537;110713;27115;132004;20071;8487;11584;20290;11017;9273;2131;1061;1070;2068;1293;775;5053;2461;2592;3540;1492;2048;7498;4710;2788;2172.0;1571.0;1671.0;1493.0;7756.0;7010.0;7
1539;Nijmegen (GA);2017;173915;35003;110925;27987;133219;20210;8618;11592;20486;11047;9439;2157;1084;1073;2087;1306;781;5084;2454;2630;3566;1473;2093;7592;4730;2862;2176.0;1597.0;1655.0;1486.0;7781.0;7067.0;7
1540;Nijmegen (GA);2018;175401;35419;111084;28898;134347;20303;8723;11580;20751;11103;9648;2240;1115;1125;2142;1346;796;5091;2425;2666;3597;1472;2125;7681;4745;2936;2191.0;1616.0;1626.0;1490.0;7633.0;7103.0;7
1541;Nijmegen (GA);2019;176671;35771;111188;29712;135347;20375;8802;11573;20949;11092;9857;2289;1142;1147;2167;1347;820;5122;2422;2700;3600;1447;2153;7771;4734;3037;2217.0;1659.0;1618.0;1467.0;7541.0;7158.0;7
1542;Nijmegen (GA);2020;177792;36053;111222;30517;136244;20470;8892;11578;21078;11089;9989;2332;1156;1176;2175;1364;811;5103;2395;2708;3646;1448;2198;7822;4726;3096;2195.0;1674.0;1630.0;1466.0;7708.0;7110.0;7
1543;Nijmegen (GA);2021;179094;36345;111477;31272;137057;20627;9011;11616;21410;11187;10223;2388;1180;1208;2238;1400;838;5148;2395;2753;3698;1463;2235;7938;4749;3189;2185.0;1708.0;1631.0;1431.0;7486.0;7199.0;7
1544;Nijmegen (GA);2022;180080;36588;111500;31992;137670;20737;9119;11618;21673;11255;10418;2443;1192;1251;2261;1404;857;5169;2385;2784;3727;1474;2253;8073;4800;3273;2189.0;1738.0;1631.0;1453.0;7315.0;7141.0;7
1545;Nijmegen (GA);2023;180903;36865;111345;32693;138157;20809;9280;11529;21937;11305;10632;2526;1213;1313;2292;1415;877;5199;2377;2822;3753;1472;2281;8167;4828;3339;2182.0;1766.0;1577.0;1428.0;7507.0;7132.0;7
1546;Nijmegen (GA);2024;181863;37070;111339;33454;138733;20911;9401;11510;22219;11388;10831;2565;1224;1341;2337;1454;883;5252;2369;2883;3772;1460;2312;8293;4881;3412;2173.0;1789.0;1597.0;1424.0;7371.0;7198.0;7
1547;Nijmegen (GA);2025;182614;37183;111176;34255;139123;20954;9497;11457;22537;11508;11029;2634;1253;1381;2390;1482;908;5248;2357;2891;3846;1465;2381;8419;4951;3468;;;;;;;7
1548;Amersfoort (GA);2008;169349;44993;103536;20820;135032;14254;5206;9048;20063;11637;8426;1825;905;920;1642;960;682;5560;3035;2525;4147;2085;2062;6889;4652;2237;2145.0;1237.0;1012.0;1135.0;7751.0;6717.0;8
1549;Amersfoort (GA);2009;171198;45251;104512;21435;136451;14451;5300;9151;20296;11666;8630;1857;914;943;1667;964;703;5569;3023;2546;4175;2075;2100;7028;4690;2338;2133.0;1252.0;1039.0;1120.0;8031.0;6793.0;8
1550;Amersfoort (GA);2010;173263;45551;105590;22122;138015;14655;5381;9274;20593;11712;8881;1942;935;1007;1684;988;696;5594;3015;2579;4262;2078;2184;7111;4696;2415;2078.0;1283.0;1051.0;1119.0;8072.0;6947.0;8
1551;Amersfoort (GA);2011;175136;45669;106807;22660;139463;14863;5483;9380;20810;11752;9058;2004;968;1036;1711;1009;702;5583;2993;2590;4302;2077;2225;7210;4705;2505;2067.0;1307.0;1102.0;1099.0;8027.0;7036.0;8
1552;Amersfoort (GA);2012;176918;45778;107183;23957;140791;15048;5579;9469;21079;11819;9260;2083;994;1089;1736;1034;702;5599;2986;2613;4338;2070;2268;7323;4735;2588;2038.0;1321.0;1069.0;1095.0;8004.0;7077.0;8
1553;Amersfoort (GA);2013;178559;45768;107782;25009;142028;15208;5648;9560;21323;11875;9448;2111;1009;1102;1782;1053;729;5591;2971;2620;4376;2074;2302;7463;4768;2695;2012.0;1367.0;1087.0;1082.0;7985.0;7125.0;8
1554;Amersfoort (GA);2014;180085;45708;108326;26051;143157;15389;5739;9650;21539;11965;9574;2143;1029;1114;1830;1080;750;5548;2974;2574;4431;2072;2359;7587;4810;2777;2013.0;1384.0;1075.0;1086.0;8074.0;7143.0;8
1555;Amersfoort (GA);2015;181662;45682;109039;26941;144306;15613;5893;9720;21743;12007;9736;2174;1035;1139;1840;1091;749;5546;2967;2579;4458;2066;2392;7725;4848;2877;1988.0;1392.0;1063.0;1064.0;8154.0;7150.0;8
1556;Amersfoort (GA);2016;183274;45532;109787;27955;145480;15817;5970;9847;21977;12122;9855;2230;1071;1159;1858;1081;777;5512;2943;2569;4493;2066;2427;7884;4961;2923;1976.0;1421.0;1081.0;1059.0;7625.0;7213.0;8
1557;Amersfoort (GA);2017;184282;45426;110002;28854;146247;15937;6044;9893;22098;12229;9869;2286;1109;1177;1847;1093;754;5470;2939;2531;4500;2069;2431;7995;5019;2976;1979.0;1475.0;1091.0;1035.0;7536.0;7280.0;8
1558;Amersfoort (GA);2018;185126;45105;110310;29711;146751;16058;6130;9928;22317;12295;10022;2335;1128;1207;1883;1098;785;5482;2940;2542;4461;2042;2419;8156;5087;3069;1972.0;1511.0;1099.0;1051.0;7900.0;7194.0;8
1559;Amersfoort (GA);2019;186354;44862;110772;30720;147564;16248;6227;10021;22542;12429;10113;2389;1160;1229;1920;1124;796;5464;2939;2525;4495;2064;2431;8274;5142;3132;1979.0;1534.0;1029.0;1038.0;7597.0;7297.0;8
1560;Amersfoort (GA);2020;187110;44486;110976;31648;148176;16347;6281;10066;22587;12489;10098;2427;1185;1242;1952;1142;810;5418;2925;2493;4446;2039;2407;8344;5198;3146;1962.0;1550.0;1064.0;1018.0;7512.0;7279.0;8
1561;Amersfoort (GA);2021;187833;44067;111230;32536;148575;16565;6435;10130;22693;12579;10114;2446;1203;1243;1980;1154;826;5390;2938;2452;4429;2039;2390;8448;5245;3203;1962.0;1583.0;1072.0;1029.0;7666.0;7332.0;8
1562;Amersfoort (GA);2022;188610;43688;111379;33543;149157;16606;6476;10130;22847;12668;10179;2485;1221;1264;2016;1188;828;5320;2921;2399;4420;2039;2381;8606;5299;3307;1971.0;1616.0;1005.0;1016.0;7813.0;7387.0;8
1563;Amersfoort (GA);2023;189401;43313;111505;34583;149601;16709;6593;10116;23091;12774;10317;2509;1237;1272;2054;1196;858;5340;2916;2424;4441;2042;2399;8747;5383;3364;1958.0;1657.0;1036.0;984.0;7939.0;7420.0;8
1564;Amersfoort (GA);2024;190298;42919;111750;35629;150074;16881;6718;10163;23343;12945;10398;2581;1277;1304;2081;1209;872;5294;2911;2383;4451;2032;2419;8936;5516;3420;1944.0;1683.0;1035.0;1003.0;7749.0;7391.0;8
1565;Amersfoort (GA);2025;190975;42702;111578;36695;150459;17028;6822;10206;23488;13024;10464;2612;1293;1319;2109;1232;877;5301;2913;2388;4446;2035;2411;9020;5551;3469;;;;;;;8
1566;Utrecht (GA);2008;430353;97144;285933;47276;313987;40964;16922;24042;75402;41608;33794;11838;6434;5404;3626;2027;1599;14127;7208;6919;28424;14390;14034;17387;11549;5838;6121.0;2867.0;4188.0;4326.0;25062.0;22700.0;9
1567;Utrecht (GA);2009;435932;98970;288052;48910;317778;41793;17326;24467;76361;41604;34757;11875;6420;5455;3789;2122;1667;14250;7127;7123;28541;14097;14444;17906;11838;6068;6167.0;2982.0;4378.0;4308.0;24692.0;22923.0;9
1568;Utrecht (GA);2010;441040;100508;290005;50527;321374;42471;17613;24858;77195;41633;35562;11889;6393;5496;3915;2202;1713;14309;7062;7247;28641;13863;14778;18441;12113;6328;6228.0;3068.0;4593.0;4365.0;24753.0;22701.0;9
1569;Utrecht (GA);2011;446561;102064;292641;51856;325050;43335;18125;25210;78176;41649;36527;11975;6384;5591;4075;2323;1752;14458;7042;7416;28747;13637;15110;18921;12263;6658;6279.0;3133.0;4749.0;4352.0;24983.0;22880.0;9
1570;Utrecht (GA);2012;452276;103573;293804;54899;328910;44145;18560;25585;79221;41780;37441;11984;6354;5630;4250;2456;1794;14565;6987;7578;28889;13465;15424;19533;12518;7015;6316.0;3182.0;4806.0;4369.0;25330.0;22885.0;9
1571;Utrecht (GA);2013;458362;105268;295395;57699;333159;45011;18988;26023;80192;41781;38411;12007;6334;5673;4456;2583;1873;14675;6952;7723;28982;13208;15774;20072;12704;7368;6396.0;3261.0;4862.0;4401.0;25380.0;22994.0;9
1572;Utrecht (GA);2014;464419;107084;297087;60248;337264;45927;19537;26390;81228;41914;39314;12040;6320;5720;4624;2705;1919;14798;6934;7864;29181;13082;16099;20585;12873;7712;6473.0;3347.0;4922.0;4388.0;25428.0;23000.0;9
1573;Utrecht (GA);2015;470562;108900;298992;62670;341509;46798;20035;26763;82255;42001;40254;12089;6327;5762;4811;2812;1999;14924;6915;8009;29243;12901;16342;21188;13046;8142;6523.0;3416.0;4983.0;4413.0;25095.0;23088.0;9
1574;Utrecht (GA);2016;476311;110713;300662;64936;345433;47647;20496;27151;83231;42101;41130;12087;6302;5785;4981;2932;2049;15117;6935;8182;29268;12699;16569;21778;13233;8545;6530.0;3496.0;5013.0;4372.0;25046.0;23196.0;9
1575;Utrecht (GA);2017;481903;112270;302527;67106;349157;48525;21002;27523;84221;42224;41997;12160;6306;5854;5146;3044;2102;15197;6922;8275;29289;12527;16762;22429;13425;9004;6571.0;3589.0;5055.0;4432.0;25619.0;23286.0;9
1576;Utrecht (GA);2018;487916;114070;304486;69360;353242;49448;21455;27993;85226;42375;42851;12183;6288;5895;5328;3134;2194;15394;6938;8456;29329;12411;16918;22992;13604;9388;6614.0;3701.0;5096.0;4419.0;25715.0;23484.0;9
1577;Utrecht (GA);2019;493803;115668;306628;71507;357222;50356;21912;28444;86225;42504;43721;12268;6277;5991;5511;3247;2264;15551;6937;8614;29347;12312;17035;23548;13731;9817;6625.0;3738.0;5119.0;4448.0;25500.0;23799.0;9
1578;Utrecht (GA);2020;499128;116912;308587;73629;360801;51211;22305;28906;87116;42607;44509;12344;6262;6082;5685;3330;2355;15627;6891;8736;29274;12207;17067;24186;13917;10269;6573.0;3873.0;5129.0;4445.0;26074.0;23947.0;9
1579;Utrecht (GA);2021;504702;117940;310976;75786;364295;52221;22842;29379;88186;42882;45304;12434;6267;6167;5864;3461;2403;15768;6882;8886;29180;12079;17101;24940;14193;10747;6638.0;3920.0;5120.0;4499.0;26358.0;24238.0;9
1580;Utrecht (GA);2022;510235;118923;313203;78109;367711;53215;23313;29902;89309;43061;46248;12535;6256;6279;6043;3560;2483;15917;6876;9041;29167;11971;17196;25647;14398;11249;6658.0;4008.0;5282.0;4493.0;26063.0;24507.0;9
1581;Utrecht (GA);2023;515291;119523;315284;80484;370826;54029;23667;30362;90436;43480;46956;12640;6284;6356;6283;3709;2574;15956;6834;9122;29148;11926;17222;26409;14727;11682;6639.0;4100.0;5212.0;4465.0;26598.0;24696.0;9
1582;Utrecht (GA);2024;520553;120099;317478;82976;374203;54969;24165;30804;91381;43752;47629;12672;6268;6404;6455;3817;2638;16102;6811;9291;29044;11805;17239;27108;15051;12057;6605.0;4260.0;5227.0;4459.0;27080.0;25003.0;9
1583;Utrecht (GA);2025;525817;120751;319704;85362;377511;55856;24737;31119;92450;43963;48487;12740;6241;6499;6587;3895;2692;16250;6783;9467;28970;11703;17267;27903;15341;12562;;;;;;;9
1584;Amsterdam (GA);2008;1033951;224324;678275;131352;602005;141267;74661;66606;290679;170135;120544;75322;43669;31653;13265;8217;5048;49649;27006;22643;67743;34658;33085;84700;56585;28115;13227.0;8220.0;17746.0;17152.0;41039.0;39565.0;10
1585;Amsterdam (GA);2009;1041159;226091;680865;134203;606290;144528;76981;67547;290341;167908;122433;74242;42614;31628;13406;8291;5115;49661;26618;23043;67689;33941;33748;85343;56444;28899;13280.0;8333.0;18511.0;17094.0;41730.0;39860.0;10
1586;Amsterdam (GA);2010;1049531;228393;683581;137557;611155;148193;79631;68562;290183;165901;124282;73183;41655;31528;13605;8388;5217;49721;26191;23530;67666;33368;34298;86008;56299;29709;13320.0;8409.0;19217.0;17015.0;40036.0;39950.0;10
1587;Amsterdam (GA);2011;1056872;229911;687177;139784;614839;151816;82279;69537;290217;164083;126134;72454;40882;31572;13861;8513;5348;49717;25816;23901;67659;32798;34861;86526;56074;30452;13329.0;8511.0;19768.0;16839.0;39058.0;40160.0;10
1588;Amsterdam (GA);2012;1063633;231074;686240;146319;617931;155485;84954;70531;290217;162351;127866;71622;40111;31511;14121;8668;5453;49800;25459;24341;67767;32365;35402;86907;55748;31159;13312.0;8622.0;19800.0;16866.0;39130.0;39904.0;10
1589;Amsterdam (GA);2013;1070598;232422;686199;151977;621277;159036;87502;71534;290285;160729;129556;70820;39358;31462;14369;8768;5601;49799;25176;24623;67879;31940;35939;87418;55487;31931;13239.0;8693.0;19958.0;16745.0;39215.0;39997.0;10
1590;Amsterdam (GA);2014;1077701;234189;686676;156836;624793;162572;90064;72508;290336;159120;131216;70135;38701;31434;14572;8853;5719;49753;24890;24863;67884;31443;36441;87992;55233;32759;13270.0;8796.0;19971.0;16678.0;38821.0;39809.0;10
1591;Amsterdam (GA);2015;1084585;235747;687620;161218;628024;166109;92532;73577;290452;157577;132875;69527;38092;31435;14794;8927;5867;49792;24619;25173;67907;30997;36910;88432;54942;33490;13281.0;8918.0;20069.0;16602.0;38668.0;39503.0;10
1592;Amsterdam (GA);2016;1091702;237318;688708;165676;631586;169666;94879;74787;290450;156001;134449;68871;37406;31465;15028;9028;6000;49784;24324;25460;67856;30592;37264;88911;54651;34260;13382.0;9066.0;19937.0;16514.0;38463.0;40010.0;10
1593;Amsterdam (GA);2017;1097995;238546;690025;169424;634686;172769;96980;75789;290540;154688;135852;68192;36820;31372;15267;9142;6125;49774;24079;25695;67800;30222;37578;89507;54425;35082;13438.0;9185.0;20052.0;16390.0;38349.0;39862.0;10
1594;Amsterdam (GA);2018;1104515;239605;691208;173702;637704;176395;99288;77107;290416;153242;137174;67481;36187;31294;15473;9218;6255;49702;23865;25837;67734;29887;37847;90026;54085;35941;13457.0;9267.0;20044.0;16383.0;38362.0;40099.0;10
1595;Amsterdam (GA);2019;1110745;240270;692751;177724;640637;179610;101444;78166;290498;152070;138428;66826;35575;31251;15701;9317;6384;49720;23661;26059;67628;29536;38092;90623;53981;36642;13564.0;9345.0;20003.0;16296.0;38502.0;40162.0;10
1596;Amsterdam (GA);2020;1117140;241114;694308;181718;643627;182875;103493;79382;290638;150826;139812;66148;34967;31181;15910;9394;6516;49716;23437;26279;67561;29193;38368;91303;53835;37468;13675.0;9535.0;20080.0;16229.0;38118.0;40229.0;10
1597;Amsterdam (GA);2021;1123132;241548;695773;185811;646522;186162;105602;80560;290448;149559;140889;65475;34351;31124;16084;9443;6641;49693;23258;26435;67313;28855;38458;91883;53652;38231;13709.0;9688.0;20107.0;16124.0;37507.0;40597.0;10
1598;Amsterdam (GA);2022;1128156;241444;696591;190121;648311;189278;107617;81661;290567;148532;142035;64921;33741;31180;16319;9554;6765;49555;23025;26530;67093;28573;38520;92679;53639;39040;13782.0;9847.0;20016.0;16028.0;37600.0;40462.0;10
1599;Amsterdam (GA);2023;1133318;241623;697432;194263;650306;192463;109574;82889;290549;147376;143173;64355;33186;31169;16555;9609;6946;49541;22814;26727;66683;28223;38460;93415;53544;39871;13798.0;9991.0;20134.0;15908.0;38367.0;41147.0;10
1600;Amsterdam (GA);2024;1138675;241492;698584;198599;652209;195590;111482;84108;290876;146407;144469;63858;32605;31253;16827;9724;7103;49503;22626;26877;66483;27950;38533;94205;53502;40703;13953.0;10182.0;20017.0;15844.0;37765.0;41267.0;10
1601;Amsterdam (GA);2025;1143244;241479;698813;202952;653491;198606;113278;85328;291147;145389;145758;63285;31989;31296;17002;9766;7236;49509;22434;27075;66204;27642;38562;95147;53558;41589;;;;;;;10
1602;Haarlem (GA);2008;188281;42540;114339;31402;146294;20890;8109;12781;21097;11916;9181;2371;1185;1186;1109;558;551;6090;3252;2838;4481;2407;2074;7046;4514;2532;2045.0;1823.0;1531.0;1491.0;8930.0;9242.0;11
1603;Haarlem (GA);2009;188262;42474;114273;31515;145749;21082;8239;12843;21431;12007;9424;2448;1194;1254;1144;589;555;6033;3242;2791;4516;2372;2144;7290;4610;2680;2017.0;1838.0;1610.0;1495.0;9102.0;9318.0;11
1604;Haarlem (GA);2010;188361;42373;114242;31746;145343;21228;8408;12820;21790;12136;9654;2502;1210;1292;1179;636;543;5996;3198;2798;4605;2353;2252;7508;4739;2769;1976.0;1822.0;1711.0;1486.0;8514.0;9280.0;11
1605;Haarlem (GA);2011;187996;42016;114231;31749;144586;21411;8607;12804;21999;12207;9792;2557;1232;1325;1224;670;554;5917;3158;2759;4636;2344;2292;7665;4803;2862;1946.0;1828.0;1727.0;1459.0;9001.0;9321.0;11
1606;Haarlem (GA);2012;188087;41859;113400;32828;144195;21598;8767;12831;22294;12275;10019;2606;1239;1367;1262;694;568;5859;3129;2730;4690;2329;2361;7877;4884;2993;1894.0;1801.0;1726.0;1431.0;8775.0;9382.0;11
1607;Haarlem (GA);2013;187893;41618;112426;33849;143587;21733;8955;12778;22573;12390;10183;2678;1267;1411;1327;734;593;5792;3092;2700;4735;2337;2398;8041;4960;3081;1859.0;1840.0;1729.0;1443.0;8870.0;9350.0;11
1608;Haarlem (GA);2014;187743;41204;111978;34561;143027;21859;9121;12738;22857;12479;10378;2747;1309;1438;1362;749;613;5745;3074;2671;4784;2340;2444;8219;5007;3212;1822.0;1822.0;1723.0;1378.0;8787.0;9274.0;11
1609;Haarlem (GA);2015;187623;40995;111411;35217;142500;22092;9321;12771;23031;12553;10478;2771;1329;1442;1397;779;618;5708;3058;2650;4831;2337;2494;8324;5050;3274;1817.0;1829.0;1717.0;1392.0;9178.0;9234.0;11
1610;Haarlem (GA);2016;187904;40837;111337;35730;142293;22306;9482;12824;23305;12649;10656;2833;1337;1496;1429;807;622;5682;3041;2641;4878;2346;2532;8483;5118;3365;1798.0;1843.0;1672.0;1383.0;9193.0;9276.0;11
1611;Haarlem (GA);2017;188086;40724;111244;36118;141901;22625;9763;12862;23560;12689;10871;2864;1345;1519;1497;837;660;5650;3008;2642;4884;2305;2579;8665;5194;3471;1816.0;1852.0;1718.0;1365.0;9104.0;9291.0;11
1612;Haarlem (GA);2018;188230;40522;111242;36466;141553;22875;9978;12897;23802;12821;10981;2888;1355;1533;1583;885;698;5592;3003;2589;4911;2314;2597;8828;5264;3564;1809.0;1845.0;1733.0;1374.0;9279.0;9295.0;11
1613;Haarlem (GA);2019;188559;40313;111326;36920;141290;23246;10222;13024;24023;12945;11078;2909;1362;1547;1644;931;713;5576;2979;2597;4916;2330;2586;8978;5343;3635;1835.0;1853.0;1689.0;1369.0;9268.0;9486.0;11
1614;Haarlem (GA);2020;188657;39965;111325;37367;140963;23493;10418;13075;24201;13030;11171;2918;1357;1561;1700;968;732;5550;2965;2585;4903;2323;2580;9130;5417;3713;1827.0;1863.0;1713.0;1347.0;9251.0;9455.0;11
1615;Haarlem (GA);2021;188801;39691;111245;37865;140694;23634;10571;13063;24473;13138;11335;2992;1393;1599;1762;1003;759;5509;2923;2586;4897;2318;2579;9313;5501;3812;1820.0;1861.0;1677.0;1353.0;9349.0;9459.0;11
1616;Haarlem (GA);2022;188994;39395;111277;38322;140511;23849;10726;13123;24634;13219;11415;3020;1386;1634;1798;1019;779;5440;2873;2567;4886;2325;2561;9490;5616;3874;1824.0;1876.0;1659.0;1339.0;9533.0;9498.0;11
1617;Haarlem (GA);2023;189321;39152;111303;38866;140305;24105;10939;13166;24911;13346;11565;3037;1380;1657;1854;1047;807;5451;2879;2572;4916;2330;2586;9653;5710;3943;1797.0;1872.0;1681.0;1357.0;9431.0;9619.0;11
1618;Haarlem (GA);2024;189404;38783;111166;39455;139932;24370;11108;13262;25102;13453;11649;3066;1402;1664;1891;1069;822;5427;2860;2567;4904;2327;2577;9814;5795;4019;1793.0;1902.0;1632.0;1331.0;9202.0;9573.0;11
1619;Haarlem (GA);2025;189249;38411;110723;40115;139487;24558;11248;13310;25204;13523;11681;3092;1417;1675;1954;1102;852;5386;2839;2547;4868;2321;2547;9904;5844;4060;;;;;;;11
1620;Leiden (GA);2008;249291;58963;156046;34282;199043;25360;12079;13281;24888;14787;10101;3228;1732;1496;1790;1008;782;3567;1893;1674;5999;3139;2860;10304;7015;3289;2832.0;1944.0;2699.0;2493.0;10401.0;11712.0;12
1621;Leiden (GA);2009;249106;58617;155485;35004;198388;25483;12173;13310;25235;14885;10350;3304;1759;1545;1799;1011;788;3699;1932;1767;6031;3137;2894;10402;7046;3356;2830.0;1975.0;2774.0;2460.0;10114.0;11752.0;12
1622;Leiden (GA);2010;248670;57993;154794;35883;197465;25723;12391;13332;25482;14932;10550;3355;1768;1587;1770;1012;758;3802;1953;1849;6059;3125;2934;10496;7074;3422;2807.0;1993.0;2874.0;2440.0;10600.0;11621.0;12
1623;Leiden (GA);2011;248927;57455;155093;36379;197082;26069;12596;13473;25776;15031;10745;3389;1773;1616;1793;1043;750;3889;1998;1891;6056;3089;2967;10649;7128;3521;2799.0;2016.0;2929.0;2402.0;10031.0;11531.0;12
1624;Leiden (GA);2012;248770;56777;153792;38201;196336;26302;12757;13545;26132;15198;10934;3452;1800;1652;1879;1114;765;3950;2027;1923;6092;3071;3021;10759;7186;3573;2797.0;2026.0;2953.0;2387.0;10286.0;11359.0;12
1625;Leiden (GA);2013;249061;56359;153015;39687;195917;26586;12945;13641;26558;15320;11238;3519;1845;1674;1965;1159;806;4054;2078;1976;6156;3036;3120;10864;7202;3662;2762.0;2058.0;2972.0;2370.0;10347.0;11276.0;12
1626;Leiden (GA);2014;249473;56008;152488;40977;195641;26913;13147;13766;26919;15478;11441;3536;1840;1696;1996;1197;799;4173;2142;2031;6209;3041;3168;11005;7258;3747;2774.0;2095.0;2924.0;2352.0;10101.0;11050.0;12
1627;Leiden (GA);2015;249803;55649;152055;42099;195245;27263;13385;13878;27295;15600;11695;3567;1843;1724;2064;1225;839;4249;2162;2087;6248;3035;3213;11167;7335;3832;2746.0;2121.0;2919.0;2322.0;10206.0;11149.0;12
1628;Leiden (GA);2016;250108;55337;151631;43140;194842;27587;13582;14005;27679;15753;11926;3625;1862;1763;2093;1256;837;4304;2163;2141;6293;3040;3253;11364;7432;3932;2770.0;2132.0;2878.0;2304.0;10561.0;11102.0;12
1629;Leiden (GA);2017;250806;55233;151388;44185;194816;27871;13773;14098;28119;15951;12168;3706;1902;1804;2174;1312;862;4396;2183;2213;6283;3029;3254;11560;7525;4035;2761.0;2173.0;2875.0;2278.0;10320.0;11051.0;12
1630;Leiden (GA);2018;251296;55106;150874;45316;194694;28195;14030;14165;28407;16058;12349;3721;1916;1805;2210;1344;866;4484;2205;2279;6291;3007;3284;11701;7586;4115;2744.0;2227.0;2885.0;2243.0;10301.0;11063.0;12
1631;Leiden (GA);2019;251723;54722;150726;46275;194544;28507;14279;14228;28672;16182;12490;3751;1909;1842;2239;1348;891;4508;2246;2262;6302;2987;3315;11872;7692;4180;2738.0;2234.0;2879.0;2221.0;10461.0;11149.0;12
1632;Leiden (GA);2020;252234;54412;150473;47349;194350;28829;14524;14305;29055;16366;12689;3780;1928;1852;2308;1390;918;4628;2294;2334;6278;2982;3296;12061;7772;4289;2736.0;2268.0;2841.0;2214.0;10286.0;11107.0;12
1633;Leiden (GA);2021;252539;54092;150175;48272;194020;29174;14764;14410;29345;16520;12825;3814;1939;1875;2355;1424;931;4704;2340;2364;6296;2971;3325;12176;7846;4330;2729.0;2321.0;2869.0;2202.0;10361.0;11130.0;12
1634;Leiden (GA);2022;252879;53784;149729;49366;193691;29442;14975;14467;29746;16684;13062;3832;1963;1869;2420;1477;943;4750;2348;2402;6344;2977;3367;12400;7919;4481;2721.0;2354.0;2850.0;2158.0;10453.0;11077.0;12
1635;Leiden (GA);2023;253359;53515;149434;50410;193432;29830;15240;14590;30097;16847;13250;3845;1975;1870;2455;1492;963;4883;2400;2483;6354;2978;3376;12560;8002;4558;2699.0;2383.0;2860.0;2156.0;10521.0;11184.0;12
1636;Leiden (GA);2024;253748;53228;149024;51496;193024;30271;15493;14778;30453;16971;13482;3914;1995;1919;2544;1525;1019;4902;2423;2479;6323;2957;3366;12770;8071;4699;2659.0;2428.0;2837.0;2142.0;10323.0;11119.0;12
1637;Leiden (GA);2025;253923;53044;148390;52489;192464;30546;15708;14838;30913;17239;13674;3934;2029;1905;2598;1550;1048;4985;2445;2540;6362;2995;3367;13034;8220;4814;;;;;;;12
1638;'s-Gravenhage (GA);2008;624357;142439;387618;94300;369670;87317;46625;40692;167370;101673;65697;48073;28977;19096;12083;8363;3720;33194;18323;14871;27122;13872;13250;46898;32138;14760;7766.0;5953.0;11636.0;10023.0;26355.0;27416.0;13
1639;'s-Gravenhage (GA);2009;626799;143376;388584;94839;369837;89619;48502;41117;167343;100009;67334;47476;28375;19101;12033;8210;3823;33121;17818;15303;27490;13713;13777;47223;31893;15330;7733.0;5902.0;12140.0;9932.0;25148.0;27409.0;13
1640;'s-Gravenhage (GA);2010;628641;143706;389032;95903;369455;91966;50408;41558;167220;98562;68658;46796;27852;18944;12121;8204;3917;33095;17374;15721;27848;13608;14240;47360;31524;15836;7686.0;5954.0;12677.0;9875.0;25059.0;27012.0;13
1641;'s-Gravenhage (GA);2011;631295;144000;391161;96134;369413;94540;52470;42070;167342;97340;70002;46188;27357;18831;12194;8195;3999;33159;17076;16083;28273;13545;14728;47528;31167;16361;7716.0;5983.0;12944.0;9801.0;25316.0;27042.0;13
1642;'s-Gravenhage (GA);2012;634500;144568;390092;99840;369869;97223;54620;42603;167408;96095;71313;45607;26861;18746;12201;8134;4067;33237;16792;16445;28559;13457;15102;47804;30851;16953;7714.0;5947.0;13105.0;9722.0;24445.0;26417.0;13
1643;'s-Gravenhage (GA);2013;637731;145051;389932;102748;370065;100115;56767;43348;167551;95127;72424;45090;26455;18635;12208;8144;4064;33344;16535;16809;28864;13405;15459;48045;30588;17457;7724.0;5944.0;13209.0;9739.0;23783.0;26160.0;13
1644;'s-Gravenhage (GA);2014;640670;145313;390204;105153;370013;102964;58861;44103;167693;94152;73541;44546;26031;18515;12276;8119;4157;33412;16302;17110;29166;13314;15852;48293;30386;17907;7795.0;5966.0;13333.0;9729.0;23312.0;26064.0;13
1645;'s-Gravenhage (GA);2015;643417;145664;390453;107300;370053;105726;60823;44903;167638;93272;74366;43984;25597;18387;12331;8135;4196;33430;16156;17274;29453;13275;16178;48440;30109;18331;7877.0;6007.0;13370.0;9641.0;22847.0;25677.0;13
1646;'s-Gravenhage (GA);2016;646243;146341;390656;109246;369891;108542;62798;45744;167810;92525;75285;43410;25179;18231;12495;8177;4318;33412;15998;17414;29771;13249;16522;48722;29922;18800;7953.0;6014.0;13391.0;9607.0;22374.0;25799.0;13
1647;'s-Gravenhage (GA);2017;648595;146803;390708;111084;369621;111259;64659;46600;167715;91686;76029;42880;24775;18105;12504;8114;4390;33297;15823;17474;30000;13212;16788;49034;29762;19272;8038.0;6009.0;13404.0;9573.0;22610.0;25582.0;13
1648;'s-Gravenhage (GA);2018;651538;147308;391221;113009;369555;114158;66556;47602;167825;91055;76770;42345;24366;17979;12574;8121;4453;33302;15694;17608;30252;13207;17045;49352;29667;19685;8062.0;6043.0;13467.0;9525.0;22271.0;25799.0;13
1649;'s-Gravenhage (GA);2019;654035;147379;391554;115102;369519;116916;68321;48595;167600;90264;77336;41798;23991;17807;12608;8091;4517;33262;15575;17687;30431;13165;17266;49501;29442;20059;8203.0;6076.0;13540.0;9545.0;21473.0;25639.0;13
1650;'s-Gravenhage (GA);2020;656046;147340;391448;117258;369043;119624;70087;49537;167379;89485;77894;41295;23608;17687;12692;8131;4561;33131;15379;17752;30584;13122;17462;49677;29245;20432;8227.0;6124.0;13536.0;9496.0;21617.0;25763.0;13
1651;'s-Gravenhage (GA);2021;658084;147044;391770;119270;368322;122471;71828;50643;167291;88901;78390;40807;23258;17549;12725;8096;4629;33121;15301;17820;30738;13089;17649;49900;29157;20743;8161.0;6219.0;13636.0;9365.0;21878.0;26084.0;13
1652;'s-Gravenhage (GA);2022;660131;146559;392256;121316;367745;125310;73596;51714;167076;88308;78768;40264;22887;17377;12851;8134;4717;33014;15172;17842;30766;13027;17739;50181;29088;21093;8224.0;6234.0;13649.0;9366.0;21974.0;26119.0;13
1653;'s-Gravenhage (GA);2023;662311;146161;392656;123494;367114;128190;75379;52811;167007;87823;79184;39876;22560;17316;12845;8116;4729;32901;15063;17838;30795;13022;17773;50590;29062;21528;8221.0;6345.0;13677.0;9315.0;22011.0;26422.0;13
1654;'s-Gravenhage (GA);2024;664197;145585;393191;125421;366328;130935;77121;53814;166934;87265;79669;39392;22181;17211;12844;8094;4750;32839;14977;17862;30888;12950;17938;50971;29063;21908;8242.0;6392.0;13743.0;9277.0;22245.0;26495.0;13
1655;'s-Gravenhage (GA);2025;666307;145081;393813;127413;365603;133869;78902;54967;166835;86748;80087;38990;21825;17165;12857;8033;4824;32645;14855;17790;30935;12922;18013;51408;29113;22295;;;;;;;13
1656;Rotterdam (GA);2008;987999;228783;613595;145621;633855;92130;43494;48636;262014;149118;112896;62955;35953;27002;25065;16331;8734;59989;30538;29451;43181;21297;21884;70824;44999;25825;11607.0;9342.0;9031.0;13277.0;40573.0;40415.0;14
1657;Rotterdam (GA);2009;986311;227451;611998;146862;634147;92385;43286;49099;259779;145690;114089;62123;35138;26985;24669;15771;8898;59471;29952;29519;43486;21041;22445;70030;43788;26242;11510.0;9389.0;9254.0;12901.0;41250.0;39973.0;14
1658;Rotterdam (GA);2010;986183;226517;611156;148510;635219;92820;43243;49577;258144;142839;115305;61343;34416;26927;24452;15349;9103;59045;29444;29601;43754;20778;22976;69550;42852;26698;11420.0;9382.0;9446.0;12624.0;39645.0;39450.0;14
1659;Rotterdam (GA);2011;985335;225003;611326;149006;635683;93258;43332;49926;256394;139994;116400;60584;33807;26777;24303;14990;9313;58575;28856;29719;43974;20533;23441;68958;41808;27150;11399.0;9410.0;9434.0;12289.0;38955.0;39082.0;14
1660;Rotterdam (GA);2012;984454;223374;606267;154813;635829;93756;43411;50345;254869;137329;117540;59819;33174;26645;24107;14637;9470;58212;28345;29867;44251;20331;23920;68480;40842;27638;11303.0;9413.0;9451.0;11926.0;39537.0;38730.0;14
1661;Rotterdam (GA);2013;984778;222189;602896;159693;636892;94332;43603;50729;253554;135165;118389;59056;32554;26502;23999;14396;9603;57804;27956;29848;44475;20168;24307;68220;40091;28129;11232.0;9434.0;9335.0;11715.0;38437.0;38313.0;14
1662;Rotterdam (GA);2014;984415;221037;599785;163593;637372;94909;43633;51276;252134;132979;119155;58339;31963;26376;23882;14156;9726;57322;27542;29780;44637;19969;24668;67954;39349;28605;11317.0;9500.0;9247.0;11466.0;38907.0;38260.0;14
1663;Rotterdam (GA);2015;984765;220427;597687;166651;638263;95491;43850;51641;251011;130960;120051;57665;31436;26229;23835;13900;9935;56845;27104;29741;44823;19811;25012;67843;38709;29134;11211.0;9479.0;9059.0;11213.0;38648.0;37987.0;14
1664;Rotterdam (GA);2016;985105;219830;595782;169493;639143;96212;44141;52071;249750;129143;120607;56963;30926;26037;23709;13683;10026;56407;26722;29685;44914;19640;25274;67757;38172;29585;11256.0;9547.0;8978.0;11017.0;39121.0;38226.0;14
1665;Rotterdam (GA);2017;985764;219577;593863;172324;640102;96797;44286;52511;248865;127570;121295;56289;30370;25919;23609;13458;10151;55924;26378;29546;45049;19528;25521;67994;37836;30158;11309.0;9575.0;8815.0;10797.0;38641.0;38005.0;14
1666;Rotterdam (GA);2018;986243;218985;592075;175183;640961;97537;44559;52978;247745;125925;121820;55633;29853;25780;23397;13212;10185;55516;26034;29482;45127;19386;25741;68072;37440;30632;11318.0;9616.0;8828.0;10717.0;38452.0;38117.0;14
1667;Rotterdam (GA);2019;986500;218439;590086;177975;641428;98179;44809;53370;246893;124422;122471;55035;29376;25659;23268;13007;10261;55016;25650;29366;45239;19264;25975;68335;37125;31210;11389.0;9748.0;8721.0;10502.0;39177.0;37997.0;14
1668;Rotterdam (GA);2020;987621;218254;588626;180741;642336;98978;45093;53885;246307;123007;123300;54447;28909;25538;23169;12802;10367;54727;25327;29400;45288;19127;26161;68676;36842;31834;11518.0;9780.0;8536.0;10323.0;38748.0;37921.0;14
1669;Rotterdam (GA);2021;988490;217561;587055;183874;642916;99762;45339;54423;245812;121733;124079;53775;28370;25405;23173;12658;10515;54308;24994;29314;45412;19002;26410;69144;36709;32435;11526.0;9829.0;8545.0;10230.0;39025.0;38407.0;14
1670;Rotterdam (GA);2022;989213;217280;585401;186532;643339;100580;45696;54884;245294;120409;124885;53139;27878;25261;23082;12447;10635;54067;24704;29363;45424;18829;26595;69582;36551;33031;11617.0;9930.0;8459.0;10019.0;38758.0;38212.0;14
1671;Rotterdam (GA);2023;989984;216997;583533;189454;643698;101423;46012;55411;244863;119161;125702;52485;27420;25065;23000;12265;10735;53918;24451;29467;45508;18738;26770;69952;36287;33665;11651.0;10013.0;8345.0;9918.0;38812.0;38343.0;14
1672;Rotterdam (GA);2024;990619;216754;581395;192470;643892;102280;46365;55915;244447;118023;126424;51773;26885;24888;23013;12187;10826;53581;24127;29454;45587;18614;26973;70493;36210;34283;11665.0;10146.0;8254.0;9798.0;38399.0;38448.0;14
1673;Rotterdam (GA);2025;990649;216615;578347;195687;643554;103110;46639;56471;243985;116858;127127;51193;26408;24785;22954;12037;10917;53275;23831;29444;45569;18464;27105;70994;36118;34876;;;;;;;14
1674;Dordrecht (GA);2008;235524;57486;141605;36433;188050;19019;7623;11396;28455;16077;12378;3921;2140;1781;3898;2475;1423;8181;4086;4095;4018;1986;2032;8437;5390;3047;2623.0;2103.0;1023.0;1347.0;7714.0;7972.0;15
1675;Dordrecht (GA);2009;235507;57265;141197;37045;187671;19118;7667;11451;28718;16041;12677;3938;2110;1828;3886;2437;1449;8173;4066;4107;4175;2072;2103;8546;5356;3190;2606.0;2104.0;1129.0;1309.0;7543.0;7967.0;15
1676;Dordrecht (GA);2010;235426;56900;140730;37796;187205;19157;7704;11453;29064;16101;12963;3998;2124;1874;3899;2421;1478;8135;4047;4088;4322;2122;2200;8710;5387;3323;2567.0;2129.0;1157.0;1292.0;7494.0;7765.0;15
1677;Dordrecht (GA);2011;235480;56587;140664;38229;186873;19243;7776;11467;29364;16128;13236;4059;2118;1941;3879;2395;1484;8110;4038;4072;4473;2187;2286;8843;5390;3453;2521.0;2149.0;1165.0;1267.0;7798.0;7806.0;15
1678;Dordrecht (GA);2012;235765;56198;139599;39968;186774;19266;7790;11476;29725;16173;13552;4117;2140;1977;3916;2364;1552;8108;4044;4064;4598;2221;2377;8986;5404;3582;2517.0;2182.0;1189.0;1236.0;7803.0;7751.0;15
1679;Dordrecht (GA);2013;236131;55833;138857;41441;186647;19414;7879;11535;30070;16249;13821;4149;2157;1992;3914;2341;1573;8122;4046;4076;4773;2284;2489;9112;5421;3691;2497.0;2196.0;1157.0;1233.0;7526.0;7646.0;15
1680;Dordrecht (GA);2014;236257;55571;138134;42552;186289;19572;7921;11651;30396;16330;14066;4181;2164;2017;3950;2342;1608;8101;4033;4068;4905;2351;2554;9259;5440;3819;2481.0;2186.0;1136.0;1228.0;7702.0;7666.0;15
1681;Dordrecht (GA);2015;236523;55174;137815;43534;186236;19659;8007;11652;30628;16311;14317;4204;2157;2047;3953;2308;1645;8045;4023;4022;4997;2373;2624;9429;5450;3979;2473.0;2219.0;1148.0;1206.0;7618.0;7539.0;15
1682;Dordrecht (GA);2016;236820;54883;137514;44423;186104;19800;8085;11715;30916;16279;14637;4255;2130;2125;3947;2286;1661;7984;3983;4001;5171;2414;2757;9559;5466;4093;2484.0;2238.0;1120.0;1189.0;7191.0;7569.0;15
1683;Dordrecht (GA);2017;236639;54574;136908;45157;185576;19966;8175;11791;31097;16250;14847;4267;2121;2146;3983;2285;1698;7963;3974;3989;5253;2446;2807;9631;5424;4207;2487.0;2271.0;1142.0;1171.0;7160.0;7526.0;15
1684;Dordrecht (GA);2018;236489;54324;136271;45894;184978;20093;8219;11874;31418;16314;15104;4305;2122;2183;3990;2260;1730;7963;3975;3988;5351;2482;2869;9809;5475;4334;2480.0;2298.0;1106.0;1150.0;7424.0;7565.0;15
1685;Dordrecht (GA);2019;236510;53783;136179;46548;184653;20197;8282;11915;31660;16370;15290;4317;2111;2206;4007;2259;1748;7944;3944;4000;5471;2518;2953;9921;5538;4383;2498.0;2302.0;1092.0;1118.0;6992.0;7515.0;15
1686;Dordrecht (GA);2020;236184;53412;135494;47278;184183;20251;8349;11902;31750;16375;15375;4320;2103;2217;3999;2226;1773;7886;3930;3956;5487;2526;2961;10058;5590;4468;2476.0;2331.0;1107.0;1120.0;7105.0;7590.0;15
1687;Dordrecht (GA);2021;235856;52816;135058;47982;183592;20333;8424;11909;31931;16459;15472;4324;2117;2207;4044;2239;1805;7807;3900;3907;5576;2563;3013;10180;5640;4540;2491.0;2361.0;1100.0;1107.0;7389.0;7658.0;15
1688;Dordrecht (GA);2022;235734;52445;134523;48766;183164;20441;8500;11941;32129;16555;15574;4366;2152;2214;4040;2223;1817;7766;3884;3882;5664;2609;3055;10293;5687;4606;2514.0;2392.0;1094.0;1083.0;7316.0;7526.0;15
1689;Dordrecht (GA);2023;235677;51999;134197;49481;182847;20487;8546;11941;32343;16625;15718;4375;2145;2230;4052;2225;1827;7741;3862;3879;5725;2628;3097;10450;5765;4685;2524.0;2403.0;1062.0;1077.0;7184.0;7493.0;15
1690;Dordrecht (GA);2024;235493;51604;133630;50259;182433;20629;8613;12016;32431;16601;15830;4409;2153;2256;4043;2213;1830;7722;3850;3872;5743;2629;3114;10514;5756;4758;2532.0;2436.0;1085.0;1047.0;7413.0;7615.0;15
1691;Dordrecht (GA);2025;235456;51397;132994;51065;182045;20799;8731;12068;32612;16689;15923;4444;2173;2271;4063;2213;1850;7690;3856;3834;5785;2664;3121;10630;5783;4847;;;;;;;15
1692;Breda (GA);2008;171982;39977;106149;25856;136770;17195;6518;10677;18017;9875;8142;2162;1117;1045;2057;1171;886;3021;1467;1554;5126;2442;2684;5651;3678;1973;2050.0;1586.0;1437.0;1761.0;4754.0;4194.0;16
1693;Breda (GA);2009;172705;40275;106299;26131;137034;17288;6607;10681;18383;9963;8420;2241;1159;1082;2089;1191;898;3084;1474;1610;5251;2447;2804;5718;3692;2026;2062.0;1593.0;1503.0;1761.0;4742.0;4225.0;16
1694;Breda (GA);2010;173467;40484;106515;26468;137296;17434;6721;10713;18737;10114;8623;2310;1194;1116;2106;1212;894;3143;1500;1643;5366;2476;2890;5812;3732;2080;2073.0;1608.0;1556.0;1714.0;4883.0;4227.0;16
1695;Breda (GA);2011;174449;40713;106922;26814;137721;17591;6842;10749;19137;10180;8957;2388;1225;1163;2195;1260;935;3265;1521;1744;5428;2467;2961;5861;3707;2154;2079.0;1626.0;1599.0;1724.0;5125.0;4395.0;16
1696;Breda (GA);2012;175529;40917;107065;27547;138207;17816;6967;10849;19506;10227;9279;2462;1244;1218;2257;1292;965;3370;1546;1824;5507;2458;3049;5910;3687;2223;2091.0;1645.0;1626.0;1705.0;4935.0;4376.0;16
1697;Breda (GA);2013;176479;41068;107202;28209;138578;18036;7105;10931;19865;10289;9576;2531;1270;1261;2289;1308;981;3481;1575;1906;5595;2463;3132;5969;3673;2296;2086.0;1636.0;1609.0;1698.0;4949.0;4380.0;16
1698;Breda (GA);2014;177429;41193;107455;28781;138988;18224;7240;10984;20217;10348;9869;2607;1300;1307;2328;1334;994;3579;1607;1972;5688;2463;3225;6015;3644;2371;2123.0;1652.0;1605.0;1645.0;5101.0;4438.0;16
1699;Breda (GA);2015;178550;41459;107748;29343;139500;18365;7285;11080;20685;10537;10148;2682;1325;1357;2393;1386;1007;3659;1632;2027;5803;2482;3321;6148;3712;2436;2134.0;1667.0;1636.0;1635.0;4994.0;4451.0;16
1700;Breda (GA);2016;179587;41725;108015;29847;140001;18499;7397;11102;21087;10647;10440;2761;1349;1412;2470;1414;1056;3719;1651;2068;5831;2478;3353;6306;3755;2551;2153.0;1668.0;1634.0;1625.0;4855.0;4515.0;16
1701;Breda (GA);2017;180449;42103;108108;30238;140321;18687;7497;11190;21441;10728;10713;2826;1362;1464;2522;1442;1080;3816;1682;2134;5893;2472;3421;6384;3770;2614;2179.0;1687.0;1654.0;1610.0;4894.0;4507.0;16
1702;Breda (GA);2018;181395;42451;108174;30770;140638;18928;7640;11288;21829;10838;10991;2904;1382;1522;2576;1460;1116;3882;1699;2183;5946;2473;3473;6521;3824;2697;2159.0;1711.0;1628.0;1620.0;5114.0;4575.0;16
1703;Breda (GA);2019;182435;42746;108491;31198;141119;19128;7768;11360;22188;10951;11237;2969;1427;1542;2647;1497;1150;3932;1703;2229;6024;2486;3538;6616;3838;2778;2164.0;1723.0;1585.0;1601.0;5020.0;4602.0;16
1704;Breda (GA);2020;183302;42805;108818;31679;141522;19299;7910;11389;22481;11050;11431;3031;1458;1573;2713;1538;1175;3966;1704;2262;6060;2480;3580;6711;3870;2841;2155.0;1726.0;1563.0;1599.0;5070.0;4673.0;16
1705;Breda (GA);2021;184113;42856;109091;32166;141935;19440;7977;11463;22738;11156;11582;3113;1494;1619;2729;1555;1174;3969;1690;2279;6119;2508;3611;6808;3909;2899;2143.0;1748.0;1553.0;1569.0;4942.0;4698.0;16
1706;Breda (GA);2022;184761;42910;109203;32648;142189;19598;8070;11528;22974;11235;11739;3156;1518;1638;2753;1565;1188;4052;1739;2313;6138;2497;3641;6875;3916;2959;2108.0;1761.0;1589.0;1578.0;5253.0;4719.0;16
1707;Breda (GA);2023;185679;42923;109617;33139;142663;19769;8238;11531;23247;11343;11904;3239;1552;1687;2792;1591;1201;4066;1745;2321;6174;2496;3678;6976;3959;3017;2097.0;1790.0;1596.0;1567.0;4737.0;4761.0;16
1708;Breda (GA);2024;186027;42939;109389;33699;142671;19921;8340;11581;23435;11424;12011;3298;1590;1708;2811;1598;1213;4093;1765;2328;6191;2493;3698;7042;3978;3064;2047.0;1800.0;1525.0;1546.0;5057.0;4755.0;16
1709;Breda (GA);2025;186587;42886;109440;34261;142818;20110;8463;11647;23659;11513;12146;3334;1589;1745;2859;1622;1237;4129;1768;2361;6200;2485;3715;7137;4049;3088;;;;;;;16
1710;Tilburg (GA);2008;224609;51761;142287;30561;178327;18215;7036;11179;28067;16056;12011;3443;1896;1547;3974;2583;1391;7547;3828;3719;5276;2577;2699;7827;5172;2655;2488.0;1855.0;1576.0;1909.0;7241.0;6836.0;17
1711;Tilburg (GA);2009;225357;52068;141855;31434;178678;18297;7102;11195;28382;16010;12372;3491;1905;1586;3958;2539;1419;7575;3781;3794;5407;2589;2818;7951;5196;2755;2485.0;1907.0;1690.0;1880.0;7044.0;6903.0;17
1712;Tilburg (GA);2010;225935;52274;141345;32316;178743;18467;7203;11264;28725;15981;12744;3605;1953;1652;3910;2506;1404;7605;3727;3878;5540;2610;2930;8065;5185;2880;2497.0;1960.0;1717.0;1850.0;7049.0;6785.0;17
1713;Tilburg (GA);2011;226637;52300;141039;33298;178987;18676;7359;11317;28974;15854;13120;3656;1964;1692;3928;2485;1443;7614;3667;3947;5659;2614;3045;8117;5124;2993;2488.0;2005.0;1760.0;1813.0;7178.0;6960.0;17
1714;Tilburg (GA);2012;227319;52475;140273;34571;179131;18865;7487;11378;29323;15835;13488;3750;2014;1736;3920;2456;1464;7630;3652;3978;5791;2629;3162;8232;5084;3148;2487.0;2033.0;1760.0;1788.0;7219.0;6905.0;17
1715;Tilburg (GA);2013;228091;52809;139492;35790;179370;19070;7625;11445;29651;15868;13783;3815;2034;1781;3954;2471;1483;7647;3635;4012;5873;2658;3215;8362;5070;3292;2499.0;2069.0;1789.0;1746.0;7304.0;6974.0;17
1716;Tilburg (GA);2014;228932;53084;138859;36989;179700;19232;7725;11507;30000;15875;14125;3866;2062;1804;3953;2446;1507;7675;3588;4087;5972;2672;3300;8534;5107;3427;2508.0;2099.0;1760.0;1719.0;7272.0;7043.0;17
1717;Tilburg (GA);2015;229634;53186;138314;38134;179905;19388;7854;11534;30341;15928;14413;3962;2106;1856;3971;2447;1524;7663;3545;4118;6096;2712;3384;8649;5118;3531;2496.0;2124.0;1759.0;1716.0;7430.0;7093.0;17
1718;Tilburg (GA);2016;230420;53423;137934;39063;180236;19483;7935;11548;30701;15967;14734;4027;2141;1886;4002;2438;1564;7724;3541;4183;6161;2715;3446;8787;5132;3655;2512.0;2187.0;1757.0;1669.0;7399.0;7024.0;17
1719;Tilburg (GA);2017;231239;53772;137596;39871;180592;19682;8074;11608;30965;16011;14954;4046;2151;1895;3992;2431;1561;7736;3522;4214;6258;2732;3526;8933;5175;3758;2532.0;2197.0;1730.0;1684.0;7437.0;7120.0;17
1720;Tilburg (GA);2018;231974;53948;137367;40659;180865;19823;8187;11636;31286;16117;15169;4104;2183;1921;4007;2423;1584;7773;3513;4260;6266;2718;3548;9136;5280;3856;2545.0;2232.0;1774.0;1658.0;7457.0;7120.0;17
1721;Tilburg (GA);2019;232778;54095;137101;41582;181202;19945;8293;11652;31631;16195;15436;4159;2214;1945;4038;2445;1593;7778;3498;4280;6316;2734;3582;9340;5304;4036;2542.0;2248.0;1705.0;1631.0;7438.0;7200.0;17
1722;Tilburg (GA);2020;233414;54205;136807;42402;181350;20118;8413;11705;31946;16298;15648;4233;2255;1978;4044;2443;1601;7797;3493;4304;6377;2731;3646;9495;5376;4119;2563.0;2308.0;1716.0;1639.0;7477.0;7226.0;17
1723;Tilburg (GA);2021;234031;54143;136776;43112;181521;20253;8496;11757;32257;16400;15857;4270;2279;1991;4051;2440;1611;7804;3473;4331;6444;2729;3715;9688;5479;4209;2564.0;2330.0;1697.0;1610.0;7512.0;7240.0;17
1724;Tilburg (GA);2022;234655;54142;136557;43956;181666;20436;8628;11808;32553;16513;16040;4287;2279;2008;4045;2424;1621;7784;3460;4324;6513;2764;3749;9924;5586;4338;2564.0;2374.0;1665.0;1611.0;7564.0;7286.0;17
1725;Tilburg (GA);2023;235206;54250;136198;44758;181728;20615;8738;11877;32863;16667;16196;4337;2311;2026;4053;2408;1645;7787;3467;4320;6517;2781;3736;10169;5700;4469;2590.0;2418.0;1692.0;1594.0;7570.0;7240.0;17
1726;Tilburg (GA);2024;235838;54293;135970;45575;181850;20765;8840;11925;33223;16804;16419;4381;2322;2059;4083;2418;1665;7785;3454;4331;6600;2815;3785;10374;5795;4579;2578.0;2426.0;1720.0;1594.0;7520.0;7351.0;17
1727;Tilburg (GA);2025;236325;54313;135651;46361;181824;20884;8941;11943;33617;16947;16670;4421;2332;2089;4092;2398;1694;7799;3464;4335;6667;2839;3828;10638;5914;4724;;;;;;;17
1728;'s-Hertogenbosch (GA);2008;161698;38071;101004;22623;133082;13903;5226;8677;14713;8265;6448;2025;1044;981;1014;558;456;2880;1500;1380;4239;2107;2132;4555;3056;1499;1888.0;1398.0;843.0;1126.0;6840.0;5976.0;18
1729;'s-Hertogenbosch (GA);2009;162796;38348;101451;22997;133722;14034;5314;8720;15040;8371;6669;2082;1055;1027;1041;566;475;2951;1524;1427;4263;2124;2139;4703;3102;1601;1887.0;1435.0;896.0;1116.0;7025.0;6088.0;18
1730;'s-Hertogenbosch (GA);2010;163981;38619;101876;23486;134409;14210;5417;8793;15362;8494;6868;2114;1066;1048;1041;560;481;3027;1559;1468;4329;2131;2198;4851;3178;1673;1875.0;1448.0;952.0;1128.0;7299.0;6216.0;18
1731;'s-Hertogenbosch (GA);2011;165341;38845;102467;24029;135204;14408;5531;8877;15729;8623;7106;2168;1082;1086;1065;573;492;3070;1569;1501;4409;2156;2253;5017;3243;1774;1842.0;1468.0;999.0;1122.0;7418.0;6350.0;18
1732;'s-Hertogenbosch (GA);2012;166679;39087;102674;24918;136069;14554;5644;8910;16056;8738;7318;2196;1095;1101;1101;597;504;3134;1595;1539;4452;2157;2295;5173;3294;1879;1857.0;1479.0;1004.0;1099.0;6780.0;6404.0;18
1733;'s-Hertogenbosch (GA);2013;167358;39145;102370;25843;136416;14600;5681;8919;16342;8873;7469;2261;1145;1116;1111;593;518;3132;1602;1530;4498;2168;2330;5340;3365;1975;1844.0;1514.0;971.0;1082.0;6951.0;6347.0;18
1734;'s-Hertogenbosch (GA);2014;168195;39221;102212;26762;136867;14671;5735;8936;16657;8972;7685;2312;1171;1141;1108;589;519;3193;1634;1559;4546;2160;2386;5498;3418;2080;1794.0;1558.0;977.0;1095.0;6917.0;6355.0;18
1735;'s-Hertogenbosch (GA);2015;168894;39236;102239;27419;137208;14804;5797;9007;16882;9050;7832;2332;1186;1146;1130;588;542;3216;1629;1587;4571;2170;2401;5633;3477;2156;1811.0;1560.0;997.0;1078.0;6699.0;6334.0;18
1736;'s-Hertogenbosch (GA);2016;169448;39269;102008;28171;137341;14959;5946;9013;17148;9150;7998;2377;1214;1163;1143;588;555;3257;1648;1609;4607;2179;2428;5764;3521;2243;1803.0;1583.0;987.0;1071.0;6869.0;6324.0;18
1737;'s-Hertogenbosch (GA);2017;170146;39229;102086;28831;137601;15149;6117;9032;17396;9278;8118;2416;1229;1187;1193;630;563;3255;1655;1600;4622;2179;2443;5910;3585;2325;1784.0;1617.0;962.0;1068.0;6905.0;6370.0;18
1738;'s-Hertogenbosch (GA);2018;170768;39232;101952;29584;137793;15309;6227;9082;17666;9478;8188;2459;1260;1199;1222;650;572;3269;1668;1601;4650;2215;2435;6066;3685;2381;1770.0;1633.0;974.0;1053.0;6865.0;6438.0;18
1739;'s-Hertogenbosch (GA);2019;171275;39232;101859;30184;137852;15480;6284;9196;17943;9587;8356;2505;1291;1214;1239;646;593;3310;1661;1649;4672;2216;2456;6217;3773;2444;1767.0;1650.0;957.0;1054.0;6931.0;6425.0;18
1740;'s-Hertogenbosch (GA);2020;171820;39078;101901;30841;138017;15632;6381;9251;18171;9692;8479;2543;1303;1240;1242;648;594;3322;1662;1660;4708;2244;2464;6356;3835;2521;1767.0;1663.0;966.0;1046.0;6996.0;6478.0;18
1741;'s-Hertogenbosch (GA);2021;172383;38886;102035;31462;138213;15796;6509;9287;18374;9801;8573;2551;1317;1234;1273;653;620;3351;1688;1663;4724;2257;2467;6475;3886;2589;1763.0;1708.0;948.0;1038.0;7009.0;6461.0;18
1742;'s-Hertogenbosch (GA);2022;172917;38725;102175;32017;138378;15891;6601;9290;18648;9944;8704;2580;1319;1261;1305;660;645;3383;1707;1676;4718;2265;2453;6662;3993;2669;1785.0;1701.0;971.0;1045.0;6907.0;6545.0;18
1743;'s-Hertogenbosch (GA);2023;173315;38563;102077;32675;138320;16063;6693;9370;18932;10087;8845;2608;1328;1280;1331;681;650;3417;1722;1695;4779;2284;2495;6797;4072;2725;1753.0;1736.0;936.0;1045.0;7011.0;6497.0;18
1744;'s-Hertogenbosch (GA);2024;173753;38379;102026;33348;138388;16150;6784;9366;19215;10192;9023;2662;1348;1314;1353;689;664;3432;1726;1706;4789;2271;2518;6979;4158;2821;1748.0;1759.0;969.0;1026.0;6656.0;6515.0;18
1745;'s-Hertogenbosch (GA);2025;173847;38095;101672;34080;138208;16295;6935;9360;19344;10303;9041;2706;1368;1338;1360;699;661;3460;1744;1716;4759;2251;2508;7059;4241;2818;;;;;;;18
1746;Eindhoven (GA);2008;324992;71918;201354;51720;252328;34960;14509;20451;37704;22509;15195;4437;2396;2041;2835;1727;1108;10001;5299;4702;6023;2886;3137;14408;10201;4207;3451.0;2851.0;3539.0;3235.0;13169.0;12944.0;19
1747;Eindhoven (GA);2009;326170;72130;201462;52578;252401;35407;14933;20474;38362;22822;15540;4490;2421;2069;2869;1726;1143;10051;5351;4700;6192;2926;3266;14760;10398;4362;3486.0;2891.0;3731.0;3247.0;13045.0;13052.0;19
1748;Eindhoven (GA);2010;327295;72049;201749;53497;252453;35833;15397;20436;39009;23038;15971;4558;2446;2112;2928;1752;1176;10102;5344;4758;6329;2973;3356;15092;10523;4569;3522.0;2949.0;3852.0;3212.0;12905.0;13100.0;19
1749;Eindhoven (GA);2011;328362;71880;202148;54334;252304;36331;15876;20455;39727;23300;16427;4640;2486;2154;2960;1770;1190;10104;5338;4766;6523;3046;3477;15500;10660;4840;3539.0;2972.0;3973.0;3172.0;12638.0;13304.0;19
1750;Eindhoven (GA);2012;329112;71722;201716;55674;251817;36802;16276;20526;40493;23572;16921;4731;2516;2215;3028;1828;1200;10203;5374;4829;6661;3066;3595;15870;10788;5082;3479.0;3022.0;3978.0;3158.0;12457.0;13217.0;19
1751;Eindhoven (GA);2013;329676;71422;201309;56945;251321;37186;16679;20507;41169;23743;17426;4809;2564;2245;3117;1877;1240;10259;5386;4873;6831;3101;3730;16153;10815;5338;3529.0;3035.0;3984.0;3084.0;12587.0;13291.0;19
1752;Eindhoven (GA);2014;330411;71305;201050;58056;250984;37648;17156;20492;41779;23969;17810;4890;2625;2265;3201;1911;1290;10299;5372;4927;6924;3128;3796;16465;10933;5532;3513.0;3090.0;3973.0;3045.0;12389.0;13317.0;19
1753;Eindhoven (GA);2015;330873;71013;200779;59081;250439;38072;17603;20469;42362;24131;18231;4965;2655;2310;3263;1946;1317;10315;5349;4966;7041;3159;3882;16778;11022;5756;3521.0;3108.0;3967.0;3054.0;12584.0;13297.0;19
1754;Eindhoven (GA);2016;331530;70983;200552;59995;250048;38423;17964;20459;43059;24425;18634;5035;2693;2342;3345;2005;1340;10361;5348;5013;7147;3179;3968;17171;11200;5971;3533.0;3143.0;4004.0;3038.0;11746.0;13267.0;19
1755;Eindhoven (GA);2017;331411;70716;200020;60675;248940;38833;18329;20504;43638;24638;19000;5058;2714;2344;3400;2026;1374;10358;5378;4980;7282;3198;4084;17540;11322;6218;3514.0;3186.0;3934.0;3003.0;11923.0;13191.0;19
1756;Eindhoven (GA);2018;331444;70511;199517;61416;248066;39197;18686;20511;44181;24795;19386;5142;2730;2412;3436;2055;1381;10372;5380;4992;7412;3215;4197;17819;11415;6404;3543.0;3200.0;3967.0;3010.0;11730.0;13228.0;19
1757;Eindhoven (GA);2019;331289;70174;199117;61998;247093;39546;19017;20529;44650;24909;19741;5180;2728;2452;3479;2087;1392;10361;5335;5026;7471;3213;4258;18159;11546;6613;3552.0;3204.0;3958.0;2966.0;11686.0;13131.0;19
1758;Eindhoven (GA);2020;331227;69895;198597;62735;246092;39978;19431;20547;45157;25111;20046;5260;2768;2492;3545;2131;1414;10350;5337;5013;7559;3221;4338;18443;11654;6789;3559.0;3252.0;3899.0;2924.0;11880.0;13104.0;19
1759;Eindhoven (GA);2021;331320;69461;198414;63445;245256;40331;19729;20602;45733;25292;20441;5327;2782;2545;3617;2155;1462;10350;5351;4999;7624;3238;4386;18815;11766;7049;3601.0;3239.0;3923.0;2913.0;11947.0;13106.0;19
1760;Eindhoven (GA);2022;331574;69170;198083;64321;244559;40716;20019;20697;46299;25543;20756;5375;2811;2564;3700;2196;1504;10382;5365;5017;7702;3287;4415;19140;11884;7256;3633.0;3311.0;3913.0;2856.0;11599.0;13130.0;19
1761;Eindhoven (GA);2023;331465;68908;197470;65087;243464;41084;20298;20786;46917;25805;21112;5414;2829;2585;3737;2203;1534;10370;5388;4982;7830;3332;4498;19566;12053;7513;3615.0;3338.0;3912.0;2896.0;11482.0;13032.0;19
1762;Eindhoven (GA);2024;331256;68659;196670;65927;242389;41458;20589;20869;47409;26014;21395;5439;2820;2619;3828;2249;1579;10392;5390;5002;7901;3359;4542;19849;12196;7653;3642.0;3319.0;3870.0;2835.0;11498.0;13003.0;19
1763;Eindhoven (GA);2025;331146;68536;195643;66967;241460;41831;20954;20877;47855;26215;21640;5459;2829;2630;3919;2313;1606;10420;5384;5036;7945;3363;4582;20112;12326;7786;;;;;;;19
1764;Geleen/Sittard (GA);2008;139090;30064;84799;24227;112891;19324;5679;13645;6875;4088;2787;463;236;227;399;226;173;746;438;308;2318;1210;1108;2949;1978;971;1178.0;1361.0;738.0;1053.0;4680.0;4596.0;20
1765;Geleen/Sittard (GA);2009;138697;29714;84413;24570;112589;19006;5641;13365;7102;4155;2947;535;284;251;438;242;196;810;449;361;2313;1185;1128;3006;1995;1011;1158.0;1377.0;779.0;1041.0;4650.0;4670.0;20
1766;Geleen/Sittard (GA);2010;138215;29215;84039;24961;112263;18652;5565;13087;7300;4243;3057;578;302;276;464;256;208;873;483;390;2330;1193;1137;3055;2009;1046;1155.0;1392.0;799.0;993.0;4657.0;4715.0;20
1767;Geleen/Sittard (GA);2011;137742;28669;83592;25481;111950;18276;5504;12772;7516;4312;3204;640;336;304;496;283;213;923;491;432;2354;1176;1178;3103;2026;1077;1141.0;1424.0;804.0;968.0;4492.0;4683.0;20
1768;Geleen/Sittard (GA);2012;137122;28095;82923;26104;111437;17929;5495;12434;7756;4414;3342;687;364;323;527;299;228;1007;526;481;2354;1164;1190;3181;2061;1120;1123.0;1442.0;812.0;946.0;4560.0;4732.0;20
1769;Geleen/Sittard (GA);2013;136513;27620;82120;26773;111038;17561;5434;12127;7914;4423;3491;732;384;348;550;308;242;1087;545;542;2353;1136;1217;3192;2050;1142;1139.0;1452.0;788.0;920.0;4479.0;4732.0;20
1770;Geleen/Sittard (GA);2014;135825;27201;81311;27313;110470;17228;5396;11832;8127;4496;3631;782;399;383;570;328;242;1156;560;596;2394;1132;1262;3225;2077;1148;1139.0;1473.0;767.0;907.0;4443.0;4747.0;20
1771;Geleen/Sittard (GA);2015;135061;26772;80380;27909;109876;16906;5354;11552;8279;4550;3729;819;421;398;601;344;257;1210;559;651;2389;1126;1263;3260;2100;1160;1140.0;1480.0;787.0;875.0;4463.0;4672.0;20
1772;Geleen/Sittard (GA);2016;134439;26359;79589;28491;109365;16565;5302;11263;8509;4640;3869;856;444;412;637;370;267;1268;573;695;2438;1145;1293;3310;2108;1202;1140.0;1493.0;731.0;873.0;4548.0;4614.0;20
1773;Geleen/Sittard (GA);2017;133892;25946;78945;29001;108897;16286;5287;10999;8709;4739;3970;922;478;444;673;387;286;1321;597;724;2463;1152;1311;3330;2125;1205;1145.0;1503.0;710.0;849.0;4391.0;4600.0;20
1774;Geleen/Sittard (GA);2018;133202;25597;78016;29589;108333;15951;5249;10702;8918;4807;4111;974;506;468;690;403;287;1380;612;768;2492;1152;1340;3382;2134;1248;1149.0;1529.0;717.0;824.0;4471.0;4647.0;20
1775;Geleen/Sittard (GA);2019;132549;25203;77331;30015;107832;15630;5195;10435;9087;4846;4241;997;511;486;714;407;307;1435;631;804;2518;1156;1362;3423;2141;1282;1164.0;1541.0;721.0;802.0;4454.0;4629.0;20
1776;Geleen/Sittard (GA);2020;131932;24914;76629;30389;107234;15345;5173;10172;9353;4959;4394;1037;541;496;757;416;341;1498;657;841;2564;1154;1410;3497;2191;1306;1168.0;1558.0;680.0;801.0;4395.0;4587.0;20
1777;Geleen/Sittard (GA);2021;131248;24618;75822;30808;106666;15125;5151;9974;9457;5002;4455;1066;557;509;797;430;367;1516;663;853;2536;1134;1402;3542;2218;1324;1167.0;1541.0;685.0;794.0;4370.0;4595.0;20
1778;Geleen/Sittard (GA);2022;130554;24248;75014;31292;106141;14817;5098;9719;9596;5034;4562;1077;572;505;827;445;382;1566;677;889;2560;1128;1432;3566;2212;1354;1140.0;1563.0;689.0;777.0;4356.0;4501.0;20
1779;Geleen/Sittard (GA);2023;129915;24082;74080;31753;105577;14631;5119;9512;9707;5059;4648;1104;580;524;848;466;382;1603;696;907;2601;1127;1474;3551;2190;1361;1148.0;1587.0;659.0;755.0;4348.0;4461.0;20
1780;Geleen/Sittard (GA);2024;129276;23880;73189;32207;104925;14383;5096;9287;9968;5158;4810;1151;612;539;895;477;418;1644;706;938;2655;1126;1529;3623;2237;1386;1119.0;1589.0;640.0;748.0;4297.0;4432.0;20
1781;Geleen/Sittard (GA);2025;128577;23838;72097;32642;104262;14203;5121;9082;10112;5200;4912;1191;642;549;910;489;421;1696;717;979;2654;1112;1542;3661;2240;1421;;;;;;;20
1782;Heerlen (GA);2008;208153;41861;128632;37660;151383;45402;15661;29741;11368;6747;4621;764;401;363;1057;673;384;1326;703;623;3320;1680;1640;4901;3290;1611;1750.0;2338.0;1362.0;1771.0;9311.0;9375.0;21
1783;Heerlen (GA);2009;207116;41346;127908;37862;150940;44378;15428;28950;11798;6936;4862;857;456;401;1099;690;409;1434;734;700;3327;1669;1658;5081;3387;1694;1756.0;2349.0;1319.0;1758.0;9451.0;9392.0;21
1784;Heerlen (GA);2010;206166;40833;127227;38106;150772;43361;15121;28240;12033;7024;5009;932;505;427;1110;688;422;1508;750;758;3326;1673;1653;5157;3408;1749;1748.0;2346.0;1390.0;1682.0;9522.0;9553.0;21
1785;Heerlen (GA);2011;205266;40352;126318;38596;150459;42431;14892;27539;12376;7160;5216;1047;568;479;1120;693;427;1618;800;818;3320;1655;1665;5271;3444;1827;1750.0;2362.0;1342.0;1650.0;9392.0;9447.0;21
1786;Heerlen (GA);2012;204313;39812;125269;39232;150078;41504;14656;26848;12731;7238;5493;1124;610;514;1150;700;450;1752;826;926;3350;1639;1711;5355;3463;1892;1764.0;2364.0;1333.0;1611.0;9374.0;9343.0;21
1787;Heerlen (GA);2013;203489;39540;124061;39888;149770;40631;14431;26200;13088;7414;5674;1199;666;533;1173;717;456;1862;882;980;3394;1640;1754;5460;3509;1951;1763.0;2398.0;1313.0;1569.0;9310.0;9330.0;21
1788;Heerlen (GA);2014;202601;39172;122955;40474;149457;39745;14239;25506;13399;7523;5876;1271;707;564;1227;754;473;1993;924;1069;3401;1635;1766;5507;3503;2004;1760.0;2388.0;1290.0;1536.0;9208.0;9303.0;21
1789;Heerlen (GA);2015;201655;38803;121707;41145;149005;38895;13987;24908;13755;7656;6099;1349;744;605;1276;773;503;2098;972;1126;3428;1619;1809;5604;3548;2056;1762.0;2410.0;1255.0;1505.0;9091.0;9149.0;21
1790;Heerlen (GA);2016;200718;38656;120417;41645;148543;38123;13805;24318;14052;7773;6279;1434;781;653;1303;789;514;2203;1019;1184;3404;1595;1809;5708;3589;2119;1762.0;2402.0;1231.0;1458.0;9084.0;9165.0;21
1791;Heerlen (GA);2017;199793;38511;119140;42142;148198;37254;13616;23638;14341;7829;6512;1518;813;705;1324;792;532;2306;1046;1260;3413;1582;1831;5780;3596;2184;1768.0;2412.0;1187.0;1444.0;9057.0;9027.0;21
1792;Heerlen (GA);2018;198946;38294;117806;42846;147895;36452;13432;23020;14599;7926;6673;1594;853;741;1358;806;552;2400;1070;1330;3399;1561;1838;5848;3636;2212;1789.0;2435.0;1174.0;1410.0;8948.0;8898.0;21
1793;Heerlen (GA);2019;198146;38108;116559;43479;147561;35704;13247;22457;14881;8032;6849;1657;879;778;1417;826;591;2505;1119;1386;3408;1564;1844;5894;3644;2250;1796.0;2434.0;1142.0;1373.0;8947.0;8879.0;21
1794;Heerlen (GA);2020;197366;37999;115363;44004;147286;34931;13094;21837;15149;8136;7013;1736;901;835;1434;842;592;2609;1152;1457;3422;1570;1852;5948;3671;2277;1782.0;2434.0;1136.0;1338.0;8911.0;8862.0;21
1795;Heerlen (GA);2021;196583;37772;114299;44512;146918;34234;12942;21292;15431;8275;7156;1806;941;865;1468;863;605;2701;1190;1511;3402;1557;1845;6054;3724;2330;1776.0;2439.0;1071.0;1330.0;8873.0;8794.0;21
1796;Heerlen (GA);2022;195755;37634;112956;45165;146460;33587;12771;20816;15708;8341;7367;1844;950;894;1544;894;650;2789;1211;1578;3400;1558;1842;6131;3728;2403;1771.0;2471.0;1071.0;1297.0;8855.0;8776.0;21
1797;Heerlen (GA);2023;194926;37533;111695;45698;145978;32966;12628;20338;15982;8437;7545;1880;969;911;1569;890;679;2855;1238;1617;3450;1568;1882;6228;3772;2456;1782.0;2465.0;1055.0;1244.0;8683.0;8677.0;21
1798;Heerlen (GA);2024;194090;37348;110478;46264;145492;32409;12524;19885;16189;8523;7666;1908;969;939;1613;910;703;2939;1270;1669;3443;1583;1860;6286;3791;2495;1795.0;2489.0;1045.0;1236.0;8682.0;8592.0;21
1799;Heerlen (GA);2025;193313;37285;109163;46865;145060;31817;12381;19436;16436;8650;7786;1945;1009;936;1638;937;701;3054;1322;1732;3463;1576;1887;6336;3806;2530;;;;;;;21
1800;Maastricht (GA);2008;118445;22172;75792;20481;92678;17034;7123;9911;8733;5417;3316;483;230;253;587;389;198;1622;836;786;1838;925;913;4203;3037;1166;916.0;1293.0;1886.0;2112.0;4341.0;4538.0;22
1801;Maastricht (GA);2009;117665;21882;75292;20491;92089;16886;7170;9716;8690;5302;3388;533;258;275;604;401;203;1617;827;790;1862;908;954;4074;2908;1166;923.0;1307.0;1920.0;2057.0;4347.0;4519.0;22
1802;Maastricht (GA);2010;116997;21645;74803;20549;91562;16705;7193;9512;8730;5226;3504;597;288;309;623;419;204;1659;837;822;1887;910;977;3964;2772;1192;935.0;1300.0;1937.0;1975.0;4277.0;4493.0;22
1803;Maastricht (GA);2011;116401;21292;74257;20852;91014;16626;7303;9323;8761;5171;3590;642;303;339;653;435;218;1670;838;832;1907;897;1010;3889;2698;1191;972.0;1310.0;1970.0;1967.0;4276.0;4494.0;22
1804;Maastricht (GA);2012;115869;21052;73607;21210;90517;16548;7335;9213;8804;5124;3680;705;344;361;676;443;233;1687;835;852;1901;876;1025;3835;2626;1209;1000.0;1305.0;1985.0;1894.0;4161.0;4457.0;22
1805;Maastricht (GA);2013;115383;20975;72854;21554;89995;16479;7433;9046;8909;5079;3830;754;372;382;725;456;269;1734;851;883;1924;853;1071;3772;2547;1225;1020.0;1301.0;1953.0;1857.0;4159.0;4458.0;22
1806;Maastricht (GA);2014;114914;20855;72210;21849;89532;16395;7477;8918;8987;5069;3918;804;391;413;748;477;271;1755;852;903;1937;859;1078;3743;2490;1253;1046.0;1318.0;1929.0;1811.0;4152.0;4436.0;22
1807;Maastricht (GA);2015;114499;20720;71774;22005;89136;16252;7488;8764;9111;5100;4011;849;417;432;803;508;295;1777;872;905;1943;844;1099;3739;2459;1280;1062.0;1309.0;1881.0;1783.0;4150.0;4437.0;22
1808;Maastricht (GA);2016;114081;20729;71153;22199;88776;16179;7503;8676;9126;5063;4063;897;438;459;819;523;296;1797;881;916;1922;831;1091;3691;2390;1301;1077.0;1311.0;1828.0;1748.0;4087.0;4370.0;22
1809;Maastricht (GA);2017;113666;20733;70583;22350;88340;16110;7565;8545;9216;5057;4159;940;464;476;839;539;300;1821;876;945;1941;833;1108;3675;2345;1330;1079.0;1308.0;1837.0;1721.0;4089.0;4407.0;22
1810;Maastricht (GA);2018;113254;20810;69909;22535;87921;16010;7571;8439;9323;5099;4224;977;498;479;854;541;313;1844;884;960;1980;838;1142;3668;2338;1330;1087.0;1295.0;1809.0;1686.0;4114.0;4385.0;22
1811;Maastricht (GA);2019;112916;20768;69382;22766;87573;15943;7583;8360;9400;5106;4294;1033;527;506;876;556;320;1867;877;990;1980;838;1142;3644;2308;1336;1083.0;1312.0;1751.0;1663.0;4047.0;4410.0;22
1812;Maastricht (GA);2020;112429;20715;68798;22916;87171;15802;7594;8208;9456;5106;4350;1043;536;507;893;563;330;1897;883;1014;2009;834;1175;3614;2290;1324;1082.0;1310.0;1721.0;1622.0;4102.0;4342.0;22
1813;Maastricht (GA);2021;112082;20619;68382;23081;86785;15806;7662;8144;9491;5100;4391;1073;550;523;900;563;337;1916;899;1017;2013;821;1192;3589;2267;1322;1074.0;1293.0;1698.0;1601.0;4066.0;4348.0;22
1814;Maastricht (GA);2022;111700;20649;67807;23244;86385;15722;7669;8053;9593;5143;4450;1099;564;535;911;569;342;1924;897;1027;2060;834;1226;3599;2279;1320;1049.0;1312.0;1650.0;1582.0;4118.0;4323.0;22
1815;Maastricht (GA);2023;111315;20580;67313;23422;85979;15643;7676;7967;9693;5141;4552;1146;579;567;914;567;347;1941;905;1036;2073;832;1241;3619;2258;1361;1057.0;1318.0;1651.0;1557.0;4049.0;4281.0;22
1816;Maastricht (GA);2024;110933;20676;66714;23543;85607;15544;7688;7856;9782;5164;4618;1183;602;581;940;571;369;1944;911;1033;2086;833;1253;3629;2247;1382;1075.0;1301.0;1609.0;1511.0;3963.0;4260.0;22
1817;Maastricht (GA);2025;110521;20705;66074;23742;85164;15490;7710;7780;9867;5202;4665;1235;627;608;967;587;380;1952;909;1043;2094;834;1260;3619;2245;1374;;;;;;;22
1818;Aa en Hunze;2008;25388;5920;14842;4626;23912;992;327;665;484;253;231;97;43;54;36;12;24;69;32;37;39;24;15;243;142;101;196.0;232.0;60.0;81.0;1197.0;1156.0;1680
1819;Aa en Hunze;2009;25374;5835;14762;4777;23806;1004;318;686;564;291;273;106;48;58;40;13;27;92;35;57;50;33;17;276;162;114;199.0;233.0;68.0;82.0;1238.0;1190.0;1680
1820;Aa en Hunze;2010;25378;5790;14716;4872;23721;1024;325;699;633;329;304;116;50;66;49;19;30;103;47;56;63;36;27;302;177;125;186.0;242.0;65.0;77.0;1143.0;1194.0;1680
1821;Aa en Hunze;2011;25263;5657;14620;4986;23520;1042;322;720;701;352;349;122;48;74;58;24;34;127;58;69;70;34;36;324;188;136;191.0;240.0;72.0;84.0;1138.0;1192.0;1680
1822;Aa en Hunze;2012;25150;5500;14439;5211;23341;1062;323;739;747;375;372;123;51;72;71;28;43;132;63;69;85;44;41;336;189;147;189.0;243.0;75.0;82.0;1183.0;1197.0;1680
1823;Aa en Hunze;2013;25081;5381;14248;5452;23212;1063;321;742;806;409;397;126;57;69;82;34;48;168;81;87;88;44;44;342;193;149;187.0;246.0;72.0;82.0;1281.0;1194.0;1680
1824;Aa en Hunze;2014;25101;5307;14120;5674;23178;1043;322;721;880;447;433;136;57;79;90;38;52;197;101;96;105;50;55;352;201;151;191.0;248.0;70.0;83.0;1097.0;1200.0;1680
1825;Aa en Hunze;2015;24931;5194;13879;5858;22965;1044;319;725;922;474;448;142;61;81;91;40;51;207;111;96;111;53;58;371;209;162;192.0;262.0;73.0;85.0;1200.0;1187.0;1680
1826;Aa en Hunze;2016;24865;5129;13725;6011;22820;1051;318;733;994;493;501;154;73;81;98;45;53;228;112;116;131;58;73;383;205;178;194.0;253.0;72.0;85.0;1202.0;1186.0;1680
1827;Aa en Hunze;2017;24811;4983;13656;6172;22702;1057;331;726;1052;522;530;164;74;90;102;46;56;251;129;122;136;64;72;399;209;190;206.0;258.0;68.0;87.0;1260.0;1197.0;1680
1828;Aa en Hunze;2018;24809;4909;13586;6314;22660;1055;343;712;1094;526;568;166;74;92;108;48;60;259;131;128;149;68;81;412;205;207;208.0;267.0;72.0;82.0;1268.0;1194.0;1680
1829;Aa en Hunze;2019;24816;4860;13554;6402;22588;1077;357;720;1151;560;591;176;78;98;121;53;68;274;137;137;154;68;86;426;224;202;213.0;272.0;79.0;87.0;1245.0;1215.0;1680
1830;Aa en Hunze;2020;24781;4803;13482;6496;22494;1084;348;736;1203;589;614;177;79;98;127;58;69;287;138;149;155;74;81;457;240;217;214.0;276.0;69.0;83.0;1261.0;1191.0;1680
1831;Aa en Hunze;2021;24778;4750;13393;6635;22412;1112;362;750;1254;613;641;180;79;101;132;59;73;303;146;157;170;81;89;469;248;221;217.0;279.0;82.0;82.0;1276.0;1209.0;1680
1832;Aa en Hunze;2022;24785;4689;13326;6770;22350;1124;365;759;1311;644;667;194;85;109;137;70;67;318;149;169;180;89;91;482;251;231;226.0;285.0;77.0;86.0;1256.0;1218.0;1680
1833;Aa en Hunze;2023;24758;4614;13293;6851;22236;1141;371;770;1381;669;712;203;92;111;140;72;68;338;151;187;207;93;114;493;261;232;228.0;284.0;75.0;87.0;1352.0;1208.0;1680
1834;Aa en Hunze;2024;24836;4612;13234;6990;22239;1157;377;780;1440;692;748;214;99;115;144;72;72;346;156;190;223;97;126;513;268;245;232.0;292.0;88.0;87.0;1285.0;1198.0;1680
1835;Aa en Hunze;2025;24864;4645;13114;7105;22210;1161;373;788;1493;701;792;234;103;131;158;78;80;364;157;207;228;97;131;509;266;243;;;;;;;1680
1836;Aalburg;2008;12200;3577;7114;1509;11641;360;129;231;199;123;76;32;17;15;14;8;6;23;13;10;22;11;11;108;74;34;152.0;96.0;38.0;48.0;179.0;346.0;738
1837;Aalburg;2009;12081;3511;7044;1526;11485;367;126;241;229;143;86;31;19;12;20;11;9;28;16;12;27;11;16;123;86;37;146.0;99.0;36.0;47.0;272.0;342.0;738
1838;Aalburg;2010;12049;3461;7024;1564;11402;377;131;246;270;160;110;38;21;17;21;10;11;44;18;26;31;15;16;136;96;40;146.0;98.0;37.0;50.0;256.0;353.0;738
1839;Aalburg;2011;11989;3382;7010;1597;11305;396;143;253;288;173;115;39;21;18;28;12;16;42;18;24;33;17;16;146;105;41;144.0;100.0;40.0;46.0;357.0;370.0;738
1840;Aalburg;2012;12015;3326;7009;1680;11278;425;153;272;312;187;125;47;27;20;29;11;18;42;19;23;42;19;23;152;111;41;146.0;100.0;49.0;45.0;264.0;377.0;738
1841;Aalburg;2013;11952;3247;6964;1741;11168;440;157;283;344;204;140;51;30;21;32;13;19;51;24;27;49;21;28;161;116;45;138.0;101.0;48.0;46.0;358.0;374.0;738
1842;Aalburg;2014;11976;3202;6975;1799;11160;454;161;293;362;210;152;52;32;20;34;14;20;55;26;29;47;21;26;174;117;57;140.0;102.0;50.0;46.0;343.0;370.0;738
1843;Aalburg;2015;11992;3137;6977;1878;11133;472;172;300;387;220;167;56;34;22;40;15;25;62;28;34;49;21;28;180;122;58;145.0;106.0;47.0;49.0;376.0;361.0;738
1844;Aalburg;2016;12045;3116;6989;1940;11143;488;180;308;414;229;185;60;37;23;44;18;26;72;32;40;53;22;31;185;120;65;142.0;107.0;44.0;47.0;379.0;383.0;738
1845;Aalburg;2017;12074;3081;6982;2011;11147;489;177;312;438;240;198;67;38;29;44;19;25;77;35;42;57;23;34;193;125;68;144.0;103.0;43.0;47.0;411.0;384.0;738
1846;Aalburg;2018;12138;3052;7015;2071;11169;503;189;314;466;250;216;72;40;32;47;22;25;82;36;46;67;27;40;198;125;73;151.0;108.0;46.0;50.0;411.0;389.0;738
1847;Aalburg;2019;12200;2988;7095;2117;11197;516;198;318;487;262;225;69;38;31;50;24;26;90;38;52;68;30;38;210;132;78;149.0;114.0;42.0;46.0;429.0;397.0;738
1848;Aalburg;2020;12263;2971;7109;2183;11243;515;192;323;505;268;237;65;38;27;53;23;30;94;41;53;66;30;36;227;136;91;149.0;114.0;42.0;46.0;415.0;379.0;738
1849;Aalburg;2021;12331;2931;7147;2253;11279;531;199;332;521;277;244;72;39;33;52;25;27;97;45;52;74;27;47;226;141;85;154.0;116.0;43.0;45.0;467.0;404.0;738
1850;Aalburg;2022;12430;2892;7222;2316;11343;540;203;337;547;280;267;73;37;36;54;29;25;115;46;69;77;28;49;228;140;88;158.0;119.0;38.0;46.0;361.0;402.0;738
1851;Aalburg;2023;12422;2880;7174;2368;11293;557;209;348;572;289;283;72;36;36;59;33;26;128;50;78;78;28;50;235;142;93;153.0;120.0;44.0;46.0;434.0;407.0;738
1852;Aalburg;2024;12481;2866;7184;2431;11351;548;206;342;582;290;292;76;34;42;51;29;22;126;49;77;79;29;50;250;149;101;156.0;125.0;47.0;48.0;416.0;398.0;738
1853;Aalburg;2025;12530;2848;7201;2481;11367;555;205;350;608;297;311;80;37;43;50;28;22;122;46;76;83;31;52;273;155;118;;;;;;;738
1854;Aalsmeer;2008;26224;6359;15753;4112;22301;2374;1185;1189;1549;855;694;269;106;163;65;27;38;131;67;64;367;186;181;717;469;248;260.0;199.0;248.0;177.0;1321.0;902.0;358
1855;Aalsmeer;2009;26775;6451;16064;4260;22627;2471;1243;1228;1677;916;761;283;111;172;77;31;46;162;81;81;374;186;188;781;507;274;259.0;211.0;271.0;180.0;1257.0;937.0;358
1856;Aalsmeer;2010;27236;6567;16254;4415;22825;2603;1329;1274;1808;1000;808;296;116;180;87;42;45;192;100;92;385;187;198;848;555;293;271.0;213.0;278.0;182.0;1157.0;901.0;358
1857;Aalsmeer;2011;27649;6615;16499;4535;22999;2703;1406;1297;1947;1070;877;318;127;191;100;46;54;218;113;105;415;202;213;896;582;314;273.0;217.0;298.0;188.0;1260.0;927.0;358
1858;Aalsmeer;2012;28151;6714;16644;4793;23210;2863;1496;1367;2078;1120;958;325;125;200;107;51;56;250;128;122;437;211;226;959;605;354;272.0;223.0;342.0;184.0;1069.0;951.0;358
1859;Aalsmeer;2013;28483;6723;16726;5034;23262;2976;1582;1394;2245;1201;1044;357;141;216;119;59;60;269;138;131;464;222;242;1036;641;395;276.0;232.0;337.0;198.0;1086.0;929.0;358
1860;Aalsmeer;2014;28825;6832;16767;5226;23339;3095;1653;1442;2391;1277;1114;376;146;230;140;69;71;292;150;142;492;238;254;1091;674;417;278.0;234.0;347.0;199.0;1183.0;931.0;358
1861;Aalsmeer;2015;29271;6952;16937;5382;23521;3196;1715;1481;2554;1356;1198;391;147;244;167;87;80;324;163;161;513;254;259;1159;705;454;276.0;241.0;355.0;204.0;796.0;893.0;358
1862;Aalsmeer;2016;29362;6928;16895;5539;23448;3271;1760;1511;2643;1412;1231;411;157;254;169;93;76;341;169;172;524;267;257;1198;726;472;287.0;243.0;364.0;212.0;836.0;889.0;358
1863;Aalsmeer;2017;29504;6958;16886;5660;23359;3393;1838;1555;2752;1463;1289;412;172;240;199;107;92;360;169;191;536;273;263;1245;742;503;282.0;246.0;359.0;211.0;901.0;900.0;358
1864;Aalsmeer;2018;29690;7008;16926;5756;23367;3449;1875;1574;2874;1521;1353;422;184;238;212;115;97;396;185;211;554;274;280;1290;763;527;288.0;254.0;362.0;211.0;866.0;893.0;358
1865;Aalsmeer;2019;29850;7048;16937;5865;23337;3513;1913;1600;3000;1577;1423;444;195;249;222;121;101;422;201;221;570;275;295;1342;785;557;291.0;264.0;375.0;211.0;1002.0;904.0;358
1866;Aalsmeer;2020;30141;7051;17121;5969;23419;3625;1981;1644;3097;1630;1467;447;194;253;243;138;105;436;213;223;585;283;302;1386;802;584;289.0;263.0;376.0;222.0;843.0;921.0;358
1867;Aalsmeer;2021;30243;7013;17142;6088;23366;3700;2038;1662;3177;1689;1488;444;196;248;249;152;97;455;221;234;589;291;298;1440;829;611;285.0;270.0;409.0;212.0;889.0;933.0;358
1868;Aalsmeer;2022;30414;7053;17154;6207;23321;3769;2082;1687;3324;1761;1563;460;202;258;280;167;113;494;232;262;595;298;297;1495;862;633;289.0;280.0;373.0;212.0;790.0;933.0;358
1869;Aalsmeer;2023;30442;7000;17131;6311;23215;3817;2130;1687;3410;1805;1605;463;200;263;308;191;117;515;243;272;592;294;298;1532;877;655;290.0;279.0;383.0;218.0;909.0;911.0;358
1870;Aalsmeer;2024;30616;7048;17095;6473;23208;3900;2192;1708;3508;1869;1639;472;213;259;335;214;121;537;252;285;601;308;293;1563;882;681;296.0;285.0;379.0;207.0;857.0;958.0;358
1871;Aalsmeer;2025;30699;6992;17079;6628;23115;3985;2210;1775;3599;1906;1693;478;217;261;358;225;133;554;262;292;615;317;298;1594;885;709;;;;;;;358
1872;Aalten;2008;27304;6696;16178;4430;23839;2500;993;1507;965;560;405;77;39;38;23;11;12;385;188;197;35;14;21;445;308;137;269.0;244.0;81.0;124.0;603.0;716.0;197
1873;Aalten;2009;27175;6580;16060;4535;23686;2453;974;1479;1036;594;442;85;46;39;33;16;17;400;196;204;46;18;28;472;318;154;254.0;240.0;79.0;116.0;606.0;717.0;197
1874;Aalten;2010;27045;6444;15986;4615;23536;2417;963;1454;1092;618;474;99;48;51;35;16;19;410;202;208;49;21;28;499;331;168;251.0;244.0;80.0;120.0;693.0;718.0;197
1875;Aalten;2011;26990;6305;16002;4683;23486;2365;956;1409;1139;639;500;112;52;60;38;22;16;414;200;214;56;24;32;519;341;178;257.0;253.0;82.0;115.0;673.0;736.0;197
1876;Aalten;2012;26899;6147;15883;4869;23424;2332;944;1388;1143;623;520;114;51;63;39;23;16;406;194;212;64;24;40;520;331;189;247.0;259.0;81.0;106.0;738.0;723.0;197
1877;Aalten;2013;26878;6057;15790;5031;23356;2322;934;1388;1200;645;555;128;61;67;39;25;14;414;195;219;71;29;42;548;335;213;240.0;262.0;89.0;115.0;699.0;745.0;197
1878;Aalten;2014;26786;5957;15680;5149;23251;2288;925;1363;1247;667;580;130;61;69;35;23;12;407;191;216;95;38;57;580;354;226;238.0;261.0;81.0;116.0;746.0;748.0;197
1879;Aalten;2015;26729;5832;15650;5247;23196;2243;904;1339;1290;680;610;141;67;74;40;26;14;396;183;213;101;41;60;612;363;249;234.0;259.0;83.0;106.0;740.0;733.0;197
1880;Aalten;2016;26688;5711;15617;5360;23128;2189;891;1298;1371;739;632;156;78;78;47;29;18;389;187;202;114;45;69;665;400;265;235.0;268.0;80.0;102.0;791.0;716.0;197
1881;Aalten;2017;26711;5631;15613;5467;23143;2171;879;1292;1397;744;653;165;82;83;51;31;20;386;191;195;120;49;71;675;391;284;238.0;266.0;95.0;100.0;779.0;724.0;197
1882;Aalten;2018;26735;5563;15568;5604;23122;2153;869;1284;1460;790;670;177;89;88;57;34;23;389;191;198;122;48;74;715;428;287;244.0;276.0;76.0;106.0;754.0;724.0;197
1883;Aalten;2019;26706;5435;15545;5726;23063;2145;867;1278;1498;811;687;191;92;99;59;35;24;392;193;199;130;54;76;726;437;289;247.0;280.0;84.0;105.0;865.0;737.0;197
1884;Aalten;2020;26782;5390;15555;5837;23099;2127;858;1269;1556;833;723;207;97;110;66;37;29;397;199;198;138;56;82;748;444;304;248.0;286.0;82.0;109.0;773.0;743.0;197
1885;Aalten;2021;26750;5275;15534;5941;23064;2106;858;1248;1580;858;722;219;107;112;78;44;34;394;203;191;146;58;88;743;446;297;251.0;286.0;78.0;96.0;781.0;736.0;197
1886;Aalten;2022;26745;5212;15449;6084;23073;2069;829;1240;1603;883;720;230;118;112;82;48;34;390;205;185;156;65;91;745;447;298;249.0;290.0;83.0;99.0;768.0;731.0;197
1887;Aalten;2023;26728;5140;15362;6226;23038;2030;822;1208;1660;913;747;238;126;112;91;50;41;416;218;198;174;75;99;741;444;297;255.0;297.0;81.0;92.0;824.0;732.0;197
1888;Aalten;2024;26769;5103;15274;6392;23018;2034;827;1207;1717;950;767;257;139;118;98;54;44;406;215;191;175;75;100;781;467;314;256.0;303.0;75.0;97.0;791.0;738.0;197
1889;Aalten;2025;26755;5047;15210;6498;22980;2003;814;1189;1772;981;791;270;147;123;117;68;49;408;215;193;177;78;99;800;473;327;;;;;;;197
1890;Abcoude;2008;8521;2311;4859;1351;7185;891;313;578;445;227;218;105;41;64;46;18;28;21;8;13;18;10;8;255;150;105;59.0;70.0;31.0;43.0;377.0;402.0;305
1891;Abcoude;2009;8473;2259;4841;1373;7099;908;322;586;466;236;230;107;42;65;41;14;27;32;15;17;24;11;13;262;154;108;58.0;72.0;34.0;43.0;466.0;427.0;305
1892;Abcoude;2010;8490;2209;4878;1403;7050;933;329;604;507;251;256;109;44;65;40;13;27;40;18;22;33;11;22;285;165;120;54.0;73.0;38.0;49.0;435.0;421.0;305
1893;Abcoude;2011;8475;2146;4931;1398;6976;945;327;618;554;272;282;115;44;71;46;17;29;51;24;27;36;11;25;306;176;130;58.0;73.0;39.0;45.0;456.0;426.0;305
1894;Abcoude;2012;8485;2094;4925;1466;6946;960;333;627;579;288;291;115;43;72;45;19;26;52;24;28;38;11;27;329;191;138;55.0;74.0;37.0;44.0;392.0;446.0;305
1895;Abcoude;2013;8407;1998;4896;1513;6867;960;327;633;580;291;289;114;46;68;46;22;24;54;24;30;45;13;32;321;186;135;61.0;78.0;40.0;45.0;449.0;439.0;305
1896;Abcoude;2014;8396;1962;4906;1528;6826;959;322;637;611;313;298;122;49;73;49;28;21;62;27;35;47;13;34;331;196;135;61.0;76.0;37.0;43.0;451.0;427.0;305
1897;Abcoude;2015;8401;1929;4930;1542;6815;981;320;661;605;312;293;114;44;70;47;29;18;59;26;33;58;13;45;327;200;127;63.0;79.0;35.0;43.0;453.0;441.0;305
1898;Abcoude;2016;8391;1885;4960;1546;6778;979;322;657;634;331;303;114;44;70;53;34;19;64;30;34;57;13;44;346;210;136;66.0;80.0;34.0;39.0;434.0;440.0;305
1899;Abcoude;2017;8366;1824;4978;1564;6707;990;335;655;669;358;311;117;48;69;57;35;22;64;32;32;60;15;45;371;228;143;67.0;79.0;40.0;44.0;415.0;449.0;305
1900;Abcoude;2018;8317;1759;4964;1594;6645;1008;343;665;664;352;312;123;49;74;56;39;17;63;34;29;60;14;46;362;216;146;71.0;83.0;33.0;41.0;474.0;423.0;305
1901;Abcoude;2019;8349;1727;4980;1642;6651;1023;346;677;675;352;323;126;50;76;57;40;17;66;34;32;56;14;42;370;214;156;69.0;84.0;39.0;44.0;464.0;433.0;305
1902;Abcoude;2020;8362;1734;4974;1654;6612;1033;351;682;717;363;354;133;50;83;60;41;19;79;38;41;67;19;48;378;215;163;75.0;79.0;34.0;39.0;455.0;441.0;305
1903;Abcoude;2021;8368;1694;4991;1683;6594;1044;353;691;730;361;369;142;52;90;62;42;20;80;37;43;70;19;51;376;211;165;78.0;82.0;30.0;40.0;515.0;441.0;305
1904;Abcoude;2022;8429;1687;5007;1735;6652;1032;352;680;745;371;374;143;55;88;60;37;23;82;37;45;75;22;53;385;220;165;76.0;82.0;37.0;40.0;438.0;451.0;305
1905;Abcoude;2023;8410;1649;4991;1770;6636;1036;349;687;738;377;361;147;59;88;62;40;22;79;37;42;79;26;53;371;215;156;80.0;87.0;33.0;39.0;467.0;453.0;305
1906;Abcoude;2024;8412;1637;4995;1780;6603;1068;373;695;741;379;362;143;59;84;61;40;21;85;39;46;74;27;47;378;214;164;80.0;90.0;59.0;43.0;489.0;449.0;305
1907;Abcoude;2025;8458;1661;4960;1837;6600;1088;376;712;770;398;372;144;61;83;63;41;22;83;39;44;73;30;43;407;227;180;;;;;;;305
1908;Achtkarspelen;2008;28022;7314;16675;4033;27007;599;199;400;416;249;167;42;21;21;24;12;12;44;19;25;38;16;22;268;181;87;364.0;231.0;50.0;85.0;893.0;1055.0;59
1909;Achtkarspelen;2009;27962;7264;16609;4089;26864;619;193;426;479;289;190;54;29;25;28;14;14;54;30;24;51;20;31;292;196;96;360.0;236.0;55.0;85.0;864.0;1048.0;59
1910;Achtkarspelen;2010;27878;7179;16482;4217;26709;623;196;427;546;317;229;76;40;36;38;22;16;54;26;28;63;24;39;315;205;110;346.0;237.0;63.0;84.0;976.0;1087.0;59
1911;Achtkarspelen;2011;27863;7142;16393;4328;26620;640;209;431;603;335;268;91;45;46;44;21;23;72;30;42;69;25;44;327;214;113;341.0;240.0;81.0;88.0;938.0;1058.0;59
1912;Achtkarspelen;2012;27849;7172;16147;4530;26538;652;211;441;659;372;287;103;51;52;51;28;23;85;38;47;73;29;44;347;226;121;333.0;246.0;65.0;81.0;947.0;1065.0;59
1913;Achtkarspelen;2013;27804;7134;16000;4670;26427;664;225;439;713;399;314;114;56;58;58;32;26;86;39;47;89;35;54;366;237;129;333.0;254.0;69.0;91.0;965.0;1045.0;59
1914;Achtkarspelen;2014;27783;7108;15898;4777;26340;688;236;452;755;415;340;124;58;66;62;35;27;95;43;52;95;38;57;379;241;138;328.0;253.0;64.0;87.0;964.0;1061.0;59
1915;Achtkarspelen;2015;27741;7097;15758;4886;26239;698;239;459;804;441;363;129;58;71;72;38;34;91;46;45;102;44;58;410;255;155;321.0;251.0;72.0;87.0;1021.0;1064.0;59
1916;Achtkarspelen;2016;27754;7052;15692;5010;26184;712;243;469;858;457;401;141;67;74;77;41;36;98;47;51;105;43;62;437;259;178;323.0;256.0;61.0;90.0;981.0;1041.0;59
1917;Achtkarspelen;2017;27736;7009;15609;5118;26093;727;250;477;916;495;421;145;70;75;82;47;35;118;56;62;111;43;68;460;279;181;326.0;260.0;66.0;93.0;942.0;1054.0;59
1918;Achtkarspelen;2018;27667;6942;15497;5228;25984;736;254;482;947;507;440;143;71;72;88;54;34;133;57;76;114;39;75;469;286;183;329.0;261.0;72.0;94.0;1077.0;1050.0;59
1919;Achtkarspelen;2019;27745;6930;15483;5332;25974;752;261;491;1019;541;478;148;77;71;92;60;32;147;61;86;130;44;86;502;299;203;334.0;264.0;74.0;92.0;1064.0;1067.0;59
1920;Achtkarspelen;2020;27798;6910;15462;5426;25942;767;265;502;1089;577;512;152;79;73;110;68;42;159;67;92;135;47;88;533;316;217;340.0;274.0;70.0;89.0;1027.0;1077.0;59
1921;Achtkarspelen;2021;27799;6844;15427;5528;25850;799;273;526;1150;599;551;164;83;81;116;73;43;165;68;97;145;47;98;560;328;232;345.0;279.0;72.0;96.0;984.0;1044.0;59
1922;Achtkarspelen;2022;27783;6846;15311;5626;25776;803;272;531;1204;624;580;168;84;84;127;81;46;172;69;103;154;54;100;583;336;247;345.0;275.0;74.0;94.0;929.0;1052.0;59
1923;Achtkarspelen;2023;27711;6782;15192;5737;25604;826;291;535;1281;658;623;173;90;83;132;81;51;190;72;118;161;55;106;625;360;265;338.0;283.0;80.0;106.0;1032.0;1051.0;59
1924;Achtkarspelen;2024;27725;6786;15131;5808;25545;824;295;529;1356;691;665;183;94;89;137;76;61;204;81;123;175;59;116;657;381;276;343.0;283.0;84.0;101.0;956.0;1052.0;59
1925;Achtkarspelen;2025;27676;6734;15003;5939;25452;845;308;537;1379;701;678;183;90;93;141;81;60;201;75;126;186;65;121;668;390;278;;;;;;;59
1926;Alblasserdam;2008;18437;4956;10412;3069;16077;1238;506;732;1122;580;542;90;48;42;66;19;47;521;270;251;128;58;70;317;185;132;248.0;171.0;38.0;67.0;773.0;639.0;482
1927;Alblasserdam;2009;18619;5000;10479;3140;16218;1245;506;739;1156;589;567;100;51;49;70;21;49;505;265;240;144;58;86;337;194;143;246.0;176.0;50.0;72.0;734.0;656.0;482
1928;Alblasserdam;2010;18746;5037;10525;3184;16321;1239;502;737;1186;598;588;97;45;52;76;24;52;496;266;230;159;59;100;358;204;154;245.0;176.0;52.0;68.0;676.0;651.0;482
1929;Alblasserdam;2011;18827;5007;10603;3217;16348;1254;492;762;1225;629;596;104;43;61;76;28;48;498;269;229;165;68;97;382;221;161;234.0;177.0;60.0;68.0;814.0;632.0;482
1930;Alblasserdam;2012;19062;5055;10651;3356;16528;1251;487;764;1283;659;624;108;42;66;88;37;51;492;267;225;178;72;106;417;241;176;239.0;181.0;53.0;61.0;606.0;664.0;482
1931;Alblasserdam;2013;19056;5017;10544;3495;16493;1255;487;768;1308;669;639;116;47;69;91;41;50;502;273;229;186;74;112;413;234;179;245.0;187.0;64.0;68.0;682.0;612.0;482
1932;Alblasserdam;2014;19181;5039;10566;3576;16541;1279;494;785;1361;690;671;120;52;68;96;44;52;503;272;231;192;76;116;450;246;204;239.0;185.0;58.0;66.0;677.0;653.0;482
1933;Alblasserdam;2015;19253;5027;10601;3625;16574;1282;490;792;1397;711;686;132;54;78;104;50;54;499;266;233;200;86;114;462;255;207;238.0;186.0;62.0;65.0;633.0;646.0;482
1934;Alblasserdam;2016;19290;4983;10655;3652;16558;1306;501;805;1426;719;707;138;56;82;106;49;57;487;265;222;209;88;121;486;261;225;237.0;187.0;55.0;67.0;660.0;647.0;482
1935;Alblasserdam;2017;19341;4974;10665;3702;16583;1298;485;813;1460;717;743;149;62;87;109;50;59;494;264;230;216;83;133;492;258;234;243.0;190.0;67.0;69.0;700.0;632.0;482
1936;Alblasserdam;2018;19459;4982;10714;3763;16673;1296;483;813;1490;734;756;154;65;89;119;56;63;473;254;219;223;88;135;521;271;250;238.0;192.0;50.0;61.0;640.0;632.0;482
1937;Alblasserdam;2019;19504;4979;10752;3773;16687;1294;483;811;1523;745;778;163;67;96;118;59;59;470;247;223;226;92;134;546;280;266;239.0;193.0;51.0;65.0;648.0;671.0;482
1938;Alblasserdam;2020;19515;4928;10787;3800;16684;1288;470;818;1543;767;776;164;69;95;123;63;60;450;245;205;232;93;139;574;297;277;241.0;197.0;52.0;60.0;714.0;649.0;482
1939;Alblasserdam;2021;19617;4925;10836;3856;16769;1278;461;817;1570;779;791;167;67;100;127;69;58;441;239;202;241;100;141;594;304;290;248.0;192.0;51.0;62.0;607.0;647.0;482
1940;Alblasserdam;2022;19622;4880;10839;3903;16738;1286;467;819;1598;799;799;174;71;103;127;67;60;439;239;200;242;104;138;616;318;298;242.0;193.0;71.0;65.0;653.0;662.0;482
1941;Alblasserdam;2023;19671;4847;10838;3986;16765;1288;466;822;1618;809;809;184;75;109;128;66;62;438;235;203;238;102;136;630;331;299;243.0;198.0;58.0;64.0;652.0;685.0;482
1942;Alblasserdam;2024;19678;4822;10807;4049;16751;1299;470;829;1628;813;815;188;78;110;129;64;65;432;229;203;245;108;137;634;334;300;234.0;202.0;52.0;68.0;759.0;674.0;482
1943;Alblasserdam;2025;19782;4785;10851;4146;16808;1308;467;841;1666;829;837;203;84;119;140;71;69;438;231;207;245;105;140;640;338;302;;;;;;;482
1944;Albrandswaard;2008;21512;5381;13291;2840;18251;1555;575;980;1706;876;830;653;330;323;132;64;68;238;93;145;150;73;77;533;316;217;229.0;156.0;56.0;93.0;1161.0;905.0;613
1945;Albrandswaard;2009;21807;5379;13469;2959;18406;1561;575;986;1840;916;924;663;323;340;142;74;68;288;113;175;187;86;101;560;320;240;223.0;161.0;71.0;88.0;1241.0;955.0;613
1946;Albrandswaard;2010;22140;5359;13706;3075;18603;1597;602;995;1940;949;991;665;324;341;139;73;66;324;126;198;219;93;126;593;333;260;225.0;171.0;69.0;97.0;899.0;947.0;613
1947;Albrandswaard;2011;22122;5255;13714;3153;18492;1590;604;986;2040;982;1058;684;325;359;147;74;73;349;133;216;237;103;134;623;347;276;217.0;178.0;78.0;88.0;820.0;949.0;613
1948;Albrandswaard;2012;22022;5146;13514;3362;18360;1570;590;980;2092;995;1097;685;327;358;153;76;77;366;140;226;246;103;143;642;349;293;214.0;180.0;72.0;93.0;899.0;915.0;613
1949;Albrandswaard;2013;22019;5102;13379;3538;18293;1563;590;973;2163;1011;1152;697;331;366;146;72;74;385;146;239;262;107;155;673;355;318;214.0;186.0;76.0;84.0;951.0;893.0;613
1950;Albrandswaard;2014;22099;5049;13342;3708;18294;1577;603;974;2228;1019;1209;692;320;372;154;72;82;414;159;255;278;109;169;690;359;331;214.0;185.0;77.0;88.0;813.0;906.0;613
1951;Albrandswaard;2015;22026;4980;13185;3861;18169;1592;602;990;2265;1012;1253;685;309;376;162;76;86;432;158;274;295;119;176;691;350;341;210.0;188.0;72.0;84.0;766.0;868.0;613
1952;Albrandswaard;2016;21934;4889;13072;3973;18001;1612;622;990;2321;1032;1289;677;305;372;166;76;90;462;160;302;303;125;178;713;366;347;209.0;193.0;76.0;85.0;1050.0;888.0;613
1953;Albrandswaard;2017;22105;4886;13158;4061;18073;1648;626;1022;2384;1019;1365;662;294;368;175;75;100;505;162;343;317;122;195;725;366;359;214.0;194.0;81.0;88.0;940.0;885.0;613
1954;Albrandswaard;2018;22175;4829;13175;4171;18078;1678;648;1030;2419;1024;1395;658;292;366;173;76;97;517;165;352;333;126;207;738;365;373;224.0;197.0;76.0;82.0;841.0;887.0;613
1955;Albrandswaard;2019;22152;4785;13083;4284;18038;1669;636;1033;2445;1026;1419;635;285;350;180;78;102;541;168;373;344;130;214;745;365;380;216.0;209.0;74.0;88.0;765.0;865.0;613
1956;Albrandswaard;2020;22048;4706;12937;4405;17890;1677;631;1046;2481;1041;1440;631;283;348;184;81;103;567;176;391;342;130;212;757;371;386;214.0;204.0;74.0;85.0;1027.0;833.0;613
1957;Albrandswaard;2021;22244;4726;12997;4521;17965;1668;632;1036;2611;1067;1544;639;286;353;206;86;120;601;176;425;369;136;233;796;383;413;211.0;212.0;74.0;86.0;971.0;890.0;613
1958;Albrandswaard;2022;22316;4690;12987;4639;17965;1695;635;1060;2656;1069;1587;649;287;362;201;84;117;624;184;440;380;134;246;802;380;422;214.0;209.0;81.0;85.0;789.0;883.0;613
1959;Albrandswaard;2023;22224;4630;12833;4761;17810;1720;647;1073;2694;1092;1602;641;282;359;215;95;120;621;188;433;397;140;257;820;387;433;210.0;220.0;65.0;81.0;1066.0;890.0;613
1960;Albrandswaard;2024;22377;4608;12845;4924;17857;1744;654;1090;2776;1113;1663;646;281;365;216;93;123;635;192;443;397;139;258;882;408;474;206.0;223.0;83.0;80.0;806.0;898.0;613
1961;Albrandswaard;2025;22273;4565;12671;5037;17740;1730;648;1082;2803;1114;1689;641;277;364;217;92;125;646;194;452;400;141;259;899;410;489;;;;;;;613
1962;Alkemade;2008;14507;3708;8769;2030;13471;597;235;362;439;264;175;68;35;33;22;8;14;28;8;20;62;36;26;259;177;82;135.0;110.0;59.0;68.0;481.0;402.0;483
1963;Alkemade;2009;14604;3688;8830;2086;13492;631;253;378;481;287;194;76;36;40;26;10;16;31;11;20;69;37;32;279;193;86;141.0;108.0;65.0;66.0;544.0;405.0;483
1964;Alkemade;2010;14776;3632;8990;2154;13539;686;287;399;551;323;228;88;39;49;34;16;18;51;21;30;81;44;37;297;203;94;144.0;108.0;80.0;72.0;393.0;426.0;483
1965;Alkemade;2011;14789;3590;8986;2213;13491;707;303;404;591;340;251;93;37;56;41;20;21;58;24;34;84;43;41;315;216;99;142.0;119.0;77.0;69.0;440.0;420.0;483
1966;Alkemade;2012;14842;3530;9007;2305;13468;732;313;419;642;354;288;96;37;59;45;22;23;70;29;41;95;43;52;336;223;113;145.0;116.0;86.0;67.0;458.0;419.0;483
1967;Alkemade;2013;14932;3461;9049;2422;13457;788;341;447;687;376;311;113;49;64;47;23;24;77;31;46;101;44;57;349;229;120;143.0;123.0;83.0;71.0;378.0;419.0;483
1968;Alkemade;2014;14926;3396;9015;2515;13420;809;353;456;697;382;315;109;49;60;49;29;20;82;31;51;103;46;57;354;227;127;148.0;129.0;83.0;69.0;378.0;412.0;483
1969;Alkemade;2015;14927;3374;8956;2597;13356;845;375;470;726;393;333;109;51;58;50;28;22;89;32;57;101;49;52;377;233;144;152.0;126.0;86.0;72.0;389.0;415.0;483
1970;Alkemade;2016;14942;3355;8919;2668;13303;881;391;490;758;406;352;111;55;56;57;34;23;98;36;62;109;50;59;383;231;152;147.0;127.0;79.0;68.0;382.0;420.0;483
1971;Alkemade;2017;14934;3304;8882;2748;13265;872;395;477;797;411;386;113;53;60;64;38;26;107;37;70;113;45;68;400;238;162;149.0;137.0;85.0;70.0;426.0;391.0;483
1972;Alkemade;2018;14997;3285;8870;2842;13227;917;420;497;853;447;406;116;57;59;72;39;33;114;43;71;117;46;71;434;262;172;153.0;136.0;83.0;73.0;382.0;403.0;483
1973;Alkemade;2019;15007;3270;8818;2919;13192;932;435;497;883;467;416;115;57;58;79;45;34;122;47;75;123;49;74;444;269;175;150.0;132.0;88.0;73.0;398.0;401.0;483
1974;Alkemade;2020;15039;3230;8783;3026;13148;972;461;511;919;481;438;128;63;65;76;42;34;131;52;79;134;52;82;450;272;178;153.0;140.0;82.0;72.0;396.0;405.0;483
1975;Alkemade;2021;15054;3211;8755;3088;13086;1018;483;535;950;496;454;128;65;63;84;47;37;142;56;86;135;51;84;461;277;184;151.0;143.0;87.0;70.0;389.0;410.0;483
1976;Alkemade;2022;15058;3185;8730;3143;13017;1038;496;542;1003;520;483;132;66;66;89;50;39;147;57;90;140;51;89;495;296;199;151.0;140.0;89.0;73.0;392.0;396.0;483
1977;Alkemade;2023;15083;3152;8707;3224;12964;1090;529;561;1029;539;490;134;67;67;92;55;37;153;58;95;142;52;90;508;307;201;146.0;141.0;89.0;72.0;421.0;399.0;483
1978;Alkemade;2024;15127;3156;8648;3323;12956;1105;534;571;1066;555;511;140;73;67;100;56;44;158;60;98;146;54;92;522;312;210;148.0;151.0;97.0;78.0;359.0;399.0;483
1979;Alkemade;2025;15104;3117;8572;3415;12880;1116;542;574;1108;570;538;143;72;71;110;61;49;162;58;104;155;56;99;538;323;215;;;;;;;483
1980;Alkmaar;2008;94078;21665;59473;12940;73825;9236;3944;5292;11017;6449;4568;1401;713;688;1096;614;482;2609;1404;1205;1722;898;824;4189;2820;1369;1032.0;743.0;638.0;815.0;3797.0;3804.0;361
1981;Alkmaar;2009;94196;21500;59453;13243;73904;9276;3948;5328;11016;6446;4570;1407;714;693;1088;619;469;2564;1373;1191;1749;918;831;4208;2822;1386;997.0;763.0;674.0;820.0;3899.0;3814.0;361
1982;Alkmaar;2010;94382;21398;59345;13639;74076;9303;3983;5320;11003;6400;4603;1418;713;705;1084;615;469;2556;1362;1194;1741;905;836;4204;2805;1399;969.0;783.0;665.0;790.0;4456.0;3906.0;361
1983;Alkmaar;2011;95008;21371;59681;13956;74468;9419;4011;5408;11121;6452;4669;1451;737;714;1101;635;466;2528;1350;1178;1757;898;859;4284;2832;1452;955.0;789.0;684.0;789.0;4273.0;3960.0;361
1984;Alkmaar;2012;95394;21239;59520;14635;74732;9506;4087;5419;11156;6436;4720;1454;728;726;1094;637;457;2509;1327;1182;1793;912;881;4306;2832;1474;943.0;800.0;686.0;767.0;4382.0;3975.0;361
1985;Alkmaar;2013;95877;21153;59415;15309;75100;9503;4086;5417;11274;6474;4800;1483;739;744;1113;642;471;2530;1343;1187;1782;900;882;4366;2850;1516;938.0;817.0;737.0;752.0;4480.0;4066.0;361
1986;Alkmaar;2014;96422;21165;59406;15851;75450;9561;4144;5417;11411;6530;4881;1517;748;769;1145;667;478;2534;1348;1186;1819;906;913;4396;2861;1535;921.0;815.0;690.0;730.0;4454.0;4033.0;361
1987;Alkmaar;2015;96924;21117;59361;16446;75815;9619;4202;5417;11490;6561;4929;1529;758;771;1168;683;485;2509;1332;1177;1835;903;932;4449;2885;1564;935.0;838.0;689.0;725.0;4153.0;4019.0;361
1988;Alkmaar;2016;97131;20993;59194;16944;75936;9656;4265;5391;11539;6583;4956;1564;776;788;1157;682;475;2488;1331;1157;1869;912;957;4461;2882;1579;919.0;858.0;677.0;719.0;4222.0;4033.0;361
1989;Alkmaar;2017;97350;20975;58905;17470;76028;9694;4306;5388;11628;6572;5056;1601;809;792;1152;668;484;2477;1316;1161;1914;901;1013;4484;2878;1606;896.0;862.0;671.0;716.0;4110.0;4019.0;361
1990;Alkmaar;2018;97444;20871;58630;17943;76065;9710;4322;5388;11669;6598;5071;1605;820;785;1146;661;485;2462;1299;1163;1917;910;1007;4539;2908;1631;900.0;869.0;660.0;704.0;4257.0;3985.0;361
1991;Alkmaar;2019;97719;20733;58547;18439;76249;9729;4356;5373;11741;6602;5139;1615;829;786;1179;671;508;2466;1289;1177;1924;909;1015;4557;2904;1653;902.0;887.0;661.0;705.0;4180.0;4036.0;361
1992;Alkmaar;2020;97846;20574;58368;18904;76313;9713;4389;5324;11820;6668;5152;1645;845;800;1173;676;497;2446;1288;1158;1965;924;1041;4591;2935;1656;910.0;898.0;655.0;690.0;4128.0;4003.0;361
1993;Alkmaar;2021;97955;20393;58229;19333;76361;9719;4395;5324;11875;6694;5181;1667;850;817;1195;704;491;2420;1257;1163;1942;919;1023;4651;2964;1687;900.0;905.0;640.0;683.0;4238.0;3977.0;361
1994;Alkmaar;2022;98178;20296;58066;19816;76447;9766;4455;5311;11965;6700;5265;1666;846;820;1217;692;525;2393;1233;1160;1972;924;1048;4717;3005;1712;908.0;931.0;669.0;675.0;4155.0;4033.0;361
1995;Alkmaar;2023;98286;20163;57938;20185;76531;9780;4501;5279;11975;6694;5281;1692;852;840;1204;679;525;2369;1211;1158;1952;917;1035;4758;3035;1723;897.0;941.0;617.0;668.0;4214.0;4003.0;361
1996;Alkmaar;2024;98417;19967;57876;20574;76584;9815;4540;5275;12018;6733;5285;1709;851;858;1217;685;532;2363;1212;1151;1934;900;1034;4795;3085;1710;894.0;952.0;668.0;659.0;4272.0;4021.0;361
1997;Alkmaar;2025;98633;19894;57719;21020;76634;9859;4593;5266;12140;6791;5349;1744;854;890;1231;690;541;2339;1207;1132;1953;906;1047;4873;3134;1739;;;;;;;361
1998;Almelo;2008;72806;18309;43756;10741;56260;6945;2486;4459;9601;5349;4252;384;186;198;297;162;135;5630;2871;2759;589;275;314;2701;1855;846;930.0;680.0;288.0;368.0;2510.0;2493.0;141
1999;Almelo;2009;73002;18376;43654;10972;56536;6900;2474;4426;9566;5333;4233;400;197;203;301;166;135;5511;2827;2684;627;283;344;2727;1860;867;921.0;680.0;318.0;360.0;2497.0;2474.0;141
2000;Almelo;2010;73234;18394;43559;11281;56817;6861;2459;4402;9556;5337;4219;430;214;216;315;180;135;5383;2777;2606;646;282;364;2782;1884;898;901.0;701.0;311.0;354.0;2690.0;2527.0;141
2001;Almelo;2011;73561;18395;43734;11432;57197;6789;2414;4375;9575;5347;4228;447;223;224;330;196;134;5277;2742;2535;698;300;398;2823;1886;937;893.0;703.0;338.0;363.0;2548.0;2477.0;141
2002;Almelo;2012;73812;18429;43557;11826;57436;6787;2419;4368;9589;5326;4263;474;231;243;332;196;136;5188;2696;2492;728;304;424;2867;1899;968;879.0;706.0;323.0;330.0;2723.0;2579.0;141
2003;Almelo;2013;74129;18487;43459;12183;57794;6757;2416;4341;9578;5297;4281;495;244;251;337;201;136;5098;2648;2450;767;310;457;2881;1894;987;864.0;711.0;329.0;336.0;2644.0;2549.0;141
2004;Almelo;2014;74376;18445;43390;12541;58078;6722;2413;4309;9576;5288;4288;533;255;278;340;205;135;4985;2590;2395;779;314;465;2939;1924;1015;887.0;708.0;319.0;327.0;2757.0;2531.0;141
2005;Almelo;2015;74779;18475;43478;12826;58426;6667;2395;4272;9686;5313;4373;568;269;299;365;219;146;4911;2547;2364;825;326;499;3017;1952;1065;873.0;726.0;307.0;329.0;2550.0;2541.0;141
2006;Almelo;2016;74922;18447;43354;13121;58631;6629;2399;4230;9662;5307;4355;580;276;304;368;221;147;4833;2504;2329;826;330;496;3055;1976;1079;870.0;736.0;306.0;308.0;2835.0;2606.0;141
2007;Almelo;2017;75297;18448;43400;13449;58927;6628;2401;4227;9742;5341;4401;618;290;328;396;243;153;4747;2454;2293;866;341;525;3115;2013;1102;885.0;755.0;308.0;315.0;2669.0;2669.0;141
2008;Almelo;2018;75428;18486;43214;13728;59087;6591;2402;4189;9750;5342;4408;644;302;342;398;243;155;4667;2406;2261;880;353;527;3161;2038;1123;868.0;751.0;311.0;306.0;2625.0;2597.0;141
2009;Almelo;2019;75586;18443;43170;13973;59234;6535;2397;4138;9817;5405;4412;672;320;352;417;257;160;4601;2389;2212;911;363;548;3216;2076;1140;892.0;767.0;301.0;298.0;2603.0;2658.0;141
2010;Almelo;2020;75665;18345;43116;14204;59303;6494;2413;4081;9868;5431;4437;707;330;377;420;265;155;4507;2356;2151;943;366;577;3291;2114;1177;874.0;788.0;315.0;301.0;2606.0;2659.0;141
2011;Almelo;2021;75720;18204;43134;14382;59355;6459;2409;4050;9906;5429;4477;716;329;387;433;274;159;4451;2310;2141;976;380;596;3330;2136;1194;885.0;792.0;297.0;303.0;2582.0;2645.0;141
2012;Almelo;2022;75756;18110;43010;14636;59379;6429;2419;4010;9948;5451;4497;736;342;394;453;293;160;4354;2254;2100;1009;388;621;3396;2174;1222;894.0;794.0;301.0;280.0;2409.0;2618.0;141
2013;Almelo;2023;75678;17943;42841;14894;59378;6343;2375;3968;9957;5479;4478;753;356;397;458;311;147;4298;2224;2074;1015;394;621;3433;2194;1239;904.0;802.0;295.0;285.0;2529.0;2618.0;141
2014;Almelo;2024;75709;17876;42727;15106;59425;6288;2369;3919;9996;5500;4496;786;373;413;490;325;165;4201;2180;2021;1023;399;624;3496;2223;1273;897.0;811.0;296.0;287.0;2385.0;2580.0;141
2015;Almelo;2025;75618;17812;42448;15358;59364;6183;2334;3849;10071;5516;4555;808;384;424;509;333;176;4147;2154;1993;1064;410;654;3543;2235;1308;;;;;;;141
2016;Almere;2008;183457;55052;113957;14448;119156;17847;7103;10744;46454;25135;21319;18494;9680;8814;4056;2440;1616;3537;1620;1917;6613;3036;3577;13754;8359;5395;2524.0;929.0;1690.0;1928.0;8011.0;6853.0;34
2017;Almere;2009;185999;55330;115342;15327;120415;18252;7320;10932;47332;25058;22274;18493;9527;8966;4037;2415;1622;3856;1721;2135;7068;3170;3898;13878;8225;5653;2542.0;971.0;1749.0;1925.0;7855.0;6959.0;34
2018;Almere;2010;188317;55647;116329;16341;121382;18724;7556;11168;48211;25051;23160;18478;9395;9083;4073;2406;1667;4120;1802;2318;7486;3298;4188;14054;8150;5904;2513.0;1022.0;1864.0;1908.0;8110.0;7030.0;34
2019;Almere;2011;190861;55749;117878;17234;122585;19163;7752;11411;49113;25070;24043;18435;9282;9153;4110;2397;1713;4371;1865;2506;7897;3427;4470;14300;8099;6201;2548.0;1103.0;1876.0;1899.0;8193.0;7079.0;34
2020;Almere;2012;193414;55843;118775;18796;123822;19574;7968;11606;50018;25122;24896;18506;9275;9231;4154;2373;1781;4570;1905;2665;8312;3578;4734;14476;7991;6485;2517.0;1166.0;1922.0;1865.0;8352.0;7079.0;34
2021;Almere;2013;196109;55962;119844;20303;125030;20038;8221;11817;51041;25181;25860;18543;9238;9305;4209;2357;1852;4785;1966;2819;8768;3683;5085;14736;7937;6799;2549.0;1207.0;1888.0;1871.0;8469.0;7182.0;34
2022;Almere;2014;198772;56155;120936;21681;126333;20507;8467;12040;51932;25248;26684;18520;9187;9333;4245;2339;1906;5029;2042;2987;9128;3788;5340;15010;7892;7118;2570.0;1279.0;1878.0;1857.0;8407.0;7146.0;34
2023;Almere;2015;201359;56211;122020;23128;127489;21016;8753;12263;52854;25292;27562;18517;9127;9390;4305;2330;1975;5279;2114;3165;9521;3879;5642;15232;7842;7390;2605.0;1324.0;1908.0;1850.0;8529.0;7110.0;34
2024;Almere;2016;204131;56524;123090;24517;128895;21598;9029;12569;53638;25486;28152;18492;9076;9416;4367;2332;2035;5485;2180;3305;9842;4006;5836;15452;7892;7560;2631.0;1376.0;1925.0;1836.0;8585.0;7189.0;34
2025;Almere;2017;206887;56932;124063;25892;130243;22128;9285;12843;54516;25624;28892;18463;9032;9431;4415;2321;2094;5720;2257;3463;10201;4130;6071;15717;7884;7833;2689.0;1438.0;1907.0;1819.0;8643.0;7272.0;34
2026;Almere;2018;209615;57295;124868;27452;131490;22622;9535;13087;55503;25824;29679;18529;9039;9490;4475;2312;2163;5934;2331;3603;10557;4220;6337;16008;7922;8086;2742.0;1485.0;1911.0;1852.0;8688.0;7343.0;34
2027;Almere;2019;212299;57511;125742;29046;132834;23170;9811;13359;56295;25966;30329;18481;8981;9500;4528;2302;2226;6100;2361;3739;10866;4304;6562;16320;8018;8302;2800.0;1534.0;1946.0;1841.0;8700.0;7493.0;34
2028;Almere;2020;214896;57701;126543;30652;134111;23677;10048;13629;57108;26048;31060;18467;8949;9518;4582;2282;2300;6313;2435;3878;11195;4398;6797;16551;7984;8567;2856.0;1588.0;1929.0;1848.0;8774.0;7569.0;34
2029;Almere;2021;217468;57820;127296;32352;135460;24182;10294;13888;57826;26145;31681;18422;8887;9535;4607;2282;2325;6499;2475;4024;11437;4460;6977;16861;8041;8820;2931.0;1649.0;1908.0;1849.0;8901.0;7581.0;34
2030;Almere;2022;220150;58003;128016;34131;136830;24749;10523;14226;58571;26301;32270;18375;8848;9527;4660;2272;2388;6675;2514;4161;11679;4532;7147;17182;8135;9047;3018.0;1699.0;1935.0;1821.0;9061.0;7681.0;34
2031;Almere;2023;222977;58305;128668;36004;138252;25406;10845;14561;59319;26424;32895;18303;8772;9531;4742;2275;2467;6843;2577;4266;11929;4611;7318;17502;8189;9313;3044.0;1780.0;1988.0;1817.0;9255.0;7977.0;34
2032;Almere;2024;225701;58695;129182;37824;139583;26032;11136;14896;60086;26538;33548;18256;8695;9561;4834;2280;2554;7004;2616;4388;12140;4674;7466;17852;8273;9579;3142.0;1840.0;1959.0;1798.0;9341.0;7875.0;34
2033;Almere;2025;228651;59195;129794;39662;140947;26694;11495;15199;61010;26799;34211;18215;8651;9564;4965;2318;2647;7184;2668;4516;12416;4786;7630;18230;8376;9854;;;;;;;34
2034;Alphen aan den Rijn;2008;70949;17934;44344;8671;57539;6255;2438;3817;7155;4039;3116;1259;686;573;673;375;298;895;472;423;1805;911;894;2523;1595;928;810.0;508.0;314.0;464.0;2153.0;2514.0;484
2035;Alphen aan den Rijn;2009;70753;17760;44020;8973;57378;6204;2436;3768;7171;4028;3143;1268;679;589;655;366;289;940;491;449;1828;927;901;2480;1565;915;779.0;532.0;318.0;456.0;2252.0;2459.0;484
2036;Alphen aan den Rijn;2010;70661;17594;43757;9310;57263;6221;2455;3766;7177;4032;3145;1278;675;603;664;378;286;959;503;456;1843;941;902;2433;1535;898;774.0;530.0;333.0;439.0;2355.0;2420.0;484
2037;Alphen aan den Rijn;2011;70741;17472;43644;9625;57258;6271;2511;3760;7212;4036;3176;1287;680;607;644;371;273;981;513;468;1856;950;906;2444;1522;922;736.0;538.0;334.0;458.0;2282.0;2420.0;484
2038;Alphen aan den Rijn;2012;70687;17302;43176;10209;57100;6298;2532;3766;7289;4032;3257;1295;681;614;651;367;284;1017;521;496;1872;947;925;2454;1516;938;726.0;554.0;336.0;425.0;2288.0;2346.0;484
2039;Alphen aan den Rijn;2013;70725;17130;42811;10784;57131;6273;2527;3746;7321;4036;3285;1317;685;632;656;367;289;1020;528;492;1884;959;925;2444;1497;947;712.0;571.0;322.0;421.0;2299.0;2361.0;484
2040;Alphen aan den Rijn;2014;70711;16967;42442;11302;57025;6325;2573;3752;7361;4052;3309;1348;704;644;648;363;285;1047;547;500;1889;956;933;2429;1482;947;697.0;579.0;341.0;410.0;2242.0;2319.0;484
2041;Alphen aan den Rijn;2015;70688;16782;42129;11777;56906;6374;2607;3767;7408;4059;3349;1327;692;635;665;376;289;1071;559;512;1903;966;937;2442;1466;976;689.0;594.0;330.0;403.0;2259.0;2269.0;484
2042;Alphen aan den Rijn;2016;70707;16628;41898;12181;56849;6421;2615;3806;7437;4038;3399;1332;689;643;674;380;294;1079;544;535;1915;968;947;2437;1457;980;686.0;602.0;332.0;382.0;2279.0;2301.0;484
2043;Alphen aan den Rijn;2017;70724;16495;41628;12601;56765;6468;2673;3795;7491;4061;3430;1333;699;634;679;387;292;1120;557;563;1921;968;953;2438;1450;988;672.0;629.0;321.0;385.0;2317.0;2321.0;484
2044;Alphen aan den Rijn;2018;70705;16359;41342;13004;56636;6508;2722;3786;7561;4073;3488;1333;688;645;679;385;294;1159;563;596;1927;976;951;2463;1461;1002;666.0;628.0;308.0;385.0;2287.0;2320.0;484
2045;Alphen aan den Rijn;2019;70639;16119;41165;13355;56523;6541;2750;3791;7575;4067;3508;1327;674;653;691;395;296;1197;574;623;1911;976;935;2449;1448;1001;666.0;645.0;314.0;374.0;2296.0;2323.0;484
2046;Alphen aan den Rijn;2020;70579;15905;40899;13775;56390;6573;2785;3788;7616;4080;3536;1332;678;654;689;398;291;1228;585;643;1929;987;942;2438;1432;1006;666.0;658.0;326.0;367.0;2277.0;2297.0;484
2047;Alphen aan den Rijn;2021;70542;15677;40722;14143;56235;6616;2813;3803;7691;4117;3574;1338;683;655;693;410;283;1248;596;652;1906;973;933;2506;1455;1051;673.0;672.0;301.0;353.0;2305.0;2316.0;484
2048;Alphen aan den Rijn;2022;70486;15451;40544;14491;56044;6680;2850;3830;7762;4133;3629;1338;674;664;713;418;295;1297;616;681;1904;975;929;2510;1450;1060;674.0;680.0;321.0;339.0;2308.0;2296.0;484
2049;Alphen aan den Rijn;2023;70480;15287;40370;14823;55910;6729;2892;3837;7841;4165;3676;1332;675;657;741;429;312;1334;621;713;1893;959;934;2541;1481;1060;681.0;705.0;305.0;351.0;2266.0;2328.0;484
2050;Alphen aan den Rijn;2024;70355;15075;40144;15136;55654;6769;2943;3826;7932;4258;3674;1347;682;665;757;439;318;1368;649;719;1889;962;927;2571;1526;1045;674.0;714.0;292.0;338.0;2300.0;2335.0;484
2051;Alphen aan den Rijn;2025;70239;14956;39815;15468;55443;6812;2987;3825;7984;4294;3690;1339;675;664;766;452;314;1394;658;736;1893;967;926;2592;1542;1050;;;;;;;484
2052;Alphen-Chaam;2008;9532;2380;5660;1492;8300;1021;279;742;211;127;84;15;7;8;15;6;9;10;5;5;12;2;10;159;107;52;80.0;79.0;41.0;51.0;231.0;219.0;1723
2053;Alphen-Chaam;2009;9536;2349;5638;1549;8255;1023;287;736;258;149;109;18;9;9;13;5;8;15;4;11;22;3;19;190;128;62;80.0;81.0;49.0;56.0;242.0;243.0;1723
2054;Alphen-Chaam;2010;9528;2323;5596;1609;8190;1030;295;735;308;177;131;24;11;13;20;10;10;26;9;17;27;4;23;211;143;68;80.0;83.0;50.0;56.0;213.0;232.0;1723
2055;Alphen-Chaam;2011;9501;2276;5542;1683;8129;1008;294;714;364;210;154;34;15;19;21;10;11;29;11;18;36;7;29;244;167;77;78.0;88.0;62.0;58.0;241.0;290.0;1723
2056;Alphen-Chaam;2012;9447;2230;5447;1770;8063;992;291;701;392;223;169;41;19;22;23;12;11;34;13;21;43;10;33;251;169;82;75.0;90.0;51.0;54.0;239.0;286.0;1723
2057;Alphen-Chaam;2013;9384;2162;5394;1828;7983;984;282;702;417;229;188;44;20;24;31;18;13;41;14;27;52;12;40;249;165;84;77.0;92.0;54.0;55.0;227.0;287.0;1723
2058;Alphen-Chaam;2014;9310;2116;5324;1870;7894;967;270;697;449;236;213;53;24;29;33;17;16;50;15;35;57;13;44;256;167;89;73.0;92.0;51.0;54.0;217.0;271.0;1723
2059;Alphen-Chaam;2015;9234;2042;5291;1901;7794;961;281;680;479;248;231;53;26;27;36;19;17;56;18;38;63;11;52;271;174;97;71.0;94.0;55.0;55.0;253.0;298.0;1723
2060;Alphen-Chaam;2016;9167;1981;5229;1957;7710;934;275;659;523;275;248;59;31;28;41;24;17;61;17;44;69;11;58;293;192;101;71.0;96.0;56.0;54.0;238.0;312.0;1723
2061;Alphen-Chaam;2017;9070;1931;5147;1992;7582;942;289;653;546;296;250;66;33;33;40;22;18;66;22;44;67;12;55;307;207;100;68.0;98.0;49.0;55.0;224.0;299.0;1723
2062;Alphen-Chaam;2018;8959;1881;5059;2019;7468;922;270;652;569;307;262;69;34;35;38;22;16;76;28;48;72;13;59;314;210;104;70.0;100.0;50.0;56.0;217.0;297.0;1723
2063;Alphen-Chaam;2019;8845;1830;4968;2047;7363;900;265;635;582;313;269;80;38;42;44;25;19;78;29;49;73;13;60;307;208;99;69.0;103.0;51.0;52.0;212.0;279.0;1723
2064;Alphen-Chaam;2020;8745;1805;4832;2108;7249;884;265;619;612;323;289;83;41;42;44;22;22;80;30;50;79;13;66;326;217;109;73.0;100.0;53.0;50.0;215.0;306.0;1723
2065;Alphen-Chaam;2021;8632;1753;4768;2111;7115;865;266;599;652;348;304;90;43;47;47;22;25;79;31;48;85;16;69;351;236;115;68.0;100.0;48.0;50.0;206.0;316.0;1723
2066;Alphen-Chaam;2022;8490;1680;4670;2140;6969;865;267;598;656;340;316;88;41;47;45;19;26;85;35;50;91;17;74;347;228;119;70.0;103.0;52.0;50.0;200.0;315.0;1723
2067;Alphen-Chaam;2023;8345;1645;4517;2183;6807;855;259;596;683;350;333;93;43;50;48;19;29;90;37;53;93;15;78;359;236;123;65.0;102.0;45.0;48.0;218.0;280.0;1723
2068;Alphen-Chaam;2024;8244;1586;4467;2191;6715;851;265;586;678;344;334;92;43;49;47;21;26;87;34;53;97;16;81;355;230;125;69.0;98.0;44.0;53.0;209.0;319.0;1723
2069;Alphen-Chaam;2025;8097;1520;4351;2226;6579;848;269;579;670;337;333;95;44;51;37;19;18;86;34;52;98;16;82;354;224;130;;;;;;;1723
2070;Ameland;2008;3414;841;2047;526;3220;133;70;63;61;46;15;3;2;1;7;4;3;1;1;0;3;3;0;47;36;11;36.0;31.0;8.0;14.0;140.0;173.0;60
2071;Ameland;2009;3380;828;2002;550;3169;135;67;68;76;53;23;5;2;3;8;5;3;4;1;3;6;5;1;53;40;13;34.0;31.0;19.0;13.0;131.0;171.0;60
2072;Ameland;2010;3349;821;1962;566;3118;133;63;70;98;67;31;11;5;6;10;6;4;7;2;5;10;7;3;60;47;13;34.0;30.0;11.0;12.0;156.0;178.0;60
2073;Ameland;2011;3330;808;1929;593;3095;130;63;67;105;67;38;14;6;8;10;5;5;8;2;6;14;8;6;59;46;13;35.0;32.0;10.0;11.0;165.0;177.0;60
2074;Ameland;2012;3320;790;1911;619;3074;134;61;73;112;73;39;11;6;5;9;5;4;9;2;7;20;12;8;63;48;15;32.0;30.0;11.0;12.0;172.0;168.0;60
2075;Ameland;2013;3325;755;1922;648;3062;140;62;78;123;78;45;12;6;6;11;7;4;12;3;9;20;12;8;68;50;18;33.0;31.0;10.0;13.0;187.0;180.0;60
2076;Ameland;2014;3331;742;1927;662;3059;137;55;82;135;80;55;16;8;8;14;10;4;13;3;10;19;10;9;73;49;24;34.0;32.0;10.0;13.0;182.0;186.0;60
2077;Ameland;2015;3326;717;1938;671;3059;140;57;83;127;73;54;17;7;10;16;11;5;12;4;8;18;9;9;64;42;22;36.0;33.0;10.0;13.0;182.0;191.0;60
2078;Ameland;2016;3317;713;1905;699;3038;146;59;87;133;76;57;17;7;10;17;11;6;10;4;6;20;11;9;69;43;26;33.0;34.0;10.0;11.0;232.0;188.0;60
2079;Ameland;2017;3360;720;1931;709;3068;151;59;92;141;79;62;18;7;11;21;12;9;10;4;6;23;12;11;69;44;25;37.0;33.0;9.0;14.0;178.0;200.0;60
2080;Ameland;2018;3337;700;1914;723;3031;151;58;93;155;94;61;16;7;9;22;16;6;6;4;2;29;14;15;82;53;29;36.0;34.0;12.0;13.0;186.0;202.0;60
2081;Ameland;2019;3322;676;1898;748;3012;154;56;98;156;92;64;22;9;13;23;16;7;9;4;5;25;11;14;77;52;25;37.0;36.0;10.0;12.0;144.0;184.0;60
2082;Ameland;2020;3281;664;1859;758;2970;157;55;102;154;94;60;25;11;14;21;15;6;7;3;4;24;11;13;77;54;23;35.0;35.0;9.0;13.0;195.0;190.0;60
2083;Ameland;2021;3282;656;1867;759;2952;169;56;113;161;96;65;25;10;15;20;15;5;10;1;9;22;10;12;84;60;24;36.0;38.0;9.0;13.0;203.0;181.0;60
2084;Ameland;2022;3298;657;1863;778;2965;163;50;113;170;98;72;28;11;17;22;17;5;15;4;11;23;10;13;82;56;26;38.0;37.0;11.0;11.0;163.0;179.0;60
2085;Ameland;2023;3284;656;1830;798;2941;165;52;113;178;99;79;28;11;17;23;18;5;19;6;13;25;11;14;83;53;30;38.0;38.0;8.0;12.0;149.0;180.0;60
2086;Ameland;2024;3249;635;1826;788;2901;158;43;115;190;104;86;29;11;18;26;20;6;22;6;16;31;13;18;82;54;28;34.0;38.0;6.0;14.0;135.0;184.0;60
2087;Ameland;2025;3187;617;1769;801;2841;158;47;111;188;103;85;31;12;19;26;20;6;24;7;17;25;10;15;82;54;28;;;;;;;60
2088;Amersfoort;2008;140579;37790;86040;16749;110074;11934;4369;7565;18571;10693;7878;1637;822;815;1513;885;628;5470;2994;2476;4039;2038;2001;5912;3954;1958;1889.0;1021.0;902.0;988.0;6395.0;5330.0;307
2089;Amersfoort;2009;142450;38242;86975;17233;111570;12135;4459;7676;18745;10712;8033;1652;822;830;1526;885;641;5461;2976;2485;4054;2024;2030;6052;4005;2047;1880.0;1032.0;933.0;979.0;6681.0;5424.0;307
2090;Amersfoort;2010;144533;38721;88041;17771;113189;12362;4554;7808;18982;10730;8252;1721;836;885;1537;902;635;5470;2965;2505;4130;2025;2105;6124;4002;2122;1829.0;1060.0;935.0;979.0;6666.0;5532.0;307
2091;Amersfoort;2011;146410;39018;89193;18199;114700;12562;4657;7905;19148;10762;8386;1782;868;914;1561;923;638;5433;2935;2498;4159;2022;2137;6213;4014;2199;1818.0;1083.0;987.0;959.0;6627.0;5600.0;307
2092;Amersfoort;2012;148224;39303;89689;19232;116105;12733;4747;7986;19386;10840;8546;1855;885;970;1578;947;631;5435;2921;2514;4180;2012;2168;6338;4075;2263;1787.0;1089.0;952.0;963.0;6619.0;5650.0;307
2093;Amersfoort;2013;149898;39458;90371;20069;117418;12927;4831;8096;19553;10857;8696;1875;894;981;1616;967;649;5418;2901;2517;4202;2015;2187;6442;4080;2362;1761.0;1130.0;967.0;950.0;6603.0;5702.0;307
2094;Amersfoort;2014;151460;39544;90974;20942;118623;13108;4917;8191;19729;10920;8809;1907;909;998;1660;988;672;5368;2901;2467;4245;2005;2240;6549;4117;2432;1759.0;1141.0;952.0;950.0;6708.0;5735.0;307
2095;Amersfoort;2015;153078;39609;91810;21659;119809;13345;5067;8278;19924;10971;8953;1934;917;1017;1664;996;668;5360;2890;2470;4274;1996;2278;6692;4172;2520;1731.0;1148.0;949.0;935.0;6726.0;5714.0;307
2096;Amersfoort;2016;154702;39583;92630;22489;121015;13583;5160;8423;20104;11044;9060;1983;945;1038;1685;992;693;5319;2861;2458;4292;1988;2304;6825;4258;2567;1719.0;1177.0;955.0;937.0;6247.0;5819.0;307
2097;Amersfoort;2017;155702;39551;92936;23215;121851;13692;5243;8449;20159;11119;9040;2027;974;1053;1669;999;670;5267;2853;2414;4278;1982;2296;6918;4311;2607;1712.0;1223.0;971.0;911.0;6130.0;5878.0;307
2098;Amersfoort;2018;156526;39292;93350;23884;122388;13807;5297;8510;20331;11166;9165;2083;997;1086;1690;1005;685;5264;2854;2410;4241;1954;2287;7053;4356;2697;1696.0;1252.0;981.0;929.0;6341.0;5805.0;307
2099;Amersfoort;2019;157570;39070;93805;24695;123095;13996;5402;8594;20479;11274;9205;2123;1023;1100;1720;1025;695;5223;2845;2378;4267;1973;2294;7146;4408;2738;1695.0;1271.0;913.0;909.0;6133.0;5895.0;307
2100;Amersfoort;2020;158253;38728;94044;25481;123691;14082;5450;8632;20480;11304;9176;2152;1044;1108;1750;1040;710;5164;2823;2341;4211;1946;2265;7203;4451;2752;1680.0;1279.0;952.0;895.0;6028.0;5888.0;307
2101;Amersfoort;2021;158880;38365;94314;26201;124046;14259;5589;8670;20575;11402;9173;2173;1064;1109;1784;1056;728;5131;2831;2300;4183;1939;2244;7304;4512;2792;1672.0;1314.0;953.0;906.0;6101.0;5922.0;307
2102;Amersfoort;2022;159480;37974;94471;27035;124508;14333;5640;8693;20639;11437;9202;2205;1074;1131;1821;1089;732;5061;2817;2244;4178;1938;2240;7374;4519;2855;1682.0;1332.0;897.0;889.0;6221.0;5918.0;307
2103;Amersfoort;2023;160157;37619;94652;27886;124881;14452;5753;8699;20824;11529;9295;2225;1087;1138;1842;1086;756;5072;2811;2261;4178;1938;2240;7507;4607;2900;1658.0;1367.0;918.0;866.0;6300.0;5946.0;307
2104;Amersfoort;2024;160878;37226;94885;28767;125295;14606;5856;8750;20977;11645;9332;2280;1116;1164;1846;1087;759;5021;2808;2213;4182;1925;2257;7648;4709;2939;1635.0;1389.0;912.0;879.0;6178.0;5936.0;307
2105;Amersfoort;2025;161421;36964;94797;29660;125582;14741;5954;8787;21098;11723;9375;2298;1133;1165;1872;1105;767;5015;2801;2214;4160;1916;2244;7753;4768;2985;;;;;;;307
2106;Amstelveen;2008;80370;17645;48307;14418;55388;14536;8187;6349;10446;6322;4124;2129;1074;1055;743;410;333;693;372;321;918;450;468;5963;4016;1947;737.0;794.0;1604.0;1575.0;4888.0;4161.0;362
2107;Amstelveen;2009;81080;17687;48986;14407;55421;14940;8488;6452;10719;6335;4384;2167;1039;1128;741;407;334;790;426;364;1015;486;529;6006;3977;2029;753.0;795.0;1689.0;1593.0;4795.0;4258.0;362
2108;Amstelveen;2010;81678;17707;49572;14399;55377;15352;8806;6546;10949;6360;4589;2197;1032;1165;774;421;353;865;458;407;1102;513;589;6011;3936;2075;770.0;785.0;1768.0;1593.0;4708.0;4272.0;362
2109;Amstelveen;2011;82281;17792;50123;14366;55348;15798;9152;6646;11135;6336;4799;2244;1037;1207;786;426;360;929;489;440;1194;535;659;5982;3849;2133;785.0;785.0;1799.0;1604.0;4476.0;4271.0;362
2110;Amstelveen;2012;82685;17710;50299;14676;55166;16184;9449;6735;11335;6355;4980;2292;1033;1259;793;422;371;985;501;484;1270;559;711;5995;3840;2155;788.0;783.0;1833.0;1582.0;4502.0;4282.0;362
2111;Amstelveen;2013;83166;17646;50545;14975;55112;16541;9758;6783;11513;6374;5139;2281;1029;1252;821;441;380;1040;522;518;1330;580;750;6041;3802;2239;793.0;774.0;1835.0;1606.0;4640.0;4270.0;362
2112;Amstelveen;2014;83787;17590;51013;15184;55136;16903;10061;6842;11748;6395;5353;2334;1035;1299;818;433;385;1097;544;553;1407;608;799;6092;3775;2317;819.0;779.0;1851.0;1611.0;4476.0;4240.0;362
2113;Amstelveen;2015;84310;17525;51412;15373;55128;17237;10312;6925;11945;6401;5544;2358;1039;1319;836;435;401;1147;563;584;1469;620;849;6135;3744;2391;835.0;782.0;1850.0;1608.0;4484.0;4189.0;362
2114;Amstelveen;2016;84910;17477;51850;15583;55088;17619;10569;7050;12203;6393;5810;2409;1041;1368;864;430;434;1212;578;634;1525;626;899;6193;3718;2475;835.0;771.0;1833.0;1596.0;4463.0;4227.0;362
2115;Amstelveen;2017;85456;17405;52252;15799;55051;17948;10752;7196;12457;6441;6016;2446;1051;1395;902;455;447;1252;602;650;1589;640;949;6268;3693;2575;840.0;784.0;1877.0;1607.0;4380.0;4210.0;362
2116;Amstelveen;2018;85959;17385;52570;16004;55059;18339;11011;7328;12561;6440;6121;2443;1051;1392;901;452;449;1274;610;664;1648;664;984;6295;3663;2632;840.0;777.0;1887.0;1607.0;4385.0;4225.0;362
2117;Amstelveen;2019;86468;17279;52876;16313;55041;18670;11205;7465;12757;6461;6296;2475;1054;1421;915;464;451;1314;625;689;1709;676;1033;6344;3642;2702;843.0;774.0;1887.0;1588.0;4370.0;4265.0;362
2118;Amstelveen;2020;86945;17145;53261;16539;54975;19031;11428;7603;12939;6521;6418;2499;1067;1432;930;472;458;1368;648;720;1779;706;1073;6363;3628;2735;853.0;785.0;1912.0;1600.0;4238.0;4234.0;362
2119;Amstelveen;2021;87337;16995;53557;16785;54963;19358;11662;7696;13016;6491;6525;2488;1065;1423;960;483;477;1404;669;735;1836;725;1111;6328;3549;2779;862.0;786.0;1900.0;1570.0;4293.0;4321.0;362
2120;Amstelveen;2022;87725;16854;53778;17093;54866;19674;11870;7804;13185;6506;6679;2476;1055;1421;1005;496;509;1479;702;777;1882;730;1152;6343;3523;2820;864.0;790.0;1920.0;1593.0;4062.0;4226.0;362
2121;Amstelveen;2023;87968;16753;53795;17420;54679;20000;12074;7926;13289;6492;6797;2490;1059;1431;1033;511;522;1509;717;792;1933;724;1209;6324;3481;2843;857.0;797.0;1911.0;1561.0;4129.0;4345.0;362
2122;Amstelveen;2024;88168;16630;53733;17805;54531;20269;12249;8020;13368;6473;6895;2509;1051;1458;1059;521;538;1514;731;783;1960;719;1241;6326;3451;2875;855.0;813.0;1916.0;1553.0;4073.0;4287.0;362
2123;Amstelveen;2025;88364;16553;53629;18182;54329;20577;12424;8153;13458;6477;6981;2501;1041;1460;1066;530;536;1556;736;820;2000;732;1268;6335;3438;2897;;;;;;;362
2124;Amsterdam;2008;752063;158303;506872;86888;392536;109292;59475;49817;250235;147157;103078;66666;39211;27455;11132;7022;4110;37970;20675;17295;63803;32703;31100;70664;47546;23118;10427.0;5803.0;15161.0;14341.0;29064.0;28612.0;363
2125;Amsterdam;2009;758058;160186;508990;88882;397154;111865;61337;50528;249039;144732;104307;65514;38224;27290;11224;7065;4159;37921;20272;17649;63332;31793;31539;71048;47378;23670;10464.0;5887.0;15765.0;14287.0;29327.0;28767.0;363
2126;Amsterdam;2010;764775;162353;511104;91318;402114;114739;63433;51306;247922;142487;105435;64408;37319;27089;11317;7118;4199;37893;19834;18059;62870;31020;31850;71434;47196;24238;10509.0;5947.0;16358.0;14191.0;27376.0;28839.0;363
2127;Amsterdam;2011;770157;163865;513281;93011;405646;117546;65506;52040;246965;140411;106554;63555;36570;26985;11479;7204;4275;37836;19459;18377;62468;30285;32183;71627;46893;24734;10516.0;6029.0;16788.0;14009.0;26781.0;28979.0;363
2128;Amsterdam;2012;775320;165243;512532;97545;408810;120445;67640;52805;246065;138378;107687;62616;35801;26815;11608;7296;4312;37864;19135;18729;62230;29693;32537;71747;46453;25294;10483.0;6107.0;16832.0;14074.0;26888.0;28645.0;363
2129;Amsterdam;2013;780789;166863;512345;101581;412319;123240;69632;53608;245230;136497;108733;61757;35080;26677;11768;7359;4409;37824;18846;18978;61961;29095;32866;71920;46117;25803;10416.0;6179.0;16937.0;13919.0;26976.0;28705.0;363
2130;Amsterdam;2014;786414;168814;512528;105072;415953;126087;71670;54417;244374;134694;109680;60950;34437;26513;11923;7439;4484;37741;18569;19172;61620;28458;33162;72140;45791;26349;10434.0;6251.0;16929.0;13884.0;26489.0;28505.0;363
2131;Amsterdam;2015;791707;170556;512956;108195;419161;128861;73661;55200;243685;132944;110741;60251;33827;26424;12030;7471;4559;37749;18299;19450;61339;27902;33437;72316;45445;26871;10411.0;6324.0;16973.0;13796.0;26374.0;28329.0;363
2132;Amsterdam;2016;797106;172173;513401;111532;422647;131673;75555;56118;242786;131175;111611;59468;33157;26311;12152;7544;4608;37729;18025;19704;60932;27362;33570;72505;45087;27418;10494.0;6441.0;16922.0;13716.0;25992.0;28732.0;363
2133;Amsterdam;2017;801702;173590;513864;114248;425623;134125;77291;56834;241954;129605;112349;58685;32573;26112;12270;7617;4653;37722;17775;19947;60552;26862;33690;72725;44778;27947;10522.0;6525.0;16996.0;13609.0;25933.0;28612.0;363
2134;Amsterdam;2018;806498;174834;514241;117423;428500;136865;79069;57796;241133;127965;113168;57946;31954;25992;12397;7642;4755;37681;17581;20100;60172;26405;33767;72937;44383;28554;10493.0;6572.0;16928.0;13582.0;25869.0;28668.0;363
2135;Amsterdam;2019;811065;175813;514918;120334;431234;139384;80811;58573;240447;126558;113889;57244;31388;25856;12534;7699;4835;37709;17381;20328;59720;25935;33785;73240;44155;29085;10593.0;6649.0;16920.0;13509.0;26192.0;28662.0;363
2136;Amsterdam;2020;816051;176918;515798;123335;434212;141947;82434;59513;239892;125087;114805;56542;30790;25752;12651;7744;4907;37737;17179;20558;59325;25443;33882;73637;43931;29706;10662.0;6804.0;16941.0;13444.0;26086.0;28810.0;363
2137;Amsterdam;2021;820769;177784;516594;126391;437003;144503;84076;60427;239263;123762;115501;55848;30199;25649;12756;7762;4994;37702;17000;20702;58867;25010;33857;74090;43791;30299;10670.0;6899.0;17000.0;13350.0;25468.0;29101.0;363
2138;Amsterdam;2022;824638;178022;517080;129536;439028;146917;85662;61255;238693;122534;116159;55259;29614;25645;12898;7835;5063;37549;16777;20772;58408;24648;33760;74579;43660;30919;10691.0;7024.0;16894.0;13244.0;26013.0;29117.0;363
2139;Amsterdam;2023;828931;178422;517944;132565;441390;149387;87181;62206;238154;121280;116874;54646;29071;25575;13032;7840;5192;37588;16608;20980;57767;24239;33528;75121;43522;31599;10696.0;7124.0;17011.0;13172.0;26344.0;29562.0;363
2140;Amsterdam;2024;833209;178573;518835;135801;443353;151893;88715;63178;237963;120187;117776;54097;28516;25581;13246;7922;5324;37592;16421;21171;57360;23897;33463;75668;43431;32237;10796.0;7260.0;16903.0;13103.0;25837.0;29764.0;363
2141;Amsterdam;2025;836719;178589;519028;139102;444794;154283;90158;64125;237642;119007;118635;53500;27922;25578;13360;7937;5423;37579;16267;21312;56834;23475;33359;76369;43406;32963;;;;;;;363
2142;Andijk;2008;6630;1647;4131;852;6052;374;153;221;204;109;95;37;16;21;11;6;5;11;6;5;15;6;9;130;75;55;60.0;47.0;20.0;30.0;392.0;372.0;364
2143;Andijk;2009;6654;1622;4142;890;6066;375;153;222;213;114;99;41;16;25;14;8;6;11;4;7;22;11;11;125;75;50;61.0;50.0;22.0;29.0;407.0;377.0;364
2144;Andijk;2010;6691;1595;4170;926;6093;373;148;225;225;122;103;46;18;28;15;9;6;13;5;8;30;14;16;121;76;45;59.0;49.0;21.0;26.0;430.0;361.0;364
2145;Andijk;2011;6766;1590;4187;989;6149;371;145;226;246;134;112;48;19;29;18;11;7;19;8;11;35;14;21;126;82;44;61.0;52.0;20.0;29.0;371.0;380.0;364
2146;Andijk;2012;6758;1570;4130;1058;6134;362;138;224;262;140;122;53;21;32;19;12;7;23;10;13;41;16;25;126;81;45;60.0;53.0;19.0;26.0;370.0;373.0;364
2147;Andijk;2013;6756;1562;4065;1129;6131;358;142;216;267;142;125;57;23;34;20;11;9;27;13;14;41;17;24;122;78;44;60.0;55.0;18.0;24.0;462.0;366.0;364
2148;Andijk;2014;6852;1540;4105;1207;6203;355;145;210;294;148;146;59;24;35;24;17;7;37;15;22;42;16;26;132;76;56;61.0;58.0;18.0;27.0;321.0;378.0;364
2149;Andijk;2015;6790;1499;4023;1268;6134;349;139;210;307;156;151;64;29;35;22;15;7;42;17;25;42;15;27;137;80;57;61.0;55.0;20.0;29.0;400.0;371.0;364
2150;Andijk;2016;6817;1494;4005;1318;6161;344;138;206;312;152;160;63;26;37;22;15;7;44;17;27;46;15;31;137;79;58;59.0;59.0;17.0;27.0;367.0;370.0;364
2151;Andijk;2017;6806;1458;3974;1374;6139;345;136;209;322;161;161;67;29;38;23;14;9;44;18;26;49;17;32;139;83;56;60.0;58.0;22.0;25.0;411.0;347.0;364
2152;Andijk;2018;6870;1425;4014;1431;6186;342;141;201;342;173;169;72;30;42;29;16;13;46;17;29;51;21;30;144;89;55;61.0;61.0;22.0;21.0;373.0;355.0;364
2153;Andijk;2019;6890;1412;3994;1484;6194;347;149;198;349;177;172;68;28;40;30;16;14;47;18;29;59;23;36;145;92;53;62.0;62.0;16.0;27.0;355.0;362.0;364
2154;Andijk;2020;6872;1396;3956;1520;6160;354;156;198;358;181;177;67;28;39;30;18;12;52;23;29;55;20;35;154;92;62;60.0;64.0;18.0;26.0;403.0;364.0;364
2155;Andijk;2021;6899;1363;3973;1563;6170;359;151;208;370;183;187;73;31;42;32;18;14;49;22;27;63;25;38;153;87;66;58.0;65.0;23.0;25.0;359.0;350.0;364
2156;Andijk;2022;6900;1352;3927;1621;6155;359;164;195;386;192;194;75;34;41;29;19;10;54;25;29;69;27;42;159;87;72;60.0;66.0;22.0;27.0;348.0;371.0;364
2157;Andijk;2023;6866;1329;3879;1658;6132;350;159;191;384;191;193;73;31;42;28;18;10;56;24;32;67;26;41;160;92;68;63.0;68.0;20.0;25.0;408.0;351.0;364
2158;Andijk;2024;6913;1325;3894;1694;6169;350;164;186;394;201;193;76;34;42;25;17;8;59;27;32;66;25;41;168;98;70;66.0;69.0;16.0;25.0;335.0;358.0;364
2159;Andijk;2025;6879;1300;3833;1746;6136;344;155;189;399;202;197;74;33;41;28;16;12;66;31;35;66;25;41;165;97;68;;;;;;;364
2160;Anna Paulowna;2008;14074;3662;8620;1792;12960;688;215;473;426;223;203;66;28;38;83;38;45;27;16;11;17;9;8;233;132;101;131.0;98.0;41.0;60.0;612.0;537.0;366
2161;Anna Paulowna;2009;14164;3594;8703;1867;12992;701;222;479;471;238;233;69;29;40;87;36;51;39;22;17;20;11;9;256;140;116;136.0;103.0;54.0;61.0;447.0;547.0;366
2162;Anna Paulowna;2010;14092;3483;8673;1936;12888;710;229;481;494;240;254;76;31;45;90;36;54;48;25;23;28;13;15;252;135;117;130.0;107.0;41.0;64.0;472.0;537.0;366
2163;Anna Paulowna;2011;14029;3382;8638;2009;12808;707;229;478;514;263;251;73;33;40;87;41;46;55;32;23;42;20;22;257;137;120;124.0;106.0;43.0;63.0;382.0;543.0;366
2164;Anna Paulowna;2012;13868;3280;8486;2102;12601;718;239;479;549;288;261;79;36;43;85;40;45;63;36;27;46;22;24;276;154;122;121.0;109.0;42.0;63.0;490.0;525.0;366
2165;Anna Paulowna;2013;13825;3179;8392;2254;12539;721;241;480;565;296;269;81;36;45;83;42;41;65;35;30;47;22;25;289;161;128;122.0;113.0;42.0;60.0;515.0;507.0;366
2166;Anna Paulowna;2014;13823;3125;8344;2354;12479;728;243;485;616;314;302;87;41;46;92;43;49;90;42;48;55;24;31;292;164;128;119.0;114.0;44.0;59.0;463.0;515.0;366
2167;Anna Paulowna;2015;13761;3028;8273;2460;12402;718;237;481;641;331;310;95;44;51;97;50;47;94;45;49;56;25;31;299;167;132;121.0;119.0;42.0;55.0;560.0;513.0;366
2168;Anna Paulowna;2016;13801;2983;8293;2525;12405;732;246;486;664;333;331;94;45;49;102;50;52;99;44;55;65;27;38;304;167;137;123.0;121.0;49.0;59.0;517.0;531.0;366
2169;Anna Paulowna;2017;13780;2947;8238;2595;12347;758;262;496;675;332;343;97;46;51;102;49;53;102;45;57;63;23;40;311;169;142;119.0;123.0;46.0;59.0;598.0;522.0;366
2170;Anna Paulowna;2018;13844;2894;8260;2690;12374;759;274;485;711;347;364;98;44;54;105;54;51;113;44;69;70;26;44;325;179;146;126.0;127.0;43.0;55.0;548.0;529.0;366
2171;Anna Paulowna;2019;13852;2823;8259;2770;12357;778;277;501;717;334;383;105;45;60;107;50;57;111;44;67;72;27;45;322;168;154;128.0;129.0;44.0;56.0;526.0;515.0;366
2172;Anna Paulowna;2020;13850;2759;8238;2853;12340;782;273;509;728;343;385;106;44;62;107;52;55;123;48;75;76;29;47;316;170;146;130.0;133.0;43.0;55.0;529.0;531.0;366
2173;Anna Paulowna;2021;13833;2692;8231;2910;12315;767;278;489;751;359;392;115;47;68;107;50;57;121;51;70;93;36;57;315;175;140;131.0;134.0;42.0;56.0;488.0;532.0;366
2174;Anna Paulowna;2022;13775;2626;8156;2993;12227;783;285;498;765;368;397;126;51;75;105;50;55;127;52;75;95;37;58;312;178;134;132.0;137.0;43.0;54.0;655.0;511.0;366
2175;Anna Paulowna;2023;13904;2618;8172;3114;12312;806;303;503;786;391;395;131;51;80;109;53;56;127;57;70;99;39;60;320;191;129;129.0;146.0;39.0;53.0;497.0;542.0;366
2176;Anna Paulowna;2024;13829;2578;8064;3187;12221;827;309;518;781;379;402;131;52;79;99;48;51;135;59;76;99;38;61;317;182;135;134.0;142.0;39.0;58.0;545.0;515.0;366
2177;Anna Paulowna;2025;13833;2539;8010;3284;12200;832;309;523;801;388;413;139;56;83;99;49;50;133;59;74;114;43;71;316;181;135;;;;;;;366
2178;Apeldoorn;2008;154986;37232;93190;24564;131553;12182;4348;7834;11251;6516;4735;1052;554;498;1039;580;459;4015;2136;1879;933;465;468;4212;2781;1431;1644.0;1533.0;464.0;757.0;4758.0;4924.0;200
2179;Apeldoorn;2009;154659;36945;92842;24872;130979;12155;4321;7834;11525;6564;4961;1094;572;522;1062;595;467;4054;2130;1924;1038;501;537;4277;2766;1511;1630.0;1549.0;494.0;715.0;4803.0;4950.0;200
2180;Apeldoorn;2010;154390;36653;92461;25276;130475;12135;4324;7811;11780;6689;5091;1144;610;534;1068;599;469;4098;2159;1939;1097;521;576;4373;2800;1573;1594.0;1554.0;500.0;711.0;4810.0;5024.0;200
2181;Apeldoorn;2011;154023;36393;92136;25494;129880;12112;4272;7840;12031;6770;5261;1181;632;549;1087;603;484;4125;2172;1953;1177;541;636;4461;2822;1639;1543.0;1561.0;514.0;697.0;5659.0;5007.0;200
2182;Apeldoorn;2012;154485;36200;91686;26599;130080;12085;4263;7822;12320;6931;5389;1240;656;584;1084;602;482;4139;2212;1927;1262;577;685;4595;2884;1711;1520.0;1557.0;535.0;692.0;5471.0;5102.0;200
2183;Apeldoorn;2013;154681;35897;91295;27489;129988;12148;4331;7817;12545;7004;5541;1297;681;616;1121;615;506;4164;2215;1949;1312;599;713;4651;2894;1757;1512.0;1566.0;538.0;667.0;5804.0;5182.0;200
2184;Apeldoorn;2014;155132;35635;91216;28281;130043;12215;4340;7875;12874;7175;5699;1370;713;657;1153;644;509;4186;2221;1965;1402;639;763;4763;2958;1805;1502.0;1590.0;527.0;692.0;5895.0;5217.0;200
2185;Apeldoorn;2015;155573;35479;91127;28967;130133;12278;4346;7932;13162;7263;5899;1439;736;703;1157;644;513;4218;2237;1981;1490;662;828;4858;2984;1874;1503.0;1604.0;542.0;663.0;5836.0;5304.0;200
2186;Apeldoorn;2016;155904;35393;91014;29497;130123;12327;4379;7948;13454;7340;6114;1494;761;733;1189;677;512;4270;2251;2019;1561;668;893;4940;2983;1957;1507.0;1617.0;514.0;664.0;5849.0;5303.0;200
2187;Apeldoorn;2017;156205;35234;90899;30072;130194;12311;4420;7891;13700;7449;6251;1525;772;753;1231;694;537;4258;2249;2009;1627;686;941;5059;3048;2011;1515.0;1622.0;511.0;650.0;5785.0;5354.0;200
2188;Apeldoorn;2018;156409;35094;90717;30598;130127;12325;4459;7866;13957;7562;6395;1590;804;786;1251;696;555;4260;2267;1993;1700;716;984;5156;3079;2077;1506.0;1664.0;504.0;639.0;5634.0;5348.0;200
2189;Apeldoorn;2019;156425;34748;90580;31097;129964;12332;4470;7862;14129;7615;6514;1615;817;798;1262;692;570;4213;2240;1973;1789;735;1054;5250;3131;2119;1529.0;1656.0;509.0;640.0;5477.0;5354.0;200
2190;Apeldoorn;2020;156307;34473;90229;31605;129552;12324;4476;7848;14431;7763;6668;1674;831;843;1297;716;581;4184;2231;1953;1878;771;1107;5398;3214;2184;1511.0;1671.0;518.0;654.0;5331.0;5321.0;200
2191;Apeldoorn;2021;156042;34171;89720;32151;129162;12280;4486;7794;14600;7845;6755;1720;860;860;1299;709;590;4171;2234;1937;1934;788;1146;5476;3254;2222;1506.0;1700.0;490.0;637.0;5321.0;5269.0;200
2192;Apeldoorn;2022;155765;33815;89324;32626;128647;12302;4496;7806;14816;7944;6872;1756;885;871;1308;705;603;4172;2242;1930;2014;811;1203;5566;3301;2265;1486.0;1713.0;499.0;623.0;5276.0;5274.0;200
2193;Apeldoorn;2023;155438;33378;89000;33060;128247;12276;4551;7725;14915;7997;6918;1790;895;895;1312;712;600;4173;2256;1917;2050;824;1226;5590;3310;2280;1469.0;1730.0;491.0;621.0;5117.0;5282.0;200
2194;Apeldoorn;2024;154895;32940;88418;33537;127586;12225;4559;7666;15084;8105;6979;1828;917;911;1323;728;595;4175;2277;1898;2092;839;1253;5666;3344;2322;1438.0;1739.0;502.0;615.0;5342.0;5184.0;200
2195;Apeldoorn;2025;154654;32775;87780;34099;127163;12217;4589;7628;15274;8163;7111;1853;919;934;1338;729;609;4189;2274;1915;2133;845;1288;5761;3396;2365;;;;;;;200
2196;Appingedam;2008;11958;2632;7058;2268;10458;953;387;566;547;304;243;72;43;29;32;13;19;207;105;102;58;25;33;178;118;60;122.0;126.0;32.0;40.0;474.0;631.0;3
2197;Appingedam;2009;11791;2579;6967;2245;10297;925;372;553;569;326;243;72;42;30;36;19;17;213;109;104;59;23;36;189;133;56;119.0;125.0;32.0;42.0;501.0;637.0;3
2198;Appingedam;2010;11641;2564;6838;2239;10150;916;362;554;575;332;243;72;41;31;37;20;17;210;106;104;56;24;32;200;141;59;116.0;123.0;32.0;43.0;498.0;621.0;3
2199;Appingedam;2011;11501;2503;6758;2240;9982;909;357;552;610;350;260;80;46;34;43;24;19;211;102;109;59;25;34;217;153;64;115.0;123.0;36.0;40.0;500.0;619.0;3
2200;Appingedam;2012;11369;2477;6602;2290;9834;895;347;548;640;364;276;85;49;36;46;25;21;202;100;102;67;28;39;240;162;78;110.0;122.0;34.0;40.0;460.0;605.0;3
2201;Appingedam;2013;11207;2429;6454;2324;9672;876;332;544;659;371;288;91;50;41;45;26;19;208;98;110;67;30;37;248;167;81;108.0;118.0;32.0;34.0;460.0;609.0;3
2202;Appingedam;2014;11048;2376;6312;2360;9512;869;332;537;667;363;304;92;49;43;48;26;22;200;94;106;65;29;36;262;165;97;107.0;115.0;32.0;35.0;474.0;593.0;3
2203;Appingedam;2015;10920;2362;6189;2369;9376;846;319;527;698;377;321;101;53;48;49;26;23;202;95;107;67;31;36;279;172;107;104.0;119.0;29.0;35.0;463.0;583.0;3
2204;Appingedam;2016;10781;2331;6077;2373;9211;844;310;534;726;396;330;105;57;48;55;27;28;207;97;110;76;39;37;283;176;107;102.0;117.0;34.0;35.0;470.0;568.0;3
2205;Appingedam;2017;10669;2297;5990;2382;9082;841;317;524;746;406;340;107;57;50;64;33;31;202;95;107;78;37;41;295;184;111;100.0;114.0;32.0;35.0;447.0;559.0;3
2206;Appingedam;2018;10540;2252;5908;2380;8951;838;307;531;751;409;342;109;58;51;61;31;30;197;94;103;83;38;45;301;188;113;99.0;113.0;32.0;31.0;450.0;556.0;3
2207;Appingedam;2019;10422;2214;5779;2429;8824;819;289;530;779;417;362;110;61;49;61;31;30;202;96;106;90;39;51;316;190;126;100.0;114.0;45.0;33.0;419.0;551.0;3
2208;Appingedam;2020;10289;2181;5686;2422;8657;817;282;535;815;430;385;103;61;42;63;35;28;217;101;116;101;44;57;331;189;142;99.0;111.0;31.0;32.0;414.0;546.0;3
2209;Appingedam;2021;10146;2137;5562;2447;8482;816;283;533;848;439;409;111;64;47;72;33;39;221;100;121;106;45;61;338;197;141;97.0;109.0;44.0;34.0;421.0;534.0;3
2210;Appingedam;2022;10033;2109;5461;2463;8394;789;273;516;850;449;401;102;58;44;71;32;39;225;106;119;100;43;57;352;210;142;95.0;114.0;32.0;33.0;412.0;539.0;3
2211;Appingedam;2023;9886;2070;5346;2470;8254;772;261;511;860;460;400;106;57;49;80;39;41;225;105;120;100;44;56;349;215;134;99.0;114.0;35.0;28.0;443.0;518.0;3
2212;Appingedam;2024;9804;2063;5274;2467;8156;783;263;520;865;464;401;103;56;47;88;44;44;221;98;123;105;46;59;348;220;128;99.0;111.0;36.0;35.0;358.0;529.0;3
2213;Appingedam;2025;9623;1990;5148;2485;8000;766;258;508;857;466;391;101;60;41;87;43;44;222;96;126;100;46;54;347;221;126;;;;;;;3
2214;Arcen en Velden;2008;8738;2058;5338;1342;7456;1109;376;733;173;90;83;10;4;6;7;5;2;22;10;12;12;3;9;122;68;54;68.0;70.0;31.0;41.0;306.0;333.0;885
2215;Arcen en Velden;2009;8700;2008;5269;1423;7398;1101;372;729;201;105;96;17;7;10;11;5;6;30;15;15;13;4;9;130;74;56;66.0;75.0;32.0;41.0;321.0;332.0;885
2216;Arcen en Velden;2010;8672;1966;5237;1469;7351;1098;366;732;223;114;109;19;9;10;11;5;6;33;15;18;22;9;13;138;76;62;69.0;76.0;34.0;40.0;354.0;356.0;885
2217;Arcen en Velden;2011;8658;1904;5241;1513;7324;1091;361;730;243;120;123;22;11;11;11;4;7;35;17;18;27;9;18;148;79;69;66.0;81.0;36.0;40.0;350.0;362.0;885
2218;Arcen en Velden;2012;8628;1881;5171;1576;7296;1075;361;714;257;122;135;21;12;9;10;5;5;41;16;25;29;10;19;156;79;77;69.0;78.0;34.0;41.0;317.0;368.0;885
2219;Arcen en Velden;2013;8562;1830;5111;1621;7211;1075;360;715;276;128;148;25;15;10;13;6;7;44;17;27;30;10;20;164;80;84;72.0;79.0;34.0;41.0;338.0;359.0;885
2220;Arcen en Velden;2014;8527;1805;5055;1667;7166;1062;351;711;299;141;158;32;17;15;17;9;8;45;20;25;35;9;26;170;86;84;76.0;80.0;36.0;41.0;334.0;370.0;885
2221;Arcen en Velden;2015;8484;1754;5022;1708;7110;1045;345;700;329;148;181;35;18;17;19;10;9;50;19;31;35;10;25;190;91;99;75.0;81.0;38.0;39.0;356.0;359.0;885
2222;Arcen en Velden;2016;8475;1728;4988;1759;7081;1052;346;706;342;154;188;34;16;18;19;9;10;58;24;34;39;12;27;192;93;99;79.0;82.0;32.0;37.0;342.0;359.0;885
2223;Arcen en Velden;2017;8451;1711;4923;1817;7049;1051;342;709;351;154;197;35;19;16;17;7;10;57;23;34;43;12;31;199;93;106;78.0;86.0;35.0;35.0;364.0;368.0;885
2224;Arcen en Velden;2018;8440;1668;4922;1850;7028;1045;341;704;367;165;202;38;19;19;16;7;9;67;28;39;41;13;28;205;98;107;84.0;86.0;35.0;39.0;342.0;359.0;885
2225;Arcen en Velden;2019;8418;1658;4872;1888;6997;1033;342;691;388;178;210;41;22;19;18;9;9;75;30;45;46;16;30;208;101;107;82.0;88.0;47.0;36.0;326.0;360.0;885
2226;Arcen en Velden;2020;8390;1641;4811;1938;6961;1012;327;685;417;196;221;49;25;24;21;13;8;82;33;49;45;17;28;220;108;112;87.0;93.0;37.0;35.0;331.0;362.0;885
2227;Arcen en Velden;2021;8356;1623;4744;1989;6935;997;324;673;424;207;217;47;24;23;23;13;10;82;35;47;46;18;28;226;117;109;86.0;98.0;31.0;36.0;326.0;365.0;885
2228;Arcen en Velden;2022;8301;1607;4661;2033;6858;998;332;666;445;212;233;46;24;22;27;14;13;76;35;41;54;20;34;242;119;123;85.0;93.0;37.0;35.0;323.0;360.0;885
2229;Arcen en Velden;2023;8261;1590;4596;2075;6809;988;332;656;464;225;239;51;28;23;30;15;15;75;33;42;60;24;36;248;125;123;82.0;97.0;42.0;34.0;317.0;359.0;885
2230;Arcen en Velden;2024;8214;1600;4543;2071;6737;985;340;645;492;235;257;58;32;26;32;15;17;75;33;42;65;24;41;262;131;131;84.0;102.0;40.0;36.0;370.0;351.0;885
2231;Arcen en Velden;2025;8220;1636;4487;2097;6733;976;338;638;511;250;261;64;38;26;38;18;20;76;35;41;72;26;46;261;133;128;;;;;;;885
2232;Arnhem;2008;144836;31904;94482;18450;104386;16131;6259;9872;24319;14438;9881;3084;1648;1436;1934;1257;677;7721;4074;3647;2974;1443;1531;8606;6016;2590;1811.0;1309.0;1247.0;1530.0;7864.0;6557.0;202
2233;Arnhem;2009;146388;32308;95335;18745;105826;16151;6264;9887;24411;14281;10130;3119;1676;1443;1908;1233;675;7647;3987;3660;3119;1476;1643;8618;5909;2709;1825.0;1306.0;1273.0;1494.0;7800.0;6599.0;202
2234;Arnhem;2010;147911;32771;96057;19083;107235;16187;6312;9875;24489;14113;10376;3108;1677;1431;1905;1218;687;7587;3909;3678;3262;1510;1752;8627;5799;2828;1817.0;1323.0;1285.0;1463.0;8020.0;6566.0;202
2235;Arnhem;2011;149702;33122;97158;19422;108760;16276;6346;9930;24666;13966;10700;3144;1688;1456;1911;1199;712;7546;3837;3709;3372;1535;1837;8693;5707;2986;1830.0;1328.0;1354.0;1444.0;7145.0;6584.0;202
2236;Arnhem;2012;150702;33299;97142;20261;109597;16291;6385;9906;24814;13820;10994;3173;1701;1472;1916;1213;703;7536;3771;3765;3479;1545;1934;8710;5590;3120;1813.0;1333.0;1351.0;1414.0;7176.0;6521.0;202
2237;Arnhem;2013;151794;33524;97165;21105;110517;16372;6455;9917;24905;13719;11186;3169;1697;1472;1954;1240;714;7507;3722;3785;3571;1561;2010;8704;5499;3205;1847.0;1374.0;1343.0;1412.0;7015.0;6576.0;202
2238;Arnhem;2014;152661;33757;97234;21670;111329;16317;6502;9815;25015;13579;11436;3195;1700;1495;1947;1237;710;7468;3655;3813;3667;1584;2083;8738;5403;3335;1858.0;1381.0;1316.0;1351.0;6991.0;6504.0;202
2239;Arnhem;2015;153612;33982;97386;22244;112103;16380;6549;9831;25129;13555;11574;3203;1709;1494;1927;1222;705;7479;3641;3838;3778;1621;2157;8742;5362;3380;1880.0;1397.0;1295.0;1357.0;6753.0;6610.0;202
2240;Arnhem;2016;154192;34163;97190;22839;112585;16362;6585;9777;25245;13489;11756;3215;1707;1508;1968;1256;712;7415;3580;3835;3864;1650;2214;8783;5296;3487;1874.0;1401.0;1316.0;1319.0;6241.0;6592.0;202
2241;Arnhem;2017;154330;34299;96634;23397;112726;16247;6542;9705;25357;13458;11899;3231;1725;1506;2015;1283;732;7381;3536;3845;3933;1659;2274;8797;5255;3542;1894.0;1395.0;1261.0;1286.0;6307.0;6576.0;202
2242;Arnhem;2018;154558;34494;96119;23945;112926;16179;6501;9678;25453;13387;12066;3254;1750;1504;1998;1268;730;7326;3484;3842;3988;1664;2324;8887;5221;3666;1855.0;1425.0;1247.0;1284.0;5944.0;6523.0;202
2243;Arnhem;2019;154396;34413;95525;24458;112797;16124;6531;9593;25475;13297;12178;3248;1756;1492;2012;1270;742;7297;3441;3856;4009;1668;2341;8909;5162;3747;1835.0;1424.0;1230.0;1264.0;6078.0;6475.0;202
2244;Arnhem;2020;154398;34378;95067;24953;112799;16090;6536;9554;25509;13265;12244;3224;1732;1492;2018;1274;744;7226;3402;3824;4045;1666;2379;8996;5191;3805;1872.0;1467.0;1225.0;1259.0;6331.0;6459.0;202
2245;Arnhem;2021;154657;34421;94836;25400;112894;16070;6531;9539;25693;13291;12402;3268;1760;1508;2050;1294;756;7167;3359;3808;4121;1680;2441;9087;5198;3889;1854.0;1488.0;1214.0;1231.0;5978.0;6479.0;202
2246;Arnhem;2022;154525;34411;94213;25901;112749;16027;6511;9516;25749;13259;12490;3260;1755;1505;2060;1300;760;7128;3336;3792;4193;1681;2512;9108;5187;3921;1843.0;1465.0;1159.0;1196.0;5899.0;6449.0;202
2247;Arnhem;2023;154335;34330;93624;26381;112537;15977;6482;9495;25821;13231;12590;3232;1720;1512;2126;1331;795;7101;3312;3789;4202;1685;2517;9160;5183;3977;1827.0;1501.0;1184.0;1175.0;6080.0;6394.0;202
2248;Arnhem;2024;154379;34237;93268;26874;112445;15950;6512;9438;25984;13197;12787;3247;1726;1521;2122;1315;807;7100;3261;3839;4286;1712;2574;9229;5183;4046;1830.0;1537.0;1139.0;1186.0;5893.0;6409.0;202
2249;Arnhem;2025;154126;34180;92520;27426;112180;15835;6491;9344;26111;13146;12965;3252;1704;1548;2114;1313;801;7065;3224;3841;4360;1728;2632;9320;5177;4143;;;;;;;202
2250;Assen;2008;64975;16586;39112;9277;56079;5261;2096;3165;3635;2139;1496;444;224;220;329;196;133;450;239;211;304;142;162;2108;1338;770;805.0;564.0;339.0;335.0;3077.0;2562.0;106
2251;Assen;2009;65744;16726;39562;9456;56774;5249;2062;3187;3721;2141;1580;469;242;227;344;202;142;488;257;231;325;141;184;2095;1299;796;795.0;583.0;368.0;331.0;3120.0;2601.0;106
2252;Assen;2010;66523;16819;40026;9678;57469;5278;2105;3173;3776;2122;1654;486;251;235;401;231;170;507;260;247;350;146;204;2032;1234;798;782.0;586.0;365.0;333.0;3058.0;2606.0;106
2253;Assen;2011;67210;16818;40505;9887;58106;5284;2134;3150;3820;2151;1669;501;265;236;437;257;180;518;267;251;371;154;217;1993;1208;785;787.0;592.0;411.0;329.0;3051.0;2606.0;106
2254;Assen;2012;67946;16865;40689;10392;58724;5348;2188;3160;3874;2168;1706;532;286;246;471;267;204;533;279;254;392;160;232;1946;1176;770;789.0;610.0;393.0;320.0;3145.0;2646.0;106
2255;Assen;2013;68701;16901;41000;10800;59357;5380;2221;3159;3964;2184;1780;566;301;265;509;278;231;575;296;279;404;168;236;1910;1141;769;788.0;623.0;405.0;315.0;3025.0;2712.0;106
2256;Assen;2014;69273;16885;41225;11163;59842;5402;2221;3181;4029;2210;1819;585;315;270;539;295;244;600;297;303;413;178;235;1892;1125;767;793.0;618.0;397.0;313.0;3091.0;2705.0;106
2257;Assen;2015;69924;16949;41463;11512;60351;5425;2233;3192;4148;2285;1863;610;331;279;569;315;254;634;313;321;430;193;237;1905;1133;772;807.0;628.0;388.0;302.0;3143.0;2733.0;106
2258;Assen;2016;70605;16990;41701;11914;60960;5402;2200;3202;4243;2332;1911;616;346;270;597;332;265;650;322;328;446;195;251;1934;1137;797;808.0;633.0;386.0;302.0;3079.0;2750.0;106
2259;Assen;2017;71203;17048;41857;12298;61405;5414;2251;3163;4384;2380;2004;651;362;289;624;343;281;692;323;369;466;205;261;1951;1147;804;808.0;642.0;388.0;296.0;2935.0;2758.0;106
2260;Assen;2018;71653;17040;41924;12689;61831;5397;2262;3135;4425;2397;2028;654;363;291;638;355;283;709;344;365;492;212;280;1932;1123;809;809.0;661.0;406.0;296.0;3046.0;2739.0;106
2261;Assen;2019;72226;17054;42039;13133;62275;5413;2261;3152;4538;2489;2049;666;367;299;673;390;283;729;365;364;502;227;275;1968;1140;828;805.0;670.0;383.0;294.0;3123.0;2826.0;106
2262;Assen;2020;72760;17048;42128;13584;62730;5415;2275;3140;4615;2523;2092;672;377;295;690;394;296;758;377;381;522;229;293;1973;1146;827;811.0;688.0;383.0;303.0;3086.0;2827.0;106
2263;Assen;2021;73233;17029;42212;13992;63116;5409;2291;3118;4708;2567;2141;700;396;304;716;409;307;779;388;391;535;235;300;1978;1139;839;830.0;693.0;367.0;293.0;3162.0;2851.0;106
2264;Assen;2022;73765;17067;42251;14447;63528;5428;2295;3133;4809;2608;2201;717;406;311;741;409;332;806;399;407;560;238;322;1985;1156;829;824.0;725.0;374.0;276.0;3142.0;2828.0;106
2265;Assen;2023;74287;17100;42365;14822;63879;5467;2320;3147;4941;2675;2266;733;415;318;771;422;349;843;426;417;595;247;348;1999;1165;834;836.0;733.0;385.0;283.0;2924.0;2878.0;106
2266;Assen;2024;74550;17037;42299;15214;63984;5513;2342;3171;5053;2697;2356;734;411;323;799;433;366;875;438;437;609;243;366;2036;1172;864;834.0;752.0;396.0;293.0;3063.0;2871.0;106
2267;Assen;2025;74936;17128;42188;15620;64251;5496;2368;3128;5189;2767;2422;746;430;316;818;446;372;899;447;452;633;247;386;2093;1197;896;;;;;;;106
2268;Asten;2008;16562;4242;9950;2370;15412;621;204;417;529;310;219;56;33;23;21;12;9;32;8;24;123;68;55;297;189;108;164.0;121.0;62.0;86.0;550.0;488.0;743
2269;Asten;2009;16645;4178;9998;2469;15440;639;222;417;566;337;229;59;34;25;20;11;9;39;12;27;137;79;58;311;201;110;159.0;126.0;69.0;88.0;445.0;501.0;743
2270;Asten;2010;16606;4090;9948;2568;15368;652;225;427;586;347;239;62;35;27;18;12;6;45;16;29;136;76;60;325;208;117;159.0;128.0;68.0;86.0;593.0;547.0;743
2271;Asten;2011;16672;4023;9978;2671;15355;678;223;455;639;385;254;72;41;31;26;16;10;55;21;34;147;84;63;339;223;116;153.0;137.0;72.0;86.0;532.0;567.0;743
2272;Asten;2012;16642;3967;9921;2754;15279;676;231;445;687;412;275;78;40;38;27;18;9;68;26;42;166;98;68;348;230;118;153.0;132.0;80.0;87.0;596.0;555.0;743
2273;Asten;2013;16697;3896;9919;2882;15288;675;230;445;734;426;308;82;40;42;34;19;15;83;33;50;169;97;72;366;237;129;159.0;136.0;78.0;86.0;703.0;563.0;743
2274;Asten;2014;16854;3852;9976;3026;15378;681;236;445;795;459;336;92;45;47;40;22;18;104;39;65;182;106;76;377;247;130;154.0;140.0;86.0;82.0;596.0;596.0;743
2275;Asten;2015;16874;3780;9930;3164;15349;713;258;455;812;472;340;88;42;46;39;22;17;119;48;71;174;105;69;392;255;137;159.0;145.0;80.0;82.0;639.0;593.0;743
2276;Asten;2016;16933;3707;9956;3270;15371;723;268;455;839;481;358;94;45;49;44;27;17;119;50;69;182;104;78;400;255;145;162.0;146.0;77.0;81.0;615.0;616.0;743
2277;Asten;2017;16945;3654;9921;3370;15351;730;267;463;864;484;380;104;49;55;50;26;24;124;58;66;179;99;80;407;252;155;161.0;151.0;74.0;80.0;656.0;566.0;743
2278;Asten;2018;17041;3645;9892;3504;15394;739;264;475;908;497;411;108;52;56;51;27;24;133;57;76;191;101;90;425;260;165;168.0;158.0;78.0;81.0;500.0;602.0;743
2279;Asten;2019;16950;3577;9778;3595;15308;711;258;453;931;506;425;111;57;54;50;23;27;136;56;80;198;104;94;436;266;170;162.0;163.0;76.0;76.0;654.0;586.0;743
2280;Asten;2020;17019;3524;9814;3681;15324;736;274;462;959;529;430;107;60;47;55;24;31;144;59;85;195;105;90;458;281;177;167.0;165.0;74.0;77.0;685.0;599.0;743
2281;Asten;2021;17105;3492;9837;3776;15381;738;278;460;986;545;441;110;59;51;58;26;32;151;60;91;199;107;92;468;293;175;166.0;171.0;85.0;81.0;732.0;587.0;743
2282;Asten;2022;17250;3493;9868;3889;15454;747;279;468;1049;585;464;118;64;54;63;29;34;163;63;100;220;120;100;485;309;176;173.0;175.0;77.0;84.0;593.0;615.0;743
2283;Asten;2023;17220;3418;9827;3975;15418;752;276;476;1050;565;485;113;59;54;63;29;34;163;61;102;228;118;110;483;298;185;169.0;173.0;80.0;78.0;646.0;614.0;743
2284;Asten;2024;17252;3403;9790;4059;15376;761;284;477;1115;595;520;122;62;60;68;27;41;175;68;107;242;126;116;508;312;196;170.0;182.0;77.0;76.0;735.0;614.0;743
2285;Asten;2025;17363;3413;9777;4173;15438;782;290;492;1143;603;540;127;64;63;70;30;40;179;70;109;246;126;120;521;313;208;;;;;;;743
2286;Baarle-Nassau;2008;6580;1254;4027;1299;4946;1501;514;987;133;85;48;9;3;6;7;5;2;11;5;6;16;4;12;90;68;22;48.0;65.0;35.0;50.0;184.0;196.0;744
2287;Baarle-Nassau;2009;6537;1220;3977;1340;4934;1443;480;963;160;102;58;12;4;8;8;6;2;14;8;6;20;5;15;106;79;27;49.0;68.0;43.0;47.0;178.0;193.0;744
2288;Baarle-Nassau;2010;6499;1174;3929;1396;4924;1385;464;921;190;123;67;16;7;9;12;7;5;19;11;8;22;7;15;121;91;30;49.0;70.0;38.0;48.0;202.0;184.0;744
2289;Baarle-Nassau;2011;6487;1156;3908;1423;4947;1334;447;887;206;134;72;20;7;13;13;8;5;23;14;9;20;8;12;130;97;33;49.0;71.0;41.0;40.0;189.0;194.0;744
2290;Baarle-Nassau;2012;6461;1128;3856;1477;4949;1279;427;852;233;148;85;21;9;12;18;9;9;30;14;16;21;9;12;143;107;36;50.0;72.0;36.0;47.0;224.0;199.0;744
2291;Baarle-Nassau;2013;6453;1106;3818;1529;4980;1224;412;812;249;157;92;19;9;10;20;9;11;34;17;17;24;11;13;152;111;41;49.0;78.0;39.0;42.0;222.0;200.0;744
2292;Baarle-Nassau;2014;6444;1065;3794;1585;5004;1177;395;782;263;164;99;22;10;12;24;13;11;39;18;21;23;11;12;155;112;43;51.0;75.0;37.0;42.0;193.0;213.0;744
2293;Baarle-Nassau;2015;6398;1032;3726;1640;4985;1132;375;757;281;176;105;27;15;12;26;15;11;43;22;21;25;9;16;160;115;45;49.0;79.0;38.0;41.0;245.0;192.0;744
2294;Baarle-Nassau;2016;6420;1017;3738;1665;5013;1110;369;741;297;181;116;28;16;12;24;12;12;45;22;23;32;13;19;168;118;50;51.0;77.0;38.0;39.0;209.0;203.0;744
2295;Baarle-Nassau;2017;6400;1016;3703;1681;5000;1088;357;731;312;185;127;28;15;13;29;15;14;53;26;27;35;12;23;167;117;50;52.0;80.0;40.0;40.0;257.0;203.0;744
2296;Baarle-Nassau;2018;6427;1023;3690;1714;5030;1062;347;715;335;196;139;30;16;14;27;12;15;59;28;31;39;15;24;180;125;55;51.0;78.0;34.0;41.0;174.0;221.0;744
2297;Baarle-Nassau;2019;6347;989;3613;1745;4985;1019;333;686;343;197;146;29;16;13;30;13;17;56;27;29;41;15;26;187;126;61;49.0;81.0;37.0;36.0;228.0;200.0;744
2298;Baarle-Nassau;2020;6346;991;3586;1769;4990;997;322;675;359;202;157;31;15;16;34;15;19;60;28;32;44;18;26;190;126;64;55.0;84.0;33.0;35.0;230.0;211.0;744
2299;Baarle-Nassau;2021;6334;979;3572;1783;4992;979;320;659;363;203;160;30;13;17;34;14;20;62;28;34;43;17;26;194;131;63;54.0;82.0;35.0;37.0;227.0;205.0;744
2300;Baarle-Nassau;2022;6327;963;3550;1814;4998;958;309;649;371;202;169;31;14;17;39;15;24;66;27;39;45;19;26;190;127;63;55.0;83.0;36.0;37.0;227.0;217.0;744
2301;Baarle-Nassau;2023;6308;976;3491;1841;4986;934;301;633;388;204;184;37;17;20;43;15;28;69;28;41;45;16;29;194;128;66;50.0;88.0;33.0;35.0;237.0;205.0;744
2302;Baarle-Nassau;2024;6300;952;3468;1880;5000;899;291;608;401;213;188;35;17;18;49;17;32;69;30;39;47;16;31;201;133;68;55.0;90.0;35.0;35.0;210.0;185.0;744
2303;Baarle-Nassau;2025;6291;954;3448;1889;5001;876;279;597;414;214;200;40;20;20;52;17;35;73;31;42;48;17;31;201;129;72;;;;;;;744
2304;Baarn;2008;24269;5419;14474;4376;20517;2139;724;1415;1613;904;709;145;64;81;135;66;69;416;215;201;235;112;123;682;447;235;216.0;290.0;92.0;125.0;1199.0;1231.0;308
2305;Baarn;2009;24132;5333;14426;4373;20343;2131;731;1400;1658;940;718;160;75;85;138;68;70;431;222;209;234;114;120;695;461;234;214.0;278.0;100.0;118.0;1200.0;1255.0;308
2306;Baarn;2010;23997;5252;14373;4372;20191;2124;735;1389;1682;949;733;158;80;78;144;69;75;435;226;209;249;117;132;696;457;239;208.0;274.0;96.0;123.0;1234.0;1237.0;308
2307;Baarn;2011;23905;5218;14302;4385;20085;2104;732;1372;1716;948;768;171;83;88;152;78;74;436;220;216;264;118;146;693;449;244;217.0;273.0;107.0;118.0;1269.0;1250.0;308
2308;Baarn;2012;23860;5160;14178;4522;19993;2122;742;1380;1745;965;780;181;83;98;158;85;73;439;221;218;268;120;148;699;456;243;213.0;268.0;98.0;116.0;1237.0;1280.0;308
2309;Baarn;2013;23746;5075;14035;4636;19877;2121;745;1376;1748;956;792;193;94;99;159;92;67;444;221;223;262;116;146;690;433;257;222.0;267.0;112.0;111.0;1218.0;1249.0;308
2310;Baarn;2014;23674;5006;13939;4729;19798;2114;738;1376;1762;960;802;205;95;110;155;92;63;429;217;212;263;118;145;710;438;272;217.0;268.0;103.0;109.0;1291.0;1251.0;308
2311;Baarn;2015;23660;4948;13904;4808;19735;2116;765;1351;1809;993;816;212;99;113;168;96;72;424;218;206;268;120;148;737;460;277;216.0;271.0;97.0;106.0;1288.0;1244.0;308
2312;Baarn;2016;23643;4869;13899;4875;19695;2111;779;1332;1837;1001;836;214;99;115;169;93;76;423;217;206;267;115;152;764;477;287;209.0;264.0;99.0;107.0;1220.0;1218.0;308
2313;Baarn;2017;23586;4788;13860;4938;19619;2122;777;1345;1845;1005;840;212;105;107;173;90;83;414;213;201;275;116;159;771;481;290;220.0;261.0;92.0;103.0;1255.0;1222.0;308
2314;Baarn;2018;23568;4755;13856;4957;19546;2120;775;1345;1902;1028;874;227;108;119;178;91;87;425;217;208;280;114;166;792;498;294;223.0;262.0;89.0;105.0;1199.0;1229.0;308
2315;Baarn;2019;23484;4696;13773;5015;19459;2081;777;1304;1944;1041;903;242;115;127;187;92;95;417;213;204;284;118;166;814;503;311;222.0;262.0;92.0;102.0;1247.0;1206.0;308
2316;Baarn;2020;23480;4644;13740;5096;19417;2091;773;1318;1972;1055;917;243;119;124;195;95;100;424;213;211;300;125;175;810;503;307;228.0;267.0;88.0;101.0;1227.0;1176.0;308
2317;Baarn;2021;23483;4589;13704;5190;19403;2089;767;1322;1991;1059;932;258;124;134;197;96;101;429;216;213;300;124;176;807;499;308;229.0;269.0;95.0;101.0;1132.0;1188.0;308
2318;Baarn;2022;23382;4547;13564;5271;19292;2074;771;1303;2016;1086;930;262;129;133;200;108;92;424;217;207;314;125;189;816;507;309;223.0;269.0;87.0;100.0;1363.0;1214.0;308
2319;Baarn;2023;23475;4544;13582;5349;19300;2081;787;1294;2094;1112;982;269;132;137;210;112;98;438;218;220;327;131;196;850;519;331;226.0;270.0;101.0;96.0;1276.0;1254.0;308
2320;Baarn;2024;23460;4483;13525;5452;19283;2060;775;1285;2117;1124;993;270;137;133;213;112;101;437;213;224;335;139;196;862;523;339;225.0;277.0;85.0;97.0;1261.0;1208.0;308
2321;Baarn;2025;23451;4463;13422;5566;19217;2099;788;1311;2135;1127;1008;277;139;138;221;112;109;437;210;227;330;138;192;870;528;342;;;;;;;308
2322;Barendrecht;2008;43885;11958;26652;5275;36395;3084;1090;1994;4406;2173;2233;1416;656;760;286;134;152;855;404;451;604;284;320;1245;695;550;551.0;274.0;137.0;198.0;1655.0;1876.0;489
2323;Barendrecht;2009;43883;11851;26567;5465;36248;3134;1118;2016;4501;2213;2288;1412;652;760;280;134;146;907;430;477;616;296;320;1286;701;585;524.0;282.0;148.0;209.0;1958.0;1789.0;489
2324;Barendrecht;2010;44237;11821;26745;5671;36335;3199;1154;2045;4703;2299;2404;1419;644;775;303;144;159;971;465;506;666;319;347;1344;727;617;512.0;292.0;174.0;204.0;1569.0;1788.0;489
2325;Barendrecht;2011;44216;11739;26687;5790;36227;3191;1164;2027;4798;2332;2466;1407;642;765;327;147;180;1016;488;528;693;329;364;1355;726;629;508.0;302.0;166.0;191.0;1345.0;1716.0;489
2326;Barendrecht;2012;44030;11583;26251;6196;35996;3160;1145;2015;4874;2341;2533;1384;628;756;336;152;184;1068;495;573;715;336;379;1371;730;641;469.0;312.0;161.0;180.0;1691.0;1682.0;489
2327;Barendrecht;2013;44182;11487;26167;6528;35997;3188;1176;2012;4997;2376;2621;1390;626;764;359;166;193;1108;507;601;739;344;395;1401;733;668;462.0;320.0;170.0;194.0;1529.0;1668.0;489
2328;Barendrecht;2014;44165;11353;26049;6763;35865;3216;1172;2044;5084;2403;2681;1389;621;768;362;154;208;1140;519;621;764;357;407;1429;752;677;451.0;320.0;157.0;177.0;1415.0;1642.0;489
2329;Barendrecht;2015;44053;11208;25841;7004;35677;3187;1167;2020;5189;2403;2786;1388;624;764;388;162;226;1185;527;658;795;362;433;1433;728;705;435.0;333.0;156.0;178.0;1583.0;1627.0;489
2330;Barendrecht;2016;44092;11071;25795;7226;35600;3190;1182;2008;5302;2442;2860;1387;608;779;404;172;232;1206;531;675;826;379;447;1479;752;727;433.0;334.0;166.0;179.0;1501.0;1643.0;489
2331;Barendrecht;2017;44037;10930;25618;7489;35444;3191;1184;2007;5402;2447;2955;1377;604;773;406;165;241;1234;538;696;867;395;472;1518;745;773;420.0;343.0;155.0;188.0;1398.0;1598.0;489
2332;Barendrecht;2018;43886;10763;25385;7738;35223;3204;1185;2019;5459;2458;3001;1371;603;768;416;165;251;1248;541;707;893;406;487;1531;743;788;414.0;338.0;155.0;178.0;1241.0;1592.0;489
2333;Barendrecht;2019;43591;10521;25104;7966;34869;3232;1191;2041;5490;2479;3011;1353;588;765;428;174;254;1273;548;725;880;407;473;1556;762;794;405.0;352.0;175.0;179.0;1344.0;1566.0;489
2334;Barendrecht;2020;43418;10320;24951;8147;34591;3276;1226;2050;5551;2510;3041;1345;590;755;421;174;247;1308;564;744;899;421;478;1578;761;817;398.0;358.0;151.0;173.0;1410.0;1547.0;489
2335;Barendrecht;2021;43303;10095;24804;8404;34419;3288;1240;2048;5596;2537;3059;1346;589;757;436;180;256;1321;568;753;898;427;471;1595;773;822;386.0;372.0;145.0;180.0;1438.0;1613.0;489
2336;Barendrecht;2022;43110;9823;24679;8608;34166;3296;1226;2070;5648;2553;3095;1340;589;751;429;175;254;1338;559;779;910;426;484;1631;804;827;386.0;365.0;140.0;165.0;1421.0;1583.0;489
2337;Barendrecht;2023;42947;9613;24416;8918;33932;3313;1207;2106;5702;2560;3142;1322;582;740;429;170;259;1366;563;803;934;426;508;1651;819;832;401.0;373.0;143.0;164.0;1387.0;1564.0;489
2338;Barendrecht;2024;42779;9382;24245;9152;33699;3302;1209;2093;5778;2573;3205;1322;580;742;427;163;264;1404;569;835;943;424;519;1682;837;845;390.0;385.0;134.0;158.0;1403.0;1571.0;489
2339;Barendrecht;2025;42597;9168;24048;9381;33437;3320;1216;2104;5840;2600;3240;1311;583;728;427;168;259;1421;577;844;961;427;534;1720;845;875;;;;;;;489
2340;Barneveld;2008;50847;15528;28729;6590;46921;2134;823;1311;1792;1007;785;161;85;76;62;22;40;684;359;325;276;134;142;609;407;202;750.0;328.0;164.0;228.0;1198.0;1586.0;203
2341;Barneveld;2009;50823;15370;28601;6852;46849;2170;827;1343;1804;994;810;169;84;85;67;30;37;687;359;328;285;137;148;596;384;212;730.0;335.0;177.0;226.0;1212.0;1575.0;203
2342;Barneveld;2010;50814;15239;28547;7028;46732;2220;851;1369;1862;1030;832;184;99;85;83;41;42;706;367;339;295;147;148;594;376;218;721.0;343.0;192.0;224.0;1420.0;1595.0;203
2343;Barneveld;2011;50995;15085;28668;7242;46813;2256;863;1393;1926;1054;872;199;110;89;104;52;52;721;372;349;308;149;159;594;371;223;713.0;357.0;182.0;212.0;1317.0;1605.0;203
2344;Barneveld;2012;51040;14920;28507;7613;46796;2261;839;1422;1983;1081;902;223;129;94;121;57;64;715;371;344;324;153;171;600;371;229;718.0;368.0;185.0;216.0;1454.0;1604.0;203
2345;Barneveld;2013;51214;14809;28491;7914;46841;2320;860;1460;2053;1118;935;244;144;100;131;71;60;723;375;348;351;159;192;604;369;235;690.0;370.0;182.0;206.0;1479.0;1621.0;203
2346;Barneveld;2014;51375;14639;28542;8194;46937;2333;860;1473;2105;1131;974;257;154;103;150;76;74;726;377;349;365;161;204;607;363;244;694.0;382.0;178.0;205.0;1620.0;1617.0;203
2347;Barneveld;2015;51665;14558;28680;8427;47066;2393;869;1524;2206;1203;1003;280;171;109;167;92;75;725;380;345;393;165;228;641;395;246;701.0;384.0;195.0;213.0;1651.0;1658.0;203
2348;Barneveld;2016;51963;14522;28826;8615;47181;2466;906;1560;2316;1230;1086;302;181;121;181;97;84;744;384;360;418;171;247;671;397;274;704.0;398.0;173.0;203.0;1574.0;1658.0;203
2349;Barneveld;2017;52159;14437;28880;8842;47275;2514;926;1588;2370;1241;1129;317;186;131;184;106;78;754;384;370;437;171;266;678;394;284;698.0;408.0;171.0;209.0;1586.0;1639.0;203
2350;Barneveld;2018;52361;14328;28955;9078;47332;2578;947;1631;2451;1272;1179;335;195;140;193;112;81;757;385;372;456;173;283;710;407;303;715.0;423.0;184.0;206.0;1580.0;1647.0;203
2351;Barneveld;2019;52570;14245;29001;9324;47383;2631;953;1678;2556;1316;1240;364;207;157;225;118;107;751;385;366;487;188;299;729;418;311;695.0;427.0;194.0;212.0;1538.0;1682.0;203
2352;Barneveld;2020;52683;14098;29037;9548;47413;2634;951;1683;2636;1355;1281;380;215;165;239;126;113;765;392;373;496;191;305;756;431;325;700.0;434.0;186.0;212.0;1702.0;1657.0;203
2353;Barneveld;2021;52975;14046;29141;9788;47586;2671;973;1698;2718;1394;1324;377;216;161;252;129;123;798;415;383;512;193;319;779;441;338;705.0;435.0;178.0;215.0;1694.0;1648.0;203
2354;Barneveld;2022;53258;14004;29201;10053;47721;2744;989;1755;2793;1418;1375;388;222;166;271;134;137;814;421;393;532;202;330;788;439;349;708.0;452.0;182.0;210.0;1523.0;1667.0;203
2355;Barneveld;2023;53344;13872;29154;10318;47689;2782;996;1786;2873;1462;1411;403;229;174;285;145;140;817;421;396;553;210;343;815;457;358;696.0;458.0;177.0;213.0;1559.0;1648.0;203
2356;Barneveld;2024;53461;13800;29074;10587;47698;2820;995;1825;2943;1486;1457;411;231;180;293;148;145;830;437;393;568;215;353;841;455;386;684.0;473.0;172.0;199.0;1557.0;1649.0;203
2357;Barneveld;2025;53559;13724;28952;10883;47730;2828;996;1832;3001;1520;1481;424;240;184;303;153;150;845;445;400;575;213;362;854;469;385;;;;;;;203
2358;Bedum;2008;10797;2772;6549;1476;10121;449;129;320;227;123;104;34;10;24;27;15;12;17;8;9;12;3;9;137;87;50;110.0;87.0;25.0;44.0;530.0;612.0;5
2359;Bedum;2009;10720;2678;6520;1522;10004;467;135;332;249;131;118;42;13;29;29;16;13;26;12;14;18;6;12;134;84;50;109.0;89.0;26.0;45.0;532.0;593.0;5
2360;Bedum;2010;10662;2598;6494;1570;9937;451;143;308;274;147;127;48;14;34;33;17;16;33;20;13;24;9;15;136;87;49;112.0;90.0;25.0;40.0;549.0;611.0;5
2361;Bedum;2011;10609;2524;6478;1607;9852;455;142;313;302;169;133;49;16;33;35;19;16;42;26;16;27;12;15;149;96;53;111.0;89.0;29.0;43.0;565.0;606.0;5
2362;Bedum;2012;10578;2461;6406;1711;9791;464;152;312;323;177;146;58;20;38;33;17;16;43;25;18;33;13;20;156;102;54;112.0;89.0;34.0;45.0;575.0;602.0;5
2363;Bedum;2013;10564;2400;6380;1784;9724;496;168;328;344;183;161;66;23;43;31;15;16;46;26;20;37;14;23;164;105;59;110.0;92.0;37.0;42.0;527.0;595.0;5
2364;Bedum;2014;10510;2339;6318;1853;9654;502;189;313;354;197;157;65;25;40;31;16;15;48;27;21;41;18;23;169;111;58;109.0;92.0;36.0;45.0;546.0;597.0;5
2365;Bedum;2015;10469;2297;6256;1916;9606;512;200;312;351;192;159;66;26;40;27;14;13;45;26;19;43;19;24;170;107;63;109.0;94.0;40.0;42.0;547.0;591.0;5
2366;Bedum;2016;10438;2260;6227;1951;9563;504;195;309;371;191;180;73;29;44;29;15;14;49;25;24;49;20;29;171;102;69;110.0;94.0;37.0;41.0;581.0;578.0;5
2367;Bedum;2017;10452;2235;6199;2018;9557;517;201;316;378;190;188;75;31;44;29;19;10;53;25;28;57;19;38;164;96;68;117.0;96.0;29.0;38.0;608.0;613.0;5
2368;Bedum;2018;10462;2218;6192;2052;9533;534;210;324;395;196;199;81;30;51;34;23;11;54;27;27;52;19;33;174;97;77;116.0;102.0;32.0;42.0;599.0;612.0;5
2369;Bedum;2019;10454;2218;6153;2083;9502;538;205;333;414;212;202;85;34;51;33;24;9;68;33;35;53;20;33;175;101;74;117.0;102.0;32.0;40.0;688.0;594.0;5
2370;Bedum;2020;10555;2229;6184;2142;9582;529;203;326;444;227;217;88;38;50;34;25;9;76;34;42;57;22;35;189;108;81;120.0;98.0;32.0;41.0;599.0;588.0;5
2371;Bedum;2021;10580;2220;6160;2200;9593;524;212;312;463;229;234;93;37;56;41;29;12;72;32;40;57;21;36;200;110;90;118.0;104.0;30.0;41.0;629.0;602.0;5
2372;Bedum;2022;10612;2198;6154;2260;9584;539;219;320;489;233;256;97;39;58;44;28;16;73;27;46;62;22;40;213;117;96;115.0;108.0;29.0;41.0;553.0;595.0;5
2373;Bedum;2023;10565;2148;6109;2308;9510;545;231;314;510;246;264;96;39;57;53;34;19;67;22;45;61;22;39;233;129;104;116.0;108.0;33.0;45.0;612.0;579.0;5
2374;Bedum;2024;10596;2170;6059;2367;9546;540;226;314;510;256;254;99;42;57;52;35;17;69;22;47;57;21;36;233;136;97;120.0;112.0;33.0;42.0;582.0;605.0;5
2375;Bedum;2025;10575;2179;5999;2397;9499;547;231;316;529;255;274;97;39;58;60;35;25;74;24;50;60;24;36;238;133;105;;;;;;;5
2376;Beek (L.);2008;16773;3742;10122;2909;14490;1721;490;1231;562;344;218;30;15;15;40;25;15;62;40;22;155;79;76;275;185;90;120.0;148.0;87.0;122.0;825.0;876.0;888
2377;Beek (L.);2009;16663;3643;10042;2978;14391;1695;479;1216;577;338;239;35;18;17;44;23;21;65;42;23;156;73;83;277;182;95;119.0;150.0;82.0;122.0;857.0;860.0;888
2378;Beek (L.);2010;16591;3531;10033;3027;14320;1671;460;1211;600;346;254;47;20;27;48;23;25;75;46;29;146;74;72;284;183;101;115.0;152.0;87.0;118.0;784.0;880.0;888
2379;Beek (L.);2011;16428;3370;9969;3089;14174;1643;454;1189;611;348;263;50;24;26;54;27;27;77;45;32;144;67;77;286;185;101;110.0;155.0;90.0;110.0;816.0;875.0;888
2380;Beek (L.);2012;16305;3231;9897;3177;14084;1611;453;1158;610;357;253;55;26;29;49;25;24;83;54;29;144;72;72;279;180;99;115.0;157.0;92.0;104.0;873.0;900.0;888
2381;Beek (L.);2013;16226;3164;9804;3258;14031;1574;455;1119;621;346;275;60;29;31;51;25;26;90;51;39;143;66;77;277;175;102;121.0;158.0;85.0;104.0;832.0;890.0;888
2382;Beek (L.);2014;16115;3099;9689;3327;13912;1545;449;1096;658;360;298;59;30;29;55;28;27;107;58;49;154;65;89;283;179;104;117.0;163.0;91.0;104.0;777.0;902.0;888
2383;Beek (L.);2015;15933;3009;9533;3391;13765;1499;434;1065;669;372;297;67;35;32;58;30;28;106;60;46;143;61;82;295;186;109;120.0;161.0;103.0;103.0;865.0;882.0;888
2384;Beek (L.);2016;15875;2943;9450;3482;13703;1474;440;1034;698;384;314;72;38;34;58;28;30;117;67;50;146;62;84;305;189;116;127.0;166.0;80.0;99.0;892.0;869.0;888
2385;Beek (L.);2017;15840;2866;9420;3554;13658;1439;428;1011;743;408;335;85;42;43;61;31;30;123;72;51;154;67;87;320;196;124;125.0;162.0;81.0;94.0;848.0;874.0;888
2386;Beek (L.);2018;15766;2778;9355;3633;13605;1388;418;970;773;426;347;87;44;43;64;37;27;133;81;52;161;66;95;328;198;130;130.0;171.0;77.0;94.0;868.0;890.0;888
2387;Beek (L.);2019;15687;2722;9261;3704;13548;1368;425;943;771;420;351;89;48;41;68;36;32;134;76;58;160;68;92;320;192;128;138.0;172.0;95.0;90.0;833.0;889.0;888
2388;Beek (L.);2020;15606;2681;9176;3749;13452;1347;428;919;807;446;361;91;52;39;75;40;35;146;78;68;164;69;95;331;207;124;142.0;178.0;76.0;93.0;857.0;881.0;888
2389;Beek (L.);2021;15531;2668;9058;3805;13400;1316;417;899;815;448;367;94;58;36;76;39;37;150;79;71;170;72;98;325;200;125;143.0;170.0;86.0;91.0;836.0;889.0;888
2390;Beek (L.);2022;15445;2624;8959;3862;13329;1289;423;866;827;444;383;92;56;36;77;37;40;163;83;80;185;78;107;310;190;120;145.0;172.0;77.0;88.0;830.0;857.0;888
2391;Beek (L.);2023;15382;2623;8832;3927;13279;1272;429;843;831;443;388;97;57;40;82;38;44;162;83;79;178;73;105;312;192;120;142.0;173.0;73.0;86.0;787.0;876.0;888
2392;Beek (L.);2024;15251;2610;8660;3981;13145;1227;421;806;879;468;411;102;63;39;91;41;50;173;88;85;180;72;108;333;204;129;144.0;174.0;69.0;82.0;861.0;857.0;888
2393;Beek (L.);2025;15214;2653;8509;4052;13093;1219;426;793;902;478;424;111;66;45;92;42;50;189;92;97;175;74;101;335;204;131;;;;;;;888
2394;Beemster;2008;8435;2050;5073;1312;7701;500;159;341;234;130;104;41;18;23;16;9;7;21;8;13;17;7;10;139;88;51;76.0;74.0;30.0;40.0;384.0;392.0;370
2395;Beemster;2009;8420;2012;5055;1353;7669;493;159;334;258;134;124;45;19;26;19;10;9;22;7;15;19;7;12;153;91;62;73.0;72.0;34.0;39.0;384.0;382.0;370
2396;Beemster;2010;8419;1962;5061;1396;7632;501;163;338;286;147;139;49;20;29;21;9;12;22;10;12;20;8;12;174;100;74;76.0;79.0;36.0;41.0;436.0;415.0;370
2397;Beemster;2011;8434;1937;5080;1417;7625;506;166;340;303;152;151;55;20;35;23;9;14;21;9;12;20;6;14;184;108;76;78.0;79.0;35.0;38.0;501.0;421.0;370
2398;Beemster;2012;8512;1915;5119;1478;7674;524;177;347;314;150;164;61;21;40;26;10;16;21;9;12;25;8;17;181;102;79;82.0;78.0;63.0;38.0;487.0;425.0;370
2399;Beemster;2013;8611;1915;5152;1544;7702;545;188;357;364;169;195;66;26;40;30;12;18;31;12;19;36;10;26;201;109;92;83.0;78.0;46.0;38.0;483.0;435.0;370
2400;Beemster;2014;8673;1908;5163;1602;7720;552;190;362;401;183;218;69;28;41;38;18;20;32;10;22;44;11;33;218;116;102;87.0;80.0;41.0;41.0;467.0;459.0;370
2401;Beemster;2015;8688;1881;5153;1654;7702;567;196;371;419;188;231;79;34;45;42;23;19;33;11;22;53;12;41;212;108;104;86.0;83.0;41.0;43.0;447.0;443.0;370
2402;Beemster;2016;8695;1844;5160;1691;7691;553;195;358;451;203;248;87;36;51;39;21;18;37;14;23;66;16;50;222;116;106;87.0;84.0;45.0;38.0;506.0;459.0;370
2403;Beemster;2017;8755;1826;5197;1732;7716;560;190;370;479;213;266;95;38;57;41;22;19;44;13;31;77;20;57;222;120;102;91.0;84.0;39.0;45.0;456.0;455.0;370
2404;Beemster;2018;8758;1799;5174;1785;7707;563;183;380;488;212;276;91;37;54;42;22;20;52;16;36;81;20;61;222;117;105;94.0;87.0;41.0;38.0;461.0;451.0;370
2405;Beemster;2019;8779;1798;5178;1803;7700;582;201;381;497;213;284;94;35;59;42;21;21;52;16;36;81;20;61;228;121;107;90.0;89.0;38.0;41.0;454.0;439.0;370
2406;Beemster;2020;8793;1768;5194;1831;7694;570;195;375;529;239;290;97;41;56;46;26;20;55;16;39;89;22;67;242;134;108;90.0;90.0;46.0;39.0;531.0;453.0;370
2407;Beemster;2021;8879;1792;5215;1872;7736;584;201;383;559;261;298;97;40;57;50;32;18;59;17;42;91;22;69;262;150;112;89.0;90.0;36.0;43.0;441.0;455.0;370
2408;Beemster;2022;8857;1779;5181;1897;7694;593;208;385;570;268;302;103;43;60;53;35;18;67;22;45;90;23;67;257;145;112;95.0;88.0;44.0;43.0;444.0;445.0;370
2409;Beemster;2023;8864;1794;5112;1958;7670;598;210;388;596;276;320;107;43;64;58;40;18;71;23;48;98;28;70;262;142;120;92.0;94.0;45.0;42.0;492.0;444.0;370
2410;Beemster;2024;8914;1800;5142;1972;7688;607;212;395;619;287;332;109;48;61;64;45;19;74;23;51;98;28;70;274;143;131;94.0;95.0;44.0;44.0;490.0;440.0;370
2411;Beemster;2025;8964;1812;5142;2010;7716;619;225;394;629;283;346;109;46;63;57;38;19;76;23;53;92;27;65;295;149;146;;;;;;;370
2412;Beesel;2008;13544;3319;8229;1996;11364;1511;441;1070;669;349;320;27;12;15;38;23;15;84;45;39;353;164;189;167;105;62;138.0;119.0;58.0;65.0;410.0;418.0;889
2413;Beesel;2009;13549;3303;8176;2070;11355;1514;442;1072;680;357;323;32;14;18;39;24;15;93;48;45;344;159;185;172;112;60;139.0;116.0;52.0;63.0;359.0;423.0;889
2414;Beesel;2010;13499;3260;8119;2120;11288;1513;446;1067;698;363;335;33;15;18;39;23;16;96;47;49;341;159;182;189;119;70;138.0;122.0;52.0;61.0;511.0;427.0;889
2415;Beesel;2011;13592;3284;8145;2163;11349;1531;447;1084;712;378;334;36;17;19;45;26;19;94;46;48;330;159;171;207;130;77;135.0;128.0;55.0;64.0;528.0;439.0;889
2416;Beesel;2012;13680;3299;8119;2262;11394;1561;455;1106;725;371;354;39;16;23;47;24;23;95;47;48;331;157;174;213;127;86;137.0;129.0;61.0;59.0;491.0;442.0;889
2417;Beesel;2013;13742;3283;8099;2360;11413;1583;466;1117;746;373;373;49;22;27;50;27;23;92;46;46;329;150;179;226;128;98;140.0;130.0;56.0;60.0;500.0;456.0;889
2418;Beesel;2014;13794;3273;8099;2422;11420;1597;475;1122;777;388;389;54;24;30;48;27;21;97;45;52;331;155;176;247;137;110;137.0;140.0;56.0;67.0;519.0;454.0;889
2419;Beesel;2015;13848;3266;8094;2488;11410;1614;488;1126;824;406;418;64;26;38;50;29;21;107;52;55;335;152;183;268;147;121;142.0;138.0;57.0;62.0;516.0;465.0;889
2420;Beesel;2016;13898;3255;8060;2583;11407;1646;488;1158;845;427;418;71;31;40;58;36;22;107;53;54;332;150;182;277;157;120;146.0;145.0;56.0;64.0;534.0;477.0;889
2421;Beesel;2017;13949;3253;8070;2626;11433;1652;495;1157;864;434;430;78;34;44;62;37;25;107;52;55;318;147;171;299;164;135;150.0;145.0;57.0;68.0;533.0;472.0;889
2422;Beesel;2018;14005;3264;8016;2725;11479;1635;491;1144;891;447;444;79;33;46;66;41;25;114;53;61;320;151;169;312;169;143;151.0;145.0;61.0;60.0;518.0;493.0;889
2423;Beesel;2019;14037;3257;7966;2814;11495;1633;487;1146;909;461;448;81;35;46;73;43;30;119;55;64;301;145;156;335;183;152;154.0;151.0;59.0;63.0;497.0;473.0;889
2424;Beesel;2020;14061;3250;7942;2869;11495;1644;484;1160;922;473;449;88;41;47;71;43;28;126;60;66;300;147;153;337;182;155;154.0;150.0;57.0;54.0;547.0;482.0;889
2425;Beesel;2021;14137;3245;7950;2942;11535;1650;478;1172;952;484;468;89;41;48;71;42;29;135;60;75;301;146;155;356;195;161;157.0;154.0;56.0;61.0;525.0;475.0;889
2426;Beesel;2022;14185;3248;7957;2980;11570;1647;490;1157;968;496;472;96;42;54;74;44;30;142;63;79;295;145;150;361;202;159;164.0;156.0;55.0;58.0;555.0;481.0;889
2427;Beesel;2023;14264;3246;7950;3068;11634;1636;490;1146;994;507;487;99;45;54;73;42;31;150;67;83;290;141;149;382;212;170;170.0;158.0;62.0;62.0;562.0;478.0;889
2428;Beesel;2024;14362;3278;7951;3133;11718;1643;496;1147;1001;514;487;102;49;53;74;45;29;147;65;82;282;139;143;396;216;180;167.0;165.0;60.0;60.0;514.0;493.0;889
2429;Beesel;2025;14384;3260;7943;3181;11722;1646;500;1146;1016;517;499;108;55;53;74;46;28;146;62;84;278;133;145;410;221;189;;;;;;;889
2430;Bellingwedde;2008;9521;1915;5770;1836;8399;809;329;480;313;223;90;40;20;20;14;8;6;20;14;6;9;6;3;230;175;55;60.0;111.0;39.0;66.0;456.0;562.0;7
2431;Bellingwedde;2009;9338;1825;5646;1867;8239;791;318;473;308;196;112;46;22;24;17;8;9;28;18;10;14;9;5;203;139;64;57.0;106.0;39.0;61.0;461.0;547.0;7
2432;Bellingwedde;2010;9182;1723;5568;1891;8123;763;303;460;296;186;110;48;26;22;17;8;9;32;19;13;12;8;4;187;125;62;54.0;107.0;29.0;55.0;439.0;518.0;7
2433;Bellingwedde;2011;9024;1644;5455;1925;7984;744;299;445;296;178;118;51;28;23;17;8;9;36;20;16;19;9;10;173;113;60;54.0;106.0;28.0;52.0;458.0;506.0;7
2434;Bellingwedde;2012;8902;1563;5321;2018;7895;712;293;419;295;172;123;53;30;23;19;8;11;41;23;18;20;11;9;162;100;62;54.0;105.0;31.0;54.0;433.0;513.0;7
2435;Bellingwedde;2013;8748;1510;5183;2055;7758;685;280;405;305;170;135;60;32;28;20;9;11;46;24;22;22;14;8;157;91;66;55.0;104.0;29.0;47.0;474.0;500.0;7
2436;Bellingwedde;2014;8654;1465;5100;2089;7689;658;254;404;307;174;133;57;32;25;25;14;11;52;29;23;27;16;11;146;83;63;54.0;107.0;28.0;43.0;400.0;485.0;7
2437;Bellingwedde;2015;8502;1368;4990;2144;7548;641;250;391;313;180;133;57;33;24;28;16;12;58;31;27;28;14;14;142;86;56;54.0;104.0;27.0;42.0;445.0;492.0;7
2438;Bellingwedde;2016;8390;1323;4896;2171;7435;617;242;375;338;196;142;66;35;31;32;17;15;60;38;22;27;15;12;153;91;62;50.0;105.0;25.0;40.0;421.0;462.0;7
2439;Bellingwedde;2017;8280;1275;4795;2210;7353;594;241;353;333;193;140;67;39;28;33;18;15;63;39;24;29;15;14;141;82;59;54.0;107.0;24.0;40.0;439.0;449.0;7
2440;Bellingwedde;2018;8202;1240;4721;2241;7295;560;226;334;347;196;151;81;44;37;36;18;18;70;40;30;30;15;15;130;79;51;52.0;108.0;24.0;34.0;394.0;445.0;7
2441;Bellingwedde;2019;8085;1180;4639;2266;7195;542;219;323;348;195;153;81;43;38;36;17;19;68;39;29;34;17;17;129;79;50;56.0;109.0;22.0;38.0;410.0;432.0;7
2442;Bellingwedde;2020;7995;1158;4560;2277;7123;521;205;316;351;195;156;75;42;33;41;20;21;72;42;30;37;20;17;126;71;55;53.0;107.0;24.0;38.0;386.0;426.0;7
2443;Bellingwedde;2021;7889;1131;4460;2298;7017;500;198;302;372;203;169;75;42;33;43;19;24;83;47;36;39;20;19;132;75;57;54.0;111.0;26.0;34.0;412.0;419.0;7
2444;Bellingwedde;2022;7818;1121;4391;2306;6925;503;200;303;390;218;172;73;43;30;44;20;24;85;49;36;43;21;22;145;85;60;53.0;108.0;27.0;37.0;388.0;414.0;7
2445;Bellingwedde;2023;7728;1100;4302;2326;6856;483;191;292;389;218;171;70;42;28;44;20;24;93;51;42;45;22;23;137;83;54;53.0;113.0;23.0;33.0;407.0;410.0;7
2446;Bellingwedde;2024;7655;1077;4228;2350;6804;464;180;284;387;221;166;70;43;27;47;21;26;94;56;38;47;24;23;129;77;52;55.0;115.0;27.0;28.0;394.0;410.0;7
2447;Bellingwedde;2025;7579;1056;4162;2361;6739;445;178;267;395;229;166;72;42;30;44;20;24;99;60;39;46;23;23;134;84;50;;;;;;;7
2448;Bennebroek;2008;5114;1115;2736;1263;4442;499;177;322;173;104;69;15;7;8;30;16;14;6;4;2;25;15;10;97;62;35;30.0;65.0;31.0;38.0;351.0;335.0;372
2449;Bennebroek;2009;5089;1087;2750;1252;4408;485;174;311;196;116;80;23;12;11;33;18;15;11;7;4;25;15;10;104;64;40;30.0;66.0;36.0;34.0;405.0;348.0;372
2450;Bennebroek;2010;5113;1056;2822;1235;4406;496;181;315;211;124;87;31;16;15;32;17;15;17;11;6;25;14;11;106;66;40;31.0;62.0;33.0;36.0;443.0;359.0;372
2451;Bennebroek;2011;5163;1048;2907;1208;4452;475;165;310;236;132;104;34;13;21;32;17;15;23;12;11;28;16;12;119;74;45;33.0;65.0;37.0;32.0;338.0;375.0;372
2452;Bennebroek;2012;5099;1001;2885;1213;4376;471;171;300;252;137;115;31;12;19;31;16;15;25;14;11;32;16;16;133;79;54;36.0;64.0;39.0;36.0;354.0;366.0;372
2453;Bennebroek;2013;5063;969;2886;1208;4348;464;183;281;251;133;118;36;14;22;30;16;14;24;11;13;34;18;16;127;74;53;39.0;63.0;40.0;32.0;386.0;374.0;372
2454;Bennebroek;2014;5059;964;2892;1203;4329;473;191;282;257;133;124;35;11;24;34;16;18;32;12;20;31;16;15;125;78;47;37.0;58.0;37.0;32.0;372.0;360.0;372
2455;Bennebroek;2015;5054;942;2886;1226;4318;475;208;267;261;135;126;37;13;24;35;18;17;36;15;21;31;16;15;122;73;49;40.0;59.0;37.0;32.0;326.0;345.0;372
2456;Bennebroek;2016;5021;942;2858;1221;4279;478;214;264;264;134;130;37;14;23;33;18;15;35;16;19;35;18;17;124;68;56;43.0;61.0;37.0;34.0;370.0;350.0;372
2457;Bennebroek;2017;5026;947;2848;1231;4265;481;212;269;280;140;140;38;14;24;37;21;16;35;12;23;41;20;21;129;73;56;45.0;58.0;36.0;33.0;346.0;349.0;372
2458;Bennebroek;2018;5014;923;2847;1244;4230;497;223;274;287;146;141;44;17;27;33;19;14;36;13;23;42;19;23;132;78;54;46.0;59.0;36.0;30.0;358.0;362.0;372
2459;Bennebroek;2019;5003;924;2833;1246;4212;499;226;273;292;141;151;36;16;20;34;18;16;37;13;24;39;18;21;146;76;70;48.0;60.0;37.0;30.0;367.0;371.0;372
2460;Bennebroek;2020;4994;939;2814;1241;4196;491;223;268;307;144;163;40;16;24;38;22;16;47;18;29;38;16;22;144;72;72;50.0;57.0;34.0;30.0;388.0;372.0;372
2461;Bennebroek;2021;5007;936;2820;1251;4187;494;223;271;326;152;174;44;18;26;36;21;15;52;19;33;43;18;25;151;76;75;49.0;60.0;36.0;29.0;394.0;388.0;372
2462;Bennebroek;2022;5009;930;2817;1262;4172;517;234;283;320;140;180;43;16;27;36;18;18;52;17;35;44;20;24;145;69;76;52.0;61.0;36.0;27.0;329.0;345.0;372
2463;Bennebroek;2023;4993;926;2787;1280;4168;510;233;277;315;141;174;42;17;25;33;17;16;49;16;33;47;21;26;144;70;74;53.0;60.0;31.0;29.0;350.0;367.0;372
2464;Bennebroek;2024;4971;920;2752;1299;4147;502;227;275;322;143;179;44;18;26;38;20;18;50;16;34;49;18;31;141;71;70;54.0;60.0;35.0;29.0;373.0;356.0;372
2465;Bennebroek;2025;4989;927;2736;1326;4173;494;226;268;322;138;184;50;19;31;37;21;16;54;15;39;44;18;26;137;65;72;;;;;;;372
2466;Bergambacht;2008;9442;2529;5410;1503;8761;392;140;252;289;141;148;16;5;11;16;7;9;20;6;14;108;54;54;129;69;60;115.0;74.0;23.0;32.0;388.0;318.0;491
2467;Bergambacht;2009;9546;2527;5483;1536;8824;403;143;260;319;147;172;21;7;14;18;10;8;24;6;18;119;56;63;137;68;69;118.0;78.0;22.0;32.0;375.0;328.0;491
2468;Bergambacht;2010;9625;2516;5519;1590;8871;414;149;265;340;156;184;25;9;16;22;11;11;32;10;22;125;58;67;136;68;68;117.0;81.0;26.0;27.0;361.0;337.0;491
2469;Bergambacht;2011;9687;2490;5587;1610;8899;424;155;269;364;161;203;28;11;17;24;11;13;38;12;26;131;60;71;143;67;76;120.0;77.0;24.0;31.0;357.0;320.0;491
2470;Bergambacht;2012;9760;2488;5556;1716;8934;427;145;282;399;181;218;28;13;15;28;12;16;47;17;30;139;64;75;157;75;82;121.0;82.0;29.0;29.0;255.0;317.0;491
2471;Bergambacht;2013;9738;2467;5480;1791;8880;446;145;301;412;191;221;28;15;13;36;16;20;52;18;34;138;63;75;158;79;79;113.0;78.0;24.0;31.0;213.0;308.0;491
2472;Bergambacht;2014;9671;2428;5388;1855;8819;436;145;291;416;191;225;34;15;19;33;14;19;51;19;32;135;62;73;163;81;82;114.0;87.0;26.0;32.0;390.0;303.0;491
2473;Bergambacht;2015;9780;2450;5431;1899;8878;459;153;306;443;206;237;43;20;23;38;16;22;55;23;32;138;63;75;169;84;85;114.0;85.0;23.0;31.0;239.0;316.0;491
2474;Bergambacht;2016;9725;2412;5376;1937;8807;467;157;310;451;210;241;46;23;23;39;16;23;62;25;37;136;61;75;168;85;83;113.0;88.0;25.0;32.0;230.0;300.0;491
2475;Bergambacht;2017;9673;2371;5350;1952;8717;479;163;316;477;231;246;47;25;22;41;18;23;67;27;40;142;63;79;180;98;82;111.0;89.0;28.0;30.0;238.0;310.0;491
2476;Bergambacht;2018;9621;2332;5286;2003;8638;484;163;321;499;236;263;51;24;27;45;18;27;74;27;47;140;64;76;189;103;86;112.0;88.0;32.0;31.0;236.0;301.0;491
2477;Bergambacht;2019;9583;2317;5218;2048;8586;485;166;319;512;238;274;58;26;32;47;18;29;67;25;42;137;63;74;203;106;97;113.0;92.0;27.0;27.0;262.0;303.0;491
2478;Bergambacht;2020;9564;2281;5209;2074;8556;487;167;320;521;231;290;59;26;33;48;17;31;66;24;42;143;63;80;205;101;104;111.0;94.0;28.0;29.0;238.0;299.0;491
2479;Bergambacht;2021;9518;2249;5139;2130;8507;492;166;326;519;241;278;55;29;26;48;19;29;73;27;46;142;64;78;201;102;99;109.0;97.0;23.0;29.0;219.0;297.0;491
2480;Bergambacht;2022;9445;2189;5094;2162;8437;491;165;326;517;246;271;55;29;26;54;24;30;69;26;43;137;64;73;202;103;99;105.0;95.0;24.0;26.0;264.0;307.0;491
2481;Bergambacht;2023;9411;2173;5024;2214;8384;493;171;322;534;259;275;59;31;28;53;23;30;77;28;49;133;64;69;212;113;99;105.0;96.0;23.0;29.0;259.0;288.0;491
2482;Bergambacht;2024;9385;2164;4979;2242;8319;503;173;330;563;275;288;65;31;34;53;23;30;83;32;51;138;68;70;224;121;103;107.0;98.0;25.0;25.0;241.0;282.0;491
2483;Bergambacht;2025;9353;2157;4918;2278;8274;504;175;329;575;275;300;68;33;35;58;23;35;86;33;53;140;68;72;223;118;105;;;;;;;491
2484;Bergeijk;2008;17827;4499;10567;2761;16162;1308;342;966;357;217;140;25;11;14;14;3;11;35;20;15;20;11;9;263;172;91;169.0;128.0;85.0;107.0;408.0;478.0;1724
2485;Bergeijk;2009;17777;4433;10484;2860;16045;1303;338;965;429;260;169;40;20;20;19;5;14;46;22;24;22;12;10;302;201;101;161.0;139.0;80.0;102.0;486.0;499.0;1724
2486;Bergeijk;2010;17766;4374;10374;3018;15992;1295;328;967;479;275;204;44;20;24;21;7;14;57;26;31;38;13;25;319;209;110;164.0;143.0;85.0;104.0;443.0;511.0;1724
2487;Bergeijk;2011;17704;4279;10313;3112;15894;1291;314;977;519;304;215;50;23;27;31;14;17;60;25;35;41;15;26;337;227;110;157.0;144.0;116.0;102.0;457.0;539.0;1724
2488;Bergeijk;2012;17654;4233;10162;3259;15808;1281;310;971;565;336;229;54;28;26;38;18;20;69;29;40;48;17;31;356;244;112;158.0;149.0;96.0;100.0;420.0;513.0;1724
2489;Bergeijk;2013;17566;4119;10066;3381;15694;1274;320;954;598;353;245;60;33;27;40;18;22;74;33;41;56;18;38;368;251;117;157.0;156.0;91.0;101.0;496.0;526.0;1724
2490;Bergeijk;2014;17529;4045;9977;3507;15601;1288;333;955;640;367;273;65;39;26;44;16;28;89;36;53;65;22;43;377;254;123;162.0;159.0;114.0;97.0;439.0;543.0;1724
2491;Bergeijk;2015;17448;3959;9877;3612;15466;1287;330;957;695;403;292;69;43;26;47;18;29;93;42;51;67;25;42;419;275;144;162.0;162.0;87.0;97.0;527.0;542.0;1724
2492;Bergeijk;2016;17426;3893;9864;3669;15397;1269;314;955;760;427;333;81;48;33;55;23;32;108;49;59;75;28;47;441;279;162;162.0;166.0;103.0;96.0;532.0;546.0;1724
2493;Bergeijk;2017;17417;3832;9852;3733;15337;1264;312;952;816;452;364;83;47;36;62;28;34;116;52;64;77;26;51;478;299;179;168.0;170.0;106.0;99.0;592.0;562.0;1724
2494;Bergeijk;2018;17454;3760;9899;3795;15328;1270;316;954;856;474;382;91;51;40;63;26;37;123;55;68;81;27;54;498;315;183;168.0;174.0;96.0;99.0;528.0;563.0;1724
2495;Bergeijk;2019;17414;3663;9863;3888;15248;1264;319;945;902;492;410;95;51;44;62;23;39;131;57;74;87;29;58;527;332;195;169.0;177.0;94.0;94.0;552.0;560.0;1724
2496;Bergeijk;2020;17399;3613;9866;3920;15182;1262;322;940;955;522;433;102;52;50;64;25;39;136;60;76;100;36;64;553;349;204;176.0;184.0;91.0;92.0;493.0;573.0;1724
2497;Bergeijk;2021;17312;3556;9772;3984;15097;1249;316;933;966;536;430;105;54;51;66;26;40;127;60;67;104;39;65;564;357;207;178.0;183.0;92.0;93.0;600.0;569.0;1724
2498;Bergeijk;2022;17339;3514;9769;4056;15064;1249;316;933;1026;558;468;113;57;56;72;32;40;138;62;76;104;37;67;599;370;229;181.0;185.0;92.0;91.0;583.0;567.0;1724
2499;Bergeijk;2023;17354;3491;9701;4162;15030;1264;322;942;1060;579;481;114;57;57;72;33;39;145;61;84;111;39;72;618;389;229;187.0;187.0;91.0;95.0;448.0;539.0;1724
2500;Bergeijk;2024;17263;3448;9579;4236;14916;1259;318;941;1088;606;482;120;63;57;74;35;39;143;61;82;124;42;82;627;405;222;188.0;196.0;94.0;94.0;537.0;549.0;1724
2501;Bergeijk;2025;17245;3483;9454;4308;14842;1260;328;932;1143;654;489;121;65;56;79;40;39;144;59;85;122;42;80;677;448;229;;;;;;;1724
2502;Bergen (L.);2008;13517;3253;8141;2123;11384;1845;619;1226;288;177;111;22;10;12;10;5;5;23;11;12;35;16;19;198;135;63;109.0;110.0;51.0;67.0;342.0;386.0;893
2503;Bergen (L.);2009;13458;3196;8094;2168;11332;1807;599;1208;319;187;132;28;13;15;12;7;5;29;14;15;41;16;25;209;137;72;111.0;113.0;54.0;64.0;342.0;406.0;893
2504;Bergen (L.);2010;13385;3114;8049;2222;11256;1769;586;1183;360;211;149;40;17;23;16;9;7;35;18;17;45;18;27;224;149;75;109.0;116.0;54.0;63.0;386.0;421.0;893
2505;Bergen (L.);2011;13337;3043;8025;2269;11192;1753;591;1162;392;231;161;43;21;22;21;11;10;47;23;24;49;22;27;232;154;78;111.0;121.0;55.0;62.0;363.0;426.0;893
2506;Bergen (L.);2012;13261;2964;7939;2358;11117;1727;597;1130;417;245;172;46;24;22;19;9;10;56;26;30;56;25;31;240;161;79;108.0;118.0;60.0;64.0;403.0;424.0;893
2507;Bergen (L.);2013;13228;2883;7896;2449;11081;1690;580;1110;457;265;192;53;30;23;24;12;12;60;27;33;56;27;29;264;169;95;109.0;125.0;56.0;59.0;469.0;428.0;893
2508;Bergen (L.);2014;13252;2847;7856;2549;11080;1665;580;1085;507;286;221;58;29;29;28;14;14;73;32;41;62;29;33;286;182;104;111.0;134.0;60.0;64.0;427.0;429.0;893
2509;Bergen (L.);2015;13223;2799;7815;2609;11045;1631;575;1056;547;297;250;57;30;27;29;12;17;81;32;49;73;33;40;307;190;117;113.0;132.0;62.0;60.0;452.0;434.0;893
2510;Bergen (L.);2016;13225;2767;7784;2674;11026;1622;573;1049;577;312;265;61;35;26;32;14;18;90;34;56;77;36;41;317;193;124;115.0;131.0;54.0;56.0;518.0;451.0;893
2511;Bergen (L.);2017;13275;2736;7781;2758;11059;1598;573;1025;618;323;295;63;36;27;38;17;21;104;35;69;78;36;42;335;199;136;116.0;136.0;57.0;58.0;419.0;447.0;893
2512;Bergen (L.);2018;13228;2675;7720;2833;10985;1607;589;1018;636;330;306;64;38;26;39;17;22;112;36;76;78;37;41;343;202;141;121.0;136.0;57.0;55.0;456.0;458.0;893
2513;Bergen (L.);2019;13214;2627;7679;2908;10974;1585;605;980;655;347;308;71;42;29;42;22;20;124;41;83;77;35;42;341;207;134;123.0;140.0;61.0;55.0;466.0;447.0;893
2514;Bergen (L.);2020;13222;2602;7642;2978;10951;1583;597;986;688;362;326;73;44;29;43;25;18;134;47;87;80;35;45;358;211;147;123.0;138.0;55.0;56.0;440.0;443.0;893
2515;Bergen (L.);2021;13203;2550;7622;3031;10943;1552;582;970;708;373;335;78;46;32;46;29;17;137;51;86;89;38;51;358;209;149;124.0;140.0;56.0;60.0;497.0;436.0;893
2516;Bergen (L.);2022;13245;2542;7580;3123;10946;1558;584;974;741;384;357;77;44;33;47;30;17;148;54;94;95;42;53;374;214;160;131.0;144.0;51.0;55.0;477.0;438.0;893
2517;Bergen (L.);2023;13267;2522;7573;3172;10924;1571;599;972;772;399;373;78;44;34;52;33;19;152;55;97;106;46;60;384;221;163;133.0;145.0;50.0;59.0;497.0;437.0;893
2518;Bergen (L.);2024;13307;2524;7539;3244;10948;1560;607;953;799;413;386;82;47;35;52;34;18;160;56;104;109;47;62;396;229;167;131.0;151.0;54.0;53.0;467.0;446.0;893
2519;Bergen (L.);2025;13310;2536;7470;3304;10952;1546;611;935;812;421;391;82;49;33;52;35;17;164;60;104;112;47;65;402;230;172;;;;;;;893
2520;Bergen (NH.);2008;31270;6590;18194;6486;27570;2739;1127;1612;961;544;417;142;63;79;88;43;45;78;29;49;60;32;28;593;377;216;209.0;326.0;110.0;203.0;1357.0;1378.0;373
2521;Bergen (NH.);2009;31043;6391;18073;6579;27309;2671;1058;1613;1063;586;477;172;77;95;92;45;47;96;37;59;83;41;42;620;386;234;213.0;323.0;126.0;186.0;1393.0;1406.0;373
2522;Bergen (NH.);2010;30862;6304;17804;6754;27075;2619;1044;1575;1168;625;543;182;80;102;111;56;55;116;49;67;99;40;59;660;400;260;210.0;327.0;120.0;186.0;1495.0;1391.0;373
2523;Bergen (NH.);2011;30786;6174;17803;6809;26916;2625;1043;1582;1245;649;596;185;77;108;119;66;53;140;55;85;118;41;77;683;410;273;211.0;323.0;123.0;194.0;1446.0;1445.0;373
2524;Bergen (NH.);2012;30604;5996;17526;7082;26663;2586;1021;1565;1355;691;664;204;82;122;141;82;59;166;63;103;131;48;83;713;416;297;217.0;316.0;127.0;184.0;1533.0;1426.0;373
2525;Bergen (NH.);2013;30558;5848;17314;7396;26558;2583;1020;1563;1417;707;710;215;80;135;148;83;65;177;64;113;145;53;92;732;427;305;221.0;324.0;132.0;190.0;1455.0;1438.0;373
2526;Bergen (NH.);2014;30417;5710;17124;7583;26369;2553;1007;1546;1495;753;742;235;92;143;165;96;69;187;73;114;162;61;101;746;431;315;222.0;326.0;126.0;178.0;1486.0;1453.0;373
2527;Bergen (NH.);2015;30296;5539;17010;7747;26198;2539;985;1554;1559;779;780;244;95;149;167;96;71;214;86;128;165;57;108;769;445;324;234.0;337.0;128.0;179.0;1338.0;1426.0;373
2528;Bergen (NH.);2016;30056;5389;16828;7839;25936;2487;961;1526;1633;802;831;255;102;153;178;100;78;219;86;133;187;60;127;794;454;340;233.0;329.0;118.0;174.0;1500.0;1453.0;373
2529;Bergen (NH.);2017;29955;5343;16723;7889;25758;2485;950;1535;1712;815;897;292;113;179;183;101;82;237;91;146;199;63;136;801;447;354;244.0;328.0;118.0;168.0;1388.0;1425.0;373
2530;Bergen (NH.);2018;29789;5276;16511;8002;25582;2469;924;1545;1738;821;917;300;114;186;178;99;79;240;90;150;202;67;135;818;451;367;245.0;332.0;119.0;166.0;1359.0;1427.0;373
2531;Bergen (NH.);2019;29589;5198;16299;8092;25354;2449;936;1513;1786;847;939;309;122;187;192;111;81;251;92;159;195;65;130;839;457;382;246.0;332.0;115.0;158.0;1428.0;1399.0;373
2532;Bergen (NH.);2020;29491;5128;16198;8165;25216;2434;919;1515;1841;862;979;312;120;192;199;119;80;283;107;176;212;70;142;835;446;389;251.0;344.0;113.0;155.0;1488.0;1400.0;373
2533;Bergen (NH.);2021;29448;5087;16199;8162;25104;2438;931;1507;1906;895;1011;313;119;194;206;123;83;293;116;177;232;69;163;862;468;394;258.0;338.0;116.0;159.0;1398.0;1378.0;373
2534;Bergen (NH.);2022;29347;5044;16084;8219;24986;2427;931;1496;1934;903;1031;327;124;203;205;123;82;288;116;172;241;70;171;873;470;403;258.0;352.0;109.0;152.0;1517.0;1390.0;373
2535;Bergen (NH.);2023;29340;5037;16030;8273;24882;2469;951;1518;1989;929;1060;336;127;209;221;130;91;286;114;172;253;74;179;893;484;409;261.0;351.0;110.0;155.0;1485.0;1371.0;373
2536;Bergen (NH.);2024;29321;5052;15917;8352;24804;2441;929;1512;2076;978;1098;342;133;209;234;146;88;297;115;182;270;80;190;933;504;429;272.0;347.0;112.0;151.0;1450.0;1362.0;373
2537;Bergen (NH.);2025;29299;5061;15817;8421;24750;2443;946;1497;2106;997;1109;353;136;217;237;148;89;307;118;189;262;80;182;947;515;432;;;;;;;373
2538;Bergen op Zoom;2008;65205;15387;39664;10154;51316;5678;2304;3374;8211;4492;3719;549;292;257;274;162;112;3038;1619;1419;2757;1331;1426;1593;1088;505;652.0;630.0;376.0;435.0;1849.0;2043.0;748
2539;Bergen op Zoom;2009;64987;15223;39448;10316;51113;5670;2319;3351;8204;4498;3706;569;295;274;297;179;118;2999;1605;1394;2718;1318;1400;1621;1101;520;635.0;643.0;365.0;420.0;1831.0;2055.0;748
2540;Bergen op Zoom;2010;64710;15015;39144;10551;50849;5636;2298;3338;8225;4510;3715;597;305;292;315;188;127;2976;1602;1374;2687;1306;1381;1650;1109;541;619.0;641.0;393.0;409.0;1771.0;2014.0;748
2541;Bergen op Zoom;2011;64436;14780;38840;10816;50610;5623;2275;3348;8203;4527;3676;601;309;292;325;196;129;2926;1588;1338;2664;1310;1354;1687;1124;563;602.0;655.0;398.0;406.0;1992.0;2085.0;748
2542;Bergen op Zoom;2012;64288;14622;38424;11242;50427;5639;2284;3355;8222;4539;3683;637;316;321;347;218;129;2905;1578;1327;2640;1305;1335;1693;1122;571;617.0;654.0;400.0;406.0;2053.0;2015.0;748
2543;Bergen op Zoom;2013;64287;14416;38237;11634;50389;5671;2313;3358;8227;4519;3708;657;330;327;365;229;136;2884;1566;1318;2627;1293;1334;1694;1101;593;591.0;668.0;394.0;388.0;2063.0;2066.0;748
2544;Bergen op Zoom;2014;64221;14269;37958;11994;50283;5713;2345;3368;8225;4518;3707;672;335;337;371;237;134;2877;1572;1305;2594;1282;1312;1711;1092;619;582.0;662.0;395.0;382.0;2100.0;2136.0;748
2545;Bergen op Zoom;2015;64126;14063;37714;12349;50199;5706;2326;3380;8221;4540;3681;699;340;359;391;248;143;2817;1554;1263;2558;1271;1287;1756;1127;629;591.0;669.0;384.0;374.0;1984.0;2060.0;748
2546;Bergen op Zoom;2016;63988;13899;37481;12608;50053;5713;2308;3405;8222;4513;3709;721;343;378;405;255;150;2781;1535;1246;2542;1261;1281;1773;1119;654;591.0;678.0;384.0;373.0;2083.0;2075.0;748
2547;Bergen op Zoom;2017;63926;13781;37297;12848;49957;5725;2313;3412;8244;4537;3707;737;348;389;416;258;158;2750;1527;1223;2538;1259;1279;1803;1145;658;585.0;684.0;374.0;376.0;2118.0;2085.0;748
2548;Bergen op Zoom;2018;63864;13684;37073;13107;49811;5747;2343;3404;8306;4571;3735;758;354;404;441;272;169;2709;1506;1203;2536;1277;1259;1862;1162;700;595.0;700.0;370.0;368.0;2191.0;2085.0;748
2549;Bergen op Zoom;2019;63873;13525;37049;13299;49734;5824;2394;3430;8315;4587;3728;762;355;407;457;291;166;2676;1494;1182;2505;1266;1239;1915;1181;734;586.0;707.0;357.0;348.0;1888.0;2014.0;748
2550;Bergen op Zoom;2020;63643;13280;36818;13545;49516;5794;2358;3436;8333;4568;3765;786;363;423;469;294;175;2666;1472;1194;2452;1252;1200;1960;1187;773;597.0;721.0;361.0;361.0;2227.0;2083.0;748
2551;Bergen op Zoom;2021;63668;13165;36699;13804;49471;5866;2377;3489;8331;4570;3761;788;368;420;479;301;178;2637;1438;1199;2418;1253;1165;2009;1210;799;581.0;730.0;374.0;349.0;2207.0;2130.0;748
2552;Bergen op Zoom;2022;63627;13015;36527;14085;49339;5912;2395;3517;8376;4603;3773;807;365;442;484;308;176;2602;1431;1171;2429;1258;1171;2054;1241;813;599.0;724.0;367.0;344.0;2310.0;2129.0;748
2553;Bergen op Zoom;2023;63714;12944;36495;14275;49389;5925;2414;3511;8400;4663;3737;815;374;441;507;320;187;2580;1421;1159;2397;1254;1143;2101;1294;807;596.0;746.0;379.0;352.0;2008.0;2074.0;748
2554;Bergen op Zoom;2024;63541;12860;36234;14447;49232;5904;2424;3480;8405;4682;3723;829;376;453;527;329;198;2558;1421;1137;2357;1243;1114;2134;1313;821;596.0;753.0;380.0;345.0;2251.0;2102.0;748
2555;Bergen op Zoom;2025;63575;12872;36064;14639;49131;5985;2474;3511;8459;4692;3767;850;392;458;560;349;211;2535;1404;1131;2344;1228;1116;2170;1319;851;;;;;;;748
2556;Berkelland;2008;44692;11048;26075;7569;41024;2288;677;1611;1380;793;587;142;44;98;83;30;53;264;129;135;176;85;91;715;505;210;405.0;402.0;110.0;171.0;1470.0;1655.0;1859
2557;Berkelland;2009;44451;10886;25811;7754;40648;2292;687;1605;1511;869;642;168;56;112;94;38;56;293;136;157;185;86;99;771;553;218;394.0;417.0;130.0;175.0;1502.0;1674.0;1859
2558;Berkelland;2010;44213;10659;25643;7911;40288;2279;680;1599;1646;951;695;185;64;121;117;53;64;316;142;174;209;96;113;819;596;223;376.0;420.0;128.0;167.0;1571.0;1691.0;1859
2559;Berkelland;2011;44013;10450;25442;8121;39961;2284;691;1593;1768;1020;748;208;74;134;131;63;68;352;151;201;211;98;113;866;634;232;366.0;423.0;129.0;165.0;1561.0;1669.0;1859
2560;Berkelland;2012;43817;10221;25161;8435;39605;2309;716;1593;1903;1065;838;241;83;158;147;65;82;385;158;227;215;104;111;915;655;260;362.0;438.0;136.0;166.0;1557.0;1681.0;1859
2561;Berkelland;2013;43592;10006;24921;8665;39244;2345;732;1613;2003;1101;902;262;89;173;167;72;95;407;166;241;244;113;131;923;661;262;355.0;442.0;125.0;162.0;1640.0;1680.0;1859
2562;Berkelland;2014;43436;9854;24655;8927;38929;2366;742;1624;2141;1177;964;301;98;203;178;79;99;429;172;257;246;113;133;987;715;272;355.0;442.0;132.0;158.0;1731.0;1682.0;1859
2563;Berkelland;2015;43378;9640;24625;9113;38740;2388;751;1637;2250;1232;1018;314;111;203;197;92;105;447;173;274;261;115;146;1031;741;290;361.0;456.0;126.0;162.0;1610.0;1709.0;1859
2564;Berkelland;2016;43153;9489;24360;9304;38428;2398;769;1629;2327;1250;1077;351;120;231;200;85;115;451;175;276;272;122;150;1053;748;305;359.0;449.0;125.0;157.0;1625.0;1742.0;1859
2565;Berkelland;2017;42920;9305;24151;9464;38088;2411;782;1629;2421;1294;1127;381;129;252;220;95;125;450;179;271;290;131;159;1080;760;320;365.0;461.0;133.0;159.0;1581.0;1713.0;1859
2566;Berkelland;2018;42673;9112;23898;9663;37754;2401;780;1621;2518;1327;1191;390;135;255;237;99;138;461;190;271;309;131;178;1121;772;349;360.0;470.0;131.0;154.0;1645.0;1685.0;1859
2567;Berkelland;2019;42504;8920;23733;9851;37491;2424;805;1619;2589;1353;1236;401;143;258;254;107;147;462;185;277;321;130;191;1151;788;363;371.0;475.0;140.0;151.0;1588.0;1664.0;1859
2568;Berkelland;2020;42312;8766;23582;9964;37190;2419;783;1636;2703;1417;1286;427;153;274;275;110;165;486;196;290;321;138;183;1194;820;374;369.0;490.0;136.0;148.0;1684.0;1688.0;1859
2569;Berkelland;2021;42179;8582;23487;10110;36980;2406;788;1618;2793;1464;1329;463;163;300;296;116;180;491;205;286;325;140;185;1218;840;378;376.0;483.0;135.0;150.0;1831.0;1690.0;1859
2570;Berkelland;2022;42202;8491;23457;10254;36862;2450;839;1611;2890;1511;1379;480;171;309;304;116;188;519;211;308;337;143;194;1250;870;380;376.0;489.0;140.0;156.0;1730.0;1729.0;1859
2571;Berkelland;2023;42079;8360;23302;10417;36659;2426;831;1595;2994;1573;1421;516;191;325;329;132;197;519;218;301;344;134;210;1286;898;388;384.0;507.0;135.0;147.0;1758.0;1696.0;1859
2572;Berkelland;2024;42009;8299;23205;10505;36476;2455;859;1596;3078;1599;1479;519;199;320;344;142;202;548;228;320;352;133;219;1315;897;418;390.0;501.0;154.0;162.0;1742.0;1700.0;1859
2573;Berkelland;2025;41935;8183;23062;10690;36278;2496;879;1617;3161;1646;1515;521;201;320;354;149;205;568;237;331;372;136;236;1346;923;423;;;;;;;1859
2574;Bernheze;2008;29431;7877;17475;4079;27503;1314;415;899;614;363;251;86;48;38;46;17;29;113;51;62;36;20;16;333;227;106;292.0;212.0;57.0;109.0;733.0;896.0;1721
2575;Bernheze;2009;29301;7796;17253;4252;27303;1329;411;918;669;381;288;104;54;50;47;19;28;128;55;73;55;25;30;335;228;107;283.0;217.0;64.0;99.0;857.0;928.0;1721
2576;Bernheze;2010;29263;7650;17222;4391;27175;1364;414;950;724;412;312;106;58;48;50;23;27;140;61;79;65;31;34;363;239;124;278.0;223.0;75.0;104.0;777.0;927.0;1721
2577;Bernheze;2011;29142;7533;17039;4570;26996;1366;420;946;780;435;345;110;57;53;52;21;31;155;69;86;74;33;41;389;255;134;265.0;234.0;70.0;100.0;887.0;958.0;1721
2578;Bernheze;2012;29076;7408;16950;4718;26866;1389;432;957;821;459;362;114;62;52;64;27;37;165;77;88;82;37;45;396;256;140;266.0;237.0;78.0;94.0;868.0;954.0;1721
2579;Bernheze;2013;29006;7271;16840;4895;26712;1411;432;979;883;497;386;119;65;54;71;31;40;175;80;95;88;40;48;430;281;149;258.0;241.0;105.0;93.0;866.0;944.0;1721
2580;Bernheze;2014;28962;7211;16669;5082;26553;1444;450;994;965;552;413;132;70;62;75;36;39;187;87;100;101;48;53;470;311;159;264.0;241.0;87.0;104.0;921.0;958.0;1721
2581;Bernheze;2015;28940;7104;16529;5307;26462;1457;449;1008;1021;575;446;144;72;72;80;42;38;192;90;102;115;53;62;490;318;172;263.0;247.0;81.0;94.0;823.0;964.0;1721
2582;Bernheze;2016;28805;6979;16371;5455;26269;1465;463;1002;1071;618;453;147;77;70;88;46;42;203;95;108;125;58;67;508;342;166;263.0;260.0;92.0;101.0;987.0;973.0;1721
2583;Bernheze;2017;28815;6876;16338;5601;26162;1497;471;1026;1156;652;504;163;86;77;90;45;45;231;102;129;138;61;77;534;358;176;258.0;264.0;89.0;100.0;1140.0;985.0;1721
2584;Bernheze;2018;28955;6781;16426;5748;26214;1510;495;1015;1231;675;556;177;91;86;103;49;54;242;107;135;156;61;95;553;367;186;267.0;259.0;84.0;87.0;964.0;1017.0;1721
2585;Bernheze;2019;28908;6657;16355;5896;26052;1523;502;1021;1333;734;599;183;96;87;115;54;61;255;117;138;174;69;105;606;398;208;270.0;270.0;78.0;92.0;973.0;1018.0;1721
2586;Bernheze;2020;28852;6501;16291;6060;25919;1554;505;1049;1379;756;623;192;102;90;123;56;67;270;124;146;174;72;102;620;402;218;270.0;280.0;83.0;90.0;1043.0;1008.0;1721
2587;Bernheze;2021;28871;6348;16290;6233;25874;1566;513;1053;1431;776;655;200;106;94;126;56;70;285;130;155;175;71;104;645;413;232;278.0;291.0;77.0;103.0;1057.0;1011.0;1721
2588;Bernheze;2022;28881;6240;16251;6390;25820;1576;520;1056;1485;812;673;212;113;99;132;64;68;300;138;162;188;76;112;653;421;232;278.0;299.0;84.0;87.0;976.0;1011.0;1721
2589;Bernheze;2023;28827;6131;16151;6545;25707;1605;538;1067;1515;818;697;223;114;109;129;62;67;309;140;169;187;72;115;667;430;237;286.0;300.0;65.0;88.0;965.0;1007.0;1721
2590;Bernheze;2024;28751;6045;16017;6689;25575;1623;549;1074;1553;838;715;225;116;109;134;65;69;309;144;165;196;74;122;689;439;250;279.0;303.0;75.0;91.0;1023.0;1001.0;1721
2591;Bernheze;2025;28734;5997;15929;6808;25490;1623;558;1065;1621;854;767;233;113;120;139;66;73;318;143;175;214;76;138;717;456;261;;;;;;;1721
2592;Bernisse;2008;12568;2906;7774;1888;11533;722;225;497;313;173;140;48;21;27;34;14;20;20;6;14;16;5;11;195;127;68;100.0;103.0;32.0;45.0;580.0;407.0;568
2593;Bernisse;2009;12728;2879;7880;1969;11637;746;238;508;345;181;164;53;22;31;38;14;24;28;10;18;20;7;13;206;128;78;103.0;105.0;26.0;45.0;593.0;444.0;568
2594;Bernisse;2010;12858;2828;7968;2062;11707;766;250;516;385;209;176;60;26;34;42;18;24;38;15;23;24;10;14;221;140;81;105.0;107.0;37.0;47.0;493.0;457.0;568
2595;Bernisse;2011;12885;2781;7981;2123;11681;792;270;522;412;222;190;62;28;34;44;21;23;46;17;29;32;15;17;228;141;87;103.0;113.0;33.0;48.0;468.0;472.0;568
2596;Bernisse;2012;12859;2726;7855;2278;11625;805;274;531;429;217;212;67;28;39;45;19;26;50;20;30;38;16;22;229;134;95;107.0;115.0;33.0;48.0;551.0;442.0;568
2597;Bernisse;2013;12946;2724;7799;2423;11645;826;277;549;475;230;245;71;27;44;47;21;26;71;28;43;40;15;25;246;139;107;110.0;115.0;39.0;49.0;423.0;459.0;568
2598;Bernisse;2014;12895;2692;7702;2501;11568;822;287;535;505;237;268;77;29;48;55;25;30;77;28;49;43;16;27;253;139;114;112.0;120.0;33.0;44.0;474.0;444.0;568
2599;Bernisse;2015;12906;2643;7661;2602;11550;819;289;530;537;256;281;85;36;49;61;30;31;82;29;53;48;19;29;261;142;119;112.0;118.0;33.0;46.0;516.0;466.0;568
2600;Bernisse;2016;12938;2623;7640;2675;11555;826;289;537;557;262;295;91;40;51;63;34;29;89;32;57;58;23;35;256;133;123;111.0;124.0;34.0;44.0;524.0;479.0;568
2601;Bernisse;2017;12959;2606;7643;2710;11529;847;285;562;583;269;314;101;44;57;58;32;26;97;35;62;64;26;38;263;132;131;119.0;130.0;37.0;43.0;428.0;492.0;568
2602;Bernisse;2018;12878;2560;7548;2770;11423;838;280;558;617;278;339;107;44;63;68;38;30;110;39;71;75;31;44;257;126;131;119.0;127.0;34.0;42.0;560.0;470.0;568
2603;Bernisse;2019;12953;2529;7589;2835;11443;853;289;564;657;292;365;109;45;64;65;35;30;123;42;81;79;32;47;281;138;143;116.0;130.0;34.0;44.0;537.0;465.0;568
2604;Bernisse;2020;13004;2506;7589;2909;11450;870;295;575;684;306;378;109;44;65;71;39;32;117;42;75;87;35;52;300;146;154;122.0;135.0;36.0;45.0;525.0;466.0;568
2605;Bernisse;2021;13042;2486;7593;2963;11475;877;303;574;690;320;370;103;47;56;73;38;35;120;45;75;89;35;54;305;155;150;123.0;142.0;36.0;42.0;527.0;476.0;568
2606;Bernisse;2022;13069;2451;7614;3004;11469;881;306;575;719;329;390;110;53;57;78;40;38;127;51;76;96;34;62;308;151;157;125.0;145.0;35.0;42.0;529.0;445.0;568
2607;Bernisse;2023;13126;2471;7575;3080;11464;893;311;582;769;343;426;116;53;63;85;41;44;128;48;80;110;42;68;330;159;171;131.0;143.0;34.0;43.0;605.0;455.0;568
2608;Bernisse;2024;13257;2493;7618;3146;11502;913;319;594;842;374;468;124;56;68;87;41;46;139;53;86;121;48;73;371;176;195;135.0;153.0;36.0;37.0;615.0;483.0;568
2609;Bernisse;2025;13371;2530;7624;3217;11540;948;339;609;883;391;492;133;58;75;94;47;47;145;55;90;126;46;80;385;185;200;;;;;;;568
2610;Best;2008;28900;7663;17441;3796;25106;2162;768;1394;1632;908;724;163;79;84;112;47;65;600;293;307;125;65;60;632;424;208;309.0;172.0;143.0;184.0;959.0;1018.0;753
2611;Best;2009;28941;7610;17398;3933;25083;2164;765;1399;1694;953;741;176;82;94;116;54;62;605;297;308;130;70;60;667;450;217;300.0;190.0;148.0;181.0;973.0;1036.0;753
2612;Best;2010;28958;7496;17434;4028;25026;2171;775;1396;1761;995;766;178;82;96;121;58;63;605;295;310;148;79;69;709;481;228;293.0;197.0;150.0;176.0;996.0;1057.0;753
2613;Best;2011;28971;7404;17472;4095;24979;2172;784;1388;1820;1023;797;181;84;97;126;62;64;612;296;316;166;82;84;735;499;236;289.0;194.0;160.0;175.0;1066.0;1110.0;753
2614;Best;2012;29009;7325;17365;4319;24903;2200;816;1384;1906;1069;837;199;95;104;132;65;67;628;311;317;183;82;101;764;516;248;286.0;202.0;160.0;170.0;1061.0;1103.0;753
2615;Best;2013;29045;7187;17362;4496;24857;2198;796;1402;1990;1110;880;201;100;101;137;65;72;638;312;326;203;92;111;811;541;270;286.0;215.0;170.0;169.0;1080.0;1113.0;753
2616;Best;2014;29088;7072;17353;4663;24807;2223;836;1387;2058;1118;940;211;106;105;142;68;74;651;309;342;238;101;137;816;534;282;283.0;216.0;159.0;168.0;1040.0;1118.0;753
2617;Best;2015;29071;6982;17280;4809;24689;2240;835;1405;2142;1162;980;223;114;109;149;75;74;660;308;352;253;104;149;857;561;296;285.0;218.0;158.0;164.0;1087.0;1140.0;753
2618;Best;2016;29079;6918;17214;4947;24611;2266;866;1400;2202;1193;1009;229;120;109;146;76;70;660;308;352;271;105;166;896;584;312;288.0;230.0;166.0;163.0;1051.0;1158.0;753
2619;Best;2017;29037;6792;17148;5097;24523;2260;859;1401;2254;1216;1038;235;121;114;153;82;71;658;298;360;289;113;176;919;602;317;283.0;235.0;167.0;165.0;1201.0;1164.0;753
2620;Best;2018;29126;6716;17149;5261;24485;2315;896;1419;2326;1257;1069;233;125;108;159;87;72;663;300;363;300;120;180;971;625;346;297.0;242.0;165.0;162.0;1075.0;1159.0;753
2621;Best;2019;29102;6578;17081;5443;24392;2340;904;1436;2370;1300;1070;244;135;109;160;84;76;658;307;351;328;137;191;980;637;343;298.0;249.0;162.0;174.0;1073.0;1152.0;753
2622;Best;2020;29064;6456;17060;5548;24252;2372;929;1443;2440;1329;1111;250;141;109;164;83;81;665;302;363;334;140;194;1027;663;364;306.0;246.0;163.0;158.0;1161.0;1154.0;753
2623;Best;2021;29137;6352;17116;5669;24238;2388;943;1445;2511;1366;1145;259;144;115;174;85;89;681;307;374;333;147;186;1064;683;381;313.0;259.0;157.0;164.0;1135.0;1172.0;753
2624;Best;2022;29149;6295;17086;5768;24152;2369;963;1406;2628;1404;1224;262;152;110;182;86;96;701;305;396;362;155;207;1121;706;415;311.0;266.0;164.0;160.0;1116.0;1171.0;753
2625;Best;2023;29145;6196;17064;5885;24027;2362;969;1393;2756;1465;1291;270;154;116;185;97;88;739;312;427;394;169;225;1168;733;435;311.0;267.0;155.0;158.0;1043.0;1168.0;753
2626;Best;2024;29064;6151;16887;6026;23893;2356;973;1383;2815;1503;1312;269;156;113;183;95;88;761;323;438;401;172;229;1201;757;444;315.0;269.0;168.0;159.0;1044.0;1158.0;753
2627;Best;2025;29006;6098;16734;6174;23738;2385;995;1390;2883;1532;1351;284;162;122;181;96;85;771;333;438;433;185;248;1214;756;458;;;;;;;753
2628;Beuningen;2008;25541;6696;15800;3045;22552;1942;556;1386;1047;589;458;158;74;84;138;82;56;137;59;78;80;32;48;534;342;192;239.0;176.0;82.0;118.0;1239.0;1210.0;209
2629;Beuningen;2009;25601;6529;15963;3109;22582;1934;584;1350;1085;613;472;158;74;84;137;85;52;149;65;84;97;43;54;544;346;198;249.0;179.0;89.0;127.0;1235.0;1212.0;209
2630;Beuningen;2010;25658;6360;16075;3223;22571;1967;612;1355;1120;633;487;165;78;87;145;90;55;156;63;93;100;45;55;554;357;197;247.0;179.0;94.0;126.0;1237.0;1218.0;209
2631;Beuningen;2011;25715;6181;16184;3350;22566;1986;629;1357;1163;651;512;164;80;84;154;99;55;164;64;100;112;50;62;569;358;211;243.0;182.0;99.0;117.0;1262.0;1227.0;209
2632;Beuningen;2012;25792;6036;16242;3514;22599;1984;641;1343;1209;687;522;168;85;83;164;108;56;168;67;101;118;50;68;591;377;214;239.0;191.0;94.0;119.0;1273.0;1247.0;209
2633;Beuningen;2013;25845;5904;16227;3714;22607;1997;648;1349;1241;716;525;178;93;85;176;118;58;179;72;107;116;50;66;592;383;209;244.0;191.0;93.0;111.0;1219.0;1241.0;209
2634;Beuningen;2014;25858;5755;16191;3912;22571;2005;643;1362;1282;720;562;186;99;87;178;120;58;201;74;127;129;55;74;588;372;216;237.0;201.0;99.0;113.0;1283.0;1244.0;209
2635;Beuningen;2015;25922;5604;16263;4055;22573;2023;666;1357;1326;742;584;192;105;87;182;123;59;218;78;140;131;53;78;603;383;220;250.0;201.0;94.0;112.0;1176.0;1256.0;209
2636;Beuningen;2016;25879;5469;16205;4205;22505;2026;670;1356;1348;762;586;194;107;87;186;127;59;224;81;143;133;57;76;611;390;221;245.0;214.0;103.0;110.0;1220.0;1241.0;209
2637;Beuningen;2017;25884;5365;16155;4364;22406;2084;717;1367;1394;773;621;205;117;88;191;130;61;242;89;153;140;52;88;616;385;231;249.0;219.0;114.0;104.0;1150.0;1261.0;209
2638;Beuningen;2018;25820;5304;15995;4521;22314;2070;718;1352;1436;807;629;217;126;91;196;133;63;241;97;144;151;57;94;631;394;237;245.0;221.0;90.0;105.0;1231.0;1241.0;209
2639;Beuningen;2019;25821;5245;15940;4636;22226;2109;764;1345;1486;835;651;216;124;92;208;145;63;259;108;151;155;57;98;648;401;247;251.0;222.0;93.0;107.0;1174.0;1253.0;209
2640;Beuningen;2020;25760;5154;15821;4785;22117;2104;755;1349;1539;846;693;229;133;96;214;148;66;272;109;163;163;58;105;661;398;263;252.0;228.0;94.0;114.0;1181.0;1227.0;209
2641;Beuningen;2021;25720;5079;15691;4950;22064;2081;761;1320;1575;856;719;230;132;98;215;147;68;279;109;170;175;60;115;676;408;268;261.0;231.0;96.0;108.0;1270.0;1223.0;209
2642;Beuningen;2022;25788;5033;15647;5108;22056;2116;788;1328;1616;874;742;235;136;99;221;144;77;279;109;170;179;62;117;702;423;279;256.0;241.0;87.0;104.0;1201.0;1228.0;209
2643;Beuningen;2023;25764;4986;15508;5270;22027;2111;803;1308;1626;880;746;234;135;99;217;149;68;276;107;169;188;65;123;711;424;287;257.0;242.0;100.0;105.0;1281.0;1223.0;209
2644;Beuningen;2024;25836;4995;15379;5462;22057;2126;817;1309;1653;884;769;235;131;104;224;149;75;286;110;176;186;66;120;722;428;294;252.0;248.0;92.0;104.0;1247.0;1249.0;209
2645;Beuningen;2025;25829;4956;15214;5659;22050;2126;850;1276;1653;885;768;235;126;109;225;156;69;296;116;180;184;65;119;713;422;291;;;;;;;209
2646;Beverwijk;2008;36885;8588;22232;6065;29597;3466;1478;1988;3822;2254;1568;302;164;138;121;73;48;1649;937;712;340;175;165;1410;905;505;400.0;336.0;156.0;112.0;1919.0;1814.0;375
2647;Beverwijk;2009;37106;8665;22360;6081;29683;3470;1470;2000;3953;2292;1661;324;172;152;140;84;56;1677;935;742;362;180;182;1450;921;529;395.0;327.0;166.0;116.0;2050.0;1843.0;375
2648;Beverwijk;2010;37439;8719;22605;6115;29807;3519;1489;2030;4113;2343;1770;347;180;167;162;98;64;1690;938;752;403;190;213;1511;937;574;408.0;337.0;178.0;116.0;2068.0;1785.0;375
2649;Beverwijk;2011;37853;8785;22897;6171;30017;3567;1521;2046;4269;2419;1850;366;186;180;163;100;63;1736;960;776;423;201;222;1581;972;609;396.0;351.0;176.0;110.0;2038.0;1798.0;375
2650;Beverwijk;2012;38208;8852;22955;6401;30187;3606;1542;2064;4415;2500;1915;396;200;196;176;110;66;1784;978;806;445;218;227;1614;994;620;392.0;346.0;174.0;110.0;1984.0;1839.0;375
2651;Beverwijk;2013;38468;8850;22988;6630;30281;3650;1585;2065;4537;2559;1978;418;210;208;174;106;68;1844;1013;831;461;227;234;1640;1003;637;407.0;346.0;177.0;111.0;2050.0;1861.0;375
2652;Beverwijk;2014;38787;8874;23114;6799;30443;3689;1615;2074;4655;2612;2043;431;219;212;187;115;72;1894;1045;849;490;230;260;1653;1003;650;393.0;354.0;180.0;116.0;1994.0;1840.0;375
2653;Beverwijk;2015;39048;8890;23216;6942;30548;3728;1627;2101;4772;2671;2101;438;227;211;205;128;77;1928;1046;882;483;233;250;1718;1037;681;400.0;359.0;174.0;103.0;1955.0;1805.0;375
2654;Beverwijk;2016;39310;8939;23319;7052;30681;3729;1633;2096;4900;2719;2181;452;233;219;221;137;84;1960;1061;899;505;240;265;1762;1048;714;405.0;360.0;178.0;100.0;2064.0;1845.0;375
2655;Beverwijk;2017;39656;8968;23486;7202;30819;3772;1656;2116;5065;2770;2295;470;241;229;242;140;102;2014;1074;940;539;252;287;1800;1063;737;411.0;368.0;181.0;105.0;2102.0;1802.0;375
2656;Beverwijk;2018;40078;9001;23703;7374;31027;3827;1693;2134;5224;2829;2395;486;251;235;249;140;109;2084;1091;993;561;268;293;1844;1079;765;412.0;370.0;198.0;120.0;2043.0;1834.0;375
2657;Beverwijk;2019;40413;8979;23957;7477;31199;3864;1713;2151;5350;2867;2483;499;254;245;277;157;120;2139;1103;1036;563;269;294;1872;1084;788;429.0;359.0;203.0;107.0;2026.0;1938.0;375
2658;Beverwijk;2020;40671;9013;24014;7644;31328;3875;1716;2159;5468;2935;2533;506;265;241;280;155;125;2212;1139;1073;583;272;311;1887;1104;783;435.0;372.0;188.0;109.0;2076.0;1852.0;375
2659;Beverwijk;2021;41038;9063;24158;7817;31495;3935;1746;2189;5608;2981;2627;517;270;247;296;158;138;2266;1147;1119;601;284;317;1928;1122;806;446.0;367.0;181.0;105.0;2113.0;1937.0;375
2660;Beverwijk;2022;41370;9070;24326;7974;31701;3956;1763;2193;5713;3035;2678;528;284;244;305;167;138;2323;1177;1146;613;283;330;1944;1124;820;449.0;383.0;182.0;107.0;2085.0;1955.0;375
2661;Beverwijk;2023;41644;9070;24415;8159;31833;3989;1799;2190;5822;3076;2746;530;285;245;317;175;142;2376;1203;1173;637;289;348;1962;1124;838;449.0;383.0;176.0;105.0;2072.0;1999.0;375
2662;Beverwijk;2024;41860;9075;24437;8348;31914;4010;1813;2197;5936;3114;2822;542;299;243;335;183;152;2423;1221;1202;649;282;367;1987;1129;858;461.0;389.0;188.0;104.0;2146.0;2009.0;375
2663;Beverwijk;2025;42156;9049;24568;8539;32055;4085;1852;2233;6016;3130;2886;558;297;261;356;188;168;2420;1204;1216;657;281;376;2025;1160;865;;;;;;;375
2664;het Bildt;2008;10882;2881;6390;1611;9917;511;250;261;454;291;163;31;13;18;21;11;10;43;24;19;11;3;8;348;240;108;130.0;91.0;36.0;60.0;561.0;581.0;63
2665;het Bildt;2009;10878;2865;6367;1646;9877;509;243;266;492;306;186;34;16;18;25;12;13;55;32;23;18;3;15;360;243;117;136.0;96.0;37.0;60.0;547.0;537.0;63
2666;het Bildt;2010;10907;2864;6358;1685;9833;528;251;277;546;330;216;41;20;21;27;14;13;60;32;28;25;4;21;393;260;133;132.0;101.0;39.0;64.0;523.0;549.0;63
2667;het Bildt;2011;10889;2829;6350;1710;9754;539;256;283;596;358;238;43;22;21;34;18;16;63;34;29;31;7;24;425;277;148;131.0;102.0;50.0;63.0;529.0;534.0;63
2668;het Bildt;2012;10901;2808;6322;1771;9710;564;256;308;627;379;248;44;24;20;36;18;18;65;38;27;29;9;20;453;290;163;130.0;102.0;48.0;66.0;511.0;515.0;63
2669;het Bildt;2013;10909;2791;6294;1824;9676;561;250;311;672;404;268;49;27;22;37;19;18;75;45;30;32;9;23;479;304;175;128.0;103.0;51.0;66.0;489.0;538.0;63
2670;het Bildt;2014;10872;2756;6249;1867;9601;578;264;314;693;406;287;52;27;25;28;16;12;84;49;35;38;11;27;491;303;188;129.0;102.0;49.0;66.0;541.0;558.0;63
2671;het Bildt;2015;10866;2723;6208;1935;9541;595;267;328;730;421;309;52;26;26;29;16;13;98;55;43;47;13;34;504;311;193;127.0;108.0;45.0;66.0;501.0;542.0;63
2672;het Bildt;2016;10825;2704;6158;1963;9479;587;258;329;759;427;332;60;27;33;30;17;13;110;57;53;46;12;34;513;314;199;130.0;102.0;47.0;67.0;513.0;581.0;63
2673;het Bildt;2017;10766;2669;6085;2012;9406;589;254;335;771;423;348;54;25;29;32;15;17;119;64;55;52;14;38;514;305;209;127.0;106.0;47.0;64.0;475.0;542.0;63
2674;het Bildt;2018;10704;2639;6024;2041;9319;600;255;345;785;416;369;59;27;32;33;17;16;130;68;62;62;13;49;501;291;210;130.0;108.0;46.0;62.0;509.0;562.0;63
2675;het Bildt;2019;10657;2593;6002;2062;9259;605;267;338;793;425;368;61;30;31;35;16;19;128;66;62;65;15;50;504;298;206;129.0;106.0;54.0;61.0;510.0;553.0;63
2676;het Bildt;2020;10631;2573;5955;2103;9206;624;274;350;801;444;357;64;32;32;35;17;18;126;70;56;66;18;48;510;307;203;132.0;109.0;47.0;61.0;549.0;555.0;63
2677;het Bildt;2021;10635;2559;5922;2154;9181;634;282;352;820;447;373;68;35;33;36;20;16;138;77;61;76;23;53;502;292;210;133.0;110.0;45.0;56.0;478.0;580.0;63
2678;het Bildt;2022;10546;2534;5808;2204;9081;651;296;355;814;444;370;67;34;33;38;21;17;141;79;62;81;29;52;487;281;206;127.0;113.0;40.0;58.0;472.0;539.0;63
2679;het Bildt;2023;10476;2513;5705;2258;8990;656;301;355;830;452;378;72;38;34;47;26;21;141;81;60;86;31;55;484;276;208;127.0;113.0;43.0;56.0;453.0;532.0;63
2680;het Bildt;2024;10400;2476;5613;2311;8889;668;311;357;843;461;382;70;38;32;41;26;15;157;86;71;95;33;62;480;278;202;132.0;114.0;44.0;57.0;430.0;525.0;63
2681;het Bildt;2025;10311;2451;5527;2333;8818;658;310;348;835;458;377;71;36;35;46;29;17;157;84;73;91;30;61;470;279;191;;;;;;;63
2682;De Bilt;2008;41818;9880;23750;8188;35598;3849;1366;2483;2371;1290;1081;356;176;180;164;68;96;153;64;89;683;363;320;1015;619;396;371.0;459.0;143.0;207.0;2427.0;2288.0;310
2683;De Bilt;2009;41812;9640;24040;8132;35505;3816;1362;2454;2491;1323;1168;366;177;189;167;70;97;190;75;115;734;381;353;1034;620;414;374.0;444.0;165.0;202.0;2525.0;2368.0;310
2684;De Bilt;2010;41866;9472;24286;8108;35439;3842;1375;2467;2585;1361;1224;364;182;182;168;70;98;212;81;131;769;393;376;1072;635;437;392.0;433.0;165.0;206.0;2480.0;2392.0;310
2685;De Bilt;2011;41877;9304;24537;8036;35383;3836;1381;2455;2658;1404;1254;368;193;175;177;75;102;230;93;137;794;401;393;1089;642;447;406.0;422.0;177.0;202.0;2394.0;2393.0;310
2686;De Bilt;2012;41838;9145;24413;8280;35272;3836;1383;2453;2730;1432;1298;378;197;181;185;79;106;254;104;150;821;403;418;1092;649;443;403.0;430.0;175.0;195.0;2344.0;2419.0;310
2687;De Bilt;2013;41720;8957;24285;8478;35088;3852;1394;2458;2780;1464;1316;392;205;187;194;81;113;256;111;145;830;413;417;1108;654;454;411.0;414.0;176.0;187.0;2457.0;2429.0;310
2688;De Bilt;2014;41737;8814;24305;8618;35022;3835;1381;2454;2880;1494;1386;404;213;191;204;81;123;295;121;174;840;413;427;1137;666;471;417.0;416.0;178.0;190.0;2293.0;2400.0;310
2689;De Bilt;2015;41619;8689;24175;8755;34861;3822;1380;2442;2936;1530;1406;428;220;208;199;81;118;313;131;182;842;417;425;1154;681;473;425.0;410.0;169.0;192.0;2324.0;2370.0;310
2690;De Bilt;2016;41571;8599;24102;8870;34722;3803;1380;2423;3046;1588;1458;429;220;209;206;88;118;321;143;178;872;429;443;1218;708;510;427.0;409.0;161.0;195.0;2292.0;2406.0;310
2691;De Bilt;2017;41444;8502;23961;8981;34593;3735;1346;2389;3116;1627;1489;432;226;206;209;91;118;333;142;191;909;445;464;1233;723;510;429.0;409.0;170.0;174.0;2332.0;2351.0;310
2692;De Bilt;2018;41446;8445;23916;9085;34504;3735;1343;2392;3207;1678;1529;443;231;212;226;104;122;346;147;199;930;456;474;1262;740;522;430.0;408.0;161.0;185.0;2263.0;2309.0;310
2693;De Bilt;2019;41400;8388;23854;9158;34387;3765;1369;2396;3248;1682;1566;440;223;217;232;107;125;359;152;207;946;463;483;1271;737;534;442.0;415.0;159.0;184.0;2368.0;2297.0;310
2694;De Bilt;2020;41477;8369;23811;9297;34368;3784;1399;2385;3325;1727;1598;455;231;224;236;114;122;361;159;202;955;465;490;1318;758;560;443.0;413.0;153.0;172.0;2371.0;2337.0;310
2695;De Bilt;2021;41523;8316;23793;9414;34314;3798;1405;2393;3411;1763;1648;467;239;228;250;118;132;387;164;223;958;464;494;1349;778;571;445.0;413.0;153.0;170.0;2414.0;2344.0;310
2696;De Bilt;2022;41612;8338;23704;9570;34346;3812;1423;2389;3454;1779;1675;484;247;237;262;122;140;398;162;236;964;470;494;1346;778;568;455.0;424.0;163.0;187.0;2408.0;2348.0;310
2697;De Bilt;2023;41683;8302;23688;9693;34377;3854;1440;2414;3452;1769;1683;486;242;244;264;121;143;412;167;245;956;465;491;1334;774;560;447.0;425.0;156.0;172.0;2467.0;2342.0;310
2698;De Bilt;2024;41817;8329;23665;9823;34453;3871;1468;2403;3493;1798;1695;502;249;253;276;130;146;417;170;247;955;465;490;1343;784;559;446.0;431.0;160.0;170.0;2456.0;2350.0;310
2699;De Bilt;2025;41932;8346;23558;10028;34499;3908;1485;2423;3525;1813;1712;508;258;250;274;128;146;431;171;260;970;473;497;1342;783;559;;;;;;;310
2700;Binnenmaas;2008;28834;6638;17854;4342;26319;1473;520;953;1042;605;437;186;86;100;74;35;39;94;37;57;62;30;32;626;417;209;290.0;225.0;68.0;108.0;1288.0;1253.0;585
2701;Binnenmaas;2009;28896;6579;17812;4505;26288;1518;534;984;1090;609;481;195;91;104;80;37;43;107;43;64;69;28;41;639;410;229;289.0;232.0;70.0;113.0;1268.0;1251.0;585
2702;Binnenmaas;2010;28931;6527;17670;4734;26226;1550;554;996;1155;629;526;210;96;114;82;39;43;126;51;75;87;34;53;650;409;241;276.0;232.0;81.0;107.0;1174.0;1200.0;585
2703;Binnenmaas;2011;28925;6458;17596;4871;26121;1568;569;999;1236;673;563;214;95;119;93;43;50;148;62;86;107;47;60;674;426;248;274.0;241.0;74.0;110.0;1216.0;1216.0;585
2704;Binnenmaas;2012;28924;6359;17338;5227;26015;1611;592;1019;1298;701;597;219;99;120;101;49;52;163;68;95;115;49;66;700;436;264;266.0;251.0;92.0;104.0;1215.0;1184.0;585
2705;Binnenmaas;2013;28965;6341;17132;5492;25965;1607;591;1016;1393;741;652;235;103;132;108;55;53;184;75;109;127;53;74;739;455;284;261.0;249.0;82.0;102.0;1249.0;1168.0;585
2706;Binnenmaas;2014;29043;6263;17053;5727;25942;1626;600;1026;1475;784;691;254;116;138;119;56;63;195;83;112;142;61;81;765;468;297;268.0;255.0;95.0;100.0;1197.0;1196.0;585
2707;Binnenmaas;2015;29056;6203;16959;5894;25862;1650;606;1044;1544;791;753;265;115;150;123;63;60;215;88;127;164;65;99;777;460;317;260.0;265.0;72.0;97.0;1185.0;1138.0;585
2708;Binnenmaas;2016;29082;6144;16884;6054;25833;1659;617;1042;1590;791;799;271;115;156;133;66;67;239;88;151;163;69;94;784;453;331;260.0;266.0;95.0;102.0;1306.0;1164.0;585
2709;Binnenmaas;2017;29213;6120;16855;6238;25841;1689;636;1053;1683;809;874;291;122;169;143;66;77;263;98;165;177;71;106;809;452;357;261.0;271.0;86.0;98.0;1275.0;1169.0;585
2710;Binnenmaas;2018;29300;6053;16845;6402;25800;1747;665;1082;1753;827;926;305;122;183;142;65;77;290;104;186;190;75;115;826;461;365;264.0;278.0;79.0;97.0;1188.0;1174.0;585
2711;Binnenmaas;2019;29288;5978;16761;6549;25692;1782;676;1106;1814;839;975;298;113;185;150;69;81;297;102;195;201;80;121;868;475;393;264.0;280.0;81.0;97.0;1256.0;1183.0;585
2712;Binnenmaas;2020;29332;5960;16669;6703;25611;1826;695;1131;1895;853;1042;302;117;185;152;64;88;309;102;207;215;83;132;917;487;430;273.0;286.0;87.0;98.0;1140.0;1156.0;585
2713;Binnenmaas;2021;29294;5863;16612;6819;25469;1877;707;1170;1948;883;1065;307;118;189;151;61;90;328;110;218;241;96;145;921;498;423;269.0;299.0;85.0;103.0;1236.0;1174.0;585
2714;Binnenmaas;2022;29312;5827;16536;6949;25385;1902;721;1181;2025;926;1099;331;130;201;153;62;91;333;115;218;252;102;150;956;517;439;270.0;299.0;89.0;103.0;1146.0;1174.0;585
2715;Binnenmaas;2023;29245;5772;16404;7069;25264;1916;735;1181;2065;948;1117;334;130;204;162;71;91;341;114;227;264;100;164;964;533;431;276.0;305.0;87.0;96.0;1196.0;1161.0;585
2716;Binnenmaas;2024;29245;5709;16378;7158;25147;1947;757;1190;2151;982;1169;349;137;212;177;80;97;358;123;235;271;98;173;996;544;452;279.0;302.0;111.0;98.0;1209.0;1207.0;585
2717;Binnenmaas;2025;29241;5670;16270;7301;25073;1993;795;1198;2175;997;1178;349;141;208;184;80;104;377;132;245;264;101;163;1001;543;458;;;;;;;585
2718;Bladel;2008;19134;4838;11543;2753;17614;1092;346;746;428;265;163;53;22;31;28;11;17;24;11;13;36;18;18;287;203;84;196.0;148.0;81.0;105.0;483.0;570.0;1728
2719;Bladel;2009;19075;4799;11412;2864;17488;1105;360;745;482;291;191;60;28;32;35;15;20;41;19;22;46;24;22;300;205;95;191.0;150.0;83.0;107.0;524.0;591.0;1728
2720;Bladel;2010;19027;4767;11272;2988;17434;1079;358;721;514;299;215;63;27;36;44;20;24;50;22;28;46;23;23;311;207;104;181.0;158.0;82.0;102.0;481.0;630.0;1728
2721;Bladel;2011;18882;4647;11164;3071;17269;1085;369;716;528;303;225;66;27;39;42;19;23;58;27;31;53;25;28;309;205;104;179.0;161.0;84.0;98.0;506.0;639.0;1728
2722;Bladel;2012;18757;4544;10999;3214;17102;1086;372;714;569;332;237;77;35;42;44;21;23;62;31;31;56;27;29;330;218;112;173.0;169.0;88.0;97.0;610.0;627.0;1728
2723;Bladel;2013;18737;4456;10963;3318;17053;1066;362;704;618;366;252;81;36;45;52;27;25;66;32;34;60;30;30;359;241;118;167.0;171.0;90.0;92.0;572.0;646.0;1728
2724;Bladel;2014;18659;4347;10859;3453;16933;1059;347;712;667;397;270;86;40;46;60;31;29;78;42;36;69;30;39;374;254;120;174.0;175.0;86.0;94.0;582.0;645.0;1728
2725;Bladel;2015;18588;4260;10769;3559;16833;1056;340;716;699;422;277;82;40;42;60;33;27;89;46;43;71;34;37;397;269;128;167.0;180.0;93.0;91.0;570.0;642.0;1728
2726;Bladel;2016;18509;4170;10691;3648;16752;1044;347;697;713;424;289;89;44;45;61;35;26;99;48;51;72;33;39;392;264;128;165.0;187.0;88.0;86.0;613.0;634.0;1728
2727;Bladel;2017;18470;4084;10642;3744;16656;1049;355;694;765;450;315;93;48;45;67;36;31;102;51;51;82;37;45;421;278;143;165.0;185.0;88.0;89.0;566.0;616.0;1728
2728;Bladel;2018;18401;3969;10568;3864;16519;1087;383;704;795;463;332;103;55;48;67;35;32;109;55;54;90;40;50;426;278;148;171.0;193.0;88.0;93.0;574.0;625.0;1728
2729;Bladel;2019;18325;3904;10481;3940;16390;1080;388;692;855;499;356;112;56;56;72;39;33;118;61;57;99;44;55;454;299;155;168.0;200.0;86.0;86.0;686.0;635.0;1728
2730;Bladel;2020;18345;3821;10534;3990;16359;1075;376;699;911;522;389;115;60;55;73;39;34;134;66;68;109;46;63;480;311;169;169.0;197.0;86.0;91.0;648.0;650.0;1728
2731;Bladel;2021;18312;3757;10495;4060;16311;1071;381;690;930;528;402;121;65;56;79;46;33;138;65;73;113;49;64;479;303;176;176.0;202.0;81.0;87.0;594.0;627.0;1728
2732;Bladel;2022;18249;3679;10413;4157;16237;1062;391;671;950;537;413;127;64;63;81;46;35;144;69;75;114;53;61;484;305;179;176.0;210.0;91.0;89.0;612.0;615.0;1728
2733;Bladel;2023;18216;3634;10327;4255;16181;1061;399;662;974;549;425;131;65;66;90;51;39;144;77;67;113;49;64;496;307;189;177.0;212.0;83.0;87.0;689.0;628.0;1728
2734;Bladel;2024;18241;3589;10311;4341;16154;1064;407;657;1023;572;451;140;70;70;94;52;42;145;75;70;116;49;67;528;326;202;177.0;213.0;95.0;91.0;602.0;630.0;1728
2735;Bladel;2025;18185;3541;10212;4432;16038;1074;420;654;1073;596;477;139;68;71;106;56;50;146;73;73;125;52;73;557;347;210;;;;;;;1728
2736;Blaricum;2008;9113;2025;5452;1636;7611;1039;393;646;463;245;218;89;38;51;40;18;22;41;27;14;60;27;33;233;135;98;47.0;81.0;54.0;62.0;588.0;557.0;376
2737;Blaricum;2009;9103;1993;5381;1729;7603;1016;374;642;484;248;236;100;44;56;41;18;23;40;20;20;70;28;42;233;138;95;50.0;83.0;55.0;67.0;622.0;575.0;376
2738;Blaricum;2010;9106;1971;5364;1771;7579;1000;381;619;527;256;271;106;47;59;43;17;26;46;21;25;87;32;55;245;139;106;49.0;84.0;57.0;57.0;653.0;579.0;376
2739;Blaricum;2011;9146;1954;5379;1813;7598;1000;383;617;548;261;287;108;48;60;48;20;28;52;25;27;97;33;64;243;135;108;58.0;81.0;64.0;59.0;716.0;605.0;376
2740;Blaricum;2012;9240;1945;5371;1924;7672;997;382;615;571;269;302;114;49;65;51;23;28;54;22;32;104;36;68;248;139;109;59.0;81.0;62.0;58.0;746.0;608.0;376
2741;Blaricum;2013;9360;1975;5327;2058;7740;1017;404;613;603;283;320;122;52;70;52;23;29;62;23;39;104;38;66;263;147;116;62.0;87.0;63.0;60.0;767.0;645.0;376
2742;Blaricum;2014;9461;1975;5349;2137;7827;1017;415;602;617;276;341;127;56;71;55;24;31;75;27;48;102;36;66;258;133;125;68.0;87.0;64.0;58.0;769.0;645.0;376
2743;Blaricum;2015;9573;1966;5387;2220;7916;1011;412;599;646;284;362;133;54;79;60;27;33;78;27;51;102;35;67;273;141;132;73.0;88.0;62.0;56.0;833.0;656.0;376
2744;Blaricum;2016;9742;1995;5442;2305;8048;1018;425;593;676;291;385;138;55;83;67;28;39;80;26;54;100;33;67;291;149;142;78.0;89.0;62.0;60.0;817.0;691.0;376
2745;Blaricum;2017;9859;2015;5470;2374;8152;1015;414;601;692;284;408;141;57;84;62;22;40;90;30;60;106;32;74;293;143;150;81.0;93.0;58.0;56.0;783.0;670.0;376
2746;Blaricum;2018;9964;2046;5471;2447;8214;1022;414;608;728;304;424;147;60;87;64;24;40;112;35;77;105;34;71;300;151;149;82.0;95.0;66.0;59.0;662.0;650.0;376
2747;Blaricum;2019;9970;2053;5422;2495;8201;1016;405;611;753;317;436;145;63;82;65;24;41;120;36;84;110;34;76;313;160;153;81.0;98.0;61.0;57.0;678.0;671.0;376
2748;Blaricum;2020;9965;2063;5366;2536;8180;1027;412;615;758;323;435;151;66;85;70;24;46;115;35;80;110;34;76;312;164;148;82.0;104.0;58.0;55.0;754.0;685.0;376
2749;Blaricum;2021;10017;2080;5382;2555;8209;1043;420;623;765;327;438;154;67;87;73;27;46;116;39;77;114;36;78;308;158;150;86.0;101.0;63.0;57.0;694.0;667.0;376
2750;Blaricum;2022;10036;2084;5378;2574;8216;1027;427;600;793;351;442;152;69;83;81;33;48;119;39;80;114;39;75;327;171;156;84.0;104.0;67.0;56.0;725.0;675.0;376
2751;Blaricum;2023;10078;2090;5417;2571;8222;1035;425;610;821;352;469;162;76;86;81;31;50;124;39;85;124;37;87;330;169;161;91.0;107.0;61.0;55.0;698.0;676.0;376
2752;Blaricum;2024;10091;2115;5390;2586;8247;1018;417;601;826;355;471;160;79;81;93;34;59;124;41;83;122;38;84;327;163;164;91.0;105.0;65.0;53.0;692.0;656.0;376
2753;Blaricum;2025;10126;2141;5346;2639;8272;1003;406;597;851;375;476;168;85;83;103;44;59;124;42;82;131;40;91;325;164;161;;;;;;;376
2754;Bloemendaal;2008;16548;4005;9060;3483;13595;2248;788;1460;705;359;346;104;40;64;78;33;45;73;29;44;51;22;29;399;235;164;86.0;168.0;135.0;132.0;1157.0;1222.0;377
2755;Bloemendaal;2009;16407;3877;9081;3449;13454;2193;759;1434;760;398;362;111;45;66;84;41;43;84;35;49;68;28;40;413;249;164;85.0;166.0;134.0;128.0;1284.0;1256.0;377
2756;Bloemendaal;2010;16363;3771;9133;3459;13398;2153;752;1401;812;425;387;121;45;76;79;44;35;103;39;64;77;35;42;432;262;170;91.0;160.0;154.0;127.0;1104.0;1264.0;377
2757;Bloemendaal;2011;16163;3636;9105;3422;13225;2066;713;1353;872;462;410;136;49;87;84;43;41;111;45;66;84;38;46;457;287;170;93.0;148.0;139.0;125.0;1118.0;1271.0;377
2758;Bloemendaal;2012;15971;3471;8973;3527;13064;2017;689;1328;890;474;416;138;50;88;82;42;40;103;41;62;98;42;56;469;299;170;94.0;146.0;145.0;120.0;1159.0;1294.0;377
2759;Bloemendaal;2013;15812;3365;8843;3604;12912;1974;698;1276;926;502;424;143;55;88;91;50;41;107;43;64;103;42;61;482;312;170;101.0;147.0;135.0;121.0;1180.0;1289.0;377
2760;Bloemendaal;2014;15674;3219;8805;3650;12756;1936;685;1251;982;526;456;146;61;85;99;53;46;109;46;63;118;47;71;510;319;191;107.0;148.0;134.0;115.0;1145.0;1270.0;377
2761;Bloemendaal;2015;15528;3137;8672;3719;12584;1939;693;1246;1005;536;469;149;66;83;91;50;41;117;49;68;120;46;74;528;325;203;108.0;143.0;134.0;118.0;1218.0;1274.0;377
2762;Bloemendaal;2016;15456;3022;8693;3741;12528;1908;689;1219;1020;524;496;153;63;90;86;45;41;133;54;79;121;46;75;527;316;211;112.0;146.0;129.0;110.0;1212.0;1283.0;377
2763;Bloemendaal;2017;15370;2956;8643;3771;12380;1906;702;1204;1084;550;534;163;68;95;97;51;46;135;58;77;137;47;90;552;326;226;117.0;149.0;123.0;114.0;1294.0;1261.0;377
2764;Bloemendaal;2018;15379;2930;8670;3779;12352;1899;691;1208;1128;577;551;164;70;94;107;59;48;145;66;79;148;51;97;564;331;233;114.0;149.0;128.0;109.0;1251.0;1316.0;377
2765;Bloemendaal;2019;15299;2859;8633;3807;12226;1923;721;1202;1150;568;582;181;70;111;111;63;48;147;67;80;145;46;99;566;322;244;117.0;148.0;123.0;113.0;1266.0;1320.0;377
2766;Bloemendaal;2020;15226;2810;8591;3825;12142;1903;718;1185;1181;587;594;189;73;116;104;63;41;148;67;81;155;49;106;585;335;250;119.0;148.0;126.0;104.0;1243.0;1308.0;377
2767;Bloemendaal;2021;15155;2775;8525;3855;12097;1884;714;1170;1174;583;591;195;71;124;111;66;45;143;65;78;142;52;90;583;329;254;124.0;150.0;130.0;107.0;1278.0;1319.0;377
2768;Bloemendaal;2022;15112;2730;8494;3888;12052;1860;700;1160;1200;587;613;184;65;119;119;69;50;152;71;81;154;57;97;591;325;266;130.0;146.0;119.0;97.0;1328.0;1309.0;377
2769;Bloemendaal;2023;15138;2739;8528;3871;12004;1868;703;1165;1266;619;647;191;69;122;116;68;48;172;77;95;156;54;102;631;351;280;130.0;141.0;120.0;108.0;1305.0;1327.0;377
2770;Bloemendaal;2024;15118;2733;8476;3909;11958;1864;716;1148;1296;624;672;199;81;118;112;64;48;179;77;102;153;50;103;653;352;301;124.0;144.0;119.0;104.0;1253.0;1318.0;377
2771;Bloemendaal;2025;15049;2715;8420;3914;11872;1854;707;1147;1323;635;688;206;85;121;117;69;48;182;80;102;154;49;105;664;352;312;;;;;;;377
2772;Boarnsterhim;2008;19259;4877;11667;2715;18148;741;212;529;370;210;160;35;17;18;48;24;24;24;7;17;25;15;10;238;147;91;215.0;145.0;46.0;66.0;846.0;884.0;55
2773;Boarnsterhim;2009;19274;4859;11598;2817;18118;761;215;546;395;215;180;42;21;21;51;27;24;30;8;22;36;19;17;236;140;96;210.0;144.0;43.0;66.0;824.0;845.0;55
2774;Boarnsterhim;2010;19299;4791;11579;2929;18105;773;217;556;421;226;195;52;28;24;54;28;26;37;11;26;40;23;17;238;136;102;205.0;145.0;57.0;66.0;795.0;845.0;55
2775;Boarnsterhim;2011;19302;4706;11563;3033;18063;798;228;570;441;232;209;55;30;25;55;27;28;44;15;29;48;27;21;239;133;106;201.0;148.0;50.0;70.0;841.0;802.0;55
2776;Boarnsterhim;2012;19377;4647;11550;3180;18082;808;247;561;487;259;228;65;35;30;64;32;32;47;19;28;53;29;24;258;144;114;201.0;155.0;52.0;66.0;807.0;828.0;55
2777;Boarnsterhim;2013;19392;4596;11464;3332;18026;839;252;587;527;284;243;70;39;31;65;33;32;57;24;33;59;33;26;276;155;121;193.0;154.0;60.0;68.0;829.0;828.0;55
2778;Boarnsterhim;2014;19426;4545;11428;3453;18019;852;255;597;555;292;263;77;43;34;67;37;30;62;26;36;64;35;29;285;151;134;199.0;154.0;53.0;71.0;844.0;850.0;55
2779;Boarnsterhim;2015;19450;4484;11419;3547;18006;848;247;601;596;315;281;77;44;33;69;39;30;67;28;39;73;40;33;310;164;146;201.0;155.0;49.0;67.0;824.0;840.0;55
2780;Boarnsterhim;2016;19464;4418;11397;3649;17972;874;260;614;618;326;292;85;46;39;70;40;30;71;28;43;76;41;35;316;171;145;196.0;161.0;47.0;69.0;839.0;905.0;55
2781;Boarnsterhim;2017;19415;4346;11324;3745;17878;882;258;624;655;341;314;90;49;41;84;47;37;73;26;47;79;41;38;329;178;151;196.0;160.0;49.0;71.0;805.0;880.0;55
2782;Boarnsterhim;2018;19354;4249;11253;3852;17796;878;249;629;680;350;330;96;53;43;94;51;43;76;29;47;86;41;45;328;176;152;201.0;161.0;52.0;68.0;812.0;909.0;55
2783;Boarnsterhim;2019;19282;4199;11101;3982;17690;890;245;645;702;366;336;101;55;46;97;52;45;85;31;54;93;43;50;326;185;141;198.0;166.0;51.0;63.0;846.0;879.0;55
2784;Boarnsterhim;2020;19270;4129;11032;4109;17633;894;258;636;743;391;352;98;55;43;97;52;45;87;32;55;105;50;55;356;202;154;202.0;170.0;51.0;64.0;827.0;895.0;55
2785;Boarnsterhim;2021;19223;4042;10969;4212;17522;911;264;647;790;408;382;108;55;53;102;56;46;98;43;55;115;50;65;367;204;163;201.0;173.0;53.0;68.0;799.0;903.0;55
2786;Boarnsterhim;2022;19134;3957;10899;4278;17414;913;260;653;807;416;391;111;58;53;98;52;46;102;48;54;130;58;72;366;200;166;198.0;175.0;54.0;69.0;777.0;891.0;55
2787;Boarnsterhim;2023;19031;3856;10810;4365;17318;899;250;649;814;419;395;109;56;53;98;52;46;105;50;55;131;57;74;371;204;167;195.0;183.0;56.0;69.0;822.0;874.0;55
2788;Boarnsterhim;2024;18982;3800;10695;4487;17249;904;255;649;829;429;400;113;57;56;103;53;50;108;48;60;136;61;75;369;210;159;204.0;180.0;58.0;67.0;821.0;868.0;55
2789;Boarnsterhim;2025;18954;3816;10559;4579;17156;940;279;661;858;450;408;116;63;53;110;59;51;116;49;67;138;61;77;378;218;160;;;;;;;55
2790;Bodegraven;2008;19299;5329;11457;2513;17034;1089;410;679;1176;612;564;103;41;62;55;20;35;63;27;36;589;287;302;366;237;129;226.0;126.0;50.0;74.0;391.0;677.0;497
2791;Bodegraven;2009;19091;5195;11266;2630;16816;1085;406;679;1190;614;576;113;50;63;61;22;39;64;26;38;589;286;303;363;230;133;219.0;130.0;53.0;69.0;390.0;675.0;497
2792;Bodegraven;2010;18879;5077;11091;2711;16611;1071;385;686;1197;624;573;114;54;60;56;21;35;77;32;45;581;285;296;369;232;137;213.0;132.0;57.0;65.0;556.0;626.0;497
2793;Bodegraven;2011;18881;5003;11081;2797;16549;1073;387;686;1259;650;609;122;61;61;59;22;37;83;38;45;607;293;314;388;236;152;200.0;136.0;66.0;71.0;364.0;643.0;497
2794;Bodegraven;2012;18664;4822;10879;2963;16324;1073;400;673;1267;654;613;133;70;63;63;27;36;91;39;52;605;289;316;375;229;146;192.0;136.0;49.0;65.0;554.0;624.0;497
2795;Bodegraven;2013;18634;4741;10806;3087;16230;1085;399;686;1319;675;644;142;74;68;66;30;36;101;43;58;603;285;318;407;243;164;194.0;139.0;61.0;64.0;417.0;647.0;497
2796;Bodegraven;2014;18458;4638;10618;3202;16060;1087;397;690;1311;679;632;139;72;67;65;31;34;96;39;57;601;287;314;410;250;160;182.0;137.0;60.0;62.0;532.0;608.0;497
2797;Bodegraven;2015;18428;4534;10580;3314;15974;1116;405;711;1338;685;653;151;76;75;70;31;39;108;43;65;593;284;309;416;251;165;185.0;144.0;51.0;64.0;518.0;612.0;497
2798;Bodegraven;2016;18363;4460;10497;3406;15869;1120;408;712;1374;698;676;160;82;78;74;33;41;118;46;72;603;290;313;419;247;172;179.0;150.0;53.0;54.0;515.0;612.0;497
2799;Bodegraven;2017;18296;4365;10456;3475;15767;1123;408;715;1406;713;693;165;82;83;79;34;45;132;49;83;600;295;305;430;253;177;181.0;153.0;51.0;54.0;564.0;600.0;497
2800;Bodegraven;2018;18287;4271;10442;3574;15722;1129;404;725;1436;734;702;176;84;92;79;34;45;140;55;85;604;301;303;437;260;177;179.0;159.0;48.0;57.0;499.0;610.0;497
2801;Bodegraven;2019;18188;4177;10368;3643;15587;1128;419;709;1473;762;711;189;92;97;78;34;44;155;62;93;597;300;297;454;274;180;188.0;163.0;48.0;60.0;566.0;607.0;497
2802;Bodegraven;2020;18162;4118;10341;3703;15532;1156;427;729;1474;767;707;186;90;96;76;33;43;164;63;101;588;303;285;460;278;182;186.0;163.0;56.0;59.0;556.0;591.0;497
2803;Bodegraven;2021;18152;4012;10365;3775;15474;1170;433;737;1508;784;724;183;89;94;81;36;45;175;65;110;588;306;282;481;288;193;187.0;165.0;55.0;54.0;537.0;611.0;497
2804;Bodegraven;2022;18103;3954;10296;3853;15400;1173;429;744;1530;801;729;192;92;100;80;34;46;175;71;104;584;305;279;499;299;200;180.0;167.0;59.0;55.0;541.0;621.0;497
2805;Bodegraven;2023;18043;3889;10223;3931;15286;1189;446;743;1568;805;763;192;91;101;81;36;45;188;77;111;590;306;284;517;295;222;184.0;180.0;55.0;57.0;539.0;619.0;497
2806;Bodegraven;2024;17968;3819;10138;4011;15168;1210;469;741;1590;827;763;198;96;102;84;40;44;199;79;120;580;307;273;529;305;224;179.0;173.0;70.0;56.0;522.0;628.0;497
2807;Bodegraven;2025;17884;3750;10055;4079;15070;1239;477;762;1575;836;739;201;100;101;76;38;38;197;82;115;565;304;261;536;312;224;;;;;;;497
2808;Boekel;2008;9345;2622;5490;1233;8878;316;101;215;151;89;62;27;17;10;5;1;4;16;9;7;15;5;10;88;57;31;94.0;70.0;22.0;34.0;197.0;249.0;755
2809;Boekel;2009;9307;2571;5461;1275;8806;324;106;218;177;114;63;33;21;12;6;1;5;20;12;8;18;9;9;100;71;29;92.0;70.0;21.0;36.0;160.0;249.0;755
2810;Boekel;2010;9226;2509;5409;1308;8691;334;112;222;201;129;72;33;20;13;7;3;4;31;19;12;18;9;9;112;78;34;93.0;67.0;21.0;36.0;209.0;266.0;755
2811;Boekel;2011;9182;2460;5376;1346;8625;344;118;226;213;130;83;36;22;14;9;6;3;37;21;16;20;9;11;111;72;39;87.0;70.0;24.0;32.0;259.0;255.0;755
2812;Boekel;2012;9197;2402;5385;1410;8601;373;135;238;223;132;91;37;24;13;12;6;6;35;16;19;24;10;14;115;76;39;87.0;73.0;24.0;35.0;259.0;270.0;755
2813;Boekel;2013;9190;2329;5388;1473;8579;388;140;248;223;133;90;40;26;14;12;6;6;31;15;16;26;10;16;114;76;38;88.0;76.0;24.0;34.0;234.0;275.0;755
2814;Boekel;2014;9152;2297;5324;1531;8494;400;156;244;258;145;113;47;28;19;17;10;7;42;20;22;27;10;17;125;77;48;87.0;75.0;21.0;33.0;277.0;292.0;755
2815;Boekel;2015;9135;2237;5312;1586;8439;415;163;252;281;158;123;53;29;24;20;12;8;46;21;25;32;13;19;130;83;47;87.0;78.0;25.0;35.0;300.0;293.0;755
2816;Boekel;2016;9143;2196;5300;1647;8435;407;162;245;301;166;135;55;30;25;21;13;8;50;23;27;33;13;20;142;87;55;87.0;79.0;23.0;31.0;229.0;283.0;755
2817;Boekel;2017;9090;2117;5275;1698;8357;409;164;245;324;177;147;59;30;29;22;14;8;58;25;33;32;12;20;153;96;57;88.0;76.0;23.0;33.0;322.0;276.0;755
2818;Boekel;2018;9138;2092;5302;1744;8360;433;175;258;345;185;160;59;31;28;19;13;6;65;25;40;39;16;23;163;100;63;93.0;80.0;24.0;31.0;270.0;293.0;755
2819;Boekel;2019;9122;2030;5318;1774;8314;444;179;265;364;194;170;64;32;32;20;13;7;70;28;42;36;15;21;174;106;68;97.0;85.0;26.0;32.0;285.0;306.0;755
2820;Boekel;2020;9108;1982;5330;1796;8271;459;183;276;378;196;182;62;32;30;22;14;8;78;29;49;39;13;26;177;108;69;96.0;82.0;29.0;31.0;312.0;314.0;755
2821;Boekel;2021;9119;1950;5316;1853;8243;478;188;290;398;208;190;65;35;30;24;14;10;77;29;48;42;15;27;190;115;75;97.0;85.0;26.0;32.0;297.0;307.0;755
2822;Boekel;2022;9117;1915;5307;1895;8211;488;193;295;418;224;194;69;39;30;25;14;11;80;33;47;46;18;28;198;120;78;97.0;86.0;21.0;34.0;343.0;306.0;755
2823;Boekel;2023;9152;1871;5328;1953;8217;515;210;305;420;221;199;70;37;33;26;12;14;80;34;46;47;18;29;197;120;77;102.0;90.0;25.0;33.0;326.0;290.0;755
2824;Boekel;2024;9192;1877;5318;1997;8250;526;210;316;416;216;200;67;33;34;26;10;16;84;35;49;47;18;29;192;120;72;101.0;93.0;26.0;32.0;341.0;294.0;755
2825;Boekel;2025;9242;1889;5313;2040;8275;540;205;335;427;220;207;69;34;35;28;9;19;87;38;49;52;17;35;191;122;69;;;;;;;755
2826;Ten Boer;2008;7203;1931;4392;880;6761;289;89;200;153;82;71;28;14;14;15;6;9;24;12;12;5;3;2;81;47;34;78.0;57.0;21.0;30.0;396.0;343.0;9
2827;Ten Boer;2009;7270;1907;4443;920;6797;296;92;204;177;98;79;32;16;16;13;7;6;33;17;16;6;4;2;93;54;39;76.0;57.0;19.0;30.0;344.0;345.0;9
2828;Ten Boer;2010;7278;1874;4431;973;6780;300;94;206;198;106;92;41;18;23;14;9;5;36;16;20;12;9;3;95;54;41;74.0;58.0;20.0;29.0;337.0;339.0;9
2829;Ten Boer;2011;7284;1837;4438;1009;6771;304;88;216;209;109;100;41;20;21;18;11;7;40;16;24;17;11;6;93;51;42;73.0;59.0;24.0;29.0;325.0;365.0;9
2830;Ten Boer;2012;7254;1793;4399;1062;6735;305;87;218;214;109;105;43;24;19;18;11;7;36;15;21;21;12;9;96;47;49;76.0;60.0;21.0;28.0;354.0;358.0;9
2831;Ten Boer;2013;7259;1776;4375;1108;6716;309;91;218;234;122;112;48;27;21;21;12;9;37;16;21;22;13;9;106;54;52;76.0;62.0;21.0;30.0;393.0;358.0;9
2832;Ten Boer;2014;7302;1751;4385;1166;6732;312;92;220;258;130;128;49;27;22;28;16;12;43;17;26;21;11;10;117;59;58;81.0;60.0;31.0;30.0;393.0;367.0;9
2833;Ten Boer;2015;7350;1721;4430;1199;6753;320;100;220;277;134;143;53;31;22;28;16;12;46;19;27;27;10;17;123;58;65;80.0;60.0;22.0;30.0;327.0;355.0;9
2834;Ten Boer;2016;7334;1688;4400;1246;6737;315;100;215;282;133;149;48;28;20;29;16;13;49;20;29;31;12;19;125;57;68;81.0;61.0;24.0;29.0;350.0;342.0;9
2835;Ten Boer;2017;7358;1679;4391;1288;6742;320;104;216;296;137;159;54;32;22;29;15;14;51;21;30;34;12;22;128;57;71;81.0;61.0;21.0;28.0;355.0;340.0;9
2836;Ten Boer;2018;7386;1675;4370;1341;6765;326;101;225;295;127;168;56;29;27;30;14;16;50;23;27;34;11;23;125;50;75;80.0;65.0;24.0;30.0;320.0;344.0;9
2837;Ten Boer;2019;7372;1661;4324;1387;6740;331;102;229;301;137;164;54;32;22;33;18;15;55;21;34;33;10;23;126;56;70;83.0;64.0;22.0;26.0;327.0;349.0;9
2838;Ten Boer;2020;7366;1648;4290;1428;6724;322;99;223;320;140;180;50;29;21;35;18;17;62;25;37;39;10;29;134;58;76;85.0;67.0;24.0;26.0;406.0;353.0;9
2839;Ten Boer;2021;7436;1627;4339;1470;6768;336;107;229;332;145;187;53;30;23;37;17;20;64;26;38;38;9;29;140;63;77;79.0;67.0;27.0;30.0;358.0;356.0;9
2840;Ten Boer;2022;7449;1619;4326;1504;6752;348;110;238;349;155;194;55;32;23;35;15;20;62;27;35;45;12;33;152;69;83;82.0;67.0;28.0;30.0;366.0;359.0;9
2841;Ten Boer;2023;7469;1614;4308;1547;6760;351;114;237;358;147;211;59;32;27;41;15;26;63;24;39;47;14;33;148;62;86;84.0;70.0;27.0;29.0;381.0;364.0;9
2842;Ten Boer;2024;7499;1625;4282;1592;6782;349;112;237;368;149;219;60;34;26;38;16;22;67;25;42;50;14;36;153;60;93;80.0;72.0;24.0;29.0;388.0;345.0;9
2843;Ten Boer;2025;7545;1632;4266;1647;6804;352;118;234;389;161;228;55;30;25;39;16;23;74;28;46;57;20;37;164;67;97;;;;;;;9
2844;Bolsward;2008;9936;2459;5783;1694;9105;437;147;290;394;224;170;27;11;16;28;15;13;127;65;62;20;4;16;192;129;63;114.0;110.0;24.0;41.0;577.0;450.0;64
2845;Bolsward;2009;10053;2485;5840;1728;9233;426;138;288;394;218;176;28;12;16;28;18;10;123;60;63;22;8;14;193;120;73;113.0;107.0;25.0;40.0;493.0;465.0;64
2846;Bolsward;2010;10074;2465;5871;1738;9219;444;148;296;411;225;186;35;12;23;32;16;16;119;62;57;28;11;17;197;124;73;112.0;108.0;31.0;40.0;535.0;460.0;64
2847;Bolsward;2011;10147;2476;5883;1788;9277;458;149;309;412;223;189;36;15;21;30;15;15;123;59;64;27;11;16;196;123;73;112.0;112.0;29.0;40.0;504.0;457.0;64
2848;Bolsward;2012;10185;2483;5854;1848;9295;459;144;315;431;230;201;35;13;22;38;21;17;129;56;73;30;14;16;199;126;73;108.0;106.0;33.0;35.0;507.0;432.0;64
2849;Bolsward;2013;10259;2496;5835;1928;9332;471;146;325;456;238;218;34;12;22;36;20;16;134;60;74;36;16;20;216;130;86;112.0;115.0;29.0;38.0;519.0;434.0;64
2850;Bolsward;2014;10332;2499;5850;1983;9393;465;147;318;474;240;234;37;15;22;35;20;15;143;58;85;40;17;23;219;130;89;109.0;110.0;30.0;41.0;536.0;442.0;64
2851;Bolsward;2015;10415;2510;5888;2017;9445;471;152;319;499;251;248;44;20;24;35;20;15;147;57;90;48;23;25;225;131;94;102.0;110.0;35.0;38.0;436.0;447.0;64
2852;Bolsward;2016;10393;2468;5908;2017;9406;467;155;312;520;255;265;49;23;26;40;22;18;160;62;98;54;23;31;217;125;92;103.0;111.0;29.0;35.0;510.0;443.0;64
2853;Bolsward;2017;10448;2452;5928;2068;9418;488;159;329;542;263;279;53;24;29;43;25;18;167;60;107;56;23;33;223;131;92;108.0;108.0;35.0;37.0;432.0;448.0;64
2854;Bolsward;2018;10431;2403;5943;2085;9375;492;165;327;564;275;289;58;28;30;46;27;19;173;60;113;49;21;28;238;139;99;107.0;114.0;29.0;35.0;455.0;451.0;64
2855;Bolsward;2019;10423;2400;5919;2104;9326;488;157;331;609;296;313;65;31;34;46;25;21;182;62;120;59;24;35;257;154;103;115.0;112.0;30.0;36.0;469.0;437.0;64
2856;Bolsward;2020;10454;2367;5945;2142;9333;476;146;330;645;301;344;65;26;39;49;27;22;191;61;130;71;29;42;269;158;111;112.0;116.0;34.0;38.0;501.0;439.0;64
2857;Bolsward;2021;10508;2377;5974;2157;9344;496;147;349;668;309;359;68;27;41;48;24;24;204;65;139;75;31;44;273;162;111;117.0;115.0;31.0;35.0;398.0;435.0;64
2858;Bolsward;2022;10470;2356;5926;2188;9275;486;146;340;709;334;375;73;28;45;54;26;28;219;67;152;77;34;43;286;179;107;111.0;118.0;38.0;37.0;432.0;458.0;64
2859;Bolsward;2023;10439;2324;5893;2222;9220;500;157;343;719;343;376;79;34;45;60;27;33;221;67;154;67;31;36;292;184;108;114.0;113.0;32.0;37.0;489.0;440.0;64
2860;Bolsward;2024;10485;2306;5913;2266;9245;492;160;332;748;352;396;82;38;44;67;29;38;233;69;164;76;31;45;290;185;105;116.0;117.0;36.0;39.0;520.0;444.0;64
2861;Bolsward;2025;10558;2336;5904;2318;9277;510;163;347;771;363;408;87;42;45;68;30;38;245;69;176;79;32;47;292;190;102;;;;;;;64
2862;Borger-Odoorn;2008;26008;6094;15377;4537;24521;1013;330;683;474;249;225;82;33;49;40;20;20;65;33;32;26;10;16;261;153;108;200.0;220.0;64.0;132.0;1137.0;1272.0;1681
2863;Borger-Odoorn;2009;25787;5937;15113;4737;24209;1038;340;698;540;286;254;89;34;55;44;21;23;76;36;40;42;14;28;289;181;108;194.0;228.0;85.0;129.0;1075.0;1269.0;1681
2864;Borger-Odoorn;2010;25519;5812;14809;4898;23906;1043;328;715;570;305;265;91;36;55;54;27;27;82;39;43;39;18;21;304;185;119;186.0;234.0;85.0;129.0;1180.0;1266.0;1681
2865;Borger-Odoorn;2011;25343;5658;14626;5059;23672;1046;325;721;625;337;288;99;38;61;58;28;30;95;47;48;53;21;32;320;203;117;179.0;234.0;81.0;123.0;1155.0;1250.0;1681
2866;Borger-Odoorn;2012;25154;5497;14335;5322;23411;1055;322;733;688;363;325;98;37;61;60;24;36;114;53;61;77;32;45;339;217;122;174.0;245.0;100.0;127.0;1188.0;1283.0;1681
2867;Borger-Odoorn;2013;24965;5306;14076;5583;23156;1052;310;742;757;409;348;99;35;64;69;32;37;137;65;72;94;42;52;358;235;123;175.0;244.0;93.0;115.0;1212.0;1243.0;1681
2868;Borger-Odoorn;2014;24845;5182;13850;5813;22977;1058;325;733;810;423;387;110;38;72;75;33;42;142;65;77;110;45;65;373;242;131;170.0;251.0;92.0;119.0;1211.0;1258.0;1681
2869;Borger-Odoorn;2015;24692;5019;13682;5991;22784;1062;316;746;846;446;400;113;44;69;74;32;42;153;65;88;118;47;71;388;258;130;171.0;255.0;81.0;117.0;1236.0;1235.0;1681
2870;Borger-Odoorn;2016;24577;4888;13526;6163;22607;1080;328;752;890;463;427;117;46;71;80;34;46;165;74;91;127;48;79;401;261;140;171.0;261.0;86.0;116.0;1200.0;1224.0;1681
2871;Borger-Odoorn;2017;24437;4750;13395;6292;22458;1074;325;749;905;485;420;119;56;63;87;41;46;170;80;90;128;46;82;401;262;139;179.0;267.0;83.0;108.0;1212.0;1238.0;1681
2872;Borger-Odoorn;2018;24301;4640;13255;6406;22263;1064;327;737;974;518;456;127;59;68;95;49;46;189;85;104;143;50;93;420;275;145;181.0;269.0;80.0;117.0;1197.0;1228.0;1681
2873;Borger-Odoorn;2019;24150;4522;13080;6548;22059;1072;332;740;1019;522;497;138;67;71;93;45;48;207;93;114;152;49;103;429;268;161;183.0;270.0;81.0;111.0;1210.0;1230.0;1681
2874;Borger-Odoorn;2020;24016;4404;12926;6686;21880;1079;328;751;1057;552;505;149;74;75;90;45;45;219;100;119;157;52;105;442;281;161;187.0;274.0;80.0;106.0;1255.0;1201.0;1681
2875;Borger-Odoorn;2021;23959;4305;12822;6832;21753;1100;340;760;1106;576;530;153;78;75;92;44;48;234;108;126;177;55;122;450;291;159;186.0;284.0;77.0;116.0;1219.0;1244.0;1681
2876;Borger-Odoorn;2022;23800;4214;12660;6926;21560;1102;343;759;1138;587;551;163;81;82;92;48;44;239;113;126;184;56;128;460;289;171;185.0;287.0;87.0;110.0;1232.0;1199.0;1681
2877;Borger-Odoorn;2023;23709;4150;12539;7020;21424;1109;350;759;1176;599;577;175;87;88;97;51;46;244;114;130;194;59;135;466;288;178;190.0;288.0;78.0;109.0;1202.0;1198.0;1681
2878;Borger-Odoorn;2024;23588;4106;12380;7102;21267;1098;348;750;1223;623;600;177;87;90;105;56;49;259;118;141;199;66;133;483;296;187;185.0;296.0;75.0;107.0;1182.0;1165.0;1681
2879;Borger-Odoorn;2025;23462;4049;12164;7249;21082;1100;346;754;1280;644;636;185;94;91;113;55;58;277;127;150;207;67;140;498;301;197;;;;;;;1681
2880;Borne;2008;20833;5335;12278;3220;18408;1418;475;943;1007;650;357;32;18;14;34;14;20;300;142;158;17;8;9;624;468;156;195.0;161.0;69.0;88.0;1110.0;993.0;147
2881;Borne;2009;20967;5260;12363;3344;18443;1455;507;948;1069;668;401;40;20;20;38;17;21;300;141;159;29;11;18;662;479;183;197.0;166.0;72.0;87.0;1117.0;1013.0;147
2882;Borne;2010;21087;5151;12467;3469;18489;1467;519;948;1131;703;428;50;26;24;46;20;26;299;143;156;42;13;29;694;501;193;201.0;172.0;78.0;87.0;1131.0;1014.0;147
2883;Borne;2011;21227;5043;12617;3567;18542;1474;518;956;1211;757;454;63;32;31;48;23;25;302;144;158;48;19;29;750;539;211;201.0;178.0;80.0;81.0;1087.0;1055.0;147
2884;Borne;2012;21284;4933;12640;3711;18529;1483;526;957;1272;784;488;78;41;37;52;26;26;307;140;167;56;25;31;779;552;227;201.0;181.0;79.0;88.0;1073.0;1071.0;147
2885;Borne;2013;21302;4834;12606;3862;18483;1503;535;968;1316;790;526;87;44;43;56;29;27;314;144;170;62;26;36;797;547;250;203.0;188.0;77.0;85.0;1074.0;1076.0;147
2886;Borne;2014;21311;4716;12582;4013;18435;1510;556;954;1366;818;548;101;52;49;56;29;27;311;143;168;74;26;48;824;568;256;208.0;192.0;88.0;80.0;1000.0;1080.0;147
2887;Borne;2015;21261;4641;12492;4128;18372;1500;558;942;1389;841;548;100;50;50;60;34;26;309;148;161;77;28;49;843;581;262;215.0;190.0;81.0;77.0;1056.0;1078.0;147
2888;Borne;2016;21271;4585;12441;4245;18333;1501;563;938;1437;863;574;118;64;54;63;34;29;310;147;163;80;31;49;866;587;279;212.0;199.0;87.0;77.0;1155.0;1096.0;147
2889;Borne;2017;21357;4524;12464;4369;18370;1519;584;935;1468;873;595;123;64;59;66;34;32;320;147;173;88;37;51;871;591;280;222.0;195.0;85.0;83.0;1000.0;1091.0;147
2890;Borne;2018;21297;4431;12390;4476;18235;1550;591;959;1512;907;605;122;64;58;66;33;33;321;151;170;96;35;61;907;624;283;229.0;203.0;85.0;77.0;1153.0;1092.0;147
2891;Borne;2019;21392;4410;12406;4576;18254;1560;599;961;1578;947;631;127;70;57;76;38;38;331;153;178;104;40;64;940;646;294;231.0;205.0;77.0;76.0;1152.0;1108.0;147
2892;Borne;2020;21465;4342;12409;4714;18226;1602;620;982;1637;971;666;137;75;62;78;42;36;344;155;189;110;42;68;968;657;311;236.0;215.0;84.0;78.0;1134.0;1114.0;147
2893;Borne;2021;21513;4333;12385;4795;18205;1624;636;988;1684;998;686;144;76;68;83;41;42;343;156;187;110;43;67;1004;682;322;241.0;217.0;83.0;78.0;1206.0;1106.0;147
2894;Borne;2022;21644;4362;12407;4875;18274;1637;655;982;1733;1011;722;145;77;68;87;44;43;352;158;194;118;41;77;1031;691;340;240.0;217.0;76.0;82.0;1116.0;1124.0;147
2895;Borne;2023;21655;4359;12342;4954;18257;1634;658;976;1764;1028;736;155;77;78;99;52;47;351;159;192;129;46;83;1030;694;336;237.0;222.0;76.0;74.0;1103.0;1119.0;147
2896;Borne;2024;21658;4335;12294;5029;18202;1647;683;964;1809;1050;759;159;84;75;105;52;53;352;160;192;126;44;82;1067;710;357;232.0;224.0;77.0;79.0;1211.0;1111.0;147
2897;Borne;2025;21763;4342;12305;5116;18261;1676;707;969;1826;1081;745;155;86;69;114;58;56;344;158;186;125;47;78;1088;732;356;;;;;;;147
2898;Borsele;2008;22404;5961;13080;3363;20734;1227;472;755;443;241;202;67;33;34;39;15;24;55;28;27;44;18;26;238;147;91;252.0;159.0;73.0;75.0;892.0;941.0;654
2899;Borsele;2009;22449;5879;13122;3448;20694;1260;481;779;495;273;222;75;40;35;43;16;27;63;34;29;51;22;29;263;161;102;253.0;166.0;75.0;78.0;914.0;975.0;654
2900;Borsele;2010;22476;5802;13141;3533;20647;1287;479;808;542;295;247;85;43;42;57;22;35;66;33;33;61;29;32;273;168;105;252.0;169.0;73.0;76.0;850.0;956.0;654
2901;Borsele;2011;22451;5698;13095;3658;20514;1354;502;852;583;313;270;91;46;45;62;26;36;80;36;44;78;34;44;272;171;101;245.0;170.0;77.0;76.0;902.0;965.0;654
2902;Borsele;2012;22470;5586;13054;3830;20434;1392;524;868;644;325;319;103;50;53;64;29;35;95;39;56;94;32;62;288;175;113;245.0;164.0;82.0;77.0;847.0;965.0;654
2903;Borsele;2013;22442;5499;12977;3966;20325;1415;542;873;702;345;357;115;53;62;66;30;36;103;45;58;109;35;74;309;182;127;244.0;175.0;92.0;74.0;823.0;995.0;654
2904;Borsele;2014;22364;5355;12940;4069;20182;1456;566;890;726;363;363;116;54;62;69;33;36;115;49;66;114;41;73;312;186;126;241.0;181.0;84.0;74.0;894.0;987.0;654
2905;Borsele;2015;22342;5265;12888;4189;20117;1468;582;886;757;366;391;123;54;69;66;31;35;128;50;78;113;39;74;327;192;135;245.0;182.0;80.0;78.0;931.0;978.0;654
2906;Borsele;2016;22362;5188;12886;4288;20056;1501;600;901;805;396;409;130;59;71;70;33;37;127;52;75;129;43;86;349;209;140;244.0;183.0;86.0;78.0;980.0;994.0;654
2907;Borsele;2017;22420;5119;12929;4372;20049;1539;623;916;832;405;427;127;57;70;70;33;37;142;57;85;132;44;88;361;214;147;249.0;184.0;84.0;79.0;872.0;995.0;654
2908;Borsele;2018;22371;5028;12859;4484;19958;1539;615;924;874;429;445;136;65;71;76;37;39;162;64;98;132;45;87;368;218;150;252.0;188.0;87.0;74.0;876.0;987.0;654
2909;Borsele;2019;22335;4956;12779;4600;19861;1572;637;935;902;446;456;141;66;75;76;38;38;171;73;98;134;44;90;380;225;155;254.0;196.0;89.0;77.0;927.0;1007.0;654
2910;Borsele;2020;22325;4876;12760;4689;19777;1604;656;948;944;472;472;145;73;72;84;43;41;177;77;100;144;51;93;394;228;166;254.0;192.0;90.0;74.0;882.0;1001.0;654
2911;Borsele;2021;22288;4814;12673;4801;19642;1640;676;964;1006;493;513;157;79;78;95;45;50;187;81;106;158;51;107;409;237;172;252.0;201.0;88.0;77.0;911.0;979.0;654
2912;Borsele;2022;22282;4762;12593;4927;19569;1635;674;961;1078;535;543;160;84;76;113;50;63;204;89;115;168;55;113;433;257;176;250.0;199.0;80.0;74.0;950.0;1007.0;654
2913;Borsele;2023;22287;4743;12508;5036;19524;1658;681;977;1105;555;550;157;83;74;114;51;63;219;92;127;167;56;111;448;273;175;252.0;204.0;82.0;74.0;904.0;992.0;654
2914;Borsele;2024;22256;4691;12410;5155;19479;1672;675;997;1105;548;557;157;82;75;118;55;63;216;92;124;168;56;112;446;263;183;247.0;207.0;81.0;73.0;959.0;986.0;654
2915;Borsele;2025;22279;4686;12323;5270;19438;1702;683;1019;1139;570;569;157;81;76;132;64;68;222;97;125;178;60;118;450;268;182;;;;;;;654
2916;Boskoop;2008;15154;4114;8994;2046;13198;827;332;495;1129;627;502;57;26;31;29;15;14;48;27;21;663;349;314;332;210;122;185.0;108.0;38.0;58.0;488.0;576.0;499
2917;Boskoop;2009;15127;4086;8917;2124;13137;840;335;505;1150;636;514;63;31;32;29;16;13;61;30;31;652;342;310;345;217;128;184.0;112.0;40.0;54.0;484.0;580.0;499
2918;Boskoop;2010;15091;4057;8836;2198;13110;837;324;513;1144;627;517;74;36;38;33;19;14;69;31;38;643;337;306;325;204;121;171.0;119.0;45.0;55.0;646.0;587.0;499
2919;Boskoop;2011;15194;4055;8887;2252;13131;862;331;531;1201;633;568;81;38;43;39;21;18;79;34;45;652;331;321;350;209;141;171.0;118.0;48.0;58.0;635.0;602.0;499
2920;Boskoop;2012;15273;4002;8877;2394;13175;884;339;545;1214;623;591;89;39;50;42;18;24;88;36;52;644;327;317;351;203;148;166.0;123.0;47.0;56.0;608.0;612.0;499
2921;Boskoop;2013;15304;3970;8830;2504;13170;888;337;551;1246;625;621;97;44;53;45;22;23;92;33;59;636;315;321;376;211;165;170.0;125.0;47.0;58.0;584.0;580.0;499
2922;Boskoop;2014;15344;3905;8857;2582;13162;902;352;550;1280;635;645;104;43;61;56;28;28;102;41;61;640;312;328;378;211;167;168.0;129.0;50.0;52.0;495.0;600.0;499
2923;Boskoop;2015;15279;3846;8748;2685;13062;922;363;559;1295;636;659;108;45;63;54;28;26;109;42;67;627;310;317;397;211;186;170.0;125.0;51.0;53.0;608.0;581.0;499
2924;Boskoop;2016;15352;3822;8781;2749;13096;941;381;560;1315;645;670;113;46;67;61;30;31;118;45;73;613;304;309;410;220;190;174.0;138.0;46.0;56.0;665.0;592.0;499
2925;Boskoop;2017;15454;3809;8834;2811;13145;958;384;574;1351;635;716;120;49;71;66;32;34;126;44;82;605;288;317;434;222;212;178.0;131.0;57.0;53.0;582.0;613.0;499
2926;Boskoop;2018;15474;3782;8807;2885;13108;982;398;584;1384;671;713;124;54;70;70;35;35;129;48;81;602;294;308;459;240;219;174.0;135.0;44.0;58.0;612.0;611.0;499
2927;Boskoop;2019;15503;3742;8815;2946;13092;1008;421;587;1403;698;705;129;57;72;72;35;37;137;54;83;595;297;298;470;255;215;183.0;139.0;57.0;52.0;640.0;609.0;499
2928;Boskoop;2020;15584;3717;8869;2998;13122;1018;426;592;1444;704;740;136;60;76;77;37;40;144;56;88;602;292;310;485;259;226;187.0;138.0;53.0;52.0;590.0;623.0;499
2929;Boskoop;2021;15603;3678;8864;3061;13092;1030;445;585;1481;723;758;143;63;80;87;44;43;150;57;93;594;290;304;507;269;238;189.0;140.0;58.0;55.0;649.0;610.0;499
2930;Boskoop;2022;15697;3670;8907;3120;13131;1031;451;580;1535;747;788;144;64;80;91;46;45;153;61;92;605;292;313;542;284;258;194.0;150.0;62.0;54.0;687.0;631.0;499
2931;Boskoop;2023;15807;3653;9002;3152;13190;1052;466;586;1565;754;811;158;68;90;99;55;44;158;61;97;592;281;311;558;289;269;194.0;145.0;53.0;56.0;643.0;644.0;499
2932;Boskoop;2024;15854;3618;9031;3205;13185;1056;465;591;1613;790;823;166;77;89;114;64;50;170;63;107;577;279;298;586;307;279;204.0;149.0;55.0;55.0;650.0;625.0;499
2933;Boskoop;2025;15935;3617;9048;3270;13228;1063;473;590;1644;804;840;173;82;91;120;67;53;168;63;105;569;272;297;614;320;294;;;;;;;499
2934;Boxmeer;2008;28400;7215;17031;4154;25392;2021;741;1280;987;604;383;99;52;47;74;54;20;257;143;114;155;77;78;402;278;124;256.0;220.0;77.0;127.0;850.0;1101.0;756
2935;Boxmeer;2009;28138;7033;16868;4237;25086;2023;744;1279;1029;628;401;102;56;46;81;61;20;270;152;118;161;77;84;415;282;133;252.0;227.0;85.0;120.0;917.0;1118.0;756
2936;Boxmeer;2010;27932;6845;16773;4314;24880;1999;728;1271;1053;623;430;105;55;50;84;63;21;270;149;121;181;80;101;413;276;137;248.0;237.0;97.0;120.0;993.0;1163.0;756
2937;Boxmeer;2011;27753;6680;16687;4386;24669;1979;716;1263;1105;638;467;107;55;52;88;63;25;283;149;134;195;85;110;432;286;146;245.0;234.0;88.0;117.0;1054.0;1153.0;756
2938;Boxmeer;2012;27640;6527;16531;4582;24518;1985;727;1258;1137;654;483;114;58;56;92;62;30;298;154;144;203;92;111;430;288;142;243.0;242.0;87.0;119.0;1072.0;1181.0;756
2939;Boxmeer;2013;27503;6384;16351;4768;24324;1998;735;1263;1181;678;503;120;63;57;107;72;35;302;162;140;202;93;109;450;288;162;245.0;243.0;92.0;120.0;1139.0;1204.0;756
2940;Boxmeer;2014;27415;6233;16268;4914;24205;1994;735;1259;1216;698;518;133;69;64;107;72;35;306;165;141;209;96;113;461;296;165;245.0;247.0;88.0;110.0;1077.0;1190.0;756
2941;Boxmeer;2015;27281;6077;16128;5076;24070;1973;723;1250;1238;705;533;137;70;67;118;74;44;300;165;135;220;105;115;463;291;172;248.0;252.0;89.0;114.0;1218.0;1199.0;756
2942;Boxmeer;2016;27273;5946;16064;5263;23982;1992;720;1272;1299;735;564;144;72;72;125;72;53;321;177;144;222;112;110;487;302;185;253.0;259.0;89.0;108.0;1204.0;1213.0;756
2943;Boxmeer;2017;27244;5862;15957;5425;23917;1993;712;1281;1334;753;581;157;76;81;121;72;49;340;190;150;221;113;108;495;302;193;262.0;261.0;90.0;115.0;1182.0;1219.0;756
2944;Boxmeer;2018;27186;5740;15901;5545;23806;1996;719;1277;1384;780;604;167;78;89;122;73;49;356;200;156;227;117;110;512;312;200;270.0;260.0;96.0;104.0;1174.0;1205.0;756
2945;Boxmeer;2019;27157;5669;15802;5686;23691;2020;736;1284;1446;806;640;170;78;92;128;75;53;352;202;150;251;122;129;545;329;216;272.0;267.0;84.0;108.0;1214.0;1203.0;756
2946;Boxmeer;2020;27152;5567;15759;5826;23634;2031;750;1281;1487;816;671;179;80;99;132;79;53;345;193;152;257;122;135;574;342;232;278.0;265.0;99.0;101.0;1153.0;1241.0;756
2947;Boxmeer;2021;27079;5460;15644;5975;23492;2013;748;1265;1574;860;714;195;84;111;142;84;58;360;199;161;270;131;139;607;362;245;281.0;276.0;80.0;112.0;1110.0;1207.0;756
2948;Boxmeer;2022;26956;5373;15480;6103;23367;1990;724;1266;1599;886;713;208;94;114;146;91;55;359;198;161;272;132;140;614;371;243;283.0;286.0;89.0;104.0;1186.0;1214.0;756
2949;Boxmeer;2023;26911;5326;15357;6228;23271;2000;723;1277;1640;900;740;210;100;110;151;95;56;373;204;169;268;129;139;638;372;266;287.0;285.0;95.0;114.0;1198.0;1229.0;756
2950;Boxmeer;2024;26865;5313;15216;6336;23210;1995;737;1258;1660;904;756;207;106;101;144;88;56;380;208;172;270;131;139;659;371;288;288.0;292.0;84.0;97.0;1228.0;1184.0;756
2951;Boxmeer;2025;26892;5299;15113;6480;23165;2017;750;1267;1710;931;779;213;108;105;153;96;57;383;212;171;279;134;145;682;381;301;;;;;;;756
2952;Boxtel;2008;29771;7371;18239;4161;26038;1766;685;1081;1967;1087;880;214;117;97;189;116;73;330;167;163;533;242;291;701;445;256;325.0;273.0;113.0;155.0;924.0;1014.0;757
2953;Boxtel;2009;29698;7279;18139;4280;25954;1792;715;1077;1952;1095;857;214;125;89;184;111;73;335;177;158;519;241;278;700;441;259;326.0;270.0;116.0;161.0;953.0;1056.0;757
2954;Boxtel;2010;29610;7183;18032;4395;25840;1815;727;1088;1955;1092;863;215;127;88;184;109;75;337;181;156;517;238;279;702;437;265;326.0;283.0;113.0;143.0;1030.0;1026.0;757
2955;Boxtel;2011;29633;7136;17923;4574;25812;1820;729;1091;2001;1121;880;219;130;89;179;104;75;359;194;165;526;241;285;718;452;266;320.0;280.0;111.0;152.0;1066.0;1062.0;757
2956;Boxtel;2012;29640;7067;17772;4801;25760;1846;733;1113;2034;1132;902;228;123;105;181;107;74;366;198;168;530;244;286;729;460;269;316.0;288.0;128.0;149.0;1022.0;1075.0;757
2957;Boxtel;2013;29602;6973;17616;5013;25692;1852;736;1116;2058;1133;925;235;130;105;183;100;83;370;197;173;535;248;287;735;458;277;310.0;294.0;126.0;139.0;1067.0;1073.0;757
2958;Boxtel;2014;29605;6906;17546;5153;25655;1865;745;1120;2085;1149;936;235;132;103;189;104;85;381;207;174;539;241;298;741;465;276;310.0;292.0;130.0;146.0;1079.0;1060.0;757
2959;Boxtel;2015;29627;6894;17402;5331;25606;1896;783;1113;2125;1156;969;244;134;110;202;111;91;388;207;181;554;245;309;737;459;278;306.0;300.0;110.0;131.0;1086.0;1049.0;757
2960;Boxtel;2016;29651;6864;17314;5473;25573;1894;771;1123;2184;1179;1005;249;140;109;204;113;91;407;207;200;560;242;318;764;477;287;316.0;302.0;114.0;127.0;1122.0;1064.0;757
2961;Boxtel;2017;29712;6887;17231;5594;25591;1903;776;1127;2218;1208;1010;253;144;109;208;119;89;433;222;211;557;242;315;767;481;286;313.0;308.0;123.0;133.0;1103.0;1076.0;757
2962;Boxtel;2018;29738;6902;17132;5704;25586;1911;777;1134;2241;1207;1034;262;146;116;213;121;92;433;225;208;565;239;326;768;476;292;307.0;305.0;107.0;135.0;1141.0;1050.0;757
2963;Boxtel;2019;29808;6868;17109;5831;25559;1943;800;1143;2306;1245;1061;280;153;127;209;124;85;440;230;210;572;239;333;805;499;306;305.0;312.0;100.0;134.0;1104.0;1059.0;757
2964;Boxtel;2020;29817;6835;17034;5948;25544;1932;799;1133;2341;1250;1091;280;153;127;208;124;84;443;230;213;602;249;353;808;494;314;306.0;321.0;103.0;135.0;1075.0;1087.0;757
2965;Boxtel;2021;29760;6761;16963;6036;25444;1941;810;1131;2375;1242;1133;280;151;129;197;119;78;457;232;225;615;250;365;826;490;336;314.0;324.0;98.0;132.0;1130.0;1103.0;757
2966;Boxtel;2022;29745;6660;16927;6158;25379;1954;824;1130;2412;1261;1151;284;158;126;196;115;81;468;241;227;631;258;373;833;489;344;313.0;338.0;104.0;129.0;1189.0;1053.0;757
2967;Boxtel;2023;29833;6654;16892;6287;25391;1951;831;1120;2491;1278;1213;290;152;138;208;115;93;483;241;242;642;262;380;868;508;360;315.0;328.0;109.0;124.0;1116.0;1084.0;757
2968;Boxtel;2024;29842;6590;16838;6414;25374;1967;838;1129;2501;1291;1210;296;154;142;206;116;90;469;240;229;652;265;387;878;516;362;317.0;341.0;108.0;124.0;1182.0;1088.0;757
2969;Boxtel;2025;29902;6591;16823;6488;25381;1947;827;1120;2574;1318;1256;306;157;149;211;118;93;477;241;236;666;263;403;914;539;375;;;;;;;757
2970;Breda;2008;171982;39977;106149;25856;136770;17195;6518;10677;18017;9875;8142;2162;1117;1045;2057;1171;886;3021;1467;1554;5126;2442;2684;5651;3678;1973;2050.0;1586.0;1437.0;1761.0;4754.0;4194.0;758
2971;Breda;2009;172705;40275;106299;26131;137034;17288;6607;10681;18383;9963;8420;2241;1159;1082;2089;1191;898;3084;1474;1610;5251;2447;2804;5718;3692;2026;2062.0;1593.0;1503.0;1761.0;4742.0;4225.0;758
2972;Breda;2010;173467;40484;106515;26468;137296;17434;6721;10713;18737;10114;8623;2310;1194;1116;2106;1212;894;3143;1500;1643;5366;2476;2890;5812;3732;2080;2073.0;1608.0;1556.0;1714.0;4883.0;4227.0;758
2973;Breda;2011;174449;40713;106922;26814;137721;17591;6842;10749;19137;10180;8957;2388;1225;1163;2195;1260;935;3265;1521;1744;5428;2467;2961;5861;3707;2154;2079.0;1626.0;1599.0;1724.0;5125.0;4395.0;758
2974;Breda;2012;175529;40917;107065;27547;138207;17816;6967;10849;19506;10227;9279;2462;1244;1218;2257;1292;965;3370;1546;1824;5507;2458;3049;5910;3687;2223;2091.0;1645.0;1626.0;1705.0;4935.0;4376.0;758
2975;Breda;2013;176479;41068;107202;28209;138578;18036;7105;10931;19865;10289;9576;2531;1270;1261;2289;1308;981;3481;1575;1906;5595;2463;3132;5969;3673;2296;2086.0;1636.0;1609.0;1698.0;4949.0;4380.0;758
2976;Breda;2014;177429;41193;107455;28781;138988;18224;7240;10984;20217;10348;9869;2607;1300;1307;2328;1334;994;3579;1607;1972;5688;2463;3225;6015;3644;2371;2123.0;1652.0;1605.0;1645.0;5101.0;4438.0;758
2977;Breda;2015;178550;41459;107748;29343;139500;18365;7285;11080;20685;10537;10148;2682;1325;1357;2393;1386;1007;3659;1632;2027;5803;2482;3321;6148;3712;2436;2134.0;1667.0;1636.0;1635.0;4994.0;4451.0;758
2978;Breda;2016;179587;41725;108015;29847;140001;18499;7397;11102;21087;10647;10440;2761;1349;1412;2470;1414;1056;3719;1651;2068;5831;2478;3353;6306;3755;2551;2153.0;1668.0;1634.0;1625.0;4855.0;4515.0;758
2979;Breda;2017;180449;42103;108108;30238;140321;18687;7497;11190;21441;10728;10713;2826;1362;1464;2522;1442;1080;3816;1682;2134;5893;2472;3421;6384;3770;2614;2179.0;1687.0;1654.0;1610.0;4894.0;4507.0;758
2980;Breda;2018;181395;42451;108174;30770;140638;18928;7640;11288;21829;10838;10991;2904;1382;1522;2576;1460;1116;3882;1699;2183;5946;2473;3473;6521;3824;2697;2159.0;1711.0;1628.0;1620.0;5114.0;4575.0;758
2981;Breda;2019;182435;42746;108491;31198;141119;19128;7768;11360;22188;10951;11237;2969;1427;1542;2647;1497;1150;3932;1703;2229;6024;2486;3538;6616;3838;2778;2164.0;1723.0;1585.0;1601.0;5020.0;4602.0;758
2982;Breda;2020;183302;42805;108818;31679;141522;19299;7910;11389;22481;11050;11431;3031;1458;1573;2713;1538;1175;3966;1704;2262;6060;2480;3580;6711;3870;2841;2155.0;1726.0;1563.0;1599.0;5070.0;4673.0;758
2983;Breda;2021;184113;42856;109091;32166;141935;19440;7977;11463;22738;11156;11582;3113;1494;1619;2729;1555;1174;3969;1690;2279;6119;2508;3611;6808;3909;2899;2143.0;1748.0;1553.0;1569.0;4942.0;4698.0;758
2984;Breda;2022;184761;42910;109203;32648;142189;19598;8070;11528;22974;11235;11739;3156;1518;1638;2753;1565;1188;4052;1739;2313;6138;2497;3641;6875;3916;2959;2108.0;1761.0;1589.0;1578.0;5253.0;4719.0;758
2985;Breda;2023;185679;42923;109617;33139;142663;19769;8238;11531;23247;11343;11904;3239;1552;1687;2792;1591;1201;4066;1745;2321;6174;2496;3678;6976;3959;3017;2097.0;1790.0;1596.0;1567.0;4737.0;4761.0;758
2986;Breda;2024;186027;42939;109389;33699;142671;19921;8340;11581;23435;11424;12011;3298;1590;1708;2811;1598;1213;4093;1765;2328;6191;2493;3698;7042;3978;3064;2047.0;1800.0;1525.0;1546.0;5057.0;4755.0;758
2987;Breda;2025;186587;42886;109440;34261;142818;20110;8463;11647;23659;11513;12146;3334;1589;1745;2859;1622;1237;4129;1768;2361;6200;2485;3715;7137;4049;3088;;;;;;;758
2988;Breukelen;2008;14396;3676;8463;2257;12636;1146;411;735;614;344;270;110;50;60;35;18;17;41;16;25;107;51;56;321;209;112;155.0;124.0;49.0;64.0;673.0;740.0;311
2989;Breukelen;2009;14347;3636;8424;2287;12547;1154;409;745;646;356;290;114;52;62;38;22;16;48;16;32;110;51;59;336;215;121;153.0;124.0;50.0;68.0;762.0;749.0;311
2990;Breukelen;2010;14372;3615;8420;2337;12537;1174;409;765;661;360;301;120;52;68;40;21;19;65;22;43;112;54;58;324;211;113;146.0;128.0;51.0;62.0;714.0;770.0;311
2991;Breukelen;2011;14325;3496;8474;2355;12445;1173;408;765;707;383;324;129;55;74;46;23;23;75;26;49;122;59;63;335;220;115;142.0;125.0;52.0;66.0;708.0;770.0;311
2992;Breukelen;2012;14267;3418;8434;2415;12351;1170;410;760;746;410;336;130;58;72;50;25;25;84;33;51;125;56;69;357;238;119;149.0;126.0;51.0;60.0;773.0;775.0;311
2993;Breukelen;2013;14281;3382;8408;2491;12313;1187;425;762;781;406;375;139;59;80;54;26;28;87;34;53;130;55;75;371;232;139;149.0;127.0;54.0;62.0;727.0;771.0;311
2994;Breukelen;2014;14253;3294;8411;2548;12226;1213;441;772;814;415;399;144;63;81;63;30;33;90;35;55;137;54;83;380;233;147;141.0;132.0;53.0;63.0;704.0;781.0;311
2995;Breukelen;2015;14177;3225;8347;2605;12103;1219;449;770;855;435;420;145;66;79;70;35;35;96;39;57;137;51;86;407;244;163;147.0;129.0;55.0;59.0;733.0;766.0;311
2996;Breukelen;2016;14158;3206;8301;2651;12045;1218;462;756;895;445;450;161;76;85;74;35;39;101;42;59;147;53;94;412;239;173;158.0;129.0;62.0;70.0;674.0;764.0;311
2997;Breukelen;2017;14092;3144;8246;2702;11964;1224;480;744;904;457;447;156;73;83;73;35;38;103;46;57;145;52;93;427;251;176;154.0;130.0;49.0;61.0;789.0;739.0;311
2998;Breukelen;2018;14155;3146;8240;2769;11997;1233;485;748;925;453;472;154;75;79;76;32;44;112;50;62;153;53;100;430;243;187;150.0;134.0;49.0;62.0;705.0;743.0;311
2999;Breukelen;2019;14121;3063;8263;2795;11937;1251;501;750;933;448;485;155;73;82;82;38;44;114;52;62;159;51;108;423;234;189;153.0;136.0;53.0;54.0;713.0;742.0;311
3000;Breukelen;2020;14110;2992;8292;2826;11916;1259;509;750;935;451;484;150;73;77;85;44;41;121;51;70;157;50;107;422;233;189;156.0;133.0;55.0;56.0;710.0;753.0;311
3001;Breukelen;2021;14089;2906;8305;2878;11867;1262;511;751;960;466;494;151;73;78;93;50;43;118;49;69;170;53;117;428;241;187;154.0;138.0;56.0;61.0;674.0;762.0;311
3002;Breukelen;2022;14012;2859;8244;2909;11768;1251;499;752;993;476;517;159;76;83;92;52;40;130;52;78;173;56;117;439;240;199;153.0;139.0;56.0;57.0;642.0;743.0;311
3003;Breukelen;2023;13925;2802;8153;2970;11647;1261;508;753;1017;487;530;161;80;81;101;56;45;134;51;83;170;55;115;451;245;206;151.0;135.0;54.0;54.0;695.0;760.0;311
3004;Breukelen;2024;13876;2762;8103;3011;11602;1255;498;757;1019;486;533;157;77;80;98;53;45;135;55;80;177;57;120;452;244;208;146.0;137.0;48.0;52.0;763.0;733.0;311
3005;Breukelen;2025;13912;2770;8086;3056;11596;1274;526;748;1042;494;548;172;82;90;98;50;48;142;56;86;171;56;115;459;250;209;;;;;;;311
3006;Brielle;2008;16026;3712;9871;2443;14136;1247;464;783;643;313;330;87;35;52;85;35;50;102;50;52;39;16;23;330;177;153;133.0;130.0;48.0;64.0;621.0;689.0;501
3007;Brielle;2009;15948;3655;9780;2513;14030;1242;473;769;676;321;355;99;36;63;80;33;47;111;54;57;50;21;29;336;177;159;129.0;129.0;46.0;63.0;661.0;691.0;501
3008;Brielle;2010;15904;3600;9677;2627;13950;1233;458;775;721;344;377;105;40;65;80;35;45;121;62;59;61;26;35;354;181;173;126.0;134.0;42.0;65.0;693.0;686.0;501
3009;Brielle;2011;15881;3505;9700;2676;13907;1218;448;770;756;366;390;112;43;69;79;35;44;123;59;64;70;32;38;372;197;175;124.0;136.0;52.0;65.0;777.0;706.0;501
3010;Brielle;2012;15930;3473;9603;2854;13910;1221;448;773;799;384;415;108;42;66;77;34;43;132;62;70;90;41;49;392;205;187;124.0;139.0;45.0;59.0;751.0;694.0;501
3011;Brielle;2013;15960;3422;9524;3014;13891;1228;459;769;841;393;448;113;44;69;81;33;48;148;67;81;109;47;62;390;202;188;122.0;139.0;49.0;61.0;810.0;685.0;501
3012;Brielle;2014;16057;3409;9495;3153;13906;1246;467;779;905;416;489;120;47;73;87;35;52;152;67;85;125;51;74;421;216;205;125.0;145.0;45.0;59.0;804.0;717.0;501
3013;Brielle;2015;16110;3343;9509;3258;13893;1258;477;781;959;434;525;128;50;78;85;31;54;165;72;93;136;55;81;445;226;219;128.0;148.0;54.0;58.0;745.0;731.0;501
3014;Brielle;2016;16102;3307;9435;3360;13875;1252;475;777;975;454;521;126;54;72;85;29;56;167;72;95;137;57;80;460;242;218;129.0;152.0;60.0;56.0;673.0;687.0;501
3015;Brielle;2017;16069;3270;9381;3418;13813;1241;460;781;1015;475;540;136;57;79;88;31;57;178;76;102;145;64;81;468;247;221;128.0;155.0;45.0;62.0;788.0;716.0;501
3016;Brielle;2018;16098;3238;9383;3477;13788;1259;468;791;1051;478;573;144;55;89;92;35;57;184;73;111;157;65;92;474;250;224;128.0;160.0;45.0;56.0;765.0;741.0;501
3017;Brielle;2019;16082;3203;9319;3560;13730;1257;468;789;1095;502;593;151;63;88;102;39;63;192;74;118;170;73;97;480;253;227;133.0;166.0;59.0;57.0;745.0;709.0;501
3018;Brielle;2020;16089;3164;9295;3630;13701;1246;462;784;1142;525;617;159;69;90;108;39;69;194;74;120;182;80;102;499;263;236;130.0;166.0;50.0;53.0;774.0;700.0;501
3019;Brielle;2021;16126;3173;9248;3705;13693;1257;469;788;1176;544;632;170;71;99;109;39;70;194;72;122;188;81;107;515;281;234;133.0;169.0;49.0;59.0;712.0;741.0;501
3020;Brielle;2022;16051;3104;9163;3784;13635;1247;476;771;1169;543;626;171;71;100;107;37;70;193;69;124;191;82;109;507;284;223;131.0;172.0;39.0;51.0;758.0;709.0;501
3021;Brielle;2023;16048;3089;9140;3819;13582;1259;477;782;1207;554;653;184;75;109;110;40;70;204;70;134;188;79;109;521;290;231;137.0;177.0;44.0;54.0;828.0;712.0;501
3022;Brielle;2024;16115;3086;9133;3896;13586;1252;472;780;1277;580;697;194;78;116;115;43;72;213;74;139;206;86;120;549;299;250;140.0;176.0;46.0;58.0;749.0;738.0;501
3023;Brielle;2025;16080;3059;9074;3947;13512;1265;479;786;1303;581;722;202;84;118;110;40;70;213;72;141;216;88;128;562;297;265;;;;;;;501
3024;Bronckhorst;2008;37514;8969;21636;6909;35303;1541;495;1046;670;388;282;82;44;38;58;28;30;126;67;59;39;20;19;365;229;136;309.0;375.0;85.0;98.0;1066.0;1231.0;1876
3025;Bronckhorst;2009;37275;8851;21337;7087;34973;1572;511;1061;730;419;311;93;48;45;66;34;32;148;78;70;49;24;25;374;235;139;297.0;375.0;88.0;100.0;1077.0;1268.0;1876
3026;Bronckhorst;2010;37000;8671;21072;7257;34599;1594;513;1081;807;456;351;112;60;52;70;37;33;171;86;85;70;32;38;384;241;143;286.0;378.0;94.0;101.0;1147.0;1297.0;1876
3027;Bronckhorst;2011;36753;8458;20935;7360;34252;1616;517;1099;885;493;392;125;67;58;77;42;35;186;91;95;82;32;50;415;261;154;286.0;381.0;104.0;103.0;1161.0;1294.0;1876
3028;Bronckhorst;2012;36528;8262;20592;7674;33943;1625;528;1097;960;527;433;148;77;71;76;38;38;208;94;114;101;43;58;427;275;152;286.0;390.0;92.0;94.0;1116.0;1273.0;1876
3029;Bronckhorst;2013;36265;8003;20298;7964;33592;1650;538;1112;1023;555;468;157;82;75;88;43;45;231;103;128;97;46;51;450;281;169;286.0;387.0;115.0;99.0;1247.0;1294.0;1876
3030;Bronckhorst;2014;36136;7777;20175;8184;33343;1689;554;1135;1104;587;517;170;89;81;89;44;45;253;107;146;119;56;63;473;291;182;282.0;394.0;103.0;92.0;1159.0;1308.0;1876
3031;Bronckhorst;2015;35889;7574;19954;8361;33049;1673;547;1126;1167;611;556;194;101;93;98;46;52;259;110;149;130;56;74;486;298;188;288.0;405.0;100.0;94.0;1303.0;1289.0;1876
3032;Bronckhorst;2016;35796;7410;19862;8524;32852;1709;557;1152;1235;640;595;192;102;90;114;58;56;272;116;156;140;55;85;517;309;208;285.0;413.0;92.0;86.0;1196.0;1292.0;1876
3033;Bronckhorst;2017;35580;7254;19605;8721;32496;1764;578;1186;1320;690;630;210;109;101;127;69;58;296;128;168;144;56;88;543;328;215;286.0;408.0;99.0;96.0;1317.0;1293.0;1876
3034;Bronckhorst;2018;35486;7123;19445;8918;32286;1784;597;1187;1416;722;694;228;116;112;141;79;62;317;130;187;161;59;102;569;338;231;293.0;415.0;96.0;93.0;1335.0;1327.0;1876
3035;Bronckhorst;2019;35376;6962;19354;9060;32103;1791;599;1192;1482;742;740;239;115;124;136;77;59;335;135;200;172;60;112;600;355;245;302.0;428.0;89.0;94.0;1302.0;1284.0;1876
3036;Bronckhorst;2020;35268;6830;19236;9202;31933;1812;613;1199;1523;752;771;237;114;123;141;82;59;334;131;203;188;69;119;623;356;267;308.0;428.0;98.0;91.0;1377.0;1288.0;1876
3037;Bronckhorst;2021;35247;6695;19200;9352;31844;1822;605;1217;1581;785;796;251;125;126;138;81;57;346;136;210;196;70;126;650;373;277;314.0;438.0;96.0;94.0;1339.0;1318.0;1876
3038;Bronckhorst;2022;35148;6590;19075;9483;31657;1841;609;1232;1650;829;821;260;130;130;154;92;62;343;139;204;208;75;133;685;393;292;325.0;435.0;89.0;92.0;1418.0;1303.0;1876
3039;Bronckhorst;2023;35152;6492;19008;9652;31561;1866;621;1245;1725;866;859;264;136;128;161;93;68;368;147;221;221;81;140;711;409;302;322.0;442.0;95.0;88.0;1211.0;1310.0;1876
3040;Bronckhorst;2024;34944;6411;18779;9754;31279;1882;612;1270;1783;877;906;276;138;138;165;98;67;379;143;236;233;82;151;730;416;314;317.0;449.0;87.0;90.0;1371.0;1272.0;1876
3041;Bronckhorst;2025;34912;6358;18619;9935;31134;1933;633;1300;1845;904;941;292;144;148;175;99;76;383;148;235;248;89;159;747;424;323;;;;;;;1876
3042;Brummen;2008;21093;4982;12356;3755;18761;1263;394;869;1069;591;478;67;30;37;48;31;17;621;322;299;56;28;28;277;180;97;177.0;197.0;53.0;82.0;826.0;820.0;213
3043;Brummen;2009;21052;4893;12317;3842;18708;1261;391;870;1083;618;465;66;31;35;51;32;19;611;318;293;60;33;27;295;204;91;166.0;201.0;52.0;82.0;923.0;814.0;213
3044;Brummen;2010;21094;4796;12352;3946;18717;1255;392;863;1122;634;488;65;32;33;61;37;24;607;318;289;75;37;38;314;210;104;166.0;202.0;60.0;75.0;826.0;851.0;213
3045;Brummen;2011;21021;4633;12367;4021;18612;1268;406;862;1141;643;498;73;32;41;66;39;27;586;308;278;81;38;43;335;226;109;167.0;204.0;60.0;79.0;795.0;834.0;213
3046;Brummen;2012;20927;4482;12258;4187;18500;1259;398;861;1168;649;519;83;37;46;66;38;28;585;304;281;83;41;42;351;229;122;162.0;210.0;79.0;76.0;799.0;840.0;213
3047;Brummen;2013;20846;4354;12155;4337;18400;1263;400;863;1183;660;523;87;39;48;65;38;27;563;293;270;91;43;48;377;247;130;165.0;212.0;62.0;76.0;830.0;827.0;213
3048;Brummen;2014;20790;4262;12061;4467;18331;1256;406;850;1203;670;533;92;40;52;68;37;31;547;291;256;105;47;58;391;255;136;165.0;211.0;65.0;77.0;755.0;838.0;213
3049;Brummen;2015;20651;4108;11990;4553;18164;1266;412;854;1221;675;546;96;46;50;68;39;29;548;283;265;112;49;63;397;258;139;169.0;217.0;62.0;79.0;789.0;833.0;213
3050;Brummen;2016;20541;4019;11878;4644;18039;1247;405;842;1255;694;561;106;52;54;71;42;29;532;279;253;117;49;68;429;272;157;168.0;221.0;60.0;73.0;743.0;839.0;213
3051;Brummen;2017;20382;3880;11760;4742;17883;1233;396;837;1266;697;569;117;57;60;76;44;32;521;271;250;115;48;67;437;277;160;172.0;230.0;55.0;75.0;758.0;823.0;213
3052;Brummen;2018;20240;3801;11639;4800;17721;1222;388;834;1297;712;585;114;56;58;82;45;37;525;275;250;119;49;70;457;287;170;172.0;225.0;57.0;73.0;776.0;794.0;213
3053;Brummen;2019;20154;3724;11584;4846;17619;1219;387;832;1316;719;597;130;60;70;83;46;37;524;277;247;116;50;66;463;286;177;172.0;229.0;65.0;74.0;757.0;814.0;213
3054;Brummen;2020;20031;3651;11448;4932;17461;1233;405;828;1337;724;613;136;63;73;93;52;41;508;263;245;117;52;65;483;294;189;173.0;242.0;66.0;75.0;771.0;811.0;213
3055;Brummen;2021;19915;3587;11359;4969;17338;1237;396;841;1340;728;612;139;64;75;101;55;46;490;258;232;124;52;72;486;299;187;173.0;232.0;56.0;73.0;928.0;814.0;213
3056;Brummen;2022;19956;3546;11379;5031;17357;1230;395;835;1369;731;638;140;66;74;115;60;55;488;256;232;127;49;78;499;300;199;173.0;237.0;57.0;67.0;837.0;820.0;213
3057;Brummen;2023;19900;3537;11234;5129;17289;1229;398;831;1382;735;647;145;68;77;117;64;53;485;246;239;115;43;72;520;314;206;181.0;239.0;58.0;68.0;833.0;802.0;213
3058;Brummen;2024;19866;3501;11150;5215;17254;1213;401;812;1399;747;652;155;76;79;119;66;53;479;244;235;123;46;77;523;315;208;179.0;243.0;59.0;66.0;791.0;781.0;213
3059;Brummen;2025;19805;3491;11035;5279;17187;1212;405;807;1406;758;648;159;81;78;129;74;55;462;239;223;129;44;85;527;320;207;;;;;;;213
3060;Brunssum;2008;29738;6256;18046;5436;22524;5965;1486;4479;1249;682;567;110;63;47;116;66;50;82;43;39;438;210;228;503;300;203;273.0;336.0;187.0;195.0;1184.0;1146.0;899
3061;Brunssum;2009;29707;6191;18067;5449;22473;5879;1500;4379;1355;752;603;121;72;49;118;69;49;107;56;51;446;216;230;563;339;224;282.0;331.0;196.0;201.0;1289.0;1170.0;899
3062;Brunssum;2010;29775;6191;18083;5501;22576;5790;1497;4293;1409;787;622;133;82;51;120;71;49;115;60;55;451;227;224;590;347;243;275.0;337.0;200.0;198.0;1347.0;1174.0;899
3063;Brunssum;2011;29889;6174;18150;5565;22711;5713;1521;4192;1465;813;652;138;83;55;119;74;45;133;67;66;457;229;228;618;360;258;275.0;341.0;206.0;201.0;1314.0;1196.0;899
3064;Brunssum;2012;29950;6185;18123;5642;22804;5612;1529;4083;1534;834;700;148;90;58;133;75;58;152;73;79;463;234;229;638;362;276;285.0;337.0;204.0;196.0;1199.0;1180.0;899
3065;Brunssum;2013;29928;6141;18021;5766;22782;5540;1526;4014;1606;867;739;162;100;62;143;80;63;161;73;88;479;243;236;661;371;290;280.0;345.0;195.0;186.0;1404.0;1173.0;899
3066;Brunssum;2014;30107;6178;18079;5850;22988;5448;1542;3906;1671;899;772;174;101;73;153;87;66;172;77;95;488;249;239;684;385;299;289.0;336.0;209.0;182.0;1297.0;1216.0;899
3067;Brunssum;2015;30170;6172;18047;5951;23012;5398;1559;3839;1760;934;826;178;104;74;163;90;73;184;83;101;510;250;260;725;407;318;285.0;347.0;190.0;184.0;1333.0;1204.0;899
3068;Brunssum;2016;30246;6179;18012;6055;23094;5360;1574;3786;1792;958;834;189;109;80;171;98;73;195;86;109;507;253;254;730;412;318;294.0;347.0;198.0;179.0;1320.0;1213.0;899
3069;Brunssum;2017;30322;6177;17973;6172;23173;5265;1578;3687;1884;988;896;200;112;88;186;109;77;207;86;121;525;259;266;766;422;344;287.0;348.0;184.0;176.0;1290.0;1182.0;899
3070;Brunssum;2018;30379;6196;17867;6316;23254;5192;1594;3598;1933;1011;922;210;120;90;191;106;85;209;91;118;538;260;278;785;434;351;299.0;360.0;201.0;182.0;1307.0;1189.0;899
3071;Brunssum;2019;30459;6196;17827;6436;23340;5117;1590;3527;2002;1046;956;217;124;93;225;123;102;228;95;133;533;261;272;799;443;356;296.0;362.0;181.0;176.0;1358.0;1203.0;899
3072;Brunssum;2020;30557;6216;17772;6569;23453;5042;1623;3419;2062;1073;989;227;122;105;234;131;103;249;108;141;545;267;278;807;445;362;302.0;371.0;176.0;169.0;1344.0;1209.0;899
3073;Brunssum;2021;30632;6208;17769;6655;23535;4996;1646;3350;2101;1110;991;231;132;99;231;128;103;268;116;152;546;273;273;825;461;364;303.0;365.0;175.0;173.0;1409.0;1223.0;899
3074;Brunssum;2022;30758;6213;17784;6761;23671;4938;1644;3294;2149;1123;1026;234;133;101;252;134;118;273;117;156;542;276;266;848;463;385;306.0;370.0;198.0;167.0;1401.0;1222.0;899
3075;Brunssum;2023;30904;6281;17696;6927;23752;4925;1678;3247;2227;1149;1078;242;136;106;266;140;126;284;119;165;567;288;279;868;466;402;316.0;383.0;172.0;165.0;1316.0;1246.0;899
3076;Brunssum;2024;30917;6297;17565;7055;23791;4847;1678;3169;2279;1154;1125;250;137;113;272;136;136;292;122;170;574;289;285;891;470;421;310.0;384.0;166.0;164.0;1419.0;1207.0;899
3077;Brunssum;2025;31060;6326;17528;7206;23946;4789;1701;3088;2325;1184;1141;241;138;103;275;142;133;304;131;173;589;290;299;916;483;433;;;;;;;899
3078;Bunnik;2008;14175;3518;8120;2537;12639;993;311;682;543;302;241;73;35;38;75;36;39;38;19;19;83;43;40;274;169;105;131.0;113.0;45.0;61.0;660.0;709.0;312
3079;Bunnik;2009;14130;3399;8130;2601;12550;992;303;689;588;334;254;83;40;43;86;47;39;47;25;22;84;45;39;288;177;111;130.0;117.0;41.0;60.0;707.0;722.0;312
3080;Bunnik;2010;14112;3338;8121;2653;12471;1010;316;694;631;354;277;92;47;45;93;53;40;59;25;34;98;52;46;289;177;112;127.0;116.0;53.0;60.0;697.0;723.0;312
3081;Bunnik;2011;14090;3246;8169;2675;12403;1022;317;705;665;379;286;96;52;44;102;59;43;71;30;41;107;55;52;289;183;106;131.0;119.0;48.0;58.0;718.0;751.0;312
3082;Bunnik;2012;14060;3173;8176;2711;12313;1048;342;706;699;401;298;108;53;55;107;67;40;75;33;42;114;57;57;295;191;104;132.0;123.0;51.0;58.0;724.0;766.0;312
3083;Bunnik;2013;14021;3096;8162;2763;12230;1043;336;707;748;427;321;116;59;57;105;68;37;88;39;49;122;61;61;317;200;117;130.0;118.0;46.0;60.0;720.0;774.0;312
3084;Bunnik;2014;13966;3011;8176;2779;12146;1035;337;698;785;444;341;109;56;53;115;77;38;90;36;54;126;59;67;345;216;129;134.0;123.0;50.0;64.0;705.0;762.0;312
3085;Bunnik;2015;13906;2955;8118;2833;12070;1046;352;694;790;441;349;111;54;57;117;81;36;89;33;56;130;58;72;343;215;128;139.0;124.0;55.0;55.0;698.0;742.0;312
3086;Bunnik;2016;13877;2932;8075;2870;11990;1056;364;692;831;455;376;126;60;66;119;82;37;88;35;53;137;59;78;361;219;142;136.0;123.0;51.0;55.0;687.0;744.0;312
3087;Bunnik;2017;13831;2862;8046;2923;11903;1067;375;692;861;466;395;124;56;68;118;81;37;99;35;64;144;61;83;376;233;143;143.0;127.0;73.0;59.0;692.0;759.0;312
3088;Bunnik;2018;13797;2852;8009;2936;11837;1071;375;696;889;477;412;138;62;76;123;85;38;104;36;68;148;68;80;376;226;150;147.0;126.0;53.0;58.0;717.0;738.0;312
3089;Bunnik;2019;13792;2836;7991;2965;11778;1088;385;703;926;499;427;137;65;72;135;93;42;111;40;71;160;73;87;383;228;155;153.0;126.0;55.0;58.0;710.0;742.0;312
3090;Bunnik;2020;13786;2820;7928;3038;11745;1079;391;688;962;512;450;149;66;83;137;99;38;115;41;74;169;74;95;392;232;160;150.0;127.0;52.0;58.0;696.0;759.0;312
3091;Bunnik;2021;13740;2786;7904;3050;11698;1103;414;689;939;515;424;146;70;76;137;98;39;114;42;72;171;75;96;371;230;141;149.0;126.0;41.0;52.0;712.0;735.0;312
3092;Bunnik;2022;13730;2741;7905;3084;11668;1109;423;686;953;528;425;146;76;70;137;102;35;130;51;79;175;77;98;365;222;143;151.0;128.0;53.0;53.0;714.0;737.0;312
3093;Bunnik;2023;13731;2712;7877;3142;11632;1118;440;678;981;544;437;152;74;78;144;107;37;132;54;78;174;76;98;379;233;146;151.0;132.0;47.0;53.0;669.0;737.0;312
3094;Bunnik;2024;13677;2706;7785;3186;11558;1107;437;670;1012;558;454;161;81;80;157;116;41;140;57;83;168;76;92;386;228;158;151.0;137.0;46.0;50.0;733.0;743.0;312
3095;Bunnik;2025;13676;2686;7777;3213;11530;1121;440;681;1025;564;461;165;84;81;155;115;40;138;51;87;170;79;91;397;235;162;;;;;;;312
3096;Bunschoten;2008;19331;5585;11559;2187;17855;633;258;375;843;474;369;67;35;32;38;22;16;386;206;180;61;26;35;291;185;106;286.0;120.0;52.0;76.0;650.0;810.0;313
3097;Bunschoten;2009;19314;5511;11489;2314;17780;655;268;387;879;480;399;72;38;34;41;23;18;389;205;184;66;27;39;311;187;124;278.0;125.0;50.0;73.0;664.0;808.0;313
3098;Bunschoten;2010;19303;5441;11460;2402;17685;699;289;410;919;493;426;81;39;42;48;27;21;389;203;186;73;27;46;328;197;131;273.0;128.0;55.0;75.0;787.0;818.0;313
3099;Bunschoten;2011;19399;5405;11506;2488;17681;747;313;434;971;525;446;87;45;42;55;30;25;397;201;196;72;28;44;360;221;139;278.0;130.0;53.0;77.0;697.0;847.0;313
3100;Bunschoten;2012;19376;5322;11381;2673;17573;799;326;473;1004;533;471;96;54;42;56;33;23;397;193;204;81;32;49;374;221;153;272.0;135.0;86.0;72.0;734.0;829.0;313
3101;Bunschoten;2013;19438;5291;11327;2820;17527;828;329;499;1083;583;500;103;59;44;62;37;25;391;195;196;96;40;56;431;252;179;267.0;140.0;83.0;72.0;668.0;830.0;313
3102;Bunschoten;2014;19420;5251;11227;2942;17428;853;354;499;1139;591;548;117;61;56;75;41;34;412;194;218;102;42;60;433;253;180;262.0;140.0;66.0;72.0;773.0;826.0;313
3103;Bunschoten;2015;19485;5213;11246;3026;17380;902;372;530;1203;631;572;130;64;66;79;48;31;422;197;225;119;47;72;453;275;178;267.0;146.0;73.0;75.0;741.0;835.0;313
3104;Bunschoten;2016;19512;5162;11209;3141;17357;920;385;535;1235;637;598;129;65;64;85;49;36;414;190;224;129;52;77;478;281;197;262.0;150.0;79.0;69.0;699.0;835.0;313
3105;Bunschoten;2017;19501;5079;11194;3228;17312;923;386;537;1266;648;618;141;73;68;84;51;33;413;184;229;142;56;86;486;284;202;260.0;156.0;63.0;75.0;723.0;824.0;313
3106;Bunschoten;2018;19494;5049;11130;3315;17276;928;394;534;1290;657;633;139;73;66;88;53;35;418;183;235;146;57;89;499;291;208;258.0;160.0;64.0;73.0;774.0;807.0;313
3107;Bunschoten;2019;19552;5027;11117;3408;17280;939;397;542;1333;662;671;147;73;74;95;57;38;417;181;236;150;56;94;524;295;229;263.0;159.0;62.0;68.0;759.0;826.0;313
3108;Bunschoten;2020;19585;4956;11166;3463;17255;966;403;563;1364;678;686;145;74;71;93;57;36;413;179;234;150;57;93;563;311;252;267.0;164.0;70.0;73.0;784.0;806.0;313
3109;Bunschoten;2021;19663;4943;11169;3551;17255;995;422;573;1413;695;718;161;77;84;100;60;40;427;186;241;151;59;92;574;313;261;271.0;170.0;59.0;71.0;757.0;822.0;313
3110;Bunschoten;2022;19688;4919;11148;3621;17231;1025;435;590;1432;707;725;162;79;83;107;64;43;423;187;236;148;60;88;592;317;275;275.0;171.0;62.0;72.0;763.0;827.0;313
3111;Bunschoten;2023;19719;4905;11125;3689;17199;1063;444;619;1457;715;742;165;81;84;108;63;45;425;187;238;159;65;94;600;319;281;280.0;178.0;65.0;70.0;872.0;840.0;313
3112;Bunschoten;2024;19848;4946;11168;3734;17274;1079;450;629;1495;719;776;170;79;91;110;61;49;429;189;240;167;66;101;619;324;295;281.0;179.0;67.0;71.0;771.0;826.0;313
3113;Bunschoten;2025;19894;4933;11158;3803;17247;1116;472;644;1531;733;798;172;81;91;115;61;54;432;189;243;165;65;100;647;337;310;;;;;;;313
3114;Buren;2008;25532;6343;15813;3376;23855;1189;373;816;488;278;210;79;41;38;48;15;33;67;32;35;66;39;27;228;151;77;236.0;212.0;51.0;88.0;1030.0;1102.0;214
3115;Buren;2009;25449;6194;15727;3528;23711;1183;366;817;555;311;244;92;52;40;51;15;36;83;36;47;92;49;43;237;159;78;232.0;211.0;48.0;84.0;1068.0;1103.0;214
3116;Buren;2010;25404;6057;15638;3709;23564;1187;371;816;653;352;301;105;54;51;67;20;47;101;43;58;115;54;61;265;181;84;230.0;220.0;50.0;85.0;1092.0;1131.0;214
3117;Buren;2011;25343;5920;15585;3838;23405;1219;365;854;719;387;332;113;56;57;71;24;47;124;53;71;131;65;66;280;189;91;225.0;225.0;61.0;92.0;1097.0;1124.0;214
3118;Buren;2012;25286;5777;15430;4079;23273;1243;377;866;770;413;357;121;59;62;65;22;43;142;61;81;149;75;74;293;196;97;223.0;231.0;61.0;86.0;1074.0;1125.0;214
3119;Buren;2013;25203;5673;15266;4264;23129;1257;387;870;817;430;387;125;58;67;67;24;43;159;63;96;166;86;80;300;199;101;217.0;230.0;58.0;86.0;1069.0;1116.0;214
3120;Buren;2014;25120;5522;15157;4441;23011;1244;380;864;865;445;420;135;61;74;70;23;47;177;70;107;175;94;81;308;197;111;216.0;235.0;58.0;84.0;1065.0;1112.0;214
3121;Buren;2015;25030;5370;15078;4582;22853;1262;381;881;915;465;450;141;61;80;66;26;40;200;79;121;191;101;90;317;198;119;216.0;236.0;56.0;86.0;1002.0;1118.0;214
3122;Buren;2016;24868;5260;14922;4686;22635;1268;390;878;965;477;488;151;64;87;73;33;40;218;83;135;196;97;99;327;200;127;215.0;246.0;66.0;81.0;1066.0;1111.0;214
3123;Buren;2017;24781;5155;14762;4864;22495;1295;398;897;991;479;512;158;65;93;72;31;41;224;84;140;204;103;101;333;196;137;220.0;255.0;62.0;80.0;1113.0;1115.0;214
3124;Buren;2018;24729;5086;14632;5011;22387;1313;411;902;1029;488;541;163;68;95;82;36;46;248;92;156;204;101;103;332;191;141;215.0;256.0;55.0;79.0;1009.0;1089.0;214
3125;Buren;2019;24590;4959;14489;5142;22200;1312;408;904;1078;514;564;164;70;94;90;38;52;255;94;161;214;106;108;355;206;149;220.0;261.0;60.0;80.0;1097.0;1101.0;214
3126;Buren;2020;24529;4876;14347;5306;22095;1319;427;892;1115;530;585;169;76;93;92;36;56;267;96;171;232;110;122;355;212;143;214.0;275.0;63.0;82.0;997.0;1098.0;214
3127;Buren;2021;24351;4771;14162;5418;21859;1328;436;892;1164;548;616;181;82;99;95;34;61;280;99;181;235;110;125;373;223;150;224.0;271.0;60.0;76.0;987.0;1104.0;214
3128;Buren;2022;24174;4645;14013;5516;21619;1339;442;897;1216;587;629;177;82;95;101;42;59;293;105;188;244;113;131;401;245;156;215.0;270.0;53.0;81.0;1102.0;1074.0;214
3129;Buren;2023;24119;4576;13924;5619;21513;1350;454;896;1256;602;654;187;86;101;109;48;61;312;110;202;244;116;128;404;242;162;218.0;279.0;56.0;77.0;953.0;1058.0;214
3130;Buren;2024;23935;4488;13731;5716;21290;1331;432;899;1314;630;684;197;87;110;112;55;57;323;112;211;253;117;136;429;259;170;229.0;284.0;59.0;76.0;1007.0;1054.0;214
3131;Buren;2025;23818;4431;13549;5838;21111;1357;446;911;1350;648;702;202;88;114;118;62;56;336;120;216;257;114;143;437;264;173;;;;;;;214
3132;Bussum;2008;31735;7573;18066;6096;25762;3728;1406;2322;2245;1161;1084;216;82;134;139;60;79;300;156;144;637;319;318;953;544;409;316.0;305.0;201.0;229.0;2149.0;2059.0;381
3133;Bussum;2009;31811;7588;18191;6032;25752;3747;1431;2316;2312;1182;1130;239;90;149;144;58;86;305;160;145;644;317;327;980;557;423;314.0;303.0;215.0;232.0;2171.0;2085.0;381
3134;Bussum;2010;31894;7559;18321;6014;25809;3733;1440;2293;2352;1207;1145;257;103;154;139;54;85;315;164;151;614;300;314;1027;586;441;314.0;298.0;222.0;232.0;2153.0;2062.0;381
3135;Bussum;2011;31995;7509;18494;5992;25801;3756;1437;2319;2438;1221;1217;293;114;179;146;58;88;337;173;164;619;287;332;1043;589;454;309.0;299.0;232.0;226.0;2039.0;2094.0;381
3136;Bussum;2012;31958;7396;18450;6112;25710;3774;1457;2317;2474;1239;1235;307;122;185;151;59;92;346;176;170;611;288;323;1059;594;465;302.0;297.0;239.0;220.0;2067.0;2090.0;381
3137;Bussum;2013;31959;7329;18434;6196;25688;3777;1473;2304;2494;1258;1236;318;139;179;144;59;85;357;173;184;612;285;327;1063;602;461;301.0;288.0;233.0;219.0;2069.0;2051.0;381
3138;Bussum;2014;32008;7255;18492;6261;25676;3822;1507;2315;2510;1273;1237;340;146;194;151;63;88;350;165;185;590;276;314;1079;623;456;298.0;289.0;237.0;219.0;1968.0;2061.0;381
3139;Bussum;2015;31942;7139;18461;6342;25591;3785;1506;2279;2566;1315;1251;340;152;188;167;76;91;353;170;183;608;284;324;1098;633;465;291.0;286.0;223.0;217.0;1987.0;2077.0;381
3140;Bussum;2016;31865;7046;18399;6420;25498;3802;1511;2291;2565;1305;1260;344;155;189;168;75;93;346;166;180;614;284;330;1093;625;468;289.0;279.0;220.0;212.0;2059.0;2017.0;381
3141;Bussum;2017;31928;6967;18450;6511;25444;3857;1528;2329;2627;1312;1315;366;169;197;170;69;101;359;170;189;622;284;338;1110;620;490;283.0;286.0;244.0;214.0;1971.0;2057.0;381
3142;Bussum;2018;31872;6874;18398;6600;25345;3876;1541;2335;2651;1333;1318;370;173;197;175;77;98;351;170;181;625;289;336;1130;624;506;286.0;284.0;214.0;209.0;2015.0;2033.0;381
3143;Bussum;2019;31863;6820;18385;6658;25330;3848;1556;2292;2685;1367;1318;382;184;198;178;77;101;355;170;185;624;293;331;1146;643;503;291.0;286.0;235.0;206.0;1937.0;2048.0;381
3144;Bussum;2020;31788;6700;18335;6753;25250;3795;1535;2260;2743;1398;1345;395;192;203;185;81;104;368;177;191;622;293;329;1173;655;518;282.0;279.0;226.0;205.0;2073.0;2010.0;381
3145;Bussum;2021;31878;6589;18429;6860;25244;3853;1579;2274;2781;1393;1388;406;195;211;197;84;113;377;176;201;626;292;334;1175;646;529;278.0;287.0;213.0;196.0;2046.0;2019.0;381
3146;Bussum;2022;31915;6498;18464;6953;25190;3921;1604;2317;2804;1388;1416;405;189;216;200;85;115;384;177;207;624;288;336;1191;649;542;295.0;286.0;204.0;193.0;2004.0;2037.0;381
3147;Bussum;2023;31905;6430;18387;7088;25164;3923;1626;2297;2818;1404;1414;418;198;220;205;94;111;394;180;214;625;283;342;1176;649;527;279.0;289.0;211.0;195.0;1968.0;2048.0;381
3148;Bussum;2024;31835;6340;18273;7222;25076;3941;1653;2288;2818;1388;1430;426;199;227;215;100;115;391;175;216;634;287;347;1152;627;525;277.0;286.0;203.0;189.0;1956.0;2023.0;381
3149;Bussum;2025;31777;6257;18144;7376;24972;3987;1699;2288;2818;1392;1426;431;204;227;215;100;115;396;175;221;623;282;341;1153;631;522;;;;;;;381
3150;Capelle aan den IJssel;2008;65787;15602;40969;9216;47454;6849;2988;3861;11484;6600;4884;3885;2062;1823;1622;1043;579;986;474;512;849;394;455;4142;2627;1515;745.0;582.0;517.0;685.0;3725.0;3778.0;502
3151;Capelle aan den IJssel;2009;65739;15426;41021;9292;47240;6795;2950;3845;11704;6630;5074;3866;2027;1839;1570;992;578;1094;524;570;930;445;485;4244;2642;1602;739.0;585.0;532.0;664.0;4012.0;3734.0;502
3152;Capelle aan den IJssel;2010;66046;15364;41216;9466;47288;6834;2972;3862;11924;6661;5263;3841;1987;1854;1523;957;566;1186;563;623;1029;498;531;4345;2656;1689;751.0;588.0;565.0;666.0;3836.0;3703.0;502
3153;Capelle aan den IJssel;2011;66247;15286;41386;9575;47281;6831;2998;3833;12135;6667;5468;3819;1964;1855;1547;942;605;1270;590;680;1106;531;575;4393;2640;1753;750.0;577.0;563.0;649.0;3733.0;3691.0;502
3154;Capelle aan den IJssel;2012;66383;15156;41059;10168;47201;6848;2989;3859;12334;6654;5680;3800;1935;1865;1546;931;615;1321;603;718;1198;561;637;4469;2624;1845;728.0;585.0;595.0;636.0;3644.0;3653.0;502
3155;Capelle aan den IJssel;2013;66482;15074;40754;10654;47117;6892;3010;3882;12473;6628;5845;3787;1899;1888;1553;931;622;1374;621;753;1247;582;665;4512;2595;1917;729.0;594.0;574.0;638.0;3446.0;3641.0;502
3156;Capelle aan den IJssel;2014;66365;14868;40438;11059;46881;6873;3000;3873;12611;6600;6011;3748;1861;1887;1553;914;639;1424;628;796;1326;609;717;4560;2588;1972;729.0;605.0;570.0;625.0;3674.0;3569.0;502
3157;Capelle aan den IJssel;2015;66545;14811;40301;11433;46877;6918;3043;3875;12750;6598;6152;3742;1844;1898;1535;888;647;1488;650;838;1371;631;740;4614;2585;2029;721.0;592.0;553.0;619.0;3512.0;3553.0;502
3158;Capelle aan den IJssel;2016;66574;14743;40084;11747;46760;6925;3062;3863;12889;6590;6299;3719;1824;1895;1518;872;646;1522;658;864;1438;645;793;4692;2591;2101;721.0;613.0;548.0;611.0;3448.0;3559.0;502
3159;Capelle aan den IJssel;2017;66515;14641;39817;12057;46595;6932;3054;3878;12988;6549;6439;3671;1776;1895;1498;850;648;1576;680;896;1473;646;827;4770;2597;2173;697.0;612.0;545.0;591.0;3570.0;3497.0;502
3160;Capelle aan den IJssel;2018;66632;14537;39702;12393;46602;6968;3083;3885;13062;6508;6554;3630;1744;1886;1461;829;632;1633;692;941;1515;667;848;4823;2576;2247;696.0;626.0;535.0;598.0;3504.0;3524.0;502
3161;Capelle aan den IJssel;2019;66620;14419;39504;12697;46449;7044;3154;3890;13127;6463;6664;3614;1725;1889;1464;816;648;1657;688;969;1576;697;879;4816;2537;2279;702.0;627.0;543.0;581.0;3617.0;3457.0;502
3162;Capelle aan den IJssel;2020;66822;14348;39497;12977;46474;7091;3155;3936;13257;6465;6792;3588;1705;1883;1466;807;659;1697;695;1002;1622;719;903;4884;2539;2345;702.0;639.0;528.0;578.0;3390.0;3470.0;502
3163;Capelle aan den IJssel;2021;66759;14251;39233;13275;46313;7135;3152;3983;13311;6441;6870;3564;1684;1880;1469;795;674;1694;687;1007;1641;739;902;4943;2536;2407;694.0;645.0;533.0;576.0;3663.0;3526.0;502
3164;Capelle aan den IJssel;2022;66906;14301;39035;13570;46249;7216;3189;4027;13441;6460;6981;3542;1665;1877;1477;802;675;1745;698;1047;1672;745;927;5005;2550;2455;690.0;651.0;529.0;557.0;3632.0;3540.0;502
3165;Capelle aan den IJssel;2023;67013;14305;38907;13801;46247;7223;3218;4005;13543;6403;7140;3519;1626;1893;1442;778;664;1799;712;1087;1732;760;972;5051;2527;2524;685.0;670.0;518.0;566.0;3685.0;3549.0;502
3166;Capelle aan den IJssel;2024;67124;14235;38811;14078;46241;7250;3239;4011;13633;6393;7240;3480;1598;1882;1420;770;650;1858;724;1134;1763;777;986;5112;2524;2588;695.0;675.0;508.0;553.0;3538.0;3573.0;502
3167;Capelle aan den IJssel;2025;67073;14196;38551;14326;46050;7285;3241;4044;13738;6364;7374;3452;1561;1891;1418;756;662;1891;717;1174;1804;779;1025;5173;2551;2622;;;;;;;502
3168;Castricum;2008;34571;8533;19818;6220;31237;2228;746;1482;1106;580;526;188;92;96;106;40;66;116;56;60;54;20;34;642;372;270;269.0;270.0;92.0;127.0;1109.0;1259.0;383
3169;Castricum;2009;34388;8342;19672;6374;30948;2241;752;1489;1199;619;580;203;98;105;110;47;63;150;60;90;64;27;37;672;387;285;264.0;279.0;89.0;121.0;1255.0;1307.0;383
3170;Castricum;2010;34293;8164;19610;6519;30764;2256;778;1478;1273;653;620;212;95;117;120;56;64;165;65;100;84;35;49;692;402;290;264.0;286.0;103.0;126.0;1199.0;1350.0;383
3171;Castricum;2011;34100;7906;19576;6618;30510;2262;791;1471;1328;689;639;214;97;117;125;58;67;172;74;98;93;43;50;724;417;307;261.0;292.0;111.0;124.0;1367.0;1366.0;383
3172;Castricum;2012;34060;7726;19402;6932;30374;2282;806;1476;1404;721;683;223;101;122;130;60;70;194;82;112;108;47;61;749;431;318;264.0;296.0;106.0;122.0;1319.0;1395.0;383
3173;Castricum;2013;33940;7568;19172;7200;30169;2295;812;1483;1476;752;724;237;109;128;131;67;64;213;91;122;119;51;68;776;434;342;258.0;295.0;103.0;117.0;1234.0;1398.0;383
3174;Castricum;2014;33728;7326;19038;7364;29877;2274;815;1459;1577;802;775;262;122;140;149;79;70;226;91;135;114;48;66;826;462;364;267.0;310.0;117.0;123.0;1268.0;1373.0;383
3175;Castricum;2015;33582;7116;18995;7471;29622;2275;837;1438;1685;849;836;275;127;148;156;84;72;254;98;156;138;59;79;862;481;381;273.0;313.0;104.0;114.0;1391.0;1383.0;383
3176;Castricum;2016;33542;6933;19003;7606;29475;2321;870;1451;1746;892;854;287;130;157;155;81;74;270;112;158;143;59;84;891;510;381;274.0;315.0;107.0;113.0;1293.0;1395.0;383
3177;Castricum;2017;33395;6779;18881;7735;29276;2310;866;1444;1809;904;905;292;126;166;165;86;79;291;112;179;152;64;88;909;516;393;279.0;315.0;101.0;115.0;1390.0;1370.0;383
3178;Castricum;2018;33365;6662;18859;7844;29115;2325;866;1459;1925;951;974;312;133;179;175;90;85;320;121;199;170;69;101;948;538;410;290.0;323.0;106.0;116.0;1341.0;1394.0;383
3179;Castricum;2019;33273;6544;18816;7913;28960;2313;889;1424;2000;995;1005;321;140;181;176;91;85;340;123;217;180;73;107;983;568;415;297.0;329.0;103.0;113.0;1447.0;1394.0;383
3180;Castricum;2020;33288;6494;18850;7944;28833;2352;905;1447;2103;1033;1070;337;149;188;194;96;98;369;129;240;205;76;129;998;583;415;310.0;329.0;107.0;109.0;1359.0;1382.0;383
3181;Castricum;2021;33244;6376;18859;8009;28672;2395;925;1470;2177;1078;1099;347;154;193;208;103;105;396;137;259;222;88;134;1004;596;408;311.0;329.0;105.0;113.0;1473.0;1359.0;383
3182;Castricum;2022;33332;6332;18904;8096;28634;2440;966;1474;2258;1114;1144;369;163;206;214;106;108;411;144;267;238;93;145;1026;608;418;315.0;333.0;108.0;111.0;1499.0;1405.0;383
3183;Castricum;2023;33408;6283;18902;8223;28590;2473;985;1488;2345;1165;1180;373;164;209;216;111;105;423;151;272;257;100;157;1076;639;437;326.0;342.0;102.0;112.0;1440.0;1409.0;383
3184;Castricum;2024;33414;6254;18838;8322;28541;2492;995;1497;2381;1186;1195;369;166;203;209;106;103;446;160;286;274;108;166;1083;646;437;331.0;345.0;125.0;110.0;1413.0;1379.0;383
3185;Castricum;2025;33452;6245;18718;8489;28445;2503;996;1507;2504;1228;1276;373;169;204;221;115;106;484;170;314;294;111;183;1132;663;469;;;;;;;383
3186;Coevorden;2008;35984;8323;21391;6270;33147;1841;638;1203;996;625;371;97;50;47;60;33;27;133;74;59;43;18;25;663;450;213;375.0;334.0;132.0;211.0;1534.0;1618.0;109
3187;Coevorden;2009;35870;8188;21265;6417;32975;1833;634;1199;1062;669;393;110;61;49;59;36;23;149;82;67;57;26;31;687;464;223;363.0;342.0;146.0;212.0;1553.0;1623.0;109
3188;Coevorden;2010;35761;8082;21129;6550;32777;1846;644;1202;1138;699;439;121;67;54;64;41;23;169;91;78;66;33;33;718;467;251;346.0;346.0;139.0;214.0;1573.0;1638.0;109
3189;Coevorden;2011;35626;7890;21072;6664;32612;1834;631;1203;1180;706;474;127;70;57;69;42;27;170;89;81;87;42;45;727;463;264;341.0;347.0;136.0;201.0;1495.0;1608.0;109
3190;Coevorden;2012;35445;7723;20815;6907;32428;1802;608;1194;1215;722;493;139;72;67;72;44;28;176;92;84;105;49;56;723;465;258;338.0;351.0;138.0;200.0;1477.0;1598.0;109
3191;Coevorden;2013;35252;7579;20575;7098;32187;1810;609;1201;1255;734;521;140;84;56;76;48;28;191;98;93;129;54;75;719;450;269;336.0;346.0;144.0;192.0;1515.0;1609.0;109
3192;Coevorden;2014;35106;7419;20418;7269;32000;1783;596;1187;1323;761;562;154;91;63;81;49;32;211;110;101;134;58;76;743;453;290;330.0;351.0;148.0;193.0;1496.0;1594.0;109
3193;Coevorden;2015;34944;7299;20173;7472;31800;1793;604;1189;1351;774;577;161;98;63;74;42;32;225;116;109;141;63;78;750;455;295;328.0;359.0;129.0;181.0;1535.0;1567.0;109
3194;Coevorden;2016;34832;7170;20082;7580;31647;1778;596;1182;1407;800;607;177;102;75;81;45;36;239;125;114;146;65;81;764;463;301;327.0;360.0;134.0;176.0;1674.0;1566.0;109
3195;Coevorden;2017;34868;7139;19980;7749;31590;1804;607;1197;1474;822;652;203;114;89;96;50;46;235;124;111;158;68;90;782;466;316;326.0;365.0;138.0;179.0;1517.0;1591.0;109
3196;Coevorden;2018;34716;7001;19791;7924;31393;1814;621;1193;1509;828;681;212;119;93;100;56;44;241;128;113;173;76;97;783;449;334;336.0;370.0;137.0;178.0;1550.0;1560.0;109
3197;Coevorden;2019;34632;6901;19672;8059;31282;1805;618;1187;1545;845;700;218;124;94;101;53;48;257;133;124;191;83;108;778;452;326;333.0;373.0;125.0;182.0;1617.0;1557.0;109
3198;Coevorden;2020;34599;6833;19536;8230;31171;1818;630;1188;1610;884;726;225;126;99;105;54;51;259;135;124;210;87;123;811;482;329;323.0;378.0;130.0;179.0;1641.0;1555.0;109
3199;Coevorden;2021;34584;6750;19472;8362;31104;1786;626;1160;1694;915;779;229;128;101;114;63;51;278;140;138;223;88;135;850;496;354;334.0;376.0;123.0;179.0;1601.0;1578.0;109
3200;Coevorden;2022;34512;6661;19318;8533;30956;1793;645;1148;1763;957;806;230;130;100;119;67;52;300;149;151;230;94;136;884;517;367;334.0;385.0;134.0;172.0;1669.0;1606.0;109
3201;Coevorden;2023;34487;6607;19175;8705;30873;1802;657;1145;1812;991;821;241;138;103;118;64;54;305;155;150;234;99;135;914;535;379;346.0;386.0;128.0;176.0;1652.0;1587.0;109
3202;Coevorden;2024;34467;6548;19062;8857;30825;1783;653;1130;1859;1004;855;246;140;106;114;62;52;319;158;161;244;103;141;936;541;395;347.0;390.0;131.0;171.0;1635.0;1571.0;109
3203;Coevorden;2025;34454;6543;18873;9038;30761;1773;646;1127;1920;1020;900;259;142;117;124;68;56;322;156;166;254;105;149;961;549;412;;;;;;;109
3204;Cranendonck;2008;19866;4585;12082;3199;17013;2246;748;1498;607;331;276;70;29;41;54;28;26;51;19;32;94;37;57;338;218;120;162.0;154.0;99.0;136.0;382.0;514.0;1706
3205;Cranendonck;2009;19706;4472;11898;3336;16868;2205;733;1472;633;353;280;73;30;43;54;30;24;66;30;36;97;39;58;343;224;119;156.0;165.0;104.0;131.0;432.0;556.0;1706
3206;Cranendonck;2010;19548;4370;11753;3425;16729;2140;717;1423;679;376;303;75;31;44;57;31;26;75;34;41;97;37;60;375;243;132;152.0;167.0;107.0;131.0;493.0;570.0;1706
3207;Cranendonck;2011;19433;4300;11579;3554;16613;2102;703;1399;718;403;315;83;37;46;59;34;25;81;39;42;93;37;56;402;256;146;150.0;168.0;106.0;125.0;546.0;562.0;1706
3208;Cranendonck;2012;19381;4210;11446;3725;16539;2103;706;1397;739;413;326;78;36;42;63;35;28;86;42;44;108;42;66;404;258;146;152.0;181.0;103.0;125.0;503.0;546.0;1706
3209;Cranendonck;2013;19290;4130;11270;3890;16444;2070;696;1374;776;426;350;85;37;48;69;37;32;90;43;47;122;48;74;410;261;149;146.0;186.0;112.0;123.0;582.0;578.0;1706
3210;Cranendonck;2014;19245;4051;11137;4057;16380;2025;682;1343;840;469;371;93;44;49;71;36;35;103;46;57;126;48;78;447;295;152;149.0;186.0;106.0;116.0;564.0;580.0;1706
3211;Cranendonck;2015;19185;3952;11031;4202;16329;1982;667;1315;874;488;386;100;51;49;78;41;37;104;48;56;133;48;85;459;300;159;155.0;194.0;111.0;114.0;563.0;569.0;1706
3212;Cranendonck;2016;19139;3893;10923;4323;16250;1978;668;1310;911;517;394;103;56;47;78;43;35;115;52;63;138;53;85;477;313;164;152.0;194.0;110.0;115.0;549.0;592.0;1706
3213;Cranendonck;2017;19049;3810;10842;4397;16136;1967;676;1291;946;529;417;104;57;47;80;43;37;128;55;73;140;54;86;494;320;174;155.0;197.0;104.0;115.0;638.0;571.0;1706
3214;Cranendonck;2018;19064;3771;10803;4490;16100;1963;674;1289;1001;581;420;111;60;51;81;46;35;143;65;78;152;60;92;514;350;164;160.0;202.0;112.0;110.0;633.0;582.0;1706
3215;Cranendonck;2019;19077;3738;10769;4570;16066;1951;675;1276;1060;605;455;120;66;54;86;46;40;163;75;88;161;64;97;530;354;176;170.0;206.0;104.0;114.0;572.0;576.0;1706
3216;Cranendonck;2020;19029;3675;10717;4637;15985;1940;690;1250;1104;626;478;120;67;53;93;47;46;163;75;88;174;66;108;554;371;183;169.0;212.0;110.0;111.0;553.0;590.0;1706
3217;Cranendonck;2021;18949;3584;10676;4689;15881;1913;690;1223;1155;655;500;126;71;55;97;50;47;170;78;92;179;67;112;583;389;194;172.0;212.0;110.0;107.0;587.0;583.0;1706
3218;Cranendonck;2022;18918;3560;10598;4760;15791;1902;699;1203;1225;704;521;137;77;60;105;56;49;184;88;96;179;72;107;620;411;209;174.0;220.0;105.0;110.0;621.0;581.0;1706
3219;Cranendonck;2023;18909;3564;10507;4838;15752;1883;685;1198;1274;705;569;151;80;71;105;53;52;195;83;112;191;76;115;632;413;219;179.0;226.0;112.0;108.0;604.0;589.0;1706
3220;Cranendonck;2024;18884;3532;10478;4874;15685;1880;690;1190;1319;719;600;155;81;74;103;52;51;213;89;124;191;76;115;657;421;236;184.0;228.0;108.0;110.0;635.0;587.0;1706
3221;Cranendonck;2025;18888;3531;10391;4966;15625;1895;697;1198;1368;749;619;163;85;78;105;50;55;221;91;130;194;78;116;685;445;240;;;;;;;1706
3222;Cromstrijen;2008;12989;3046;8049;1894;12026;629;218;411;334;190;144;68;31;37;33;20;13;37;16;21;15;6;9;181;117;64;114.0;118.0;26.0;43.0;520.0;508.0;611
3223;Cromstrijen;2009;12982;3008;8012;1962;11981;640;223;417;361;199;162;64;28;36;35;20;15;45;21;24;25;9;16;192;121;71;110.0;115.0;28.0;44.0;452.0;525.0;611
3224;Cromstrijen;2010;12888;2923;7942;2023;11854;645;223;422;389;200;189;77;31;46;35;18;17;52;22;30;29;8;21;196;121;75;111.0;122.0;32.0;42.0;479.0;502.0;611
3225;Cromstrijen;2011;12845;2880;7886;2079;11766;654;222;432;425;209;216;89;35;54;40;21;19;52;20;32;34;8;26;210;125;85;109.0;118.0;31.0;43.0;396.0;504.0;611
3226;Cromstrijen;2012;12716;2774;7715;2227;11592;652;214;438;472;228;244;105;41;64;41;21;20;65;22;43;42;12;30;219;132;87;107.0;119.0;30.0;44.0;503.0;494.0;611
3227;Cromstrijen;2013;12700;2760;7577;2363;11531;676;224;452;493;238;255;103;40;63;47;21;26;72;27;45;41;12;29;230;138;92;107.0;124.0;29.0;40.0;446.0;490.0;611
3228;Cromstrijen;2014;12626;2697;7482;2447;11417;704;234;470;505;236;269;95;39;56;48;20;28;84;31;53;47;15;32;231;131;100;106.0;125.0;39.0;39.0;411.0;489.0;611
3229;Cromstrijen;2015;12530;2651;7364;2515;11270;712;236;476;548;254;294;100;39;61;48;22;26;93;34;59;52;17;35;255;142;113;101.0;125.0;34.0;41.0;465.0;480.0;611
3230;Cromstrijen;2016;12486;2616;7296;2574;11195;724;243;481;567;268;299;108;42;66;51;25;26;90;33;57;60;22;38;258;146;112;104.0;128.0;32.0;43.0;397.0;477.0;611
3231;Cromstrijen;2017;12373;2559;7208;2606;11061;719;249;470;593;285;308;109;45;64;55;29;26;97;34;63;65;22;43;267;155;112;106.0;126.0;33.0;38.0;452.0;489.0;611
3232;Cromstrijen;2018;12311;2514;7140;2657;10971;727;262;465;613;291;322;114;49;65;56;30;26;98;36;62;74;24;50;271;152;119;104.0;130.0;28.0;39.0;440.0;485.0;611
3233;Cromstrijen;2019;12230;2437;7095;2698;10870;734;260;474;626;290;336;118;49;69;55;29;26;104;38;66;78;28;50;271;146;125;106.0;131.0;27.0;42.0;487.0;472.0;611
3234;Cromstrijen;2020;12207;2390;7069;2748;10813;745;270;475;649;307;342;117;51;66;62;33;29;111;39;72;81;31;50;278;153;125;103.0;133.0;31.0;38.0;395.0;470.0;611
3235;Cromstrijen;2021;12097;2331;6976;2790;10700;753;271;482;644;290;354;118;51;67;54;26;28;119;42;77;82;27;55;271;144;127;100.0;136.0;37.0;39.0;447.0;477.0;611
3236;Cromstrijen;2022;12030;2265;6907;2858;10605;765;273;492;660;305;355;115;53;62;52;27;25;122;46;76;88;31;57;283;148;135;106.0;136.0;32.0;36.0;468.0;474.0;611
3237;Cromstrijen;2023;11992;2223;6882;2887;10529;783;291;492;680;308;372;122;53;69;51;26;25;127;47;80;92;31;61;288;151;137;106.0;138.0;33.0;36.0;432.0;467.0;611
3238;Cromstrijen;2024;11924;2216;6788;2920;10437;789;299;490;698;306;392;125;51;74;47;25;22;129;46;83;95;30;65;302;154;148;103.0;141.0;29.0;39.0;455.0;466.0;611
3239;Cromstrijen;2025;11867;2197;6708;2962;10371;784;293;491;712;313;399;129;48;81;48;23;25;130;46;84;99;36;63;306;160;146;;;;;;;611
3240;Cuijk;2008;24187;6056;14729;3402;19855;2261;849;1412;2071;1147;924;118;58;60;106;53;53;853;447;406;436;209;227;558;380;178;233.0;176.0;95.0;146.0;879.0;816.0;1684
3241;Cuijk;2009;24258;6036;14665;3557;19955;2189;803;1386;2114;1172;942;127;68;59;103;50;53;862;452;410;437;207;230;585;395;190;235.0;185.0;105.0;139.0;885.0;855.0;1684
3242;Cuijk;2010;24306;5982;14622;3702;19987;2175;791;1384;2144;1189;955;130;70;60;99;48;51;858;450;408;434;204;230;623;417;206;228.0;194.0;105.0;142.0;813.0;849.0;1684
3243;Cuijk;2011;24267;5929;14468;3870;19996;2133;773;1360;2138;1196;942;142;78;64;103;53;50;826;436;390;426;202;224;641;427;214;223.0;198.0;106.0;136.0;804.0;842.0;1684
3244;Cuijk;2012;24226;5865;14342;4019;19922;2124;779;1345;2180;1213;967;151;84;67;102;50;52;827;428;399;424;202;222;676;449;227;222.0;205.0;101.0;137.0;897.0;863.0;1684
3245;Cuijk;2013;24242;5814;14223;4205;19904;2126;783;1343;2212;1241;971;165;86;79;98;47;51;813;423;390;431;209;222;705;476;229;222.0;211.0;113.0;135.0;874.0;874.0;1684
3246;Cuijk;2014;24232;5724;14143;4365;19846;2139;799;1340;2247;1280;967;175;91;84;99;49;50;794;422;372;438;217;221;741;501;240;213.0;215.0;103.0;134.0;935.0;877.0;1684
3247;Cuijk;2015;24260;5664;14098;4498;19866;2101;780;1321;2293;1304;989;189;98;91;115;56;59;772;412;360;430;214;216;787;524;263;227.0;221.0;112.0;133.0;912.0;906.0;1684
3248;Cuijk;2016;24252;5556;14097;4599;19826;2088;779;1309;2338;1323;1015;196;98;98;120;62;58;770;410;360;429;212;217;823;541;282;219.0;227.0;107.0;130.0;888.0;904.0;1684
3249;Cuijk;2017;24208;5481;14021;4706;19798;2059;765;1294;2351;1357;994;195;99;96;107;58;49;765;415;350;426;213;213;858;572;286;233.0;233.0;111.0;130.0;933.0;890.0;1684
3250;Cuijk;2018;24234;5428;13993;4813;19778;2044;752;1292;2412;1372;1040;194;98;96;125;71;54;775;420;355;433;208;225;885;575;310;226.0;231.0;103.0;124.0;891.0;902.0;1684
3251;Cuijk;2019;24201;5298;14001;4902;19757;2027;747;1280;2417;1368;1049;202;100;102;126;66;60;757;418;339;445;210;235;887;574;313;229.0;239.0;109.0;123.0;903.0;926.0;1684
3252;Cuijk;2020;24158;5214;13959;4985;19718;2000;732;1268;2440;1396;1044;199;99;100;132;70;62;744;415;329;447;214;233;918;598;320;230.0;247.0;103.0;123.0;899.0;912.0;1684
3253;Cuijk;2021;24112;5109;13925;5078;19663;1987;729;1258;2462;1422;1040;199;104;95;131;74;57;721;410;311;453;214;239;958;620;338;238.0;251.0;103.0;122.0;904.0;886.0;1684
3254;Cuijk;2022;24099;5057;13903;5139;19586;2001;749;1252;2512;1447;1065;202;104;98;143;80;63;725;411;314;461;218;243;981;634;347;227.0;249.0;95.0;120.0;906.0;882.0;1684
3255;Cuijk;2023;24079;5010;13907;5162;19536;1994;754;1240;2549;1489;1060;204;106;98;146;83;63;725;416;309;464;223;241;1010;661;349;242.0;252.0;108.0;118.0;849.0;904.0;1684
3256;Cuijk;2024;24006;4986;13784;5236;19405;1995;760;1235;2606;1518;1088;211;110;101;154;93;61;717;413;304;472;221;251;1052;681;371;237.0;255.0;94.0;120.0;953.0;911.0;1684
3257;Cuijk;2025;24006;4940;13727;5339;19374;1975;747;1228;2657;1538;1119;226;120;106;155;92;63;710;409;301;476;223;253;1090;694;396;;;;;;;1684
3258;Culemborg;2008;27337;7484;16515;3338;21869;2224;735;1489;3244;1726;1518;364;194;170;137;59;78;386;187;199;1765;905;860;592;381;211;331.0;182.0;87.0;151.0;959.0;857.0;216
3259;Culemborg;2009;27530;7481;16597;3452;22070;2230;742;1488;3230;1698;1532;367;195;172;143;65;78;390;186;204;1730;871;859;600;381;219;326.0;185.0;82.0;144.0;840.0;884.0;216
3260;Culemborg;2010;27568;7360;16624;3584;22175;2199;735;1464;3194;1682;1512;378;192;186;148;74;74;390;181;209;1666;844;822;612;391;221;317.0;194.0;90.0;138.0;898.0;864.0;216
3261;Culemborg;2011;27680;7291;16697;3692;22332;2173;730;1443;3175;1670;1505;388;192;196;147;72;75;390;185;205;1645;832;813;605;389;216;308.0;201.0;94.0;137.0;858.0;873.0;216
3262;Culemborg;2012;27731;7202;16610;3919;22350;2171;746;1425;3210;1694;1516;393;194;199;153;75;78;404;185;219;1629;827;802;631;413;218;303.0;215.0;95.0;134.0;776.0;857.0;216
3263;Culemborg;2013;27702;7071;16513;4118;22373;2166;740;1426;3163;1680;1483;388;187;201;150;80;70;404;189;215;1581;807;774;640;417;223;306.0;212.0;90.0;126.0;826.0;893.0;216
3264;Culemborg;2014;27696;6984;16459;4253;22382;2174;756;1418;3140;1666;1474;400;190;210;149;78;71;403;193;210;1543;792;751;645;413;232;286.0;215.0;108.0;126.0;803.0;905.0;216
3265;Culemborg;2015;27650;6873;16385;4392;22354;2179;754;1425;3117;1662;1455;398;184;214;159;83;76;407;199;208;1500;778;722;653;418;235;291.0;220.0;93.0;125.0;888.0;876.0;216
3266;Culemborg;2016;27704;6816;16344;4544;22422;2166;759;1407;3116;1650;1466;410;189;221;169;92;77;419;208;211;1458;753;705;660;408;252;283.0;220.0;90.0;129.0;788.0;886.0;216
3267;Culemborg;2017;27633;6692;16268;4673;22397;2125;749;1376;3111;1648;1463;417;190;227;177;94;83;418;208;210;1425;732;693;674;424;250;283.0;227.0;87.0;119.0;740.0;887.0;216
3268;Culemborg;2018;27518;6580;16094;4844;22331;2112;755;1357;3075;1620;1455;423;190;233;186;95;91;412;203;209;1382;721;661;672;411;261;276.0;232.0;91.0;115.0;805.0;881.0;216
3269;Culemborg;2019;27465;6464;16072;4929;22310;2112;754;1358;3043;1604;1439;427;190;237;197;96;101;402;202;200;1344;706;638;673;410;263;277.0;238.0;83.0;109.0;809.0;878.0;216
3270;Culemborg;2020;27412;6320;15982;5110;22270;2114;751;1363;3028;1586;1442;423;179;244;212;103;109;407;208;199;1322;690;632;664;406;258;282.0;239.0;88.0;114.0;841.0;884.0;216
3271;Culemborg;2021;27389;6264;15844;5281;22252;2116;744;1372;3021;1589;1432;427;179;248;214;103;111;407;209;198;1290;677;613;683;421;262;279.0;245.0;97.0;109.0;807.0;872.0;216
3272;Culemborg;2022;27349;6161;15777;5411;22191;2134;749;1385;3024;1584;1440;442;183;259;214;101;113;408;212;196;1251;661;590;709;427;282;283.0;251.0;73.0;115.0;870.0;902.0;216
3273;Culemborg;2023;27309;6087;15696;5526;22187;2124;740;1384;2998;1574;1424;439;187;252;208;98;110;409;217;192;1241;656;585;701;416;285;273.0;255.0;83.0;116.0;776.0;865.0;216
3274;Culemborg;2024;27206;5981;15543;5682;22091;2122;745;1377;2993;1594;1399;433;185;248;219;108;111;413;220;193;1203;646;557;725;435;290;269.0;254.0;77.0;108.0;853.0;858.0;216
3275;Culemborg;2025;27188;5904;15467;5817;22085;2131;758;1373;2972;1578;1394;428;182;246;223;111;112;421;225;196;1167;629;538;733;431;302;;;;;;;216
3276;Dalfsen;2008;26813;7068;15706;4039;25659;698;217;481;456;273;183;50;21;29;18;8;10;39;23;16;23;9;14;326;212;114;288.0;208.0;56.0;82.0;1039.0;1051.0;148
3277;Dalfsen;2009;26857;6933;15759;4165;25621;705;223;482;531;319;212;54;22;32;25;10;15;59;31;28;26;12;14;367;244;123;293.0;214.0;58.0;85.0;1057.0;1039.0;148
3278;Dalfsen;2010;26930;6848;15828;4254;25606;730;221;509;594;355;239;71;33;38;30;13;17;70;35;35;40;17;23;383;257;126;294.0;216.0;58.0;78.0;1036.0;1085.0;148
3279;Dalfsen;2011;26944;6728;15882;4334;25530;746;233;513;668;388;280;92;42;50;36;15;21;93;45;48;51;22;29;396;264;132;292.0;219.0;64.0;76.0;1058.0;1051.0;148
3280;Dalfsen;2012;27016;6614;15897;4505;25528;764;234;530;724;410;314;100;45;55;48;21;27;110;53;57;56;27;29;410;264;146;293.0;229.0;66.0;75.0;1057.0;1098.0;148
3281;Dalfsen;2013;27032;6450;15904;4678;25474;782;238;544;776;429;347;105;50;55;51;21;30;119;54;65;67;28;39;434;276;158;303.0;237.0;63.0;79.0;1030.0;1084.0;148
3282;Dalfsen;2014;27030;6338;15881;4811;25401;790;241;549;839;463;376;121;58;63;56;23;33;133;60;73;72;31;41;457;291;166;304.0;233.0;60.0;78.0;1088.0;1067.0;148
3283;Dalfsen;2015;27107;6278;15929;4900;25410;811;249;562;886;474;412;126;63;63;61;27;34;156;66;90;77;35;42;466;283;183;304.0;240.0;64.0;79.0;1120.0;1103.0;148
3284;Dalfsen;2016;27177;6226;15936;5015;25405;830;248;582;942;501;441;140;69;71;69;29;40;167;71;96;81;36;45;485;296;189;306.0;244.0;75.0;79.0;1050.0;1110.0;148
3285;Dalfsen;2017;27177;6168;15920;5089;25343;823;248;575;1011;550;461;146;77;69;74;34;40;190;83;107;82;36;46;519;320;199;308.0;246.0;62.0;79.0;1020.0;1121.0;148
3286;Dalfsen;2018;27122;6102;15827;5193;25234;850;251;599;1038;553;485;147;79;68;76;30;46;196;85;111;94;37;57;525;322;203;308.0;244.0;69.0;80.0;1082.0;1097.0;148
3287;Dalfsen;2019;27162;6030;15839;5293;25205;860;261;599;1097;578;519;158;89;69;78;28;50;193;81;112;111;43;68;557;337;220;317.0;249.0;72.0;76.0;1053.0;1094.0;148
3288;Dalfsen;2020;27189;5996;15814;5379;25179;874;268;606;1136;592;544;165;95;70;81;31;50;204;86;118;125;49;76;561;331;230;314.0;252.0;66.0;79.0;1049.0;1097.0;148
3289;Dalfsen;2021;27193;5897;15790;5506;25090;897;273;624;1206;622;584;173;99;74;85;36;49;215;90;125;137;53;84;596;344;252;319.0;257.0;69.0;81.0;1039.0;1100.0;148
3290;Dalfsen;2022;27185;5826;15752;5607;25033;900;280;620;1252;634;618;184;100;84;86;38;48;224;92;132;143;54;89;615;350;265;310.0;263.0;62.0;80.0;1021.0;1069.0;148
3291;Dalfsen;2023;27168;5769;15655;5744;24957;920;277;643;1291;625;666;191;99;92;86;38;48;242;96;146;148;52;96;624;340;284;306.0;268.0;65.0;81.0;1008.0;1072.0;148
3292;Dalfsen;2024;27130;5726;15546;5858;24858;938;289;649;1334;641;693;206;106;100;94;42;52;241;99;142;160;53;107;633;341;292;307.0;266.0;66.0;83.0;1049.0;1080.0;148
3293;Dalfsen;2025;27127;5728;15407;5992;24811;948;292;656;1368;667;701;209;117;92;98;45;53;248;101;147;157;51;106;656;353;303;;;;;;;148
3294;Dantumadeel;2008;19081;4928;11207;2946;18396;429;139;290;256;149;107;30;13;17;13;7;6;28;13;15;21;7;14;164;109;55;190.0;184.0;35.0;49.0;598.0;770.0;65
3295;Dantumadeel;2009;18902;4796;11154;2952;18168;444;146;298;290;175;115;39;19;20;16;9;7;29;14;15;25;13;12;181;120;61;197.0;179.0;35.0;58.0;626.0;791.0;65
3296;Dantumadeel;2010;18734;4644;11088;3002;17965;454;150;304;315;192;123;47;22;25;18;11;7;38;18;20;32;19;13;180;122;58;192.0;181.0;37.0;52.0;617.0;784.0;65
3297;Dantumadeel;2011;18566;4513;11009;3044;17773;450;146;304;343;205;138;55;28;27;19;11;8;37;17;20;36;20;16;196;129;67;192.0;182.0;37.0;56.0;597.0;785.0;65
3298;Dantumadeel;2012;18373;4388;10849;3136;17553;457;138;319;363;211;152;61;32;29;22;13;9;40;17;23;47;24;23;193;125;68;190.0;180.0;42.0;50.0;593.0;792.0;65
3299;Dantumadeel;2013;18181;4249;10727;3205;17329;458;140;318;394;223;171;65;34;31;22;13;9;50;19;31;51;27;24;206;130;76;188.0;182.0;40.0;52.0;586.0;781.0;65
3300;Dantumadeel;2014;17981;4088;10600;3293;17094;468;143;325;419;244;175;65;37;28;23;14;9;50;20;30;60;31;29;221;142;79;187.0;175.0;49.0;51.0;565.0;762.0;65
3301;Dantumadeel;2015;17794;3977;10433;3384;16868;500;166;334;426;241;185;68;40;28;25;17;8;55;21;34;67;35;32;211;128;83;189.0;181.0;43.0;53.0;713.0;763.0;65
3302;Dantumadeel;2016;17745;3958;10316;3471;16758;519;169;350;468;269;199;69;40;29;32;23;9;60;22;38;64;36;28;243;148;95;187.0;180.0;40.0;54.0;686.0;752.0;65
3303;Dantumadeel;2017;17673;3891;10274;3508;16668;513;157;356;492;289;203;72;44;28;36;22;14;62;22;40;66;36;30;256;165;91;187.0;179.0;56.0;52.0;557.0;765.0;65
3304;Dantumadeel;2018;17480;3799;10106;3575;16432;525;160;365;523;306;217;79;51;28;46;27;19;59;21;38;69;36;33;270;171;99;183.0;184.0;40.0;54.0;642.0;755.0;65
3305;Dantumadeel;2019;17353;3735;9969;3649;16310;517;174;343;526;301;225;83;52;31;44;23;21;66;27;39;71;36;35;262;163;99;186.0;184.0;34.0;49.0;597.0;747.0;65
3306;Dantumadeel;2020;17193;3667;9809;3717;16143;508;175;333;542;305;237;79;50;29;44;23;21;82;29;53;73;39;34;264;164;100;180.0;182.0;33.0;50.0;593.0;721.0;65
3307;Dantumadeel;2021;17046;3560;9693;3793;15961;520;179;341;565;319;246;86;55;31;47;25;22;85;29;56;79;38;41;268;172;96;183.0;185.0;43.0;55.0;662.0;716.0;65
3308;Dantumadeel;2022;16981;3499;9607;3875;15868;519;185;334;594;335;259;92;57;35;46;27;19;94;35;59;83;37;46;279;179;100;183.0;190.0;53.0;51.0;647.0;718.0;65
3309;Dantumadeel;2023;16908;3494;9507;3907;15755;533;183;350;620;337;283;94;56;38;49;26;23;102;35;67;91;39;52;284;181;103;181.0;192.0;40.0;46.0;585.0;708.0;65
3310;Dantumadeel;2024;16769;3436;9343;3990;15593;540;183;357;636;335;301;98;60;38;49;25;24;98;32;66;98;40;58;293;178;115;175.0;196.0;49.0;47.0;626.0;703.0;65
3311;Dantumadeel;2025;16673;3412;9212;4049;15470;538;184;354;665;336;329;97;60;37;55;28;27;109;33;76;112;43;69;292;172;120;;;;;;;65
3312;Delft;2008;96269;19231;64197;12841;69365;11384;5869;5515;15520;10022;5498;2378;1256;1122;1490;955;535;2481;1350;1131;1474;739;735;7697;5722;1975;1031.0;812.0;1911.0;1974.0;5446.0;4887.0;503
3313;Delft;2009;97005;19417;64543;13045;69751;11647;6002;5645;15607;9846;5761;2430;1248;1182;1471;934;537;2560;1351;1209;1526;730;796;7620;5583;2037;1069.0;828.0;1950.0;1957.0;5322.0;4839.0;503
3314;Delft;2010;97742;19616;64806;13320;70059;11960;6202;5758;15723;9696;6027;2460;1219;1241;1472;918;554;2604;1362;1242;1607;751;856;7580;5446;2134;1060.0;835.0;1974.0;1924.0;5202.0;4787.0;503
3315;Delft;2011;98453;19762;65173;13518;70312;12292;6403;5889;15849;9608;6241;2503;1199;1304;1467;900;567;2647;1366;1281;1662;772;890;7570;5371;2199;1074.0;859.0;2010.0;1912.0;4782.0;4712.0;503
3316;Delft;2012;98849;19836;64821;14192;70348;12555;6569;5986;15946;9483;6463;2550;1188;1362;1457;881;576;2633;1362;1271;1756;795;961;7550;5257;2293;1097.0;874.0;2006.0;1904.0;4845.0;4593.0;503
3317;Delft;2013;99446;19910;64817;14719;70551;12827;6752;6075;16068;9382;6686;2569;1171;1398;1475;888;587;2693;1373;1320;1770;790;980;7561;5160;2401;1109.0;879.0;2056.0;1867.0;4761.0;4509.0;503
3318;Delft;2014;100135;20178;64783;15174;70846;13120;6969;6151;16169;9306;6863;2568;1145;1423;1459;871;588;2743;1403;1340;1813;796;1017;7586;5091;2495;1113.0;871.0;2073.0;1855.0;4698.0;4480.0;503
3319;Delft;2015;100830;20328;65006;15496;71135;13393;7170;6223;16302;9263;7039;2578;1127;1451;1450;853;597;2789;1415;1374;1847;791;1056;7638;5077;2561;1125.0;875.0;2067.0;1830.0;4733.0;4434.0;503
3320;Delft;2016;101636;20647;65069;15920;71475;13697;7365;6332;16464;9214;7250;2599;1131;1468;1456;844;612;2794;1393;1401;1935;806;1129;7680;5040;2640;1126.0;904.0;2071.0;1841.0;4712.0;4487.0;503
3321;Delft;2017;102336;20909;65147;16280;71758;14011;7546;6465;16567;9133;7434;2613;1129;1484;1463;828;635;2800;1375;1425;1967;806;1161;7724;4995;2729;1131.0;908.0;2079.0;1828.0;4656.0;4471.0;503
3322;Delft;2018;103013;21181;65182;16650;72085;14295;7735;6560;16633;9069;7564;2616;1130;1486;1493;829;664;2789;1358;1431;2003;813;1190;7732;4939;2793;1158.0;894.0;2048.0;1822.0;4609.0;4471.0;503
3323;Delft;2019;103656;21391;65269;16996;72300;14603;7931;6672;16753;9069;7684;2638;1137;1501;1494;829;665;2809;1375;1434;2043;814;1229;7769;4914;2855;1163.0;914.0;2057.0;1815.0;4642.0;4472.0;503
3324;Delft;2020;104330;21601;65448;17281;72624;14833;8102;6731;16873;9033;7840;2671;1139;1532;1471;808;663;2799;1366;1433;2100;810;1290;7832;4910;2922;1162.0;919.0;2052.0;1813.0;4740.0;4472.0;503
3325;Delft;2021;105097;21878;65526;17693;72969;15109;8262;6847;17019;9044;7975;2700;1150;1550;1465;801;664;2810;1371;1439;2127;811;1316;7917;4911;3006;1190.0;938.0;2056.0;1781.0;4717.0;4517.0;503
3326;Delft;2022;105842;22170;65608;18064;73270;15386;8402;6984;17186;9061;8125;2729;1164;1565;1481;807;674;2864;1393;1471;2161;815;1346;7951;4882;3069;1191.0;948.0;2060.0;1763.0;4701.0;4513.0;503
3327;Delft;2023;106587;22391;65737;18459;73618;15649;8575;7074;17320;9092;8228;2744;1150;1594;1472;803;669;2875;1406;1469;2201;828;1373;8028;4905;3123;1177.0;973.0;2022.0;1739.0;4727.0;4544.0;503
3328;Delft;2024;107277;22611;65857;18809;73865;15917;8751;7166;17495;9172;8323;2793;1176;1617;1506;828;678;2904;1433;1471;2228;837;1391;8064;4898;3166;1201.0;972.0;2045.0;1737.0;4712.0;4548.0;503
3329;Delft;2025;108001;22912;65884;19205;74111;16270;8981;7289;17620;9187;8433;2800;1171;1629;1518;818;700;2918;1438;1480;2274;861;1413;8110;4899;3211;;;;;;;503
3330;Delfzijl;2008;27216;6048;15998;5170;22719;2154;920;1234;2343;1497;846;299;188;111;432;279;153;639;347;292;43;21;22;930;662;268;258.0;233.0;85.0;155.0;931.0;1207.0;10
3331;Delfzijl;2009;26898;5931;15711;5256;22450;2143;902;1241;2305;1452;853;295;184;111;409;256;153;619;335;284;56;29;27;926;648;278;247.0;238.0;93.0;156.0;887.0;1211.0;10
3332;Delfzijl;2010;26522;5775;15374;5373;22097;2134;903;1231;2291;1439;852;295;193;102;401;254;147;614;333;281;64;29;35;917;630;287;239.0;237.0;92.0;149.0;900.0;1176.0;10
3333;Delfzijl;2011;26197;5594;15158;5445;21802;2138;913;1225;2257;1410;847;301;194;107;370;237;133;609;331;278;70;28;42;907;620;287;242.0;243.0;102.0;144.0;930.0;1165.0;10
3334;Delfzijl;2012;25927;5483;14838;5606;21555;2125;907;1218;2247;1411;836;295;193;102;368;237;131;590;321;269;84;33;51;910;627;283;241.0;239.0;97.0;132.0;872.0;1171.0;10
3335;Delfzijl;2013;25595;5376;14494;5725;21264;2073;876;1197;2258;1387;871;288;185;103;366;233;133;583;315;268;97;38;59;924;616;308;236.0;240.0;89.0;120.0;973.0;1120.0;10
3336;Delfzijl;2014;25414;5274;14327;5813;21056;2079;891;1188;2279;1380;899;304;185;119;368;233;135;601;318;283;105;41;64;901;603;298;239.0;234.0;87.0;115.0;877.0;1116.0;10
3337;Delfzijl;2015;25151;5176;14070;5905;20817;2064;891;1173;2270;1384;886;315;187;128;357;226;131;582;314;268;107;47;60;909;610;299;234.0;248.0;82.0;124.0;904.0;1114.0;10
3338;Delfzijl;2016;24888;5076;13904;5908;20546;2049;886;1163;2293;1382;911;317;186;131;356;228;128;588;313;275;111;44;67;921;611;310;230.0;244.0;89.0;114.0;859.0;1114.0;10
3339;Delfzijl;2017;24597;4981;13661;5955;20259;2027;866;1161;2311;1391;920;323;188;135;345;223;122;591;308;283;116;48;68;936;624;312;239.0;247.0;94.0;119.0;911.0;1088.0;10
3340;Delfzijl;2018;24388;4884;13463;6041;20028;2048;884;1164;2312;1384;928;325;193;132;346;220;126;582;304;278;122;47;75;937;620;317;231.0;250.0;88.0;114.0;894.0;1063.0;10
3341;Delfzijl;2019;24176;4792;13284;6100;19791;2057;885;1172;2328;1403;925;327;191;136;340;213;127;589;314;275;123;48;75;949;637;312;237.0;248.0;76.0;116.0;863.0;1075.0;10
3342;Delfzijl;2020;23913;4707;13067;6139;19550;2040;879;1161;2323;1403;920;322;189;133;338;214;124;576;311;265;137;51;86;950;638;312;233.0;249.0;86.0;107.0;817.0;1069.0;10
3343;Delfzijl;2021;23628;4633;12833;6162;19238;2034;878;1156;2356;1406;950;320;184;136;333;210;123;581;310;271;142;54;88;980;648;332;236.0;254.0;82.0;105.0;851.0;1025.0;10
3344;Delfzijl;2022;23416;4619;12620;6177;19012;2017;879;1138;2387;1421;966;314;183;131;330;201;129;580;307;273;152;62;90;1011;668;343;236.0;254.0;80.0;117.0;843.0;1005.0;10
3345;Delfzijl;2023;23204;4601;12390;6213;18812;1993;870;1123;2399;1428;971;309;178;131;328;198;130;571;309;262;155;61;94;1036;682;354;228.0;246.0;75.0;109.0;859.0;1014.0;10
3346;Delfzijl;2024;22997;4553;12171;6273;18623;1980;871;1109;2394;1425;969;297;171;126;316;184;132;574;310;264;160;69;91;1047;691;356;239.0;254.0;82.0;101.0;868.0;1015.0;10
3347;Delfzijl;2025;22817;4532;11979;6306;18455;1962;857;1105;2400;1434;966;301;174;127;303;180;123;569;313;256;168;67;101;1059;700;359;;;;;;;10
3348;Deurne;2008;30855;7521;18658;4676;28511;1421;521;900;923;522;401;179;101;78;65;23;42;68;38;30;202;83;119;409;277;132;264.0;236.0;117.0;117.0;611.0;1019.0;762
3349;Deurne;2009;30479;7288;18418;4773;28080;1414;524;890;985;555;430;189;107;82;70;26;44;79;46;33;218;88;130;429;288;141;251.0;246.0;138.0;110.0;701.0;1008.0;762
3350;Deurne;2010;30212;7104;18241;4867;27723;1429;534;895;1060;603;457;188;110;78;83;32;51;95;53;42;237;100;137;457;308;149;250.0;248.0;137.0;111.0;874.0;1036.0;762
3351;Deurne;2011;30084;6942;18185;4957;27477;1455;555;900;1152;634;518;210;115;95;85;35;50;116;61;55;253;106;147;488;317;171;253.0;251.0;140.0;113.0;911.0;1053.0;762
3352;Deurne;2012;29975;6765;18104;5106;27239;1508;590;918;1228;669;559;221;120;101;98;39;59;130;70;60;260;102;158;519;338;181;251.0;260.0;144.0;105.0;899.0;1072.0;762
3353;Deurne;2013;29833;6598;17966;5269;27025;1493;574;919;1315;718;597;234;125;109;102;44;58;155;87;68;264;103;161;560;359;201;252.0;264.0;145.0;110.0;1035.0;1091.0;762
3354;Deurne;2014;29803;6439;17909;5455;26961;1475;572;903;1367;743;624;247;123;124;101;41;60;152;83;69;268;107;161;599;389;210;259.0;271.0;135.0;105.0;1088.0;1094.0;762
3355;Deurne;2015;29817;6321;17880;5616;26874;1475;577;898;1468;798;670;267;130;137;107;40;67;173;95;78;282;113;169;639;420;219;258.0;278.0;139.0;102.0;957.0;1113.0;762
3356;Deurne;2016;29682;6204;17699;5779;26652;1492;591;901;1538;840;698;275;129;146;114;45;69;176;98;78;289;118;171;684;450;234;270.0;290.0;143.0;96.0;1069.0;1101.0;762
3357;Deurne;2017;29682;6104;17678;5900;26549;1508;604;904;1625;877;748;290;128;162;118;49;69;194;106;88;297;121;176;726;473;253;281.0;293.0;133.0;95.0;1028.0;1140.0;762
3358;Deurne;2018;29599;5998;17580;6021;26358;1541;616;925;1700;915;785;305;135;170;125;56;69;201;108;93;296;121;175;773;495;278;288.0;289.0;141.0;103.0;1130.0;1111.0;762
3359;Deurne;2019;29659;5963;17563;6133;26289;1578;642;936;1792;961;831;321;141;180;126;63;63;220;121;99;299;122;177;826;514;312;295.0;297.0;173.0;99.0;1092.0;1112.0;762
3360;Deurne;2020;29714;5911;17541;6262;26229;1603;661;942;1882;993;889;335;148;187;132;65;67;243;132;111;310;129;181;862;519;343;293.0;301.0;146.0;110.0;1167.0;1133.0;762
3361;Deurne;2021;29780;5844;17500;6436;26196;1642;685;957;1942;1028;914;332;146;186;137;67;70;255;136;119;323;131;192;895;548;347;306.0;313.0;154.0;98.0;1107.0;1126.0;762
3362;Deurne;2022;29817;5829;17441;6547;26116;1648;698;950;2053;1073;980;348;149;199;137;66;71;269;138;131;344;139;205;955;581;374;310.0;311.0;161.0;100.0;1133.0;1131.0;762
3363;Deurne;2023;29881;5844;17348;6689;26081;1649;682;967;2151;1115;1036;362;151;211;158;81;77;275;141;134;362;147;215;994;595;399;318.0;316.0;142.0;102.0;1138.0;1125.0;762
3364;Deurne;2024;29939;5871;17227;6841;26048;1676;699;977;2215;1136;1079;377;157;220;161;85;76;279;135;144;363;152;211;1035;607;428;316.0;313.0;150.0;102.0;1166.0;1145.0;762
3365;Deurne;2025;30013;5917;17131;6965;26039;1679;716;963;2295;1154;1141;399;162;237;160;83;77;294;134;160;385;154;231;1057;621;436;;;;;;;762
3366;Deventer;2008;98699;24094;60714;13891;78144;8390;3269;5121;12165;7322;4843;724;362;362;551;326;225;6359;3339;3020;446;203;243;4085;3092;993;1204.0;860.0;903.0;988.0;3634.0;2834.0;150
3367;Deventer;2009;99772;24365;61277;14130;79058;8477;3280;5197;12237;7312;4925;772;384;388;578;339;239;6288;3312;2976;493;216;277;4106;3061;1045;1187.0;876.0;934.0;981.0;3716.0;2791.0;150
3368;Deventer;2010;100973;24740;61757;14476;80016;8552;3313;5239;12405;7345;5060;797;403;394;624;366;258;6238;3275;2963;545;234;311;4201;3067;1134;1193.0;885.0;937.0;968.0;3398.0;2817.0;150
3369;Deventer;2011;101848;24896;62258;14694;80713;8577;3303;5274;12558;7392;5166;835;423;412;670;392;278;6201;3253;2948;601;261;340;4251;3063;1188;1181.0;895.0;944.0;956.0;3248.0;2824.0;150
3370;Deventer;2012;102557;25015;62299;15243;81238;8605;3299;5306;12714;7453;5261;867;438;429;738;432;306;6133;3218;2915;642;266;376;4334;3099;1235;1168.0;906.0;984.0;935.0;3322.0;2771.0;150
3371;Deventer;2013;103430;25156;62476;15798;81840;8681;3343;5338;12909;7540;5369;902;450;452;783;459;324;6089;3199;2890;701;294;407;4434;3138;1296;1148.0;919.0;961.0;937.0;3216.0;2812.0;150
3372;Deventer;2014;104098;25252;62608;16238;82323;8722;3353;5369;13053;7615;5438;949;481;468;820;477;343;6027;3182;2845;742;302;440;4515;3173;1342;1129.0;928.0;954.0;918.0;3190.0;2794.0;150
3373;Deventer;2015;104741;25245;62804;16692;82722;8742;3358;5384;13277;7705;5572;980;503;477;854;492;362;5987;3151;2836;799;322;477;4657;3237;1420;1134.0;943.0;969.0;909.0;3249.0;2805.0;150
3374;Deventer;2016;105451;25313;63055;17083;83239;8786;3364;5422;13426;7764;5662;1020;520;500;912;523;389;5920;3119;2801;850;343;507;4724;3259;1465;1125.0;956.0;961.0;905.0;3144.0;2816.0;150
3375;Deventer;2017;106010;25330;63235;17445;83636;8819;3375;5444;13555;7819;5736;1037;522;515;945;545;400;5866;3102;2764;906;358;548;4801;3292;1509;1110.0;965.0;954.0;903.0;3196.0;2838.0;150
3376;Deventer;2018;106582;25282;63417;17883;84038;8870;3448;5422;13674;7866;5808;1062;531;531;963;566;397;5772;3063;2709;961;367;594;4916;3339;1577;1126.0;966.0;950.0;900.0;3048.0;2843.0;150
3377;Deventer;2019;107006;25213;63516;18277;84300;8882;3462;5420;13824;7941;5883;1064;537;527;1002;587;415;5727;3042;2685;1020;390;630;5011;3385;1626;1105.0;979.0;967.0;884.0;3023.0;2840.0;150
3378;Deventer;2020;107411;25129;63584;18698;84543;8885;3461;5424;13983;8025;5958;1098;551;547;1034;612;422;5678;3010;2668;1047;406;641;5126;3446;1680;1118.0;1009.0;974.0;895.0;3060.0;2867.0;150
3379;Deventer;2021;107810;24975;63624;19211;84735;8918;3474;5444;14157;8096;6061;1128;562;566;1082;634;448;5606;2972;2634;1105;422;683;5236;3506;1730;1090.0;1016.0;957.0;883.0;3018.0;2857.0;150
3380;Deventer;2022;108132;24799;63663;19670;84947;8941;3496;5445;14244;8144;6100;1142;568;574;1116;656;460;5531;2947;2584;1141;425;716;5314;3548;1766;1109.0;1022.0;965.0;865.0;3001.0;2857.0;150
3381;Deventer;2023;108477;24558;63791;20128;85054;9031;3563;5468;14392;8239;6153;1167;581;586;1140;681;459;5476;2920;2556;1176;438;738;5433;3619;1814;1113.0;1046.0;941.0;868.0;2935.0;2879.0;150
3382;Deventer;2024;108687;24283;63724;20680;85109;9061;3601;5460;14517;8319;6198;1184;592;592;1185;705;480;5437;2910;2527;1188;445;743;5523;3667;1856;1097.0;1066.0;949.0;856.0;2738.0;2850.0;150
3383;Deventer;2025;108711;24083;63487;21141;84960;9077;3609;5468;14674;8416;6258;1213;613;600;1223;726;497;5384;2878;2506;1216;453;763;5638;3746;1892;;;;;;;150
3384;Diemen;2008;24077;5515;15284;3278;15739;2749;1275;1474;5589;3291;2298;1903;1035;868;464;292;172;603;355;248;613;324;289;2006;1285;721;231.0;188.0;255.0;248.0;1419.0;1505.0;384
3385;Diemen;2009;24042;5400;15294;3348;15644;2768;1286;1482;5630;3318;2312;1846;1009;837;461;294;167;629;363;266;670;357;313;2024;1295;729;238.0;180.0;258.0;247.0;1393.0;1479.0;384
3386;Diemen;2010;24028;5308;15267;3453;15579;2803;1308;1495;5646;3312;2334;1790;980;810;466;294;172;650;380;270;699;365;334;2041;1293;748;242.0;181.0;267.0;247.0;1411.0;1477.0;384
3387;Diemen;2011;24047;5246;15336;3465;15540;2838;1343;1495;5669;3316;2353;1765;965;800;481;302;179;664;393;271;710;374;336;2049;1282;767;243.0;184.0;275.0;239.0;1417.0;1450.0;384
3388;Diemen;2012;24111;5171;15302;3638;15505;2890;1385;1505;5716;3330;2386;1729;940;789;521;328;193;684;398;286;716;372;344;2066;1292;774;244.0;187.0;260.0;244.0;1445.0;1449.0;384
3389;Diemen;2013;24180;5090;15300;3790;15525;2934;1412;1522;5721;3295;2426;1697;917;780;521;322;199;705;403;302;753;397;356;2045;1256;789;242.0;190.0;269.0;241.0;1405.0;1445.0;384
3390;Diemen;2014;24223;5057;15240;3926;15496;2971;1463;1508;5756;3315;2441;1660;890;770;527;327;200;713;414;299;783;409;374;2073;1275;798;246.0;194.0;273.0;236.0;1448.0;1466.0;384
3391;Diemen;2015;24296;5001;15224;4071;15471;3033;1494;1539;5792;3329;2463;1623;869;754;555;346;209;743;421;322;776;410;366;2095;1283;812;244.0;198.0;269.0;231.0;1373.0;1457.0;384
3392;Diemen;2016;24297;4949;15182;4166;15422;3088;1529;1559;5787;3307;2480;1603;850;753;550;342;208;753;430;323;791;408;383;2090;1277;813;247.0;205.0;256.0;240.0;1517.0;1458.0;384
3393;Diemen;2017;24417;4900;15248;4269;15449;3120;1551;1569;5848;3310;2538;1575;830;745;563;346;217;773;434;339;816;414;402;2121;1286;835;254.0;206.0;257.0;226.0;1508.0;1423.0;384
3394;Diemen;2018;24581;4854;15342;4385;15516;3160;1580;1580;5905;3320;2585;1553;816;737;579;361;218;786;425;361;826;422;404;2161;1296;865;260.0;203.0;259.0;232.0;1477.0;1458.0;384
3395;Diemen;2019;24684;4855;15331;4498;15572;3199;1618;1581;5913;3335;2578;1516;795;721;597;359;238;782;439;343;832;425;407;2186;1317;869;251.0;206.0;259.0;229.0;1513.0;1453.0;384
3396;Diemen;2020;24821;4890;15312;4619;15601;3262;1651;1611;5958;3354;2604;1474;773;701;606;361;245;797;447;350;882;431;451;2199;1342;857;262.0;211.0;265.0;231.0;1398.0;1464.0;384
3397;Diemen;2021;24843;4859;15255;4729;15662;3287;1660;1627;5894;3317;2577;1446;756;690;607;358;249;789;440;349;868;436;432;2184;1327;857;267.0;223.0;263.0;232.0;1356.0;1414.0;384
3398;Diemen;2022;24861;4857;15165;4839;15614;3328;1691;1637;5919;3316;2603;1433;749;684;628;360;268;787;441;346;891;441;450;2180;1325;855;258.0;221.0;245.0;217.0;1434.0;1412.0;384
3399;Diemen;2023;24950;4899;15083;4968;15574;3393;1737;1656;5983;3347;2636;1435;741;694;633;359;274;788;445;343;887;441;446;2240;1361;879;267.0;219.0;263.0;229.0;1420.0;1417.0;384
3400;Diemen;2024;25037;4905;15072;5060;15612;3450;1777;1673;5975;3322;2653;1415;724;691;632;357;275;791;447;344;898;436;462;2239;1358;881;268.0;219.0;253.0;223.0;1403.0;1432.0;384
3401;Diemen;2025;25089;4911;15052;5126;15600;3480;1804;1676;6009;3317;2692;1387;705;682;645;362;283;788;448;340;914;442;472;2275;1360;915;;;;;;;384
3402;Dinkelland;2008;25536;7055;14261;4220;23494;1620;500;1120;422;261;161;29;17;12;23;11;12;110;55;55;19;10;9;241;168;73;247.0;204.0;66.0;81.0;254.0;575.0;1774
3403;Dinkelland;2009;25244;6892;14069;4283;23143;1625;516;1109;476;287;189;44;28;16;28;12;16;114;56;58;24;11;13;266;180;86;232.0;215.0;62.0;84.0;374.0;555.0;1774
3404;Dinkelland;2010;25061;6735;13972;4354;22900;1627;534;1093;534;313;221;55;34;21;34;13;21;124;59;65;35;15;20;286;192;94;226.0;212.0;61.0;82.0;368.0;568.0;1774
3405;Dinkelland;2011;24859;6577;13868;4414;22626;1647;553;1094;586;333;253;66;37;29;37;15;22;140;66;74;40;15;25;303;200;103;219.0;220.0;66.0;81.0;465.0;557.0;1774
3406;Dinkelland;2012;24755;6427;13820;4508;22451;1658;558;1100;646;357;289;75;43;32;36;15;21;160;67;93;53;17;36;322;215;107;212.0;219.0;71.0;76.0;472.0;592.0;1774
3407;Dinkelland;2013;24626;6253;13764;4609;22208;1686;600;1086;732;388;344;80;47;33;39;17;22;181;66;115;65;18;47;367;240;127;205.0;220.0;67.0;81.0;445.0;598.0;1774
3408;Dinkelland;2014;24445;6053;13664;4728;21998;1666;590;1076;781;422;359;92;52;40;47;21;26;187;72;115;65;21;44;390;256;134;205.0;224.0;63.0;76.0;419.0;599.0;1774
3409;Dinkelland;2015;24236;5871;13546;4819;21743;1683;605;1078;810;430;380;96;54;42;48;21;27;191;70;121;72;23;49;403;262;141;209.0;232.0;67.0;78.0;495.0;612.0;1774
3410;Dinkelland;2016;24087;5689;13496;4902;21509;1712;636;1076;866;456;410;105;67;38;51;26;25;201;72;129;83;24;59;426;267;159;207.0;236.0;70.0;73.0;476.0;622.0;1774
3411;Dinkelland;2017;23913;5541;13378;4994;21272;1727;646;1081;914;474;440;117;74;43;56;27;29;210;73;137;91;30;61;440;270;170;211.0;240.0;73.0;74.0;440.0;611.0;1774
3412;Dinkelland;2018;23715;5358;13255;5102;21001;1737;657;1080;977;502;475;122;76;46;58;30;28;227;80;147;99;31;68;471;285;186;220.0;243.0;75.0;74.0;403.0;616.0;1774
3413;Dinkelland;2019;23484;5210;13105;5169;20705;1736;654;1082;1043;542;501;138;84;54;69;37;32;234;86;148;112;38;74;490;297;193;215.0;242.0;82.0;71.0;530.0;606.0;1774
3414;Dinkelland;2020;23396;5062;13083;5251;20511;1792;686;1106;1093;551;542;143;81;62;75;37;38;236;88;148;130;40;90;509;305;204;223.0;244.0;70.0;72.0;565.0;617.0;1774
3415;Dinkelland;2021;23323;4931;13053;5339;20373;1805;707;1098;1145;567;578;145;78;67;81;39;42;265;92;173;136;42;94;518;316;202;238.0;248.0;73.0;79.0;609.0;628.0;1774
3416;Dinkelland;2022;23291;4825;13023;5443;20253;1811;721;1090;1227;593;634;161;87;74;88;40;48;286;96;190;142;42;100;550;328;222;233.0;253.0;68.0;74.0;510.0;618.0;1774
3417;Dinkelland;2023;23156;4707;12897;5552;20070;1832;741;1091;1254;611;643;167;88;79;90;43;47;287;98;189;148;44;104;562;338;224;240.0;250.0;63.0;83.0;478.0;599.0;1774
3418;Dinkelland;2024;23010;4559;12788;5663;19883;1815;736;1079;1312;641;671;173;91;82;97;47;50;297;100;197;157;51;106;588;352;236;240.0;254.0;65.0;69.0;560.0;596.0;1774
3419;Dinkelland;2025;22958;4536;12661;5761;19755;1855;754;1101;1348;652;696;179;93;86;101;49;52;314;101;213;162;55;107;592;354;238;;;;;;;1774
3420;Dirksland;2008;8244;2238;4844;1162;7852;237;101;136;155;87;68;31;17;14;11;6;5;20;8;12;9;4;5;84;52;32;109.0;78.0;16.0;27.0;315.0;333.0;504
3421;Dirksland;2009;8248;2230;4829;1189;7808;253;107;146;187;106;81;37;20;17;15;10;5;22;10;12;13;3;10;100;63;37;108.0;75.0;29.0;25.0;362.0;343.0;504
3422;Dirksland;2010;8307;2226;4848;1233;7797;270;114;156;240;127;113;42;19;23;19;11;8;33;15;18;24;10;14;122;72;50;108.0;76.0;20.0;26.0;310.0;360.0;504
3423;Dirksland;2011;8284;2202;4832;1250;7728;289;126;163;267;138;129;42;19;23;20;9;11;42;25;17;28;9;19;135;76;59;105.0;77.0;24.0;29.0;287.0;341.0;504
3424;Dirksland;2012;8254;2176;4771;1307;7659;299;130;169;296;156;140;46;21;25;23;11;12;51;31;20;34;12;22;142;81;61;98.0;75.0;18.0;28.0;267.0;323.0;504
3425;Dirksland;2013;8212;2147;4698;1367;7596;299;129;170;317;161;156;51;26;25;30;13;17;55;32;23;34;10;24;147;80;67;99.0;74.0;29.0;27.0;364.0;340.0;504
3426;Dirksland;2014;8265;2127;4713;1425;7588;321;141;180;356;177;179;57;29;28;32;13;19;65;34;31;43;12;31;159;89;70;98.0;77.0;20.0;24.0;294.0;338.0;504
3427;Dirksland;2015;8239;2089;4693;1457;7544;332;143;189;363;181;182;55;28;27;33;12;21;70;37;33;39;11;28;166;93;73;101.0;76.0;23.0;26.0;315.0;330.0;504
3428;Dirksland;2016;8247;2061;4683;1503;7520;348;152;196;379;189;190;59;29;30;36;14;22;74;38;36;38;12;26;172;96;76;96.0;75.0;17.0;27.0;295.0;332.0;504
3429;Dirksland;2017;8222;2026;4666;1530;7472;361;161;200;389;183;206;60;27;33;35;14;21;83;38;45;43;14;29;168;90;78;99.0;76.0;31.0;25.0;296.0;341.0;504
3430;Dirksland;2018;8206;2003;4642;1561;7413;373;171;202;420;196;224;65;29;36;40;14;26;83;41;42;46;14;32;186;98;88;95.0;76.0;23.0;25.0;264.0;338.0;504
3431;Dirksland;2019;8150;1955;4572;1623;7346;378;171;207;426;193;233;64;28;36;42;14;28;90;41;49;44;14;30;186;96;90;94.0;81.0;25.0;23.0;344.0;328.0;504
3432;Dirksland;2020;8182;1966;4569;1647;7346;386;171;215;450;199;251;71;29;42;44;17;27;97;41;56;51;16;35;187;96;91;97.0;80.0;19.0;25.0;311.0;342.0;504
3433;Dirksland;2021;8162;1933;4549;1680;7320;385;173;212;457;211;246;68;29;39;50;22;28;106;45;61;49;17;32;184;98;86;97.0;84.0;20.0;26.0;292.0;343.0;504
3434;Dirksland;2022;8119;1894;4510;1715;7276;388;178;210;455;215;240;61;27;34;49;23;26;112;52;60;49;16;33;184;97;87;95.0;81.0;18.0;24.0;353.0;329.0;504
3435;Dirksland;2023;8152;1880;4523;1749;7273;401;179;222;478;223;255;68;31;37;51;26;25;113;51;62;54;16;38;192;99;93;95.0;86.0;19.0;24.0;323.0;334.0;504
3436;Dirksland;2024;8146;1867;4490;1789;7247;406;175;231;493;227;266;67;29;38;54;25;29;117;52;65;58;18;40;197;103;94;97.0;85.0;21.0;22.0;294.0;334.0;504
3437;Dirksland;2025;8118;1848;4448;1822;7195;410;170;240;513;246;267;75;34;41;55;26;29;115;53;62;60;19;41;208;114;94;;;;;;;504
3438;Doesburg;2008;11636;2803;7105;1728;9489;1079;369;710;1068;608;460;127;66;61;26;15;11;722;413;309;32;12;20;161;102;59;113.0;94.0;40.0;58.0;603.0;530.0;221
3439;Doesburg;2009;11712;2820;7101;1791;9556;1074;358;716;1082;600;482;133;67;66;26;16;10;717;404;313;38;13;25;168;100;68;118.0;101.0;42.0;55.0;541.0;550.0;221
3440;Doesburg;2010;11709;2761;7073;1875;9564;1058;350;708;1087;600;487;136;66;70;33;22;11;699;390;309;40;13;27;179;109;70;112.0;101.0;46.0;54.0;536.0;557.0;221
3441;Doesburg;2011;11694;2694;7074;1926;9589;1041;347;694;1064;579;485;129;61;68;34;24;10;679;375;304;46;15;31;176;104;72;112.0;108.0;47.0;59.0;616.0;543.0;221
3442;Doesburg;2012;11761;2657;7045;2059;9650;1034;351;683;1077;596;481;132;64;68;33;23;10;673;376;297;55;20;35;184;113;71;106.0;107.0;46.0;54.0;582.0;560.0;221
3443;Doesburg;2013;11775;2602;6989;2184;9674;1020;343;677;1081;596;485;137;65;72;36;25;11;656;366;290;67;24;43;185;116;69;107.0;114.0;56.0;50.0;558.0;558.0;221
3444;Doesburg;2014;11776;2542;6960;2274;9684;1012;338;674;1080;595;485;135;69;66;34;22;12;633;357;276;73;25;48;205;122;83;107.0;112.0;43.0;54.0;499.0;549.0;221
3445;Doesburg;2015;11713;2467;6902;2344;9641;995;330;665;1077;591;486;134;71;63;36;26;10;629;354;275;82;26;56;196;114;82;104.0;113.0;42.0;52.0;607.0;568.0;221
3446;Doesburg;2016;11734;2422;6911;2401;9655;976;313;663;1103;611;492;140;75;65;39;29;10;623;353;270;91;26;65;210;128;82;106.0;121.0;42.0;53.0;625.0;567.0;221
3447;Doesburg;2017;11766;2387;6911;2468;9681;971;318;653;1114;614;500;140;74;66;46;36;10;612;345;267;105;30;75;211;129;82;110.0;126.0;45.0;53.0;675.0;594.0;221
3448;Doesburg;2018;11824;2363;6920;2541;9718;966;319;647;1140;613;527;141;75;66;48;34;14;607;336;271;109;30;79;235;138;97;109.0;124.0;47.0;48.0;643.0;592.0;221
3449;Doesburg;2019;11859;2331;6924;2604;9747;980;322;658;1132;616;516;148;84;64;47;35;12;584;333;251;123;34;89;230;130;100;110.0;131.0;46.0;50.0;655.0;574.0;221
3450;Doesburg;2020;11916;2312;6932;2672;9820;945;316;629;1151;617;534;143;83;60;52;37;15;576;323;253;130;33;97;250;141;109;113.0;132.0;45.0;48.0;630.0;574.0;221
3451;Doesburg;2021;11953;2272;6965;2716;9852;940;316;624;1161;615;546;143;82;61;55;40;15;583;328;255;137;29;108;243;136;107;115.0;135.0;42.0;48.0;612.0;594.0;221
3452;Doesburg;2022;11945;2247;6949;2749;9822;945;316;629;1178;615;563;143;82;61;55;37;18;581;319;262;137;28;109;262;149;113;111.0;136.0;41.0;47.0;637.0;581.0;221
3453;Doesburg;2023;11971;2232;6915;2824;9835;951;317;634;1185;615;570;142;83;59;63;39;24;568;311;257;150;33;117;262;149;113;118.0;142.0;42.0;51.0;665.0;588.0;221
3454;Doesburg;2024;12017;2236;6919;2862;9880;948;324;624;1189;611;578;137;81;56;68;44;24;557;301;256;156;31;125;271;154;117;112.0;141.0;40.0;49.0;648.0;563.0;221
3455;Doesburg;2025;12066;2238;6903;2925;9926;930;325;605;1210;619;591;140;82;58;80;51;29;560;296;264;155;31;124;275;159;116;;;;;;;221
3456;Doetinchem;2008;56286;13707;33966;8613;48828;4186;1454;2732;3272;1933;1339;194;89;105;189;101;88;1550;815;735;165;77;88;1174;851;323;548.0;476.0;196.0;341.0;2235.0;2335.0;222
3457;Doetinchem;2009;56127;13493;33878;8756;48637;4177;1465;2712;3313;1953;1360;229;109;120;209;114;95;1532;812;720;177;82;95;1166;836;330;536.0;486.0;181.0;332.0;2215.0;2373.0;222
3458;Doetinchem;2010;55876;13241;33694;8941;48422;4118;1446;2672;3336;1941;1395;255;122;133;219;122;97;1530;811;719;200;87;113;1132;799;333;518.0;502.0;196.0;319.0;2281.0;2360.0;222
3459;Doetinchem;2011;55697;13025;33604;9068;48230;4117;1444;2673;3350;1935;1415;272;130;142;236;131;105;1534;817;717;225;100;125;1083;757;326;510.0;504.0;191.0;311.0;2270.0;2369.0;222
3460;Doetinchem;2012;55489;12807;33271;9411;48014;4090;1445;2645;3385;1921;1464;295;135;160;262;144;118;1509;795;714;245;107;138;1074;740;334;490.0;518.0;194.0;287.0;2180.0;2361.0;222
3461;Doetinchem;2013;55193;12464;32986;9743;47751;4027;1432;2595;3415;1932;1483;306;147;159;289;162;127;1489;777;712;276;123;153;1055;723;332;483.0;523.0;196.0;283.0;2288.0;2361.0;222
3462;Doetinchem;2014;54999;12246;32659;10094;47546;4005;1430;2575;3448;1928;1520;329;150;179;301;167;134;1471;769;702;292;130;162;1055;712;343;473.0;527.0;185.0;280.0;2161.0;2354.0;222
3463;Doetinchem;2015;54663;12013;32314;10336;47251;3924;1373;2551;3488;1938;1550;342;157;185;315;171;144;1463;755;708;299;133;166;1069;722;347;470.0;531.0;172.0;274.0;2325.0;2351.0;222
3464;Doetinchem;2016;54479;11796;32086;10597;47068;3903;1370;2533;3508;1948;1560;355;162;193;326;178;148;1456;758;698;320;149;171;1051;701;350;458.0;544.0;179.0;261.0;2245.0;2348.0;222
3465;Doetinchem;2017;54214;11603;31773;10838;46751;3843;1355;2488;3620;2008;1612;382;176;206;349;189;160;1444;752;692;338;151;187;1107;740;367;464.0;548.0;176.0;273.0;2381.0;2324.0;222
3466;Doetinchem;2018;54095;11453;31573;11069;46564;3803;1357;2446;3728;2047;1681;408;186;222;376;208;168;1455;753;702;358;160;198;1131;740;391;480.0;549.0;169.0;255.0;2261.0;2337.0;222
3467;Doetinchem;2019;53869;11188;31405;11276;46344;3793;1360;2433;3732;2022;1710;423;194;229;393;210;183;1454;755;699;372;168;204;1090;695;395;470.0;558.0;167.0;258.0;2193.0;2340.0;222
3468;Doetinchem;2020;53548;10902;31131;11515;45967;3756;1352;2404;3825;2061;1764;434;205;229;407;212;195;1448;753;695;390;174;216;1146;717;429;474.0;566.0;161.0;254.0;2276.0;2292.0;222
3469;Doetinchem;2021;53352;10659;30927;11766;45740;3733;1347;2386;3879;2093;1786;452;217;235;411;218;193;1430;742;688;409;186;223;1177;730;447;473.0;575.0;170.0;242.0;2336.0;2290.0;222
3470;Doetinchem;2022;53236;10484;30740;12012;45565;3721;1367;2354;3950;2142;1808;475;224;251;430;222;208;1417;749;668;423;187;236;1205;760;445;485.0;585.0;173.0;247.0;2315.0;2291.0;222
3471;Doetinchem;2023;53092;10354;30473;12265;45383;3685;1357;2328;4024;2165;1859;495;228;267;451;228;223;1405;739;666;451;197;254;1222;773;449;492.0;596.0;172.0;246.0;2313.0;2306.0;222
3472;Doetinchem;2024;52926;10183;30245;12498;45135;3654;1353;2301;4137;2222;1915;525;251;274;466;237;229;1416;746;670;471;202;269;1259;786;473;493.0;600.0;163.0;231.0;2405.0;2297.0;222
3473;Doetinchem;2025;52864;10076;30098;12690;45081;3646;1352;2294;4137;2202;1935;525;251;274;473;235;238;1436;748;688;485;203;282;1218;765;453;;;;;;;222
3474;Dongen;2008;25550;6179;15643;3728;22216;1581;674;907;1753;1139;614;146;79;67;94;59;35;764;417;347;59;34;25;690;550;140;236.0;209.0;127.0;147.0;749.0;792.0;766
3475;Dongen;2009;25515;6111;15550;3854;22122;1582;681;901;1811;1182;629;158;87;71;100;62;38;754;409;345;72;47;25;727;577;150;232.0;215.0;129.0;147.0;825.0;823.0;766
3476;Dongen;2010;25522;6035;15521;3966;22077;1587;688;899;1858;1212;646;169;94;75;98;60;38;743;408;335;89;53;36;759;597;162;232.0;221.0;137.0;142.0;837.0;850.0;766
3477;Dongen;2011;25519;5968;15468;4083;21964;1623;714;909;1932;1248;684;181;104;77;107;67;40;739;399;340;98;56;42;807;622;185;230.0;225.0;138.0;151.0;945.0;895.0;766
3478;Dongen;2012;25563;5880;15422;4261;21911;1648;727;921;2004;1284;720;184;107;77;113;72;41;741;403;338;121;64;57;845;638;207;226.0;221.0;150.0;149.0;924.0;890.0;766
3479;Dongen;2013;25606;5803;15358;4445;21856;1677;749;928;2073;1310;763;205;121;84;120;77;43;749;403;346;132;70;62;867;639;228;229.0;230.0;141.0;143.0;913.0;886.0;766
3480;Dongen;2014;25634;5711;15269;4654;21802;1706;764;942;2126;1334;792;217;129;88;118;73;45;752;401;351;145;80;65;894;651;243;228.0;235.0;146.0;143.0;932.0;900.0;766
3481;Dongen;2015;25666;5623;15236;4807;21753;1701;761;940;2212;1380;832;223;132;91;118;72;46;752;403;349;165;92;73;954;681;273;229.0;234.0;144.0;146.0;894.0;910.0;766
3482;Dongen;2016;25644;5537;15147;4960;21636;1726;789;937;2282;1418;864;232;137;95;123;73;50;747;401;346;180;96;84;1000;711;289;233.0;246.0;147.0;145.0;957.0;888.0;766
3483;Dongen;2017;25707;5438;15136;5133;21639;1718;791;927;2350;1444;906;239;145;94;129;77;52;745;395;350;193;104;89;1044;723;321;236.0;252.0;172.0;146.0;950.0;922.0;766
3484;Dongen;2018;25753;5397;15087;5269;21629;1751;826;925;2373;1431;942;245;144;101;130;75;55;746;386;360;210;109;101;1042;717;325;237.0;260.0;166.0;137.0;924.0;941.0;766
3485;Dongen;2019;25739;5342;15006;5391;21524;1783;858;925;2432;1481;951;253;149;104;125;75;50;736;392;344;216;109;107;1102;756;346;239.0;261.0;161.0;140.0;952.0;929.0;766
3486;Dongen;2020;25763;5297;14957;5509;21476;1808;877;931;2479;1500;979;259;151;108;130;78;52;728;382;346;216;109;107;1146;780;366;249.0;270.0;149.0;146.0;1020.0;944.0;766
3487;Dongen;2021;25823;5242;14956;5625;21454;1844;903;941;2525;1512;1013;264;156;108;126;78;48;730;378;352;233;116;117;1172;784;388;252.0;273.0;158.0;142.0;952.0;963.0;766
3488;Dongen;2022;25808;5182;14895;5731;21391;1881;930;951;2536;1523;1013;262;159;103;132;83;49;719;378;341;237;120;117;1186;783;403;253.0;273.0;151.0;142.0;961.0;939.0;766
3489;Dongen;2023;25824;5131;14850;5843;21324;1915;953;962;2585;1533;1052;267;164;103;138;84;54;725;383;342;243;121;122;1212;781;431;257.0;285.0;155.0;138.0;933.0;939.0;766
3490;Dongen;2024;25807;5094;14791;5922;21249;1917;965;952;2641;1576;1065;278;170;108;142;85;57;723;391;332;243;123;120;1255;807;448;258.0;288.0;154.0;132.0;983.0;935.0;766
3491;Dongen;2025;25849;5091;14711;6047;21214;1919;968;951;2716;1614;1102;282;174;108;148;86;62;722;386;336;259;129;130;1305;839;466;;;;;;;766
3492;Dongeradeel;2008;24983;6486;14476;4021;23012;1059;510;549;912;612;300;67;31;36;58;27;31;57;35;22;35;15;20;695;504;191;293.0;209.0;77.0;125.0;914.0;998.0;58
3493;Dongeradeel;2009;24939;6411;14429;4099;22934;1055;490;565;950;624;326;71;36;35;58;30;28;73;43;30;48;22;26;700;493;207;284.0;213.0;77.0;121.0;958.0;994.0;58
3494;Dongeradeel;2010;24936;6358;14389;4189;22883;1064;493;571;989;642;347;72;37;35;63;34;29;88;52;36;59;30;29;707;489;218;284.0;217.0;93.0;119.0;936.0;1018.0;58
3495;Dongeradeel;2011;24895;6308;14346;4241;22764;1090;502;588;1041;649;392;86;45;41;69;37;32;109;57;52;68;36;32;709;474;235;289.0;220.0;85.0;121.0;893.0;1018.0;58
3496;Dongeradeel;2012;24806;6207;14247;4352;22625;1109;504;605;1072;649;423;94;47;47;76;39;37;109;50;59;75;40;35;718;473;245;278.0;217.0;83.0;121.0;900.0;996.0;58
3497;Dongeradeel;2013;24735;6109;14138;4488;22488;1118;490;628;1129;674;455;91;50;41;80;41;39;120;54;66;87;40;47;751;489;262;278.0;221.0;97.0;118.0;891.0;1006.0;58
3498;Dongeradeel;2014;24658;6041;14064;4553;22325;1150;501;649;1183;696;487;98;54;44;83;45;38;139;60;79;98;47;51;765;490;275;274.0;223.0;87.0;119.0;911.0;978.0;58
3499;Dongeradeel;2015;24614;6007;13980;4627;22233;1145;486;659;1236;721;515;103;57;46;94;53;41;145;62;83;113;54;59;781;495;286;275.0;226.0;84.0;115.0;930.0;975.0;58
3500;Dongeradeel;2016;24591;5997;13877;4717;22165;1156;493;663;1270;736;534;111;62;49;96;56;40;154;69;85;126;61;65;783;488;295;275.0;229.0;86.0;111.0;858.0;984.0;58
3501;Dongeradeel;2017;24489;5907;13804;4778;21986;1177;502;675;1326;767;559;119;73;46;90;55;35;156;68;88;143;69;74;818;502;316;271.0;229.0;83.0;112.0;886.0;958.0;58
3502;Dongeradeel;2018;24431;5896;13681;4854;21837;1197;499;698;1397;790;607;128;76;52;96;60;36;173;76;97;165;75;90;835;503;332;273.0;225.0;91.0;117.0;888.0;946.0;58
3503;Dongeradeel;2019;24397;5875;13557;4965;21733;1210;500;710;1454;819;635;137;78;59;109;73;36;177;81;96;167;76;91;864;511;353;266.0;235.0;87.0;115.0;903.0;973.0;58
3504;Dongeradeel;2020;24332;5799;13472;5061;21633;1211;491;720;1488;830;658;138;76;62;117;79;38;193;88;105;179;81;98;861;506;355;269.0;238.0;90.0;120.0;896.0;970.0;58
3505;Dongeradeel;2021;24260;5705;13378;5177;21529;1206;484;722;1525;839;686;141;77;64;128;84;44;200;86;114;181;84;97;875;508;367;273.0;236.0;87.0;114.0;871.0;987.0;58
3506;Dongeradeel;2022;24154;5625;13213;5316;21414;1192;474;718;1548;838;710;139;75;64;124;78;46;212;92;120;190;87;103;883;506;377;269.0;243.0;87.0;115.0;920.0;969.0;58
3507;Dongeradeel;2023;24107;5576;13138;5393;21316;1199;474;725;1592;858;734;145;80;65;125;85;40;219;93;126;190;86;104;913;514;399;275.0;249.0;86.0;101.0;852.0;989.0;58
3508;Dongeradeel;2024;23982;5544;12982;5456;21181;1192;482;710;1609;858;751;148;84;64;123;86;37;219;96;123;200;90;110;919;502;417;272.0;254.0;89.0;107.0;934.0;959.0;58
3509;Dongeradeel;2025;23959;5547;12893;5519;21082;1197;480;717;1680;887;793;146;83;63;129;93;36;228;104;124;222;97;125;955;510;445;;;;;;;58
3510;Dordrecht;2008;118103;28643;72128;17332;86727;11689;4967;6722;19687;11187;8500;2664;1460;1204;3012;1985;1027;6022;3030;2992;2696;1345;1351;5293;3367;1926;1300.0;1069.0;682.0;856.0;3129.0;3237.0;505
3511;Dordrecht;2009;118072;28575;71907;17590;86528;11758;4994;6764;19786;11108;8678;2661;1442;1219;3006;1954;1052;5996;3008;2988;2794;1396;1398;5329;3308;2021;1283.0;1079.0;743.0;847.0;3070.0;3227.0;505
3512;Dordrecht;2010;118027;28451;71652;17924;86289;11799;5015;6784;19939;11064;8875;2674;1432;1242;3004;1933;1071;5962;2980;2982;2878;1415;1463;5421;3304;2117;1265.0;1080.0;763.0;831.0;3052.0;3190.0;505
3513;Dordrecht;2011;118019;28268;71656;18095;86136;11871;5089;6782;20012;11001;9011;2692;1405;1287;2982;1903;1079;5915;2958;2957;2955;1443;1512;5468;3292;2176;1233.0;1086.0;781.0;815.0;3393.0;3179.0;505
3514;Dordrecht;2012;118353;28154;71297;18902;86195;11946;5131;6815;20212;11011;9201;2698;1408;1290;3008;1875;1133;5888;2947;2941;3055;1476;1579;5563;3305;2258;1232.0;1103.0;803.0;798.0;3335.0;3193.0;505
3515;Dordrecht;2013;118643;28048;70944;19651;86176;12066;5204;6862;20401;11034;9367;2705;1416;1289;2998;1848;1150;5913;2953;2960;3161;1510;1651;5624;3307;2317;1237.0;1111.0;780.0;792.0;3285.0;3147.0;505
3516;Dordrecht;2014;118906;27988;70746;20172;86150;12181;5249;6932;20575;11071;9504;2736;1421;1315;3003;1836;1167;5866;2938;2928;3254;1540;1714;5716;3336;2380;1228.0;1095.0;761.0;786.0;3357.0;3123.0;505
3517;Dordrecht;2015;119263;27871;70700;20692;86250;12311;5346;6965;20702;11023;9679;2728;1405;1323;2985;1793;1192;5814;2928;2886;3327;1553;1774;5848;3344;2504;1229.0;1111.0;779.0;765.0;3317.0;3085.0;505
3518;Dordrecht;2016;119643;27739;70671;21233;86368;12444;5398;7046;20831;10953;9878;2736;1378;1358;2983;1767;1216;5759;2892;2867;3450;1579;1871;5903;3337;2566;1240.0;1127.0;741.0;761.0;2902.0;3150.0;505
3519;Dordrecht;2017;119497;27580;70320;21597;86061;12556;5469;7087;20880;10906;9974;2733;1364;1369;3004;1761;1243;5708;2871;2837;3523;1601;1922;5912;3309;2603;1216.0;1146.0;761.0;752.0;2924.0;3132.0;505
3520;Dordrecht;2018;119380;27382;70026;21972;85767;12672;5536;7136;20941;10906;10035;2729;1352;1377;2991;1733;1258;5656;2858;2798;3578;1622;1956;5987;3341;2646;1235.0;1152.0;742.0;729.0;3060.0;3111.0;505
3521;Dordrecht;2019;119440;27144;69934;22362;85654;12724;5573;7151;21062;10921;10141;2708;1333;1375;2999;1725;1274;5620;2836;2784;3671;1652;2019;6064;3375;2689;1240.0;1150.0;732.0;714.0;2634.0;3155.0;505
3522;Dordrecht;2020;119039;26849;69444;22746;85281;12738;5613;7125;21020;10891;10129;2686;1320;1366;2984;1692;1292;5546;2825;2721;3669;1651;2018;6135;3403;2732;1221.0;1157.0;743.0;713.0;2774.0;3140.0;505
3523;Dordrecht;2021;118782;26507;69215;23060;84902;12769;5651;7118;21111;10969;10142;2686;1330;1356;3005;1697;1308;5475;2808;2667;3725;1669;2056;6220;3465;2755;1220.0;1177.0;725.0;711.0;2970.0;3146.0;505
3524;Dordrecht;2022;118669;26240;68922;23507;84668;12802;5685;7117;21199;11011;10188;2703;1349;1354;3005;1675;1330;5446;2798;2648;3760;1689;2071;6285;3500;2785;1251.0;1198.0;716.0;696.0;2871.0;3119.0;505
3525;Dordrecht;2023;118503;25948;68687;23868;84383;12875;5735;7140;21245;11018;10227;2703;1328;1375;2998;1669;1329;5386;2777;2609;3812;1708;2104;6346;3536;2810;1253.0;1189.0;686.0;689.0;2754.0;3077.0;505
3526;Dordrecht;2024;118248;25606;68414;24228;84155;12916;5770;7146;21177;10945;10232;2707;1325;1382;2974;1655;1319;5319;2750;2569;3820;1704;2116;6357;3511;2846;1255.0;1225.0;696.0;655.0;2936.0;3104.0;505
3527;Dordrecht;2025;118164;25447;68148;24569;83954;12995;5832;7163;21215;10973;10242;2724;1337;1387;2977;1643;1334;5255;2750;2505;3855;1733;2122;6404;3510;2894;;;;;;;505
3528;Drechterland;2008;18783;4821;11476;2486;17389;930;368;562;464;263;201;78;37;41;45;16;29;30;18;12;33;15;18;278;177;101;197.0;110.0;52.0;75.0;870.0;786.0;498
3529;Drechterland;2009;18933;4763;11547;2623;17473;948;366;582;512;292;220;79;37;42;46;18;28;44;23;21;44;23;21;299;191;108;191.0;114.0;55.0;75.0;776.0;819.0;498
3530;Drechterland;2010;18949;4657;11539;2753;17437;961;357;604;551;309;242;89;41;48;49;24;25;47;23;24;61;31;30;305;190;115;191.0;118.0;63.0;80.0;781.0;813.0;498
3531;Drechterland;2011;18973;4574;11516;2883;17432;973;361;612;568;318;250;96;44;52;50;23;27;51;25;26;64;34;30;307;192;115;189.0;121.0;59.0;74.0;830.0;832.0;498
3532;Drechterland;2012;19027;4509;11424;3094;17428;975;362;613;624;337;287;110;51;59;52;22;30;61;30;31;82;40;42;319;194;125;186.0;124.0;58.0;73.0;860.0;828.0;498
3533;Drechterland;2013;19108;4441;11369;3298;17448;977;358;619;683;361;322;122;57;65;53;23;30;75;33;42;89;40;49;344;208;136;191.0;130.0;61.0;69.0;812.0;811.0;498
3534;Drechterland;2014;19164;4359;11320;3485;17441;1008;368;640;715;379;336;126;57;69;53;24;29;95;40;55;91;43;48;350;215;135;191.0;139.0;58.0;74.0;845.0;828.0;498
3535;Drechterland;2015;19218;4269;11293;3656;17430;1028;387;641;760;391;369;129;52;77;51;25;26;95;40;55;102;46;56;383;228;155;192.0;138.0;54.0;71.0;761.0;829.0;498
3536;Drechterland;2016;19189;4197;11204;3788;17361;1042;379;663;786;401;385;132;57;75;56;25;31;102;39;63;107;46;61;389;234;155;188.0;137.0;60.0;78.0;851.0;811.0;498
3537;Drechterland;2017;19264;4143;11192;3929;17388;1049;384;665;827;413;414;139;59;80;63;28;35;105;36;69;126;54;72;394;236;158;193.0;148.0;52.0;74.0;858.0;838.0;498
3538;Drechterland;2018;19308;4130;11096;4082;17384;1062;382;680;862;431;431;136;61;75;69;31;38;105;35;70;143;62;81;409;242;167;189.0;149.0;50.0;77.0;857.0;825.0;498
3539;Drechterland;2019;19355;4051;11091;4213;17395;1045;374;671;915;446;469;137;62;75;73;34;39;118;43;75;154;62;92;433;245;188;196.0;156.0;58.0;71.0;903.0;853.0;498
3540;Drechterland;2020;19436;3987;11111;4338;17421;1069;393;676;946;458;488;140;66;74;81;37;44;128;49;79;151;58;93;446;248;198;204.0;155.0;59.0;75.0;902.0;850.0;498
3541;Drechterland;2021;19523;3948;11092;4483;17458;1102;415;687;963;466;497;140;69;71;82;37;45;136;56;80;161;60;101;444;244;200;199.0;164.0;58.0;74.0;907.0;830.0;498
3542;Drechterland;2022;19622;3934;11073;4615;17507;1105;411;694;1010;478;532;157;78;79;86;40;46;150;57;93;168;65;103;449;238;211;205.0;170.0;54.0;74.0;871.0;856.0;498
3543;Drechterland;2023;19654;3895;11030;4729;17499;1134;410;724;1021;476;545;159;77;82;80;35;45;162;59;103;179;67;112;441;238;203;210.0;169.0;57.0;72.0;880.0;857.0;498
3544;Drechterland;2024;19705;3885;10978;4842;17508;1149;413;736;1048;490;558;161;80;81;86;40;46;163;60;103;182;66;116;456;244;212;207.0;181.0;53.0;71.0;953.0;845.0;498
3545;Drechterland;2025;19822;3878;10991;4953;17556;1173;424;749;1093;500;593;165;82;83;90;41;49;170;62;108;194;67;127;474;248;226;;;;;;;498
3546;Drimmelen;2008;26323;6280;16120;3923;24541;1228;398;830;554;327;227;43;20;23;48;23;25;86;44;42;56;26;30;321;214;107;189.0;217.0;76.0;121.0;503.0;645.0;1719
3547;Drimmelen;2009;26112;6126;15934;4052;24287;1234;407;827;591;342;249;50;25;25;50;25;25;102;52;50;60;28;32;329;212;117;188.0;214.0;85.0;114.0;679.0;686.0;1719
3548;Drimmelen;2010;26050;6005;15823;4222;24130;1270;421;849;650;378;272;68;33;35;49;27;22;117;65;52;71;31;40;345;222;123;188.0;224.0;88.0;116.0;653.0;692.0;1719
3549;Drimmelen;2011;25951;5850;15720;4381;23932;1303;438;865;716;397;319;82;36;46;55;25;30;134;70;64;78;33;45;367;233;134;183.0;226.0;97.0;122.0;642.0;723.0;1719
3550;Drimmelen;2012;25802;5717;15483;4602;23689;1325;441;884;788;426;362;93;39;54;58;26;32;150;75;75;86;33;53;401;253;148;180.0;236.0;106.0;118.0;630.0;734.0;1719
3551;Drimmelen;2013;25635;5559;15274;4802;23448;1361;473;888;826;443;383;92;41;51;57;27;30;158;78;80;91;37;54;428;260;168;183.0;232.0;99.0;104.0;627.0;740.0;1719
3552;Drimmelen;2014;25470;5434;15041;4995;23211;1385;497;888;874;464;410;104;47;57;67;35;32;162;81;81;103;43;60;438;258;180;185.0;239.0;106.0;111.0;637.0;739.0;1719
3553;Drimmelen;2015;25312;5315;14815;5182;22983;1401;505;896;928;494;434;116;54;62;73;37;36;170;85;85;107;45;62;462;273;189;183.0;246.0;101.0;106.0;725.0;731.0;1719
3554;Drimmelen;2016;25242;5224;14636;5382;22856;1407;498;909;979;496;483;133;63;70;74;33;41;175;86;89;124;49;75;473;265;208;184.0;251.0;104.0;105.0;663.0;717.0;1719
3555;Drimmelen;2017;25121;5092;14503;5526;22651;1436;504;932;1034;515;519;139;64;75;85;42;43;181;84;97;132;51;81;497;274;223;188.0;259.0;99.0;111.0;706.0;725.0;1719
3556;Drimmelen;2018;25023;5028;14344;5651;22487;1441;510;931;1095;538;557;142;70;72;92;43;49;190;91;99;137;52;85;534;282;252;192.0;255.0;92.0;107.0;782.0;721.0;1719
3557;Drimmelen;2019;25010;4928;14308;5774;22421;1459;532;927;1130;548;582;140;70;70;96;47;49;200;92;108;144;54;90;550;285;265;192.0;272.0;100.0;103.0;692.0;745.0;1719
3558;Drimmelen;2020;24876;4822;14161;5893;22224;1458;529;929;1194;566;628;147;74;73;97;48;49;214;96;118;155;58;97;581;290;291;199.0;271.0;94.0;106.0;623.0;716.0;1719
3559;Drimmelen;2021;24700;4696;13999;6005;21961;1467;538;929;1272;595;677;155;78;77;110;57;53;222;100;122;162;58;104;623;302;321;193.0;268.0;88.0;109.0;768.0;738.0;1719
3560;Drimmelen;2022;24637;4630;13899;6108;21842;1474;536;938;1321;628;693;169;87;82;119;63;56;225;108;117;166;58;108;642;312;330;200.0;279.0;93.0;102.0;772.0;760.0;1719
3561;Drimmelen;2023;24563;4526;13779;6258;21689;1508;554;954;1366;645;721;169;88;81;130;71;59;229;110;119;183;63;120;655;313;342;200.0;288.0;103.0;104.0;745.0;730.0;1719
3562;Drimmelen;2024;24493;4466;13676;6351;21553;1518;559;959;1422;661;761;184;97;87;134;70;64;246;118;128;186;67;119;672;309;363;203.0;292.0;94.0;101.0;805.0;727.0;1719
3563;Drimmelen;2025;24477;4460;13545;6472;21462;1524;559;965;1491;688;803;189;96;93;142;68;74;251;122;129;198;71;127;711;331;380;;;;;;;1719
3564;Dronten;2008;39000;10610;23444;4946;33344;2598;1080;1518;3058;1904;1154;348;146;202;163;81;82;559;308;251;472;228;244;1516;1141;375;445.0;224.0;629.0;356.0;2041.0;2158.0;303
3565;Dronten;2009;39381;10473;23717;5191;33545;2596;1064;1532;3240;2035;1205;368;157;211;162;83;79;567;305;262;460;225;235;1683;1265;418;446.0;238.0;691.0;362.0;1916.0;2131.0;303
3566;Dronten;2010;39709;10373;23866;5470;33623;2602;1038;1564;3484;2225;1259;389;172;217;182;91;91;578;309;269;456;224;232;1879;1429;450;449.0;252.0;716.0;360.0;1823.0;2174.0;303
3567;Dronten;2011;39913;10231;24030;5652;33612;2594;1033;1561;3707;2384;1323;399;180;219;201;106;95;603;317;286;472;232;240;2032;1549;483;450.0;258.0;746.0;372.0;1794.0;2121.0;303
3568;Dronten;2012;40152;10084;24088;5980;33638;2591;1039;1552;3923;2536;1387;408;189;219;213;114;99;612;333;279;470;228;242;2220;1672;548;446.0;272.0;798.0;381.0;1735.0;2136.0;303
3569;Dronten;2013;40347;9951;24134;6262;33549;2582;1031;1551;4216;2743;1473;426;201;225;225;121;104;621;340;281;481;232;249;2463;1849;614;452.0;273.0;843.0;385.0;1849.0;2148.0;303
3570;Dronten;2014;40690;9915;24247;6528;33565;2643;1066;1577;4482;2923;1559;461;221;240;240;127;113;631;341;290;505;245;260;2645;1989;656;460.0;286.0;867.0;386.0;1779.0;2181.0;303
3571;Dronten;2015;40946;9821;24351;6774;33561;2667;1074;1593;4718;3082;1636;480;237;243;259;134;125;629;336;293;524;252;272;2826;2123;703;462.0;295.0;881.0;394.0;1765.0;2129.0;303
3572;Dronten;2016;41241;9817;24455;6969;33516;2710;1118;1592;5015;3291;1724;521;253;268;261;136;125;649;359;290;516;248;268;3068;2295;773;464.0;313.0;908.0;393.0;1830.0;2158.0;303
3573;Dronten;2017;41585;9787;24614;7184;33540;2757;1151;1606;5288;3490;1798;529;265;264;279;148;131;675;375;300;524;242;282;3281;2460;821;482.0;311.0;956.0;409.0;1681.0;2190.0;303
3574;Dronten;2018;41799;9717;24640;7442;33422;2796;1175;1621;5581;3683;1898;531;270;261;302;160;142;676;377;299;550;257;293;3522;2619;903;487.0;318.0;975.0;427.0;1582.0;2203.0;303
3575;Dronten;2019;41895;9584;24635;7676;33254;2822;1197;1625;5819;3857;1962;538;282;256;319;168;151;691;380;311;544;255;289;3727;2772;955;494.0;337.0;996.0;416.0;1786.0;2215.0;303
3576;Dronten;2020;42206;9497;24786;7923;33295;2809;1203;1606;6102;4040;2062;550;296;254;339;182;157;710;393;317;561;256;305;3942;2913;1029;502.0;338.0;1029.0;419.0;1627.0;2245.0;303
3577;Dronten;2021;42365;9382;24798;8185;33187;2827;1218;1609;6351;4183;2168;574;307;267;345;186;159;730;395;335;565;257;308;4137;3038;1099;514.0;341.0;1049.0;424.0;1659.0;2257.0;303
3578;Dronten;2022;42566;9315;24824;8427;33068;2860;1225;1635;6638;4350;2288;588;320;268;360;190;170;754;416;338;588;255;333;4348;3169;1179;525.0;348.0;1071.0;428.0;1642.0;2247.0;303
3579;Dronten;2023;42785;9298;24809;8678;32998;2842;1211;1631;6945;4536;2409;613;336;277;376;198;178;782;432;350;577;256;321;4597;3314;1283;538.0;366.0;1118.0;421.0;1629.0;2212.0;303
3580;Dronten;2024;43080;9318;24812;8950;32903;2867;1212;1655;7310;4746;2564;627;349;278;395;212;183;791;433;358;589;261;328;4908;3491;1417;552.0;368.0;1146.0;433.0;1613.0;2168.0;303
3581;Dronten;2025;43426;9352;24826;9248;32805;2935;1251;1684;7686;4982;2704;646;353;293;416;221;195;799;444;355;612;277;335;5213;3687;1526;;;;;;;303
3582;Druten;2008;17968;4644;11081;2243;15968;999;276;723;1001;557;444;87;46;41;73;45;28;491;253;238;55;20;35;295;193;102;181.0;127.0;56.0;79.0;489.0;584.0;225
3583;Druten;2009;17906;4549;11051;2306;15890;998;283;715;1018;567;451;91;49;42;80;48;32;487;256;231;61;21;40;299;193;106;180.0;132.0;58.0;78.0;540.0;601.0;225
3584;Druten;2010;17875;4492;11015;2368;15823;1020;292;728;1032;570;462;96;53;43;85;53;32;486;249;237;69;26;43;296;189;107;174.0;131.0;60.0;81.0;602.0;627.0;225
3585;Druten;2011;17875;4409;11006;2460;15762;1046;309;737;1067;596;471;105;61;44;86;53;33;495;255;240;82;34;48;299;193;106;165.0;136.0;64.0;73.0;673.0;618.0;225
3586;Druten;2012;17952;4363;10988;2601;15786;1066;312;754;1100;616;484;110;67;43;88;54;34;505;264;241;92;40;52;305;191;114;164.0;139.0;63.0;72.0;654.0;630.0;225
3587;Druten;2013;17994;4329;10941;2724;15781;1072;304;768;1141;644;497;120;73;47;95;59;36;497;268;229;107;48;59;322;196;126;163.0;149.0;63.0;74.0;675.0;632.0;225
3588;Druten;2014;18040;4285;10915;2840;15779;1108;329;779;1153;642;511;125;79;46;94;60;34;486;256;230;119;48;71;329;199;130;166.0;149.0;60.0;75.0;601.0;648.0;225
3589;Druten;2015;17997;4197;10867;2933;15730;1111;334;777;1156;641;515;129;81;48;93;60;33;476;255;221;127;50;77;331;195;136;160.0;153.0;61.0;70.0;708.0;647.0;225
3590;Druten;2016;18057;4140;10904;3013;15755;1122;337;785;1180;656;524;130;83;47;98;62;36;474;252;222;136;55;81;342;204;138;164.0;157.0;72.0;76.0;656.0;671.0;225
3591;Druten;2017;18046;4037;10893;3116;15729;1131;358;773;1186;656;530;139;88;51;106;67;39;464;246;218;137;56;81;340;199;141;169.0;160.0;60.0;75.0;656.0;641.0;225
3592;Druten;2018;18057;4006;10838;3213;15700;1139;372;767;1218;671;547;143;91;52;113;68;45;462;244;218;141;61;80;359;207;152;165.0;159.0;58.0;71.0;709.0;636.0;225
3593;Druten;2019;18127;3926;10927;3274;15707;1151;375;776;1269;703;566;150;96;54;119;71;48;475;249;226;155;65;90;370;222;148;169.0;169.0;60.0;69.0;673.0;672.0;225
3594;Druten;2020;18119;3867;10864;3388;15669;1168;388;780;1282;709;573;158;102;56;122;71;51;476;251;225;156;66;90;370;219;151;174.0;174.0;67.0;70.0;694.0;666.0;225
3595;Druten;2021;18144;3802;10894;3448;15661;1174;397;777;1309;722;587;166;108;58;132;76;56;466;246;220;169;71;98;376;221;155;176.0;174.0;68.0;68.0;740.0;681.0;225
3596;Druten;2022;18209;3768;10860;3581;15681;1197;417;780;1331;740;591;170;115;55;132;75;57;456;242;214;185;78;107;388;230;158;187.0;175.0;64.0;73.0;662.0;670.0;225
3597;Druten;2023;18206;3730;10780;3696;15633;1236;428;808;1337;745;592;169;115;54;139;81;58;454;240;214;196;84;112;379;225;154;178.0;179.0;61.0;71.0;684.0;669.0;225
3598;Druten;2024;18212;3719;10685;3808;15596;1258;451;807;1358;754;604;171;113;58;146;86;60;453;243;210;193;83;110;395;229;166;182.0;185.0;57.0;65.0;682.0;658.0;225
3599;Druten;2025;18225;3699;10639;3887;15576;1274;460;814;1375;760;615;170;111;59;152;89;63;450;245;205;199;85;114;404;230;174;;;;;;;225
3600;Duiven;2008;25750;7117;15438;3195;22661;2070;597;1473;1019;561;458;188;92;96;57;36;21;175;67;108;67;36;31;532;330;202;230.0;159.0;80.0;127.0;1270.0;1164.0;226
3601;Duiven;2009;25882;6968;15609;3305;22727;2088;609;1479;1067;573;494;197;95;102;66;44;22;193;78;115;78;40;38;533;316;217;220.0;171.0;88.0;119.0;1288.0;1235.0;226
3602;Duiven;2010;25954;6799;15784;3371;22755;2094;628;1466;1105;592;513;203;99;104;67;40;27;196;81;115;95;48;47;544;324;220;224.0;170.0;95.0;123.0;1099.0;1231.0;226
3603;Duiven;2011;25851;6576;15812;3463;22636;2074;631;1443;1141;593;548;205;100;105;75;46;29;207;84;123;105;51;54;549;312;237;223.0;180.0;95.0;114.0;1160.0;1206.0;226
3604;Duiven;2012;25832;6359;15892;3581;22599;2075;632;1443;1158;598;560;206;100;106;83;49;34;211;84;127;111;52;59;547;313;234;221.0;184.0;97.0;117.0;1073.0;1215.0;226
3605;Duiven;2013;25710;6109;15816;3785;22442;2053;615;1438;1215;633;582;199;99;100;85;51;34;224;96;128;124;57;67;583;330;253;212.0;184.0;103.0;113.0;1123.0;1224.0;226
3606;Duiven;2014;25628;5920;15753;3955;22334;2048;618;1430;1246;646;600;208;105;103;96;54;42;231;94;137;143;70;73;568;323;245;208.0;190.0;101.0;114.0;1046.0;1190.0;226
3607;Duiven;2015;25489;5721;15663;4105;22160;2028;612;1416;1301;687;614;215;113;102;104;56;48;245;100;145;151;78;73;586;340;246;214.0;199.0;88.0;111.0;1031.0;1201.0;226
3608;Duiven;2016;25312;5531;15537;4244;21979;2001;604;1397;1332;703;629;220;117;103;109;59;50;251;103;148;173;86;87;579;338;241;218.0;207.0;92.0;111.0;1023.0;1214.0;226
3609;Duiven;2017;25116;5309;15471;4336;21783;1967;619;1348;1366;732;634;230;125;105;111;59;52;248;105;143;180;88;92;597;355;242;224.0;207.0;94.0;103.0;1084.0;1201.0;226
3610;Duiven;2018;25010;5113;15423;4474;21638;1978;622;1356;1394;743;651;230;127;103;110;56;54;259;111;148;182;89;93;613;360;253;224.0;215.0;92.0;114.0;1128.0;1182.0;226
3611;Duiven;2019;24947;4934;15400;4613;21538;1943;632;1311;1466;775;691;241;131;110;111;59;52;281;119;162;205;99;106;628;367;261;228.0;213.0;91.0;100.0;1118.0;1190.0;226
3612;Duiven;2020;24888;4813;15300;4775;21438;1944;641;1303;1506;807;699;240;132;108;117;61;56;286;121;165;216;105;111;647;388;259;239.0;219.0;93.0;97.0;1035.0;1171.0;226
3613;Duiven;2021;24772;4688;15102;4982;21322;1923;643;1280;1527;812;715;240;132;108;122;64;58;301;129;172;227;106;121;637;381;256;244.0;219.0;89.0;103.0;1114.0;1168.0;226
3614;Duiven;2022;24733;4578;15022;5133;21241;1916;649;1267;1576;835;741;240;132;108;131;69;62;313;127;186;241;121;120;651;386;265;240.0;227.0;84.0;99.0;1214.0;1176.0;226
3615;Duiven;2023;24770;4520;14934;5316;21234;1903;657;1246;1633;861;772;245;133;112;135;66;69;308;127;181;258;125;133;687;410;277;248.0;232.0;88.0;94.0;1093.0;1179.0;226
3616;Duiven;2024;24697;4465;14759;5473;21136;1876;655;1221;1685;873;812;254;133;121;142;71;71;332;131;201;271;128;143;686;410;276;240.0;233.0;76.0;96.0;1124.0;1181.0;226
3617;Duiven;2025;24629;4443;14550;5636;21028;1872;665;1207;1729;888;841;259;134;125;149;72;77;350;138;212;274;130;144;697;414;283;;;;;;;226
3618;Echt-Susteren;2008;31844;6769;19665;5410;26373;4496;1364;3132;975;633;342;93;49;44;56;30;26;80;44;36;105;50;55;641;460;181;228.0;312.0;191.0;229.0;1101.0;1081.0;1711
3619;Echt-Susteren;2009;31743;6679;19501;5563;26193;4432;1348;3084;1118;697;421;117;59;58;68;39;29;101;52;49;125;56;69;707;491;216;221.0;320.0;188.0;229.0;1124.0;1074.0;1711
3620;Echt-Susteren;2010;31659;6607;19380;5672;26058;4363;1345;3018;1238;763;475;131;63;68;81;47;34;108;52;56;144;64;80;774;537;237;225.0;311.0;196.0;220.0;1080.0;1151.0;1711
3621;Echt-Susteren;2011;31482;6515;19171;5796;25821;4344;1368;2976;1317;777;540;133;63;70;80;48;32;120;57;63;157;63;94;827;546;281;225.0;324.0;197.0;221.0;1178.0;1128.0;1711
3622;Echt-Susteren;2012;31413;6408;18996;6009;25695;4321;1393;2928;1397;804;593;143;73;70;81;46;35;138;69;69;160;65;95;875;551;324;222.0;325.0;208.0;229.0;1140.0;1148.0;1711
3623;Echt-Susteren;2013;31286;6324;18772;6190;25487;4317;1435;2882;1482;826;656;148;73;75;89;54;35;158;77;81;172;70;102;915;552;363;223.0;328.0;195.0;225.0;1177.0;1155.0;1711
3624;Echt-Susteren;2014;31178;6261;18548;6369;25356;4245;1421;2824;1577;869;708;154;78;76;99;60;39;169;84;85;178;71;107;977;576;401;226.0;346.0;199.0;211.0;1167.0;1110.0;1711
3625;Echt-Susteren;2015;31105;6172;18363;6570;25271;4156;1415;2741;1678;912;766;164;92;72;107;62;45;174;88;86;185;77;108;1048;593;455;230.0;347.0;199.0;216.0;1179.0;1159.0;1711
3626;Echt-Susteren;2016;30995;6109;18161;6725;25090;4115;1440;2675;1790;965;825;175;99;76;114;65;49;195;97;98;190;79;111;1116;625;491;236.0;356.0;188.0;212.0;1063.0;1134.0;1711
3627;Echt-Susteren;2017;30783;6020;17929;6834;24894;4023;1413;2610;1866;968;898;179;97;82;119;68;51;206;103;103;203;77;126;1159;623;536;228.0;361.0;189.0;208.0;1132.0;1123.0;1711
3628;Echt-Susteren;2018;30642;5945;17737;6960;24730;3967;1422;2545;1945;991;954;192;98;94;126;69;57;219;109;110;213;79;134;1195;636;559;229.0;358.0;182.0;209.0;1082.0;1121.0;1711
3629;Echt-Susteren;2019;30452;5837;17498;7117;24506;3933;1457;2476;2013;1010;1003;200;97;103;130;69;61;225;113;112;233;87;146;1225;644;581;229.0;362.0;187.0;210.0;1095.0;1129.0;1711
3630;Echt-Susteren;2020;30266;5740;17288;7238;24309;3884;1436;2448;2073;1015;1058;207;100;107;135;72;63;236;120;116;244;89;155;1251;634;617;245.0;361.0;191.0;199.0;1069.0;1094.0;1711
3631;Echt-Susteren;2021;30121;5679;17093;7349;24098;3845;1432;2413;2178;1058;1120;225;109;116;140;70;70;247;123;124;252;88;164;1314;668;646;242.0;378.0;185.0;202.0;1083.0;1092.0;1711
3632;Echt-Susteren;2022;29962;5608;16866;7488;23946;3794;1433;2361;2222;1080;1142;227;113;114;154;79;75;246;118;128;263;92;171;1332;678;654;244.0;377.0;177.0;196.0;1104.0;1076.0;1711
3633;Echt-Susteren;2023;29841;5537;16696;7608;23797;3725;1438;2287;2319;1117;1202;245;123;122;157;82;75;264;124;140;265;95;170;1388;693;695;245.0;381.0;175.0;203.0;1060.0;1100.0;1711
3634;Echt-Susteren;2024;29640;5500;16407;7733;23600;3693;1430;2263;2347;1125;1222;240;124;116;158;81;77;277;125;152;264;98;166;1408;697;711;249.0;389.0;170.0;199.0;1070.0;1091.0;1711
3635;Echt-Susteren;2025;29452;5477;16156;7819;23413;3649;1424;2225;2390;1154;1236;246;127;119;171;81;90;288;132;156;260;108;152;1425;706;719;;;;;;;1711
3636;Edam-Volendam;2008;28066;7312;17251;3503;26131;1001;326;675;934;524;410;86;42;44;24;10;14;43;26;17;322;165;157;459;281;178;333.0;197.0;65.0;124.0;235.0;500.0;385
3637;Edam-Volendam;2009;27882;7294;16934;3654;25945;975;322;653;962;537;425;98;48;50;29;11;18;55;32;23;323;163;160;457;283;174;322.0;197.0;61.0;119.0;164.0;492.0;385
3638;Edam-Volendam;2010;27624;7198;16587;3839;25651;974;326;648;999;547;452;111;58;53;34;14;20;69;35;34;324;161;163;461;279;182;305.0;203.0;68.0;107.0;411.0;488.0;385
3639;Edam-Volendam;2011;27611;7156;16498;3957;25539;1009;344;665;1063;581;482;125;66;59;37;16;21;84;42;42;335;162;173;482;295;187;297.0;204.0;67.0;109.0;440.0;488.0;385
3640;Edam-Volendam;2012;27616;7097;16322;4197;25468;1027;358;669;1121;605;516;130;67;63;41;18;23;100;48;52;339;162;177;511;310;201;279.0;217.0;72.0;111.0;456.0;501.0;385
3641;Edam-Volendam;2013;27597;7011;16154;4432;25381;1048;371;677;1168;625;543;141;71;70;50;21;29;111;51;60;339;164;175;527;318;209;269.0;220.0;74.0;113.0;403.0;497.0;385
3642;Edam-Volendam;2014;27516;6906;16004;4606;25235;1040;369;671;1241;662;579;150;78;72;61;27;34;120;58;62;368;173;195;542;326;216;268.0;223.0;68.0;106.0;595.0;526.0;385
3643;Edam-Volendam;2015;27595;6856;15938;4801;25196;1088;407;681;1311;696;615;182;88;94;63;29;34;133;66;67;368;171;197;565;342;223;264.0;231.0;77.0;110.0;446.0;523.0;385
3644;Edam-Volendam;2016;27519;6759;15769;4991;25038;1109;408;701;1372;741;631;189;92;97;78;41;37;143;69;74;369;167;202;593;372;221;266.0;239.0;83.0;112.0;488.0;510.0;385
3645;Edam-Volendam;2017;27499;6647;15684;5168;24939;1148;425;723;1412;768;644;199;98;101;82;42;40;156;75;81;359;163;196;616;390;226;264.0;246.0;71.0;108.0;528.0;527.0;385
3646;Edam-Volendam;2018;27483;6574;15603;5306;24830;1187;432;755;1466;777;689;210;100;110;89;45;44;167;83;84;365;157;208;635;392;243;261.0;246.0;83.0;111.0;482.0;530.0;385
3647;Edam-Volendam;2019;27425;6464;15519;5442;24664;1238;458;780;1523;795;728;218;102;116;96;49;47;179;90;89;374;157;217;656;397;259;266.0;261.0;78.0;110.0;557.0;532.0;385
3648;Edam-Volendam;2020;27428;6359;15509;5560;24575;1286;480;806;1567;809;758;236;104;132;101;49;52;188;93;95;372;158;214;670;405;265;273.0;261.0;76.0;112.0;575.0;522.0;385
3649;Edam-Volendam;2021;27460;6256;15531;5673;24542;1303;486;817;1615;827;788;243;105;138;105;49;56;196;99;97;376;158;218;695;416;279;281.0;264.0;77.0;108.0;577.0;539.0;385
3650;Edam-Volendam;2022;27487;6188;15510;5789;24460;1339;518;821;1688;871;817;252;116;136;107;50;57;214;105;109;390;163;227;725;437;288;275.0;275.0;97.0;116.0;585.0;522.0;385
3651;Edam-Volendam;2023;27534;6098;15567;5869;24397;1386;552;834;1751;885;866;267;119;148;115;57;58;234;111;123;404;164;240;731;434;297;280.0;282.0;73.0;113.0;596.0;559.0;385
3652;Edam-Volendam;2024;27531;5988;15574;5969;24307;1412;566;846;1812;912;900;276;122;154;118;59;59;244;109;135;403;167;236;771;455;316;292.0;286.0;81.0;110.0;625.0;519.0;385
3653;Edam-Volendam;2025;27616;5928;15615;6073;24300;1445;585;860;1871;946;925;279;122;157;120;62;58;262;119;143;414;165;249;796;478;318;;;;;;;385
3654;Ede;2008;108052;28926;63680;15446;92562;7573;2758;4815;7917;4397;3520;675;361;314;315;156;159;2018;1041;977;2391;1158;1233;2518;1681;837;1361.0;861.0;389.0;457.0;3345.0;3257.0;228
3655;Ede;2009;108583;28843;64000;15740;92813;7626;2774;4852;8144;4499;3645;721;388;333;354;182;172;2054;1049;1005;2416;1157;1259;2599;1723;876;1358.0;872.0;392.0;452.0;3448.0;3255.0;228
3656;Ede;2010;109213;28809;64335;16069;93161;7662;2795;4867;8390;4604;3786;765;408;357;383;205;178;2062;1034;1028;2449;1166;1283;2731;1791;940;1361.0;899.0;400.0;439.0;3475.0;3328.0;228
3657;Ede;2011;109799;28728;64775;16296;93512;7702;2794;4908;8585;4696;3889;788;422;366;425;231;194;2061;1024;1037;2482;1177;1305;2829;1842;987;1359.0;912.0;445.0;441.0;3426.0;3241.0;228
3658;Ede;2012;110454;28631;64818;17005;93889;7765;2837;4928;8800;4801;3999;829;441;388;450;253;197;2078;1040;1038;2501;1177;1324;2942;1890;1052;1359.0;918.0;426.0;428.0;3211.0;3289.0;228
3659;Ede;2013;110829;28514;64671;17644;94031;7795;2860;4935;9003;4905;4098;861;461;400;481;262;219;2077;1042;1035;2540;1184;1356;3044;1956;1088;1367.0;943.0;433.0;433.0;3387.0;3295.0;228
3660;Ede;2014;111363;28400;64724;18239;94328;7831;2868;4963;9204;4977;4227;902;479;423;512;285;227;2100;1041;1059;2540;1173;1367;3150;1999;1151;1359.0;941.0;420.0;424.0;3210.0;3287.0;228
3661;Ede;2015;111710;28259;64727;18724;94477;7886;2870;5016;9347;5009;4338;945;496;449;528;292;236;2113;1043;1070;2555;1168;1387;3206;2010;1196;1358.0;971.0;418.0;431.0;3294.0;3317.0;228
3662;Ede;2016;112070;28146;64773;19151;94666;7899;2877;5022;9505;5068;4437;971;508;463;553;312;241;2117;1048;1069;2576;1152;1424;3288;2048;1240;1365.0;990.0;435.0;419.0;3286.0;3328.0;228
3663;Ede;2017;112426;28163;64684;19579;94870;7929;2901;5028;9627;5147;4480;993;515;478;576;332;244;2111;1049;1062;2581;1167;1414;3366;2084;1282;1337.0;994.0;425.0;413.0;3361.0;3324.0;228
3664;Ede;2018;112826;28017;64753;20056;95005;7969;2932;5037;9852;5255;4597;1036;525;511;593;344;249;2119;1052;1067;2603;1166;1437;3501;2168;1333;1365.0;1014.0;462.0;428.0;3465.0;3353.0;228
3665;Ede;2019;113334;27932;64869;20533;95295;8041;2975;5066;9998;5314;4684;1055;537;518;616;366;250;2130;1054;1076;2612;1159;1453;3585;2198;1387;1364.0;1025.0;464.0;404.0;3564.0;3348.0;228
3666;Ede;2020;113973;27904;65011;21058;95670;8085;2980;5105;10218;5427;4791;1102;564;538;651;376;275;2144;1065;1079;2625;1159;1466;3696;2263;1433;1368.0;1039.0;442.0;408.0;3444.0;3426.0;228
3667;Ede;2021;114366;27691;65149;21526;95866;8105;3007;5098;10395;5529;4866;1141;593;548;685;397;288;2184;1076;1108;2628;1149;1479;3757;2314;1443;1385.0;1070.0;422.0;403.0;3454.0;3399.0;228
3668;Ede;2022;114767;27561;65091;22115;96092;8137;3048;5089;10538;5616;4922;1179;614;565;701;408;293;2177;1079;1098;2651;1150;1501;3830;2365;1465;1393.0;1073.0;432.0;398.0;3476.0;3359.0;228
3669;Ede;2023;115250;27530;65064;22656;96358;8199;3080;5119;10693;5695;4998;1222;641;581;721;429;292;2206;1097;1109;2620;1126;1494;3924;2402;1522;1386.0;1084.0;427.0;411.0;3413.0;3424.0;228
3670;Ede;2024;115566;27450;64986;23130;96561;8184;3083;5101;10821;5759;5062;1247;648;599;740;433;307;2226;1111;1115;2598;1110;1488;4010;2457;1553;1385.0;1090.0;423.0;395.0;3375.0;3438.0;228
3671;Ede;2025;115841;27396;64795;23650;96660;8160;3104;5056;11021;5873;5148;1278;662;616;769;450;319;2225;1111;1114;2616;1122;1494;4133;2528;1605;;;;;;;228
3672;Eemnes;2008;8823;2335;5429;1059;7752;707;219;488;364;188;176;43;17;26;37;7;30;51;27;24;31;11;20;202;126;76;83.0;42.0;31.0;42.0;375.0;424.0;317
3673;Eemnes;2009;8805;2290;5393;1122;7712;698;217;481;395;202;193;46;16;30;37;8;29;61;30;31;39;16;23;212;132;80;84.0;46.0;26.0;39.0;482.0;424.0;317
3674;Eemnes;2010;8889;2269;5396;1224;7764;703;210;493;422;210;212;54;23;31;40;8;32;64;26;38;49;17;32;215;136;79;82.0;48.0;31.0;41.0;437.0;443.0;317
3675;Eemnes;2011;8908;2214;5425;1269;7762;718;215;503;428;217;211;62;25;37;45;11;34;65;26;39;42;14;28;214;141;73;77.0;50.0;29.0;41.0;448.0;446.0;317
3676;Eemnes;2012;8927;2196;5363;1368;7745;724;219;505;458;225;233;65;27;38;45;14;31;74;30;44;50;16;34;224;138;86;81.0;50.0;32.0;41.0;495.0;433.0;317
3677;Eemnes;2013;9012;2156;5378;1478;7786;733;230;503;493;244;249;72;29;43;40;13;27;81;35;46;54;17;37;246;150;96;74.0;55.0;31.0;38.0;459.0;424.0;317
3678;Eemnes;2014;9061;2111;5367;1583;7819;717;227;490;525;268;257;73;31;42;43;17;26;86;36;50;60;19;41;263;165;98;75.0;56.0;34.0;41.0;508.0;447.0;317
3679;Eemnes;2015;9136;2090;5419;1627;7852;728;226;502;556;271;285;83;33;50;41;15;26;88;34;54;69;22;47;275;167;108;79.0;59.0;30.0;39.0;421.0;453.0;317
3680;Eemnes;2016;9116;2034;5385;1697;7842;719;222;497;555;266;289;90;37;53;38;14;24;92;37;55;66;21;45;269;157;112;82.0;62.0;33.0;41.0;489.0;458.0;317
3681;Eemnes;2017;9161;2020;5387;1754;7873;715;215;500;573;277;296;86;41;45;38;14;24;98;38;60;74;24;50;277;160;117;77.0;64.0;34.0;40.0;463.0;444.0;317
3682;Eemnes;2018;9187;1985;5395;1807;7896;725;222;503;566;276;290;95;46;49;41;17;24;97;39;58;72;21;51;261;153;108;78.0;68.0;31.0;37.0;444.0;450.0;317
3683;Eemnes;2019;9186;1962;5377;1847;7892;717;217;500;577;281;296;95;43;52;39;15;24;109;43;66;79;31;48;255;149;106;79.0;71.0;29.0;38.0;501.0;440.0;317
3684;Eemnes;2020;9247;1934;5412;1901;7906;734;237;497;607;288;319;100;46;54;43;20;23;116;42;74;83;32;51;265;148;117;85.0;69.0;32.0;33.0;518.0;472.0;317
3685;Eemnes;2021;9309;1915;5438;1956;7923;744;240;504;642;299;343;102;49;53;48;20;28;121;46;75;84;30;54;287;154;133;85.0;73.0;41.0;40.0;479.0;467.0;317
3686;Eemnes;2022;9335;1887;5436;2012;7941;731;239;492;663;307;356;104;47;57;59;26;33;124;46;78;87;30;57;289;158;131;90.0;73.0;45.0;37.0;498.0;459.0;317
3687;Eemnes;2023;9401;1869;5444;2088;7963;738;245;493;700;323;377;104;47;57;62;31;31;130;47;83;98;32;66;306;166;140;90.0;74.0;35.0;35.0;453.0;461.0;317
3688;Eemnes;2024;9410;1837;5411;2162;7956;726;232;494;728;348;380;110;51;59;64;34;30;137;53;84;93;35;58;324;175;149;90.0;81.0;30.0;36.0;509.0;441.0;317
3689;Eemnes;2025;9482;1850;5413;2219;7990;744;238;506;748;358;390;105;48;57;72;40;32;132;50;82;100;38;62;339;182;157;;;;;;;317
3690;Eemsmond;2008;16640;4156;9842;2642;15612;646;199;447;382;234;148;55;29;26;48;26;22;35;13;22;19;5;14;225;161;64;182.0;146.0;47.0;71.0;522.0;664.0;1651
3691;Eemsmond;2009;16512;4122;9682;2708;15426;667;214;453;419;247;172;63;32;31;47;24;23;47;21;26;31;9;22;231;161;70;177.0;148.0;47.0;68.0;500.0;685.0;1651
3692;Eemsmond;2010;16338;4087;9493;2758;15220;685;219;466;433;247;186;68;36;32;53;26;27;51;21;30;31;11;20;230;153;77;170.0;155.0;49.0;66.0;535.0;664.0;1651
3693;Eemsmond;2011;16208;4034;9363;2811;15075;677;214;463;456;251;205;75;39;36;56;27;29;56;23;33;37;12;25;232;150;82;168.0;149.0;47.0;65.0;493.0;645.0;1651
3694;Eemsmond;2012;16059;3978;9165;2916;14884;691;212;479;484;257;227;79;40;39;55;24;31;65;24;41;45;15;30;240;154;86;167.0;150.0;53.0;67.0;522.0;650.0;1651
3695;Eemsmond;2013;15936;3907;8989;3040;14723;697;213;484;516;270;246;80;41;39;59;24;35;76;27;49;50;14;36;251;164;87;158.0;150.0;52.0;65.0;594.0;644.0;1651
3696;Eemsmond;2014;15883;3888;8905;3090;14637;700;202;498;546;287;259;87;47;40;59;24;35;79;28;51;50;14;36;271;174;97;157.0;150.0;49.0;65.0;468.0;636.0;1651
3697;Eemsmond;2015;15708;3796;8764;3148;14448;715;204;511;545;292;253;92;50;42;61;24;37;85;37;48;51;14;37;256;167;89;152.0;147.0;48.0;61.0;528.0;613.0;1651
3698;Eemsmond;2016;15615;3722;8673;3220;14331;723;202;521;561;311;250;89;50;39;64;28;36;87;43;44;54;18;36;267;172;95;152.0;151.0;47.0;58.0;494.0;617.0;1651
3699;Eemsmond;2017;15483;3693;8501;3289;14169;735;209;526;579;318;261;89;50;39;64;29;35;100;47;53;57;20;37;269;172;97;146.0;151.0;58.0;60.0;467.0;603.0;1651
3700;Eemsmond;2018;15340;3622;8376;3342;13988;742;225;517;610;341;269;94;53;41;75;35;40;97;49;48;67;23;44;277;181;96;145.0;150.0;48.0;65.0;490.0;606.0;1651
3701;Eemsmond;2019;15200;3574;8234;3392;13816;755;224;531;629;340;289;99;56;43;83;39;44;111;55;56;72;26;46;264;164;100;142.0;150.0;44.0;61.0;514.0;630.0;1651
3702;Eemsmond;2020;15060;3524;8112;3424;13660;760;221;539;640;344;296;105;60;45;91;44;47;116;56;60;67;24;43;261;160;101;140.0;155.0;45.0;56.0;448.0;601.0;1651
3703;Eemsmond;2021;14882;3445;7962;3475;13442;771;224;547;669;346;323;111;66;45;95;44;51;119;54;65;78;25;53;266;157;109;140.0;158.0;45.0;57.0;478.0;598.0;1651
3704;Eemsmond;2022;14734;3386;7817;3531;13286;766;212;554;682;361;321;108;65;43;95;46;49;135;57;78;80;26;54;264;167;97;139.0;154.0;39.0;57.0;442.0;574.0;1651
3705;Eemsmond;2023;14570;3334;7677;3559;13117;760;207;553;693;370;323;110;68;42;94;48;46;138;56;82;80;25;55;271;173;98;127.0;154.0;45.0;55.0;478.0;573.0;1651
3706;Eemsmond;2024;14440;3285;7559;3596;12983;763;209;554;694;374;320;109;67;42;103;52;51;131;56;75;83;27;56;268;172;96;132.0;158.0;42.0;57.0;437.0;554.0;1651
3707;Eemsmond;2025;14284;3237;7421;3626;12819;748;205;543;717;376;341;118;73;45;102;48;54;137;55;82;85;29;56;275;171;104;;;;;;;1651
3708;Eersel;2008;17908;4406;10575;2927;16617;953;313;640;338;211;127;39;23;16;22;9;13;40;18;22;18;11;7;219;150;69;147.0;142.0;68.0;88.0;468.0;579.0;770
3709;Eersel;2009;17784;4294;10483;3007;16435;959;309;650;390;244;146;40;27;13;30;16;14;54;26;28;26;16;10;240;159;81;148.0;146.0;66.0;84.0;423.0;593.0;770
3710;Eersel;2010;17600;4169;10370;3061;16236;943;298;645;421;257;164;52;34;18;30;15;15;63;27;36;32;17;15;244;164;80;143.0;149.0;67.0;82.0;477.0;619.0;770
3711;Eersel;2011;17439;4007;10314;3118;16059;940;305;635;440;260;180;61;36;25;33;16;17;64;27;37;41;20;21;241;161;80;138.0;147.0;69.0;85.0;504.0;622.0;770
3712;Eersel;2012;17298;3883;10235;3180;15865;956;308;648;477;281;196;66;39;27;32;15;17;74;28;46;49;25;24;256;174;82;139.0;156.0;77.0;83.0;567.0;602.0;770
3713;Eersel;2013;17242;3765;10215;3262;15767;958;308;650;517;298;219;66;37;29;36;15;21;83;28;55;56;29;27;276;189;87;140.0;156.0;68.0;80.0;483.0;626.0;770
3714;Eersel;2014;17072;3598;10130;3344;15557;953;309;644;562;323;239;80;45;35;40;14;26;89;33;56;68;37;31;285;194;91;144.0;163.0;62.0;79.0;604.0;618.0;770
3715;Eersel;2015;17024;3495;10119;3410;15463;958;326;632;603;339;264;93;47;46;52;20;32;97;35;62;67;37;30;294;200;94;149.0;170.0;75.0;76.0;519.0;643.0;770
3716;Eersel;2016;16880;3388;10019;3473;15260;954;325;629;666;367;299;100;47;53;69;26;43;101;42;59;74;38;36;322;214;108;149.0;169.0;66.0;74.0;602.0;629.0;770
3717;Eersel;2017;16827;3309;9958;3560;15166;970;340;630;691;375;316;107;50;57;65;25;40;104;43;61;78;37;41;337;220;117;154.0;174.0;74.0;75.0;550.0;644.0;770
3718;Eersel;2018;16713;3213;9882;3618;15033;950;330;620;730;383;347;113;53;60;66;27;39;119;48;71;89;36;53;343;219;124;156.0;177.0;66.0;71.0;674.0;645.0;770
3719;Eersel;2019;16718;3181;9832;3705;15018;942;325;617;758;395;363;115;55;60;70;34;36;119;44;75;98;34;64;356;228;128;163.0;178.0;79.0;73.0;661.0;636.0;770
3720;Eersel;2020;16735;3149;9826;3760;14991;953;327;626;791;410;381;114;55;59;71;33;38;122;47;75;107;37;70;377;238;139;170.0;185.0;83.0;73.0;647.0;652.0;770
3721;Eersel;2021;16727;3141;9771;3815;14932;957;338;619;838;432;406;118;57;61;78;38;40;125;44;81;111;38;73;406;255;151;176.0;180.0;78.0;68.0;530.0;637.0;770
3722;Eersel;2022;16627;3112;9657;3858;14806;961;329;632;860;443;417;125;61;64;76;37;39;131;48;83;113;42;71;415;255;160;175.0;191.0;76.0;72.0;648.0;624.0;770
3723;Eersel;2023;16640;3099;9583;3958;14777;976;341;635;887;450;437;128;66;62;82;39;43;144;53;91;114;43;71;419;249;170;180.0;195.0;76.0;76.0;695.0;648.0;770
3724;Eersel;2024;16673;3174;9440;4059;14782;978;336;642;913;461;452;134;66;68;77;37;40;151;58;93;124;46;78;427;254;173;179.0;191.0;70.0;74.0;625.0;644.0;770
3725;Eersel;2025;16640;3166;9326;4148;14689;1002;350;652;949;486;463;138;69;69;78;36;42;159;64;95;136;52;84;438;265;173;;;;;;;770
3726;Eijsden;2008;11434;2811;6757;1866;9941;1247;368;879;246;156;90;23;11;12;11;7;4;17;8;9;26;15;11;169;115;54;84.0;104.0;56.0;78.0;367.0;405.0;905
3727;Eijsden;2009;11354;2761;6683;1910;9845;1224;356;868;285;180;105;29;15;14;13;8;5;24;12;12;40;24;16;179;121;58;81.0;105.0;57.0;76.0;382.0;416.0;905
3728;Eijsden;2010;11277;2669;6626;1982;9748;1220;355;865;309;190;119;34;18;16;19;14;5;30;14;16;42;23;19;184;121;63;81.0;109.0;59.0;79.0;365.0;428.0;905
3729;Eijsden;2011;11167;2547;6606;2014;9623;1216;355;861;328;199;129;36;18;18;19;12;7;33;15;18;51;29;22;189;125;64;85.0;112.0;57.0;75.0;351.0;417.0;905
3730;Eijsden;2012;11057;2462;6525;2070;9500;1208;365;843;349;209;140;41;19;22;23;17;6;35;19;16;60;31;29;190;123;67;83.0;115.0;59.0;72.0;371.0;418.0;905
3731;Eijsden;2013;10964;2400;6415;2149;9406;1184;363;821;374;215;159;45;23;22;23;16;7;40;20;20;72;37;35;194;119;75;84.0;118.0;57.0;77.0;384.0;417.0;905
3732;Eijsden;2014;10877;2313;6361;2203;9302;1177;364;813;398;217;181;49;24;25;28;16;12;43;24;19;78;37;41;200;116;84;88.0;119.0;56.0;69.0;360.0;433.0;905
3733;Eijsden;2015;10762;2244;6272;2246;9176;1173;366;807;413;221;192;54;23;31;36;21;15;43;24;19;78;38;40;202;115;87;90.0;116.0;52.0;69.0;365.0;419.0;905
3734;Eijsden;2016;10666;2192;6174;2300;9088;1139;359;780;439;231;208;55;22;33;36;20;16;53;29;24;85;40;45;210;120;90;91.0;123.0;65.0;66.0;366.0;426.0;905
3735;Eijsden;2017;10574;2140;6087;2347;8987;1117;353;764;470;247;223;60;24;36;41;25;16;56;33;23;92;42;50;221;123;98;95.0;124.0;48.0;65.0;379.0;409.0;905
3736;Eijsden;2018;10499;2081;6014;2404;8899;1110;356;754;490;258;232;62;23;39;39;26;13;64;35;29;101;48;53;224;126;98;100.0;123.0;54.0;67.0;351.0;417.0;905
3737;Eijsden;2019;10399;2027;5934;2438;8779;1124;376;748;496;259;237;64;25;39;41;24;17;70;36;34;98;49;49;223;125;98;96.0;126.0;48.0;63.0;308.0;401.0;905
3738;Eijsden;2020;10262;1963;5817;2482;8647;1117;377;740;498;267;231;71;26;45;38;21;17;74;37;37;99;53;46;216;130;86;97.0;125.0;47.0;63.0;328.0;392.0;905
3739;Eijsden;2021;10154;1898;5736;2520;8527;1126;393;733;501;273;228;73;27;46;39;23;16;68;35;33;101;52;49;220;136;84;96.0;123.0;52.0;64.0;349.0;375.0;905
3740;Eijsden;2022;10088;1877;5651;2560;8458;1120;390;730;510;283;227;79;29;50;38;22;16;71;38;33;100;55;45;222;139;83;99.0;128.0;53.0;61.0;349.0;408.0;905
3741;Eijsden;2023;9993;1847;5568;2578;8333;1119;397;722;541;292;249;83;32;51;39;24;15;77;38;39;110;61;49;232;137;95;94.0;129.0;47.0;60.0;346.0;397.0;905
3742;Eijsden;2024;9895;1810;5495;2590;8217;1106;395;711;572;298;274;86;34;52;35;22;13;89;43;46;120;62;58;242;137;105;94.0;133.0;53.0;58.0;355.0;392.0;905
3743;Eijsden;2025;9815;1788;5430;2597;8095;1124;410;714;596;313;283;88;38;50;34;19;15;93;45;48;131;67;64;250;144;106;;;;;;;905
3744;Eindhoven;2008;210675;44353;133564;32758;153873;25027;10964;14063;31775;19006;12769;3663;2036;1627;2330;1473;857;9241;4934;4307;5397;2618;2779;11144;7945;3199;2379.0;1931.0;2807.0;2456.0;8248.0;8239.0;772
3745;Eindhoven;2009;211521;44744;133663;33114;154026;25474;11385;14089;32021;19081;12940;3693;2055;1638;2343;1457;886;9176;4913;4263;5495;2633;2862;11314;8023;3291;2417.0;1951.0;2956.0;2471.0;8214.0;8222.0;772
3746;Eindhoven;2010;212506;45054;133929;33523;154250;25863;11823;14040;32393;19168;13225;3727;2071;1656;2385;1479;906;9153;4869;4284;5582;2659;2923;11546;8090;3456;2460.0;1975.0;3050.0;2453.0;8233.0;8241.0;772
3747;Eindhoven;2011;213607;45266;134409;33932;154493;26378;12284;14094;32736;19250;13486;3773;2091;1682;2402;1484;918;9081;4835;4246;5725;2705;3020;11755;8135;3620;2484.0;1987.0;3144.0;2423.0;8106.0;8325.0;772
3748;Eindhoven;2012;214645;45568;134419;34658;154648;26847;12701;14146;33150;19395;13755;3809;2107;1702;2448;1525;923;9077;4831;4246;5826;2720;3106;11990;8212;3778;2447.0;2005.0;3163.0;2423.0;7860.0;8373.0;772
3749;Eindhoven;2013;215344;45630;134383;35331;154615;27195;13039;14156;33534;19487;14047;3866;2143;1723;2511;1558;953;9066;4827;4239;5928;2747;3181;12163;8212;3951;2478.0;2010.0;3147.0;2355.0;7883.0;8344.0;772
3750;Eindhoven;2014;216177;45843;134414;35920;154676;27653;13479;14174;33848;19588;14260;3905;2184;1721;2574;1581;993;9042;4797;4245;5984;2758;3226;12343;8268;4075;2460.0;2041.0;3137.0;2346.0;7742.0;8331.0;772
3751;Eindhoven;2015;216828;45876;134511;36441;154610;28042;13882;14160;34176;19642;14534;3947;2195;1752;2627;1610;1017;8987;4761;4226;6075;2788;3287;12540;8288;4252;2462.0;2030.0;3147.0;2342.0;7782.0;8328.0;772
3752;Eindhoven;2016;217552;46058;134576;36918;154692;28387;14225;14162;34473;19740;14733;3987;2217;1770;2697;1658;1039;8946;4725;4221;6120;2798;3322;12723;8342;4381;2465.0;2061.0;3172.0;2337.0;7197.0;8269.0;772
3753;Eindhoven;2017;217757;46092;134429;37236;154232;28807;14567;14240;34718;19807;14911;3994;2213;1781;2705;1665;1040;8882;4718;4164;6194;2808;3386;12943;8403;4540;2435.0;2085.0;3117.0;2308.0;7315.0;8204.0;772
3754;Eindhoven;2018;218055;46146;134281;37628;153927;29154;14871;14283;34974;19897;15077;4056;2227;1829;2702;1672;1030;8827;4704;4123;6258;2809;3449;13131;8485;4646;2451.0;2082.0;3130.0;2317.0;7048.0;8202.0;772
3755;Eindhoven;2019;218118;46108;134024;37986;153491;29519;15181;14338;35108;19883;15225;4046;2203;1843;2738;1700;1038;8728;4627;4101;6269;2800;3469;13327;8553;4774;2451.0;2082.0;3137.0;2264.0;6992.0;8168.0;772
3756;Eindhoven;2020;218218;46015;133822;38381;152986;29900;15544;14356;35332;19964;15368;4090;2227;1863;2785;1729;1056;8653;4615;4038;6310;2789;3521;13494;8604;4890;2442.0;2104.0;3066.0;2230.0;7184.0;8134.0;772
3757;Eindhoven;2021;218466;45862;133837;38767;152706;30209;15822;14387;35551;19994;15557;4103;2218;1885;2822;1731;1091;8612;4610;4002;6348;2794;3554;13666;8641;5025;2459.0;2082.0;3097.0;2232.0;7279.0;8100.0;772
3758;Eindhoven;2022;218914;45724;133956;39234;152485;30625;16133;14492;35804;20115;15689;4121;2221;1900;2874;1767;1107;8558;4599;3959;6393;2828;3565;13858;8700;5158;2477.0;2147.0;3063.0;2180.0;6939.0;8167.0;772
3759;Eindhoven;2023;218931;45641;133703;39587;151912;30990;16398;14592;36029;20198;15831;4132;2220;1912;2904;1773;1131;8483;4589;3894;6442;2855;3587;14068;8761;5307;2454.0;2150.0;3070.0;2226.0;6798.0;8104.0;772
3760;Eindhoven;2024;218811;45489;133254;40068;151257;31339;16655;14684;36215;20299;15916;4144;2206;1938;2979;1816;1163;8434;4574;3860;6455;2869;3586;14203;8834;5369;2482.0;2145.0;3026.0;2150.0;6753.0;8025.0;772
3761;Eindhoven;2025;218780;45423;132704;40653;150720;31677;16979;14698;36383;20365;16018;4135;2205;1930;3018;1847;1171;8426;4552;3874;6461;2855;3606;14343;8906;5437;;;;;;;772
3762;Elburg;2008;21860;5992;12930;2938;20665;729;258;471;466;274;192;42;21;21;32;14;18;63;34;29;26;8;18;303;197;106;301.0;160.0;79.0;84.0;568.0;685.0;230
3763;Elburg;2009;21885;5961;12863;3061;20607;758;269;489;520;301;219;50;24;26;37;16;21;74;37;37;31;9;22;328;215;113;298.0;161.0;83.0;82.0;506.0;676.0;230
3764;Elburg;2010;21858;5908;12749;3201;20515;777;280;497;566;331;235;59;29;30;41;23;18;78;39;39;34;10;24;354;230;124;290.0;165.0;80.0;84.0;640.0;697.0;230
3765;Elburg;2011;21925;5893;12741;3291;20505;804;293;511;616;357;259;67;35;32;43;24;19;87;43;44;46;18;28;373;237;136;283.0;166.0;79.0;82.0;645.0;685.0;230
3766;Elburg;2012;22004;5858;12653;3493;20493;837;321;516;674;375;299;73;38;35;48;27;21;95;47;48;58;21;37;400;242;158;284.0;177.0;86.0;90.0;712.0;697.0;230
3767;Elburg;2013;22125;5871;12594;3660;20525;857;334;523;743;414;329;83;42;41;54;32;22;106;48;58;69;25;44;431;267;164;289.0;178.0;94.0;88.0;568.0;701.0;230
3768;Elburg;2014;22111;5841;12487;3783;20446;880;343;537;785;420;365;90;43;47;54;28;26;111;50;61;79;30;49;451;269;182;290.0;182.0;91.0;87.0;648.0;697.0;230
3769;Elburg;2015;22179;5824;12453;3902;20452;892;352;540;835;450;385;98;48;50;60;32;28;118;55;63;80;31;49;479;284;195;290.0;188.0;86.0;79.0;561.0;715.0;230
3770;Elburg;2016;22138;5765;12379;3994;20358;902;358;544;878;474;404;106;50;56;64;33;31;123;56;67;99;41;58;486;294;192;280.0;189.0;91.0;82.0;625.0;698.0;230
3771;Elburg;2017;22165;5727;12348;4090;20310;923;366;557;932;495;437;115;58;57;72;37;35;130;59;71;114;44;70;501;297;204;283.0;192.0;96.0;83.0;670.0;717.0;230
3772;Elburg;2018;22225;5716;12346;4163;20282;970;397;573;973;520;453;130;65;65;72;38;34;138;63;75;118;43;75;515;311;204;285.0;196.0;101.0;88.0;635.0;703.0;230
3773;Elburg;2019;22260;5680;12325;4255;20249;985;411;574;1026;550;476;138;69;69;84;47;37;145;65;80;126;46;80;533;323;210;280.0;201.0;88.0;85.0;701.0;732.0;230
3774;Elburg;2020;22312;5639;12368;4305;20201;1041;435;606;1070;573;497;148;71;77;85;48;37;158;74;84;125;48;77;554;332;222;279.0;201.0;100.0;86.0;714.0;743.0;230
3775;Elburg;2021;22376;5563;12409;4404;20191;1072;444;628;1113;595;518;153;76;77;91;49;42;174;81;93;125;50;75;570;339;231;284.0;209.0;102.0;87.0;696.0;749.0;230
3776;Elburg;2022;22413;5513;12427;4473;20181;1084;453;631;1148;621;527;158;81;77;93;53;40;172;82;90;133;52;81;592;353;239;281.0;209.0;84.0;84.0;762.0;705.0;230
3777;Elburg;2023;22545;5511;12501;4533;20248;1109;455;654;1188;642;546;166;86;80;96;59;37;179;81;98;147;54;93;600;362;238;285.0;210.0;92.0;88.0;753.0;730.0;230
3778;Elburg;2024;22647;5505;12487;4655;20299;1115;463;652;1233;671;562;173;93;80;99;61;38;192;85;107;168;64;104;601;368;233;284.0;217.0;82.0;82.0;756.0;731.0;230
3779;Elburg;2025;22742;5502;12478;4762;20345;1119;458;661;1278;681;597;177;92;85;99;56;43;205;87;118;179;68;111;618;378;240;;;;;;;230
3780;Emmen;2008;109214;25724;65294;18196;97371;7340;2671;4669;4503;2688;1815;512;254;258;352;203;149;953;510;443;474;227;247;2212;1494;718;1112.0;1066.0;423.0;575.0;3342.0;2524.0;114
3781;Emmen;2009;109938;25849;65469;18620;97706;7405;2687;4718;4827;2816;2011;550;272;278;386;223;163;1058;555;503;533;249;284;2300;1517;783;1130.0;1096.0;447.0;581.0;3264.0;2529.0;114
3782;Emmen;2010;110586;26005;65578;19003;97992;7461;2709;4752;5133;2934;2199;590;286;304;404;226;178;1126;586;540;603;278;325;2410;1558;852;1126.0;1109.0;465.0;565.0;3363.0;2587.0;114
3783;Emmen;2011;111292;26130;65846;19316;98333;7525;2711;4814;5434;3060;2374;631;306;325;431;244;187;1215;627;588;666;302;364;2491;1581;910;1134.0;1112.0;479.0;570.0;3088.0;2554.0;114
3784;Emmen;2012;111766;26135;65655;19976;98396;7591;2752;4839;5779;3218;2561;697;341;356;470;269;201;1287;656;631;724;333;391;2601;1619;982;1117.0;1137.0;488.0;566.0;3126.0;2542.0;114
3785;Emmen;2013;112258;26149;65437;20672;98540;7630;2752;4878;6088;3374;2714;741;356;385;488;283;205;1347;682;665;802;367;435;2710;1686;1024;1124.0;1152.0;497.0;557.0;2967.0;2559.0;114
3786;Emmen;2014;112588;26189;65066;21333;98539;7681;2747;4934;6368;3515;2853;778;381;397;523;301;222;1408;701;707;872;404;468;2787;1728;1059;1120.0;1174.0;484.0;546.0;3151.0;2570.0;114
3787;Emmen;2015;113059;26223;64998;21838;98666;7718;2762;4956;6675;3659;3016;809;400;409;541;307;234;1506;740;766;945;438;507;2874;1774;1100;1142.0;1169.0;507.0;546.0;3084.0;2549.0;114
3788;Emmen;2016;113540;26266;64906;22368;98789;7794;2804;4990;6957;3764;3193;868;424;444;558;312;246;1574;767;807;989;455;534;2968;1806;1162;1139.0;1192.0;515.0;554.0;3058.0;2588.0;114
3789;Emmen;2017;113927;26272;64855;22800;98750;7899;2845;5054;7278;3908;3370;914;445;469;587;328;259;1650;801;849;1055;483;572;3072;1851;1221;1146.0;1210.0;484.0;548.0;3239.0;2597.0;114
3790;Emmen;2018;114447;26267;64783;23397;98940;7924;2848;5076;7583;4048;3535;965;470;495;611;338;273;1721;831;890;1116;508;608;3170;1901;1269;1159.0;1232.0;503.0;551.0;3141.0;2589.0;114
3791;Emmen;2019;114894;26143;64840;23911;98932;7995;2878;5117;7967;4198;3769;1019;496;523;648;352;296;1803;851;952;1186;530;656;3311;1969;1342;1161.0;1229.0;520.0;550.0;2940.0;2612.0;114
3792;Emmen;2020;115132;25943;64758;24431;98821;8029;2920;5109;8282;4340;3942;1045;508;537;665;361;304;1890;878;1012;1253;560;693;3429;2033;1396;1176.0;1267.0;488.0;548.0;3180.0;2643.0;114
3793;Emmen;2021;115532;25921;64691;24920;98887;8076;2961;5115;8569;4415;4154;1079;515;564;676;361;315;1961;896;1065;1312;584;728;3541;2059;1482;1203.0;1296.0;510.0;549.0;3144.0;2634.0;114
3794;Emmen;2022;115916;25862;64668;25386;98869;8145;3027;5118;8902;4553;4349;1119;532;587;706;378;328;2041;912;1129;1372;598;774;3664;2133;1531;1218.0;1299.0;531.0;554.0;3266.0;2662.0;114
3795;Emmen;2023;116426;25902;64588;25936;98902;8242;3075;5167;9282;4735;4547;1153;543;610;730;391;339;2113;945;1168;1456;625;831;3830;2231;1599;1255.0;1333.0;530.0;544.0;3077.0;2675.0;114
3796;Emmen;2024;116743;25962;64356;26425;98827;8345;3139;5206;9571;4870;4701;1184;560;624;750;406;344;2180;963;1217;1538;655;883;3919;2286;1633;1248.0;1338.0;510.0;536.0;3248.0;2661.0;114
3797;Emmen;2025;117224;26085;64250;26889;98878;8463;3232;5231;9883;5016;4867;1217;583;634;767;424;343;2259;1001;1258;1613;682;931;4027;2326;1701;;;;;;;114
3798;Enkhuizen;2008;17810;4235;11059;2516;15531;1108;422;686;1171;656;515;122;62;60;54;30;24;380;202;178;131;57;74;484;305;179;199.0;135.0;69.0;92.0;916.0;821.0;388
3799;Enkhuizen;2009;17949;4237;11118;2594;15611;1114;419;695;1224;687;537;128;62;66;63;32;31;375;201;174;145;69;76;513;323;190;200.0;142.0;61.0;99.0;935.0;835.0;388
3800;Enkhuizen;2010;18070;4258;11117;2695;15710;1136;424;712;1224;688;536;136;69;67;69;36;33;357;198;159;146;63;83;516;322;194;203.0;149.0;69.0;93.0;1039.0;838.0;388
3801;Enkhuizen;2011;18303;4253;11269;2781;15906;1148;414;734;1249;688;561;147;73;74;78;39;39;343;186;157;153;68;85;528;322;206;197.0;145.0;66.0;92.0;1006.0;873.0;388
3802;Enkhuizen;2012;18464;4205;11304;2955;16040;1162;415;747;1262;691;571;147;72;75;79;42;37;343;182;161;149;64;85;544;331;213;201.0;151.0;68.0;89.0;958.0;879.0;388
3803;Enkhuizen;2013;18574;4188;11247;3139;16136;1171;433;738;1267;705;562;153;77;76;80;43;37;342;181;161;142;63;79;550;341;209;198.0;149.0;71.0;90.0;971.0;886.0;388
3804;Enkhuizen;2014;18692;4187;11202;3303;16209;1189;438;751;1294;734;560;163;83;80;92;49;43;330;180;150;147;68;79;562;354;208;199.0;153.0;67.0;87.0;1052.0;886.0;388
3805;Enkhuizen;2015;18887;4160;11305;3422;16390;1197;439;758;1300;748;552;171;86;85;89;49;40;326;183;143;149;69;80;565;361;204;200.0;160.0;64.0;88.0;906.0;872.0;388
3806;Enkhuizen;2016;18941;4143;11243;3555;16432;1216;450;766;1293;748;545;161;85;76;90;51;39;327;182;145;157;76;81;558;354;204;198.0;162.0;68.0;89.0;948.0;868.0;388
3807;Enkhuizen;2017;19038;4146;11236;3656;16487;1216;436;780;1335;762;573;160;86;74;92;56;36;344;188;156;163;73;90;576;359;217;197.0;170.0;71.0;77.0;1015.0;871.0;388
3808;Enkhuizen;2018;19205;4163;11276;3766;16618;1233;452;781;1354;766;588;165;89;76;93;53;40;350;189;161;169;75;94;577;360;217;193.0;167.0;63.0;85.0;903.0;879.0;388
3809;Enkhuizen;2019;19236;4134;11223;3879;16659;1199;430;769;1378;765;613;169;90;79;93;52;41;349;188;161;178;76;102;589;359;230;202.0;179.0;63.0;80.0;1010.0;868.0;388
3810;Enkhuizen;2020;19389;4175;11213;4001;16778;1209;441;768;1402;771;631;178;91;87;96;55;41;346;183;163;184;82;102;598;360;238;201.0;180.0;69.0;79.0;934.0;890.0;388
3811;Enkhuizen;2021;19447;4156;11191;4100;16792;1235;455;780;1420;784;636;177;92;85;105;58;47;359;189;170;191;91;100;588;354;234;209.0;184.0;69.0;78.0;858.0;887.0;388
3812;Enkhuizen;2022;19437;4106;11117;4214;16763;1249;455;794;1425;786;639;174;91;83;104;56;48;362;189;173;194;96;98;591;354;237;207.0;196.0;65.0;78.0;959.0;845.0;388
3813;Enkhuizen;2023;19552;4135;11110;4307;16854;1249;463;786;1449;784;665;175;92;83;105;59;46;351;178;173;199;94;105;619;361;258;210.0;199.0;79.0;84.0;957.0;887.0;388
3814;Enkhuizen;2024;19632;4123;11156;4353;16892;1273;480;793;1467;793;674;181;98;83;108;61;47;341;172;169;197;94;103;640;368;272;209.0;201.0;67.0;81.0;933.0;867.0;388
3815;Enkhuizen;2025;19695;4115;11127;4453;16941;1262;486;776;1492;795;697;188;101;87;111;63;48;335;168;167;207;97;110;651;366;285;;;;;;;388
3816;Enschede;2008;156346;35831;98234;22281;115199;19196;7552;11644;21951;12510;9441;2032;1082;950;911;553;358;8710;4334;4376;2334;1078;1256;7964;5463;2501;1790.0;1488.0;1682.0;1884.0;5483.0;4628.0;153
3817;Enschede;2009;157327;36125;98396;22806;116139;19231;7606;11625;21957;12258;9699;2092;1125;967;941;562;379;8685;4259;4426;2427;1102;1325;7812;5210;2602;1801.0;1524.0;1721.0;1809.0;4915.0;4582.0;153
3818;Enschede;2010;157877;36271;98335;23271;116630;19273;7685;11588;21974;12082;9892;2145;1142;1003;971;567;404;8659;4243;4416;2501;1124;1377;7698;5006;2692;1818.0;1528.0;1787.0;1800.0;4414.0;4525.0;153
3819;Enschede;2011;158061;36395;98067;23599;116718;19293;7763;11530;22050;11948;10102;2182;1151;1031;1039;610;429;8590;4191;4399;2613;1127;1486;7626;4869;2757;1829.0;1545.0;1788.0;1745.0;4294.0;4438.0;153
3820;Enschede;2012;158272;36419;97385;24468;116851;19322;7807;11515;22099;11816;10283;2214;1164;1050;1079;635;444;8511;4135;4376;2737;1152;1585;7558;4730;2828;1816.0;1545.0;1785.0;1724.0;4231.0;4388.0;153
3821;Enschede;2013;158471;36581;96631;25259;117035;19276;7812;11464;22160;11653;10507;2262;1186;1076;1130;660;470;8469;4059;4410;2783;1152;1631;7516;4596;2920;1838.0;1558.0;1749.0;1686.0;4154.0;4380.0;153
3822;Enschede;2014;158607;36661;96109;25837;117178;19240;7875;11365;22189;11552;10637;2300;1214;1086;1191;690;501;8407;3991;4416;2848;1174;1674;7443;4483;2960;1832.0;1584.0;1763.0;1633.0;4004.0;4312.0;153
3823;Enschede;2015;158698;36724;95685;26289;117156;19261;7957;11304;22281;11503;10778;2368;1244;1124;1254;718;536;8338;3960;4378;2913;1197;1716;7408;4384;3024;1819.0;1605.0;1724.0;1609.0;3916.0;4299.0;153
3824;Enschede;2016;158659;36870;95075;26714;117139;19228;8012;11216;22292;11432;10860;2384;1266;1118;1305;754;551;8263;3887;4376;2997;1210;1787;7343;4315;3028;1863.0;1606.0;1710.0;1574.0;4017.0;4277.0;153
3825;Enschede;2017;158814;37054;94726;27034;117223;19255;8115;11140;22336;11428;10908;2426;1297;1129;1340;770;570;8195;3846;4349;3059;1226;1833;7316;4289;3027;1836.0;1628.0;1654.0;1568.0;4102.0;4297.0;153
3826;Enschede;2018;158936;37209;94375;27352;117326;19217;8137;11080;22393;11430;10963;2468;1314;1154;1382;792;590;8107;3776;4331;3121;1255;1866;7315;4293;3022;1856.0;1638.0;1664.0;1518.0;3980.0;4255.0;153
3827;Enschede;2019;159048;37414;93945;27689;117321;19280;8248;11032;22447;11383;11064;2525;1330;1195;1426;815;611;8000;3744;4256;3199;1278;1921;7297;4216;3081;1863.0;1647.0;1630.0;1495.0;3852.0;4245.0;153
3828;Enschede;2020;159023;37499;93593;27931;117254;19269;8299;10970;22500;11344;11156;2584;1346;1238;1471;840;631;7891;3685;4206;3246;1286;1960;7308;4187;3121;1869.0;1654.0;1588.0;1468.0;4033.0;4229.0;153
3829;Enschede;2021;159177;37512;93482;28183;117350;19239;8322;10917;22588;11326;11262;2612;1359;1253;1515;866;649;7812;3643;4169;3340;1310;2030;7309;4148;3161;1882.0;1684.0;1609.0;1456.0;3911.0;4265.0;153
3830;Enschede;2022;159194;37587;93119;28488;117356;19227;8419;10808;22611;11273;11338;2641;1381;1260;1557;883;674;7708;3594;4114;3409;1314;2095;7296;4101;3195;1884.0;1693.0;1599.0;1441.0;4051.0;4239.0;153
3831;Enschede;2023;159373;37762;92852;28759;117463;19216;8485;10731;22694;11242;11452;2671;1379;1292;1601;914;687;7651;3557;4094;3489;1341;2148;7282;4051;3231;1886.0;1717.0;1557.0;1413.0;4140.0;4211.0;153
3832;Enschede;2024;159637;37822;92762;29053;117572;19233;8553;10680;22832;11253;11579;2696;1386;1310;1653;941;712;7588;3502;4086;3555;1360;2195;7340;4064;3276;1909.0;1722.0;1543.0;1392.0;3897.0;4273.0;153
3833;Enschede;2025;159619;37879;92306;29434;117483;19205;8599;10606;22931;11304;11627;2770;1422;1348;1708;972;736;7495;3469;4026;3577;1353;2224;7381;4088;3293;;;;;;;153
3834;Epe;2008;32216;7268;18875;6073;28608;2014;779;1235;1594;878;716;87;43;44;92;35;57;924;490;434;84;38;46;407;272;135;282.0;329.0;126.0;105.0;882.0;1031.0;232
3835;Epe;2009;32044;7152;18716;6176;28368;2047;790;1257;1629;901;728;99;48;51;98;42;56;916;480;436;98;47;51;418;284;134;266.0;332.0;131.0;102.0;864.0;1038.0;232
3836;Epe;2010;31835;6998;18522;6315;28110;2061;785;1276;1664;916;748;110;57;53;100;40;60;902;467;435;122;61;61;430;291;139;263.0;329.0;135.0;100.0;777.0;1049.0;232
3837;Epe;2011;31534;6782;18358;6394;27755;2054;790;1264;1725;961;764;126;70;56;111;44;67;885;463;422;127;65;62;476;319;157;266.0;332.0;146.0;101.0;935.0;1043.0;232
3838;Epe;2012;31408;6656;18121;6631;27559;2049;803;1246;1800;1012;788;141;78;63;128;54;74;875;466;409;138;66;72;518;348;170;259.0;331.0;135.0;101.0;866.0;1085.0;232
3839;Epe;2013;31154;6521;17842;6791;27265;2041;799;1242;1848;1060;788;164;93;71;124;64;60;851;457;394;153;74;79;556;372;184;258.0;335.0;139.0;97.0;1009.0;1058.0;232
3840;Epe;2014;31073;6409;17723;6941;27127;2039;795;1244;1907;1083;824;183;100;83;128;64;64;838;448;390;166;80;86;592;391;201;257.0;332.0;143.0;94.0;962.0;1068.0;232
3841;Epe;2015;30945;6296;17594;7055;26919;2048;788;1260;1978;1118;860;191;104;87;145;76;69;834;439;395;180;90;90;628;409;219;266.0;341.0;147.0;94.0;1017.0;1052.0;232
3842;Epe;2016;30892;6193;17557;7142;26801;2045;803;1242;2046;1137;909;194;106;88;151;75;76;834;430;404;196;96;100;671;430;241;262.0;340.0;151.0;97.0;989.0;1077.0;232
3843;Epe;2017;30784;6065;17490;7229;26622;2043;804;1239;2119;1170;949;207;109;98;150;74;76;842;430;412;200;100;100;720;457;263;267.0;342.0;141.0;98.0;1050.0;1095.0;232
3844;Epe;2018;30707;6002;17372;7333;26495;2043;811;1232;2169;1190;979;216;111;105;154;77;77;817;408;409;218;104;114;764;490;274;273.0;347.0;138.0;91.0;956.0;1067.0;232
3845;Epe;2019;30572;5875;17307;7390;26269;2056;817;1239;2247;1231;1016;235;121;114;163;86;77;820;410;410;230;105;125;799;509;290;269.0;343.0;135.0;91.0;1024.0;1076.0;232
3846;Epe;2020;30492;5784;17209;7499;26122;2064;819;1245;2306;1265;1041;243;127;116;169;87;82;829;413;416;239;110;129;826;528;298;272.0;350.0;138.0;97.0;946.0;1071.0;232
3847;Epe;2021;30332;5643;17152;7537;25931;2066;832;1234;2335;1280;1055;251;132;119;184;98;86;824;407;417;247;117;130;829;526;303;277.0;361.0;140.0;93.0;953.0;1040.0;232
3848;Epe;2022;30211;5566;17035;7610;25740;2084;861;1223;2387;1297;1090;256;134;122;193;102;91;823;402;421;256;118;138;859;541;318;284.0;354.0;142.0;93.0;865.0;1043.0;232
3849;Epe;2023;30015;5476;16877;7662;25519;2065;855;1210;2431;1327;1104;274;146;128;193;104;89;806;393;413;268;124;144;890;560;330;278.0;356.0;142.0;95.0;1001.0;1035.0;232
3850;Epe;2024;29951;5466;16708;7777;25384;2063;853;1210;2504;1340;1164;284;149;135;196;99;97;815;394;421;272;124;148;937;574;363;284.0;363.0;146.0;96.0;1017.0;1036.0;232
3851;Epe;2025;29904;5462;16571;7871;25270;2054;848;1206;2580;1386;1194;287;153;134;207;101;106;818;396;422;277;128;149;991;608;383;;;;;;;232
3852;Ermelo;2008;25715;6270;15015;4430;23352;1382;471;911;981;544;437;108;50;58;68;25;43;185;102;83;109;55;54;511;312;199;256.0;244.0;101.0;110.0;1095.0;1351.0;233
3853;Ermelo;2009;25468;6042;14913;4513;23072;1392;483;909;1004;548;456;125;59;66;79;37;42;187;102;85;120;53;67;493;297;196;251.0;245.0;110.0;117.0;1069.0;1338.0;233
3854;Ermelo;2010;25199;5829;14754;4616;22778;1372;469;903;1049;557;492;134;65;69;83;39;44;200;99;101;128;51;77;504;303;201;247.0;242.0;120.0;110.0;1210.0;1351.0;233
3855;Ermelo;2011;25080;5693;14719;4668;22616;1367;459;908;1097;584;513;146;72;74;82;41;41;211;102;109;135;58;77;523;311;212;245.0;243.0;110.0;113.0;1123.0;1341.0;233
3856;Ermelo;2012;24863;5540;14524;4799;22378;1351;450;901;1134;592;542;144;68;76;91;47;44;226;107;119;141;56;85;532;314;218;239.0;248.0;118.0;111.0;1148.0;1321.0;233
3857;Ermelo;2013;24688;5388;14377;4923;22185;1332;446;886;1171;601;570;156;73;83;87;46;41;242;108;134;153;59;94;533;315;218;234.0;245.0;106.0;101.0;1018.0;1261.0;233
3858;Ermelo;2014;24443;5235;14182;5026;21922;1340;448;892;1181;607;574;148;75;73;95;51;44;236;105;131;170;65;105;532;311;221;233.0;244.0;107.0;110.0;1079.0;1277.0;233
3859;Ermelo;2015;24231;5154;13981;5096;21658;1346;453;893;1227;624;603;164;82;82;103;58;45;255;113;142;155;57;98;550;314;236;235.0;248.0;104.0;100.0;1054.0;1280.0;233
3860;Ermelo;2016;23999;4995;13811;5193;21415;1353;457;896;1231;635;596;165;83;82;107;62;45;268;128;140;156;59;97;535;303;232;232.0;251.0;101.0;96.0;1133.0;1238.0;233
3861;Ermelo;2017;23883;4936;13686;5261;21269;1358;449;909;1256;657;599;169;91;78;104;64;40;276;126;150;172;63;109;535;313;222;225.0;248.0;107.0;103.0;1126.0;1253.0;233
3862;Ermelo;2018;23737;4831;13582;5324;21123;1322;443;879;1292;676;616;178;91;87;110;63;47;275;126;149;175;66;109;554;330;224;224.0;250.0;95.0;93.0;1179.0;1236.0;233
3863;Ermelo;2019;23661;4754;13486;5421;21040;1294;430;864;1327;701;626;178;96;82;115;68;47;275;130;145;187;66;121;572;341;231;228.0;253.0;95.0;94.0;1187.0;1235.0;233
3864;Ermelo;2020;23591;4708;13381;5502;20946;1275;413;862;1370;721;649;179;93;86;105;66;39;272;134;138;202;71;131;612;357;255;234.0;259.0;106.0;93.0;1189.0;1217.0;233
3865;Ermelo;2021;23553;4650;13348;5555;20839;1294;424;870;1420;757;663;191;99;92;123;71;52;284;143;141;215;76;139;607;368;239;238.0;263.0;95.0;95.0;1147.0;1211.0;233
3866;Ermelo;2022;23466;4607;13213;5646;20713;1284;417;867;1469;782;687;204;102;102;127;77;50;291;143;148;217;74;143;630;386;244;231.0;266.0;100.0;94.0;1217.0;1193.0;233
3867;Ermelo;2023;23462;4593;13149;5720;20626;1295;419;876;1541;810;731;223;110;113;129;79;50;300;145;155;237;81;156;652;395;257;236.0;257.0;97.0;85.0;1212.0;1243.0;233
3868;Ermelo;2024;23425;4550;13069;5806;20526;1299;424;875;1600;845;755;224;110;114;140;83;57;315;149;166;234;87;147;687;416;271;232.0;263.0;99.0;89.0;1165.0;1221.0;233
3869;Ermelo;2025;23356;4547;12917;5892;20429;1279;422;857;1648;850;798;236;110;126;147;83;64;305;151;154;246;89;157;714;417;297;;;;;;;233
3870;Etten-Leur;2008;40758;9908;25281;5569;33714;3477;1475;2002;3567;2056;1511;309;154;155;247;108;139;820;437;383;755;356;399;1436;1001;435;427.0;317.0;228.0;279.0;1547.0;1373.0;777
3871;Etten-Leur;2009;40996;9856;25345;5795;33864;3515;1489;2026;3617;2059;1558;323;158;165;248;115;133;838;443;395;768;351;417;1440;992;448;432.0;328.0;238.0;274.0;1495.0;1387.0;777
3872;Etten-Leur;2010;41176;9840;25316;6020;33946;3550;1508;2042;3680;2069;1611;339;174;165;255;120;135;855;451;404;787;348;439;1444;976;468;415.0;333.0;237.0;275.0;1489.0;1404.0;777
3873;Etten-Leur;2011;41308;9789;25280;6239;33978;3595;1528;2067;3735;2093;1642;362;187;175;269;128;141;859;452;407;798;353;445;1447;973;474;412.0;353.0;248.0;257.0;1591.0;1509.0;777
3874;Etten-Leur;2012;41448;9743;25163;6542;33977;3667;1550;2117;3804;2109;1695;362;180;182;273;135;138;867;448;419;818;362;456;1484;984;500;407.0;362.0;243.0;270.0;1493.0;1515.0;777
3875;Etten-Leur;2013;41446;9592;25037;6817;33912;3684;1560;2124;3850;2090;1760;379;188;191;282;136;146;869;450;419;837;365;472;1483;951;532;400.0;361.0;249.0;267.0;1470.0;1479.0;777
3876;Etten-Leur;2014;41460;9498;24893;7069;33810;3776;1609;2167;3874;2073;1801;382;189;193;286;142;144;880;451;429;843;357;486;1483;934;549;400.0;371.0;236.0;253.0;1532.0;1503.0;777
3877;Etten-Leur;2015;41505;9401;24785;7319;33764;3836;1668;2168;3905;2071;1834;406;200;206;277;143;134;883;457;426;846;344;502;1493;927;566;390.0;377.0;238.0;251.0;1538.0;1472.0;777
3878;Etten-Leur;2016;41577;9352;24639;7586;33700;3891;1701;2190;3986;2075;1911;427;207;220;284;151;133;903;459;444;861;338;523;1511;920;591;389.0;394.0;267.0;255.0;1448.0;1483.0;777
3879;Etten-Leur;2017;41554;9278;24476;7800;33578;3938;1706;2232;4038;2098;1940;435;210;225;280;151;129;910;462;448;877;347;530;1536;928;608;394.0;396.0;249.0;245.0;1463.0;1475.0;777
3880;Etten-Leur;2018;41549;9192;24386;7971;33509;3972;1737;2235;4068;2091;1977;448;209;239;289;158;131;904;447;457;882;341;541;1545;936;609;400.0;399.0;241.0;245.0;1466.0;1484.0;777
3881;Etten-Leur;2019;41532;9120;24266;8146;33418;4030;1789;2241;4084;2094;1990;451;204;247;290;158;132;914;455;459;869;334;535;1560;943;617;399.0;402.0;233.0;243.0;1487.0;1425.0;777
3882;Etten-Leur;2020;41583;9035;24221;8327;33373;4056;1800;2256;4154;2102;2052;466;212;254;287;154;133;916;455;461;893;334;559;1592;947;645;399.0;423.0;228.0;250.0;1578.0;1518.0;777
3883;Etten-Leur;2021;41601;8971;24134;8496;33346;4058;1782;2276;4197;2103;2094;470;215;255;289;156;133;931;462;469;905;329;576;1602;941;661;392.0;425.0;240.0;242.0;1462.0;1516.0;777
3884;Etten-Leur;2022;41515;8836;23999;8680;33209;4070;1809;2261;4236;2107;2129;486;223;263;299;163;136;905;442;463;918;332;586;1628;947;681;392.0;429.0;230.0;234.0;1532.0;1541.0;777
3885;Etten-Leur;2023;41468;8784;23847;8837;33064;4139;1839;2300;4265;2103;2162;495;224;271;293;163;130;910;447;463;939;325;614;1628;944;684;398.0;439.0;232.0;246.0;1434.0;1466.0;777
3886;Etten-Leur;2024;41386;8690;23690;9006;32923;4140;1832;2308;4323;2127;2196;492;221;271;295;166;129;931;453;478;952;330;622;1653;957;696;389.0;443.0;216.0;235.0;1464.0;1522.0;777
3887;Etten-Leur;2025;41256;8616;23489;9151;32737;4144;1824;2320;4375;2156;2219;496;231;265;303;170;133;922;444;478;969;339;630;1685;972;713;;;;;;;777
3888;Ferwerderadiel;2008;8840;2356;5217;1267;8396;282;88;194;162;87;75;21;13;8;23;14;9;10;5;5;18;7;11;90;48;42;118.0;73.0;21.0;30.0;331.0;424.0;1722
3889;Ferwerderadiel;2009;8783;2347;5124;1312;8312;295;90;205;176;88;88;22;12;10;28;15;13;20;9;11;22;7;15;84;45;39;112.0;76.0;20.0;31.0;324.0;406.0;1722
3890;Ferwerderadiel;2010;8726;2330;5046;1350;8235;298;90;208;193;95;98;25;14;11;28;15;13;20;10;10;28;8;20;92;48;44;108.0;75.0;20.0;24.0;366.0;397.0;1722
3891;Ferwerderadiel;2011;8727;2315;5022;1390;8207;293;92;201;227;110;117;25;15;10;34;16;18;26;13;13;33;9;24;109;57;52;103.0;74.0;25.0;31.0;380.0;393.0;1722
3892;Ferwerderadiel;2012;8738;2308;4968;1462;8205;295;98;197;238;110;128;32;18;14;40;21;19;33;14;19;30;10;20;103;47;56;101.0;76.0;26.0;27.0;303.0;388.0;1722
3893;Ferwerderadiel;2013;8679;2260;4888;1531;8116;314;103;211;249;107;142;33;19;14;43;22;21;34;15;19;31;11;20;108;40;68;95.0;81.0;20.0;28.0;351.0;379.0;1722
3894;Ferwerderadiel;2014;8659;2243;4822;1594;8077;318;99;219;264;119;145;38;21;17;46;22;24;32;15;17;34;12;22;114;49;65;88.0;82.0;29.0;29.0;345.0;397.0;1722
3895;Ferwerderadiel;2015;8615;2197;4777;1641;8019;317;101;216;279;124;155;37;21;16;46;20;26;37;14;23;37;14;23;122;55;67;91.0;78.0;21.0;31.0;365.0;408.0;1722
3896;Ferwerderadiel;2016;8577;2168;4737;1672;7994;310;89;221;273;123;150;41;25;16;47;20;27;39;13;26;40;15;25;106;50;56;92.0;81.0;19.0;26.0;319.0;408.0;1722
3897;Ferwerderadiel;2017;8493;2137;4643;1713;7890;316;90;226;287;130;157;42;25;17;50;20;30;46;18;28;42;15;27;107;52;55;90.0;79.0;18.0;25.0;327.0;389.0;1722
3898;Ferwerderadiel;2018;8436;2090;4597;1749;7838;305;84;221;293;137;156;40;23;17;46;19;27;46;18;28;45;14;31;116;63;53;88.0;81.0;20.0;29.0;364.0;411.0;1722
3899;Ferwerderadiel;2019;8388;2036;4579;1773;7779;312;85;227;297;140;157;40;24;16;45;20;25;56;21;35;45;16;29;111;59;52;85.0;85.0;24.0;25.0;272.0;404.0;1722
3900;Ferwerderadiel;2020;8256;1969;4487;1800;7645;304;92;212;307;151;156;42;25;17;45;20;25;57;26;31;45;16;29;118;64;54;86.0;82.0;19.0;29.0;303.0;400.0;1722
3901;Ferwerderadiel;2021;8155;1916;4404;1835;7529;309;95;214;317;157;160;45;27;18;47;22;25;59;27;32;53;20;33;113;61;52;82.0;84.0;25.0;28.0;377.0;395.0;1722
3902;Ferwerderadiel;2022;8133;1875;4372;1886;7480;314;96;218;339;162;177;53;27;26;50;23;27;69;28;41;54;21;33;113;63;50;80.0;84.0;21.0;25.0;298.0;382.0;1722
3903;Ferwerderadiel;2023;8042;1836;4287;1919;7396;302;89;213;344;166;178;49;27;22;53;24;29;67;28;39;60;22;38;115;65;50;73.0;86.0;18.0;26.0;305.0;389.0;1722
3904;Ferwerderadiel;2024;7938;1774;4226;1938;7298;302;87;215;338;160;178;47;24;23;49;21;28;63;27;36;58;20;38;121;68;53;70.0;86.0;24.0;27.0;309.0;368.0;1722
3905;Ferwerderadiel;2025;7861;1742;4165;1954;7209;301;77;224;351;159;192;46;23;23;47;20;27;66;24;42;64;20;44;128;72;56;;;;;;;1722
3906;Franekeradeel;2008;20759;5143;12451;3165;18958;1004;337;667;797;502;295;86;49;37;37;20;17;61;30;31;113;49;64;500;354;146;238.0;186.0;68.0;104.0;1018.0;1068.0;70
3907;Franekeradeel;2009;20727;5100;12362;3265;18913;992;334;658;822;505;317;88;48;40;40;25;15;70;32;38;127;55;72;497;345;152;231.0;188.0;65.0;100.0;900.0;1002.0;70
3908;Franekeradeel;2010;20636;4975;12317;3344;18769;1013;354;659;854;508;346;94;45;49;51;33;18;86;35;51;140;60;80;483;335;148;233.0;189.0;63.0;99.0;940.0;967.0;70
3909;Franekeradeel;2011;20619;4918;12309;3392;18738;1018;355;663;863;505;358;102;53;49;58;35;23;87;35;52;147;60;87;469;322;147;224.0;189.0;75.0;93.0;868.0;933.0;70
3910;Franekeradeel;2012;20574;4801;12211;3562;18664;993;338;655;917;539;378;110;53;57;58;36;22;88;37;51;162;68;94;499;345;154;220.0;192.0;68.0;93.0;851.0;943.0;70
3911;Franekeradeel;2013;20491;4740;12085;3666;18574;998;340;658;919;526;393;110;51;59;59;34;25;95;38;57;172;77;95;483;326;157;222.0;192.0;66.0;88.0;847.0;947.0;70
3912;Franekeradeel;2014;20402;4655;11983;3764;18468;987;342;645;947;529;418;119;54;65;58;37;21;104;47;57;182;79;103;484;312;172;217.0;193.0;62.0;91.0;862.0;946.0;70
3913;Franekeradeel;2015;20314;4565;11931;3818;18363;985;336;649;966;520;446;127;59;68;68;41;27;110;47;63;207;82;125;454;291;163;220.0;189.0;64.0;85.0;864.0;959.0;70
3914;Franekeradeel;2016;20233;4504;11810;3919;18260;991;341;650;982;519;463;135;61;74;69;42;27;108;49;59;230;84;146;440;283;157;215.0;196.0;66.0;85.0;875.0;978.0;70
3915;Franekeradeel;2017;20130;4419;11693;4018;18166;988;341;647;976;508;468;144;64;80;64;38;26;106;49;57;235;84;151;427;273;154;213.0;194.0;64.0;81.0;832.0;908.0;70
3916;Franekeradeel;2018;20061;4340;11591;4130;18072;989;354;635;1000;507;493;152;65;87;67;40;27;114;52;62;251;90;161;416;260;156;212.0;198.0;57.0;85.0;917.0;979.0;70
3917;Franekeradeel;2019;19984;4243;11499;4242;17935;999;351;648;1050;517;533;157;65;92;66;40;26;124;56;68;283;94;189;420;262;158;209.0;202.0;70.0;81.0;859.0;947.0;70
3918;Franekeradeel;2020;19901;4153;11406;4342;17830;993;350;643;1078;510;568;161;64;97;75;42;33;122;57;65;300;96;204;420;251;169;209.0;211.0;65.0;79.0;865.0;972.0;70
3919;Franekeradeel;2021;19779;4057;11271;4451;17666;1019;359;660;1094;516;578;156;71;85;78;43;35;133;58;75;309;99;210;418;245;173;207.0;209.0;52.0;75.0;857.0;961.0;70
3920;Franekeradeel;2022;19652;3975;11184;4493;17550;996;358;638;1106;518;588;160;74;86;84;46;38;140;63;77;312;98;214;410;237;173;201.0;210.0;64.0;70.0;860.0;960.0;70
3921;Franekeradeel;2023;19540;3904;11079;4557;17400;1001;367;634;1139;534;605;167;74;93;90;49;41;141;62;79;328;101;227;413;248;165;195.0;211.0;54.0;74.0;826.0;912.0;70
3922;Franekeradeel;2024;19418;3850;10961;4607;17265;990;363;627;1163;549;614;179;76;103;90;50;40;148;68;80;340;106;234;406;249;157;207.0;221.0;53.0;76.0;832.0;913.0;70
3923;Franekeradeel;2025;19304;3799;10829;4676;17155;969;352;617;1180;550;630;178;76;102;92;51;41;150;67;83;362;109;253;398;247;151;;;;;;;70
3924;Gaasterlân-Sleat;2008;10209;2512;5736;1961;9712;379;122;257;118;65;53;16;9;7;26;11;15;11;5;6;9;5;4;56;35;21;101.0;107.0;18.0;31.0;368.0;344.0;653
3925;Gaasterlân-Sleat;2009;10218;2462;5782;1974;9688;373;119;254;157;86;71;20;11;9;27;12;15;15;7;8;13;7;6;82;49;33;96.0;111.0;20.0;34.0;346.0;361.0;653
3926;Gaasterlân-Sleat;2010;10176;2366;5791;2019;9630;377;117;260;169;95;74;21;12;9;28;13;15;17;9;8;13;8;5;90;53;37;95.0;111.0;28.0;32.0;406.0;354.0;653
3927;Gaasterlân-Sleat;2011;10210;2320;5838;2052;9636;393;116;277;181;97;84;24;14;10;26;11;15;18;9;9;21;10;11;92;53;39;97.0;111.0;22.0;31.0;312.0;368.0;653
3928;Gaasterlân-Sleat;2012;10132;2239;5784;2109;9557;393;110;283;182;96;86;24;14;10;25;12;13;18;9;9;22;8;14;93;53;40;97.0;112.0;31.0;30.0;386.0;360.0;653
3929;Gaasterlân-Sleat;2013;10143;2190;5795;2158;9553;391;106;285;199;98;101;28;15;13;27;12;15;23;9;14;26;9;17;95;53;42;95.0;109.0;21.0;32.0;345.0;355.0;653
3930;Gaasterlân-Sleat;2014;10109;2118;5783;2208;9500;388;107;281;221;111;110;28;16;12;27;14;13;25;9;16;35;11;24;106;61;45;97.0;115.0;21.0;31.0;347.0;355.0;653
3931;Gaasterlân-Sleat;2015;10072;2056;5747;2269;9441;393;110;283;238;122;116;32;18;14;25;13;12;29;12;17;37;13;24;115;66;49;98.0;112.0;33.0;34.0;304.0;351.0;653
3932;Gaasterlân-Sleat;2016;10011;2014;5674;2323;9359;401;114;287;251;134;117;35;21;14;26;13;13;37;16;21;34;15;19;119;69;50;92.0;113.0;21.0;32.0;355.0;358.0;653
3933;Gaasterlân-Sleat;2017;9977;1959;5657;2361;9303;403;114;289;271;143;128;38;23;15;26;13;13;46;18;28;41;17;24;120;72;48;91.0;115.0;24.0;28.0;414.0;364.0;653
3934;Gaasterlân-Sleat;2018;10000;1910;5691;2399;9291;411;115;296;298;165;133;43;27;16;27;13;14;53;25;28;43;16;27;132;84;48;95.0;115.0;23.0;30.0;388.0;356.0;653
3935;Gaasterlân-Sleat;2019;10010;1889;5646;2475;9275;430;121;309;305;165;140;43;28;15;27;13;14;49;22;27;40;14;26;146;88;58;91.0;118.0;23.0;32.0;376.0;353.0;653
3936;Gaasterlân-Sleat;2020;9998;1844;5640;2514;9246;431;121;310;321;174;147;42;29;13;28;14;14;50;23;27;45;14;31;156;94;62;94.0;121.0;24.0;27.0;379.0;344.0;653
3937;Gaasterlân-Sleat;2021;10002;1792;5638;2572;9239;434;115;319;329;172;157;41;27;14;27;15;12;60;22;38;45;17;28;156;91;65;92.0;122.0;25.0;29.0;349.0;353.0;653
3938;Gaasterlân-Sleat;2022;9967;1758;5597;2612;9184;439;122;317;344;177;167;47;29;18;29;15;14;65;26;39;49;17;32;154;90;64;95.0;123.0;24.0;27.0;371.0;335.0;653
3939;Gaasterlân-Sleat;2023;9972;1738;5578;2656;9173;438;118;320;361;193;168;50;31;19;32;18;14;69;30;39;47;17;30;163;97;66;95.0;127.0;22.0;31.0;409.0;330.0;653
3940;Gaasterlân-Sleat;2024;10011;1721;5588;2702;9198;443;123;320;370;198;172;51;32;19;34;19;15;72;35;37;51;21;30;162;91;71;94.0;133.0;21.0;27.0;400.0;348.0;653
3941;Gaasterlân-Sleat;2025;10018;1724;5531;2763;9178;448;122;326;392;204;188;52;30;22;36;20;16;80;39;41;55;23;32;169;92;77;;;;;;;653
3942;Geertruidenberg;2008;20879;4790;13153;2936;18997;1227;447;780;655;374;281;140;72;68;43;22;21;121;62;59;67;32;35;284;186;98;201.0;199.0;77.0;109.0;720.0;677.0;779
3943;Geertruidenberg;2009;20895;4782;13100;3013;18936;1241;459;782;718;398;320;155;78;77;50;23;27;145;70;75;66;31;35;302;196;106;203.0;199.0;87.0;104.0;745.0;741.0;779
3944;Geertruidenberg;2010;20888;4761;13000;3127;18868;1257;475;782;763;412;351;159;81;78;58;28;30;158;71;87;77;32;45;311;200;111;204.0;200.0;88.0;104.0;757.0;749.0;779
3945;Geertruidenberg;2011;20886;4754;12888;3244;18835;1261;487;774;790;422;368;163;80;83;62;31;31;166;72;94;85;33;52;314;206;108;201.0;203.0;89.0;103.0;766.0;779.0;779
3946;Geertruidenberg;2012;20859;4713;12748;3398;18766;1276;495;781;817;434;383;171;84;87;66;33;33;180;79;101;89;35;54;311;203;108;192.0;208.0;98.0;100.0;756.0;751.0;779
3947;Geertruidenberg;2013;20849;4643;12655;3551;18684;1300;501;799;865;450;415;190;96;94;70;34;36;189;86;103;93;38;55;323;196;127;190.0;217.0;82.0;100.0;683.0;754.0;779
3948;Geertruidenberg;2014;20734;4531;12506;3697;18519;1325;513;812;890;468;422;196;96;100;67;31;36;190;91;99;98;38;60;339;212;127;185.0;211.0;85.0;96.0;746.0;750.0;779
3949;Geertruidenberg;2015;20694;4471;12402;3821;18421;1345;508;837;928;495;433;203;103;100;71;37;34;194;95;99;105;45;60;355;215;140;185.0;224.0;88.0;98.0;689.0;740.0;779
3950;Geertruidenberg;2016;20599;4426;12273;3900;18261;1374;522;852;964;515;449;206;100;106;72;37;35;210;98;112;115;50;65;361;230;131;184.0;226.0;108.0;99.0;749.0;721.0;779
3951;Geertruidenberg;2017;20603;4419;12200;3984;18177;1389;535;854;1037;543;494;214;105;109;86;42;44;217;96;121;134;52;82;386;248;138;183.0;224.0;93.0;95.0;694.0;730.0;779
3952;Geertruidenberg;2018;20528;4344;12102;4082;18058;1386;521;865;1084;564;520;217;101;116;90;46;44;232;105;127;143;53;90;402;259;143;179.0;232.0;102.0;96.0;702.0;743.0;779
3953;Geertruidenberg;2019;20441;4276;11991;4174;17922;1385;528;857;1134;601;533;224;108;116;92;51;41;245;106;139;151;58;93;422;278;144;183.0;236.0;91.0;95.0;746.0;739.0;779
3954;Geertruidenberg;2020;20394;4244;11901;4249;17870;1381;538;843;1143;613;530;221;107;114;103;57;46;254;117;137;149;60;89;416;272;144;182.0;233.0;91.0;93.0;741.0;734.0;779
3955;Geertruidenberg;2021;20354;4168;11833;4353;17797;1380;537;843;1177;629;548;232;109;123;104;56;48;264;123;141;153;61;92;424;280;144;180.0;235.0;82.0;88.0;723.0;760.0;779
3956;Geertruidenberg;2022;20260;4111;11731;4418;17657;1393;551;842;1210;631;579;240;113;127;107;54;53;266;124;142;164;62;102;433;278;155;185.0;240.0;87.0;95.0;860.0;730.0;779
3957;Geertruidenberg;2023;20330;4107;11724;4499;17646;1411;561;850;1273;657;616;239;111;128;107;53;54;285;128;157;172;65;107;470;300;170;189.0;250.0;84.0;92.0;812.0;765.0;779
3958;Geertruidenberg;2024;20311;4094;11671;4546;17565;1419;568;851;1327;667;660;252;114;138;116;57;59;310;137;173;174;62;112;475;297;178;187.0;248.0;83.0;94.0;802.0;770.0;779
3959;Geertruidenberg;2025;20274;4038;11614;4622;17458;1431;577;854;1385;698;687;259;119;140;123;59;64;321;146;175;187;69;118;495;305;190;;;;;;;779
3960;Geldermalsen;2008;26035;6961;15647;3427;24008;1174;359;815;853;480;373;83;39;44;82;39;43;47;23;24;276;132;144;365;247;118;278.0;180.0;62.0;99.0;732.0;868.0;236
3961;Geldermalsen;2009;25963;6857;15560;3546;23911;1165;360;805;887;491;396;85;41;44;87;42;45;64;29;35;275;123;152;376;256;120;269.0;185.0;60.0;96.0;827.0;876.0;236
3962;Geldermalsen;2010;25971;6784;15493;3694;23885;1150;352;798;936;507;429;94;47;47;85;42;43;73;32;41;276;121;155;408;265;143;258.0;191.0;59.0;97.0;849.0;896.0;236
3963;Geldermalsen;2011;25956;6631;15513;3812;23811;1186;383;803;959;522;437;103;51;52;88;44;44;81;36;45;279;131;148;408;260;148;256.0;196.0;76.0;93.0;857.0;913.0;236
3964;Geldermalsen;2012;25945;6506;15418;4021;23741;1206;381;825;998;534;464;111;53;58;95;48;47;94;42;52;281;127;154;417;264;153;258.0;198.0;58.0;94.0;833.0;921.0;236
3965;Geldermalsen;2013;25884;6356;15321;4207;23641;1203;373;830;1040;545;495;121;52;69;94;48;46;109;47;62;286;129;157;430;269;161;248.0;204.0;60.0;88.0;874.0;921.0;236
3966;Geldermalsen;2014;25859;6242;15225;4392;23566;1207;371;836;1086;569;517;138;61;77;99;50;49;126;53;73;286;127;159;437;278;159;244.0;205.0;63.0;97.0;821.0;929.0;236
3967;Geldermalsen;2015;25759;6108;15119;4532;23440;1198;358;840;1121;592;529;145;65;80;102;54;48;127;56;71;286;125;161;461;292;169;243.0;211.0;66.0;92.0;956.0;922.0;236
3968;Geldermalsen;2016;25798;6000;15134;4664;23426;1202;369;833;1170;596;574;159;72;87;108;54;54;138;55;83;282;118;164;483;297;186;254.0;214.0;66.0;86.0;840.0;949.0;236
3969;Geldermalsen;2017;25710;5886;15028;4796;23311;1201;380;821;1198;606;592;172;82;90;109;55;54;149;60;89;285;121;164;483;288;195;253.0;222.0;64.0;84.0;912.0;901.0;236
3970;Geldermalsen;2018;25734;5813;14991;4930;23284;1185;384;801;1265;631;634;199;91;108;113;55;58;157;66;91;287;121;166;509;298;211;254.0;221.0;63.0;84.0;829.0;938.0;236
3971;Geldermalsen;2019;25635;5683;14918;5034;23136;1181;389;792;1318;665;653;200;94;106;113;54;59;171;67;104;303;127;176;531;323;208;258.0;227.0;70.0;89.0;898.0;947.0;236
3972;Geldermalsen;2020;25602;5533;14916;5153;23082;1190;394;796;1330;670;660;208;96;112;107;50;57;169;72;97;307;127;180;539;325;214;263.0;231.0;62.0;88.0;775.0;935.0;236
3973;Geldermalsen;2021;25452;5394;14800;5258;22940;1156;387;769;1356;691;665;215;100;115;113;55;58;186;75;111;295;128;167;547;333;214;255.0;240.0;59.0;85.0;883.0;919.0;236
3974;Geldermalsen;2022;25406;5318;14742;5346;22874;1151;380;771;1381;694;687;215;100;115;115;59;56;202;83;119;292;119;173;557;333;224;261.0;238.0;58.0;83.0;877.0;928.0;236
3975;Geldermalsen;2023;25355;5273;14650;5432;22771;1174;399;775;1410;708;702;225;104;121;114;57;57;210;86;124;287;118;169;574;343;231;261.0;244.0;64.0;83.0;822.0;918.0;236
3976;Geldermalsen;2024;25260;5200;14497;5563;22636;1181;410;771;1443;731;712;219;103;116;121;63;58;225;94;131;290;118;172;588;353;235;251.0;246.0;61.0;78.0;944.0;919.0;236
3977;Geldermalsen;2025;25274;5170;14473;5631;22618;1203;420;783;1453;730;723;216;104;112;121;61;60;227;96;131;295;117;178;594;352;242;;;;;;;236
3978;Geldrop-Mierlo;2008;38333;9120;23116;6097;32764;3246;1145;2101;2323;1288;1035;293;136;157;217;128;89;492;234;258;256;93;163;1065;697;368;362.0;328.0;206.0;263.0;1788.0;1616.0;1771
3979;Geldrop-Mierlo;2009;38486;9104;23096;6286;32785;3227;1130;2097;2474;1380;1094;296;139;157;215;130;85;545;272;273;297;100;197;1121;739;382;358.0;332.0;207.0;260.0;1824.0;1659.0;1771
3980;Geldrop-Mierlo;2010;38630;9027;23157;6446;32839;3236;1108;2128;2555;1431;1124;306;140;166;222;131;91;580;289;291;309;112;197;1138;759;379;364.0;343.0;217.0;254.0;1701.0;1688.0;1771
3981;Geldrop-Mierlo;2011;38636;8969;23103;6564;32768;3211;1102;2109;2657;1471;1186;313;143;170;234;139;95;602;297;305;319;115;204;1189;777;412;358.0;344.0;216.0;251.0;1680.0;1717.0;1771
3982;Geldrop-Mierlo;2012;38579;8881;22930;6768;32567;3216;1097;2119;2796;1504;1292;340;154;186;242;145;97;659;306;353;336;117;219;1219;782;437;354.0;354.0;215.0;244.0;1577.0;1692.0;1771
3983;Geldrop-Mierlo;2013;38441;8782;22675;6984;32352;3230;1120;2110;2859;1504;1355;332;152;180;255;153;102;682;307;375;368;118;250;1222;774;448;354.0;361.0;221.0;232.0;1621.0;1722.0;1771
3984;Geldrop-Mierlo;2014;38327;8642;22515;7170;32173;3234;1138;2096;2920;1523;1397;340;159;181;249;145;104;714;320;394;378;123;255;1239;776;463;354.0;364.0;219.0;234.0;1578.0;1658.0;1771
3985;Geldrop-Mierlo;2015;38224;8567;22297;7360;31983;3234;1140;2094;3007;1580;1427;360;168;192;238;141;97;736;325;411;376;123;253;1297;823;474;354.0;375.0;221.0;236.0;1636.0;1662.0;1771
3986;Geldrop-Mierlo;2016;38166;8521;22115;7530;31815;3219;1145;2074;3132;1622;1510;367;165;202;234;141;93;777;335;442;412;133;279;1342;848;494;356.0;368.0;220.0;229.0;1574.0;1684.0;1771
3987;Geldrop-Mierlo;2017;38038;8434;21952;7652;31579;3218;1148;2070;3241;1675;1566;374;178;196;248;151;97;800;348;452;452;146;306;1367;852;515;366.0;380.0;210.0;224.0;1583.0;1655.0;1771
3988;Geldrop-Mierlo;2018;37939;8347;21769;7823;31373;3224;1177;2047;3342;1674;1668;385;173;212;269;160;109;827;347;480;491;153;338;1370;841;529;365.0;390.0;211.0;227.0;1595.0;1669.0;1771
3989;Geldrop-Mierlo;2019;37827;8230;21646;7951;31163;3192;1166;2026;3472;1717;1755;397;182;215;269;158;111;861;360;501;520;155;365;1425;862;563;361.0;392.0;212.0;221.0;1580.0;1650.0;1771
3990;Geldrop-Mierlo;2020;37718;8110;21516;8092;30965;3201;1178;2023;3552;1739;1813;407;186;221;276;158;118;881;354;527;534;159;375;1454;882;572;365.0;405.0;216.0;212.0;1578.0;1638.0;1771
3991;Geldrop-Mierlo;2021;37626;7994;21424;8208;30738;3216;1198;2018;3672;1799;1873;429;194;235;290;170;120;916;368;548;533;160;373;1504;907;597;364.0;400.0;213.0;218.0;1584.0;1656.0;1771
3992;Geldrop-Mierlo;2022;37517;7928;21246;8343;30540;3215;1188;2027;3762;1818;1944;446;201;245;307;174;133;939;369;570;535;153;382;1535;921;614;373.0;401.0;223.0;216.0;1619.0;1641.0;1771
3993;Geldrop-Mierlo;2023;37477;7838;21161;8478;30387;3201;1178;2023;3889;1861;2028;453;205;248;304;174;130;987;386;601;559;157;402;1586;939;647;387.0;416.0;231.0;212.0;1580.0;1639.0;1771
3994;Geldrop-Mierlo;2024;37408;7813;20998;8597;30229;3190;1175;2015;3989;1892;2097;465;209;256;298;174;124;1020;396;624;578;161;417;1628;952;676;379.0;413.0;212.0;219.0;1588.0;1640.0;1771
3995;Geldrop-Mierlo;2025;37318;7755;20863;8700;30042;3196;1182;2014;4080;1905;2175;476;205;271;318;182;136;1042;401;641;592;164;428;1652;953;699;;;;;;;1771
3996;Gemert-Bakel;2008;27947;7002;17176;3769;25660;1577;627;950;710;441;269;94;45;49;33;14;19;72;48;24;90;38;52;421;296;125;265.0;219.0;116.0;127.0;758.0;852.0;1652
3997;Gemert-Bakel;2009;27894;6927;17091;3876;25520;1593;631;962;781;473;308;97;46;51;35;13;22;96;60;36;101;42;59;452;312;140;252.0;229.0;116.0;121.0;846.0;880.0;1652
3998;Gemert-Bakel;2010;27880;6858;17042;3980;25390;1633;645;988;857;518;339;104;52;52;42;19;23;114;61;53;102;45;57;495;341;154;258.0;231.0;129.0;123.0;806.0;931.0;1652
3999;Gemert-Bakel;2011;27792;6767;16913;4112;25230;1645;643;1002;917;540;377;111;57;54;53;26;27;122;62;60;111;44;67;520;351;169;254.0;240.0;147.0;126.0;885.0;933.0;1652
4000;Gemert-Bakel;2012;27780;6687;16805;4288;25129;1672;648;1024;979;574;405;114;56;58;55;28;27;145;74;71;113;44;69;552;372;180;249.0;249.0;133.0;120.0;943.0;949.0;1652
4001;Gemert-Bakel;2013;27789;6573;16740;4476;25050;1691;670;1021;1048;597;451;124;58;66;61;31;30;161;86;75;126;43;83;576;379;197;248.0;248.0;133.0;117.0;904.0;953.0;1652
4002;Gemert-Bakel;2014;27759;6450;16665;4644;24945;1710;678;1032;1104;627;477;142;68;74;63;32;31;176;90;86;137;45;92;586;392;194;248.0;254.0;148.0;113.0;932.0;932.0;1652
4003;Gemert-Bakel;2015;27791;6336;16619;4836;24884;1739;698;1041;1168;653;515;149;72;77;66;33;33;189;95;94;148;50;98;616;403;213;248.0;262.0;130.0;117.0;936.0;957.0;1652
4004;Gemert-Bakel;2016;27772;6297;16503;4972;24780;1784;718;1066;1208;693;515;152;77;75;70;32;38;199;101;98;149;53;96;638;430;208;253.0;261.0;140.0;121.0;946.0;936.0;1652
4005;Gemert-Bakel;2017;27796;6233;16435;5128;24720;1820;730;1090;1256;710;546;163;80;83;70;33;37;224;107;117;158;62;96;641;428;213;251.0;268.0;141.0;121.0;851.0;937.0;1652
4006;Gemert-Bakel;2018;27716;6120;16313;5283;24563;1828;731;1097;1325;742;583;177;84;93;75;40;35;226;110;116;179;66;113;668;442;226;264.0;275.0;137.0;114.0;1032.0;936.0;1652
4007;Gemert-Bakel;2019;27828;6091;16304;5433;24553;1868;752;1116;1407;774;633;189;89;100;80;44;36;247;115;132;188;69;119;703;457;246;265.0;281.0;142.0;117.0;980.0;963.0;1652
4008;Gemert-Bakel;2020;27856;6037;16206;5613;24461;1906;781;1125;1489;817;672;205;98;107;91;50;41;260;120;140;208;73;135;725;476;249;258.0;286.0;139.0;117.0;1047.0;960.0;1652
4009;Gemert-Bakel;2021;27939;5973;16172;5794;24447;1929;800;1129;1563;849;714;207;100;107;94;48;46;267;122;145;220;79;141;775;500;275;271.0;290.0;137.0;115.0;1039.0;978.0;1652
4010;Gemert-Bakel;2022;28005;5958;16151;5896;24359;1982;829;1153;1664;916;748;230;113;117;98;55;43;282;131;151;246;89;157;808;528;280;276.0;297.0;149.0;114.0;1035.0;967.0;1652
4011;Gemert-Bakel;2023;28087;5940;16102;6045;24342;2013;850;1163;1732;952;780;234;108;126;106;62;44;291;139;152;259;100;159;842;543;299;284.0;295.0;140.0;115.0;988.0;964.0;1652
4012;Gemert-Bakel;2024;28129;5899;16047;6183;24274;2041;863;1178;1814;996;818;241;112;129;115;68;47;307;144;163;279;105;174;872;567;305;292.0;306.0;152.0;114.0;991.0;937.0;1652
4013;Gemert-Bakel;2025;28209;5915;15989;6305;24251;2071;886;1185;1887;1023;864;253;118;135;118;66;52;336;156;180;293;107;186;887;576;311;;;;;;;1652
4014;Gennep;2008;16698;3824;10280;2594;14255;1741;505;1236;702;398;304;33;19;14;27;15;12;89;39;50;260;127;133;293;198;95;142.0;149.0;59.0;76.0;584.0;588.0;907
4015;Gennep;2009;16672;3791;10188;2693;14228;1704;480;1224;740;409;331;41;22;19;31;17;14;97;41;56;265;127;138;306;202;104;145.0;157.0;86.0;73.0;615.0;594.0;907
4016;Gennep;2010;16698;3759;10182;2757;14232;1690;463;1227;776;426;350;51;28;23;36;17;19;95;42;53;267;126;141;327;213;114;135.0;159.0;68.0;73.0;560.0;605.0;907
4017;Gennep;2011;16627;3702;10104;2821;14162;1664;448;1216;801;440;361;59;33;26;41;20;21;102;46;56;268;127;141;331;214;117;141.0;166.0;72.0;73.0;653.0;626.0;907
4018;Gennep;2012;16629;3685;9981;2963;14109;1682;460;1222;838;457;381;70;40;30;40;20;20;116;52;64;267;124;143;345;221;124;138.0;165.0;79.0;72.0;625.0;637.0;907
4019;Gennep;2013;16599;3627;9861;3111;14033;1702;481;1221;864;470;394;75;42;33;47;22;25;124;62;62;265;120;145;353;224;129;136.0;170.0;77.0;74.0;610.0;619.0;907
4020;Gennep;2014;16561;3560;9779;3222;14018;1673;473;1200;870;482;388;77;46;31;47;26;21;138;67;71;261;118;143;347;225;122;135.0;172.0;80.0;68.0;625.0;646.0;907
4021;Gennep;2015;16522;3497;9712;3313;13938;1678;480;1198;906;493;413;87;51;36;52;27;25;140;66;74;262;121;141;365;228;137;137.0;175.0;77.0;70.0;649.0;645.0;907
4022;Gennep;2016;16496;3437;9632;3427;13914;1661;476;1185;921;501;420;90;52;38;59;30;29;150;70;80;259;122;137;363;227;136;141.0;171.0;66.0;69.0;669.0;635.0;907
4023;Gennep;2017;16499;3416;9587;3496;13905;1632;474;1158;962;522;440;90;51;39;66;37;29;161;74;87;259;121;138;386;239;147;138.0;176.0;71.0;72.0;708.0;633.0;907
4024;Gennep;2018;16535;3392;9544;3599;13944;1615;489;1126;976;531;445;94;53;41;70;41;29;166;76;90;253;119;134;393;242;151;141.0;186.0;67.0;70.0;689.0;639.0;907
4025;Gennep;2019;16538;3361;9526;3651;13898;1623;486;1137;1017;557;460;97;55;42;80;48;32;173;81;92;257;118;139;410;255;155;152.0;184.0;82.0;62.0;637.0;632.0;907
4026;Gennep;2020;16535;3327;9515;3693;13860;1619;500;1119;1056;572;484;102;56;46;87;52;35;181;83;98;272;129;143;414;252;162;155.0;190.0;67.0;65.0;723.0;627.0;907
4027;Gennep;2021;16598;3295;9499;3804;13866;1656;506;1150;1076;584;492;112;64;48;91;55;36;187;86;101;266;122;144;420;257;163;158.0;192.0;71.0;66.0;646.0;648.0;907
4028;Gennep;2022;16569;3247;9439;3883;13824;1633;487;1146;1112;610;502;116;68;48;103;63;40;190;88;102;266;121;145;437;270;167;158.0;200.0;64.0;66.0;720.0;628.0;907
4029;Gennep;2023;16618;3254;9405;3959;13858;1631;490;1141;1129;614;515;114;65;49;104;64;40;196;89;107;271;124;147;444;272;172;159.0;195.0;62.0;62.0;733.0;637.0;907
4030;Gennep;2024;16680;3264;9377;4039;13867;1654;510;1144;1159;625;534;116;60;56;112;72;40;212;100;112;264;123;141;455;270;185;161.0;201.0;66.0;63.0;701.0;635.0;907
4031;Gennep;2025;16712;3288;9307;4117;13893;1643;502;1141;1176;632;544;127;65;62;117;81;36;201;93;108;266;121;145;465;272;193;;;;;;;907
4032;Giessenlanden;2008;14292;3799;8503;1990;13420;604;217;387;268;136;132;31;13;18;28;9;19;24;8;16;39;15;24;146;91;55;161.0;107.0;24.0;38.0;308.0;496.0;689
4033;Giessenlanden;2009;14145;3695;8362;2088;13244;613;219;394;288;138;150;37;13;24;33;11;22;24;8;16;48;19;29;146;87;59;152.0;108.0;28.0;37.0;443.0;484.0;689
4034;Giessenlanden;2010;14140;3667;8297;2176;13191;622;221;401;327;152;175;41;16;25;34;14;20;35;11;24;58;23;35;159;88;71;150.0;115.0;26.0;40.0;423.0;472.0;689
4035;Giessenlanden;2011;14113;3599;8285;2229;13134;629;220;409;350;157;193;50;20;30;39;18;21;45;15;30;58;23;35;158;81;77;156.0;116.0;25.0;36.0;423.0;467.0;689
4036;Giessenlanden;2012;14099;3570;8152;2377;13068;660;242;418;371;161;210;52;22;30;39;16;23;49;16;33;64;25;39;167;82;85;156.0;123.0;30.0;36.0;392.0;470.0;689
4037;Giessenlanden;2013;14048;3500;8077;2471;12966;670;248;422;412;184;228;59;26;33;44;20;24;55;23;32;66;24;42;188;91;97;149.0;120.0;45.0;36.0;428.0;472.0;689
4038;Giessenlanden;2014;14044;3447;8012;2585;12907;683;257;426;454;190;264;62;27;35;45;22;23;67;27;40;81;26;55;199;88;111;148.0;122.0;35.0;40.0;432.0;479.0;689
4039;Giessenlanden;2015;14019;3366;7969;2684;12839;699;252;447;481;204;277;65;28;37;49;25;24;76;30;46;88;28;60;203;93;110;148.0;123.0;32.0;40.0;433.0;472.0;689
4040;Giessenlanden;2016;13998;3313;7916;2769;12787;706;249;457;505;212;293;72;35;37;51;25;26;84;32;52;90;28;62;208;92;116;146.0;128.0;29.0;39.0;422.0;485.0;689
4041;Giessenlanden;2017;13944;3256;7876;2812;12707;705;245;460;532;230;302;68;35;33;53;28;25;94;33;61;98;32;66;219;102;117;147.0;135.0;27.0;37.0;446.0;481.0;689
4042;Giessenlanden;2018;13911;3222;7821;2868;12660;713;250;463;538;229;309;73;37;36;54;29;25;92;28;64;99;32;67;220;103;117;152.0;133.0;30.0;41.0;458.0;507.0;689
4043;Giessenlanden;2019;13872;3143;7803;2926;12586;710;242;468;576;255;321;83;39;44;58;32;26;101;34;67;107;35;72;227;115;112;150.0;136.0;33.0;36.0;437.0;479.0;689
4044;Giessenlanden;2020;13843;3085;7762;2996;12528;707;247;460;608;255;353;91;39;52;61;31;30;106;37;69;107;35;72;243;113;130;150.0;138.0;42.0;38.0;405.0;486.0;689
4045;Giessenlanden;2021;13780;3050;7682;3048;12443;707;247;460;630;271;359;93;41;52;72;37;35;119;43;76;108;37;71;238;113;125;152.0;140.0;29.0;34.0;473.0;466.0;689
4046;Giessenlanden;2022;13795;3023;7679;3093;12422;716;255;461;657;284;373;92;43;49;77;42;35;123;45;78;119;41;78;246;113;133;151.0;142.0;34.0;36.0;447.0;486.0;689
4047;Giessenlanden;2023;13764;2996;7604;3164;12364;717;258;459;683;292;391;102;47;55;83;44;39;124;44;80;128;43;85;246;114;132;158.0;146.0;34.0;37.0;454.0;475.0;689
4048;Giessenlanden;2024;13754;3000;7548;3206;12312;735;258;477;707;307;400;106;47;59;92;48;44;133;52;81;130;42;88;246;118;128;157.0;146.0;29.0;38.0;463.0;488.0;689
4049;Giessenlanden;2025;13732;2998;7474;3260;12242;750;266;484;740;316;424;107;45;62;92;48;44;136;53;83;139;41;98;266;129;137;;;;;;;689
4050;Gilze en Rijen;2008;25443;6180;15640;3623;21976;1752;568;1184;1715;1002;713;96;44;52;86;40;46;805;414;391;103;56;47;625;448;177;251.0;180.0;300.0;153.0;761.0;869.0;784
4051;Gilze en Rijen;2009;25555;6119;15623;3813;22024;1761;570;1191;1770;1032;738;101;47;54;91;43;48;792;408;384;113;57;56;673;477;196;247.0;189.0;327.0;157.0;744.0;931.0;784
4052;Gilze en Rijen;2010;25598;6046;15569;3983;22001;1750;567;1183;1847;1082;765;107;52;55;93;42;51;787;403;384;123;61;62;737;524;213;249.0;198.0;334.0;149.0;747.0;937.0;784
4053;Gilze en Rijen;2011;25646;5947;15573;4126;22015;1725;556;1169;1906;1124;782;121;61;60;94;43;51;772;397;375;124;60;64;795;563;232;244.0;196.0;357.0;154.0;701.0;1000.0;784
4054;Gilze en Rijen;2012;25599;5828;15437;4334;21916;1726;551;1175;1957;1156;801;126;67;59;104;44;60;758;391;367;135;63;72;834;591;243;238.0;206.0;357.0;156.0;753.0;980.0;784
4055;Gilze en Rijen;2013;25609;5761;15375;4473;21847;1736;556;1180;2026;1190;836;127;69;58;111;52;59;760;385;375;135;60;75;893;624;269;234.0;212.0;357.0;151.0;691.0;999.0;784
4056;Gilze en Rijen;2014;25532;5656;15213;4663;21756;1701;540;1161;2075;1225;850;140;76;64;110;57;53;728;375;353;148;60;88;949;657;292;236.0;214.0;370.0;152.0;691.0;1013.0;784
4057;Gilze en Rijen;2015;25453;5561;15013;4879;21644;1713;560;1153;2096;1259;837;145;81;64;112;60;52;715;376;339;149;59;90;975;683;292;235.0;220.0;363.0;150.0;722.0;1035.0;784
4058;Gilze en Rijen;2016;25365;5470;14856;5039;21550;1706;568;1138;2109;1270;839;143;82;61;111;59;52;701;366;335;150;58;92;1004;705;299;234.0;219.0;359.0;142.0;732.0;1003.0;784
4059;Gilze en Rijen;2017;25329;5358;14772;5199;21448;1691;564;1127;2190;1289;901;155;89;66;126;64;62;698;361;337;164;64;100;1047;711;336;228.0;232.0;364.0;150.0;691.0;982.0;784
4060;Gilze en Rijen;2018;25249;5247;14695;5307;21301;1685;561;1124;2263;1315;948;163;87;76;129;66;63;702;358;344;183;70;113;1086;734;352;230.0;233.0;375.0;143.0;711.0;1001.0;784
4061;Gilze en Rijen;2019;25189;5140;14657;5392;21170;1682;574;1108;2337;1363;974;171;92;79;140;74;66;705;361;344;187;72;115;1134;764;370;238.0;234.0;360.0;139.0;742.0;1014.0;784
4062;Gilze en Rijen;2020;25145;5084;14545;5516;21078;1699;567;1132;2368;1390;978;169;95;74;138;70;68;691;361;330;187;70;117;1183;794;389;235.0;244.0;350.0;148.0;760.0;1034.0;784
4063;Gilze en Rijen;2021;25066;5021;14434;5611;20969;1686;582;1104;2411;1414;997;181;104;77;142;66;76;679;364;315;200;75;125;1209;805;404;240.0;250.0;360.0;150.0;713.0;1019.0;784
4064;Gilze en Rijen;2022;24962;4953;14315;5694;20796;1692;582;1110;2474;1447;1027;191;111;80;157;75;82;678;359;319;205;77;128;1243;825;418;244.0;252.0;344.0;143.0;701.0;1025.0;784
4065;Gilze en Rijen;2023;24835;4899;14139;5797;20628;1686;595;1091;2521;1471;1050;198;112;86;163;79;84;661;352;309;214;79;135;1285;849;436;243.0;257.0;344.0;144.0;735.0;1012.0;784
4066;Gilze en Rijen;2024;24744;4865;13972;5907;20486;1696;618;1078;2562;1482;1080;195;112;83;175;87;88;650;343;307;225;76;149;1317;864;453;244.0;266.0;360.0;135.0;714.0;1013.0;784
4067;Gilze en Rijen;2025;24651;4822;13831;5998;20359;1690;613;1077;2602;1494;1108;199;113;86;171;80;91;640;334;306;243;86;157;1349;881;468;;;;;;;784
4068;Goedereede;2008;11444;2831;6764;1849;10874;360;136;224;210;117;93;49;18;31;5;5;0;13;8;5;20;8;12;123;78;45;138.0;111.0;18.0;36.0;237.0;295.0;511
4069;Goedereede;2009;11398;2797;6721;1880;10788;376;146;230;234;133;101;51;20;31;7;6;1;22;12;10;23;9;14;131;86;45;136.0;106.0;22.0;32.0;229.0;305.0;511
4070;Goedereede;2010;11343;2765;6648;1930;10687;382;150;232;274;162;112;54;20;34;12;6;6;31;16;15;26;14;12;151;106;45;135.0;108.0;22.0;33.0;151.0;306.0;511
4071;Goedereede;2011;11204;2711;6543;1950;10545;378;142;236;281;164;117;53;20;33;13;5;8;35;20;15;30;16;14;150;103;47;125.0;108.0;20.0;34.0;242.0;301.0;511
4072;Goedereede;2012;11150;2679;6435;2036;10453;394;147;247;303;172;131;57;23;34;15;7;8;39;20;19;34;15;19;158;107;51;120.0;110.0;27.0;32.0;202.0;289.0;511
4073;Goedereede;2013;11069;2625;6358;2086;10341;408;154;254;320;179;141;55;22;33;21;10;11;44;20;24;38;17;21;162;110;52;120.0;109.0;22.0;29.0;270.0;299.0;511
4074;Goedereede;2014;11045;2612;6283;2150;10278;424;167;257;343;188;155;60;24;36;24;10;14;49;23;26;38;17;21;172;114;58;117.0;111.0;23.0;28.0;302.0;294.0;511
4075;Goedereede;2015;11056;2585;6252;2219;10280;422;167;255;354;186;168;57;21;36;29;11;18;56;28;28;45;20;25;167;106;61;117.0;110.0;34.0;32.0;287.0;289.0;511
4076;Goedereede;2016;11065;2572;6211;2282;10252;428;174;254;385;191;194;56;18;38;30;11;19;63;30;33;59;22;37;177;110;67;113.0;112.0;22.0;35.0;343.0;294.0;511
4077;Goedereede;2017;11103;2564;6196;2343;10242;448;180;268;413;201;212;62;20;42;35;13;22;67;32;35;59;23;36;190;113;77;119.0;117.0;26.0;29.0;291.0;289.0;511
4078;Goedereede;2018;11103;2525;6173;2405;10195;459;187;272;449;223;226;68;22;46;36;15;21;84;38;46;57;25;32;204;123;81;115.0;117.0;22.0;31.0;279.0;293.0;511
4079;Goedereede;2019;11078;2498;6123;2457;10136;471;192;279;471;230;241;70;22;48;35;14;21;92;43;49;59;25;34;215;126;89;113.0;115.0;23.0;29.0;323.0;292.0;511
4080;Goedereede;2020;11102;2468;6121;2513;10136;477;188;289;489;240;249;67;21;46;40;17;23;96;43;53;62;27;35;224;132;92;117.0;119.0;24.0;28.0;211.0;305.0;511
4081;Goedereede;2021;11003;2411;6061;2531;10010;482;186;296;511;252;259;69;23;46;42;19;23;100;45;55;66;29;37;234;136;98;119.0;124.0;23.0;30.0;322.0;291.0;511
4082;Goedereede;2022;11022;2374;6070;2578;9992;489;190;299;541;271;270;73;26;47;47;22;25;105;47;58;69;29;40;247;147;100;117.0;118.0;25.0;30.0;160.0;299.0;511
4083;Goedereede;2023;10878;2316;5962;2600;9833;489;187;302;556;279;277;74;29;45;46;23;23;111;48;63;74;29;45;251;150;101;114.0;119.0;25.0;31.0;257.0;280.0;511
4084;Goedereede;2024;10845;2278;5934;2633;9782;493;194;299;570;279;291;78;29;49;42;24;18;114;47;67;82;30;52;254;149;105;113.0;128.0;25.0;29.0;278.0;289.0;511
4085;Goedereede;2025;10815;2257;5886;2672;9713;507;197;310;595;298;297;78;29;49;43;24;19;118;51;67;84;32;52;272;162;110;;;;;;;511
4086;Goes;2008;37023;8585;21958;6480;32068;2682;1077;1605;2273;1282;991;508;262;246;124;74;50;273;134;139;284;139;145;1084;673;411;375.0;381.0;155.0;179.0;1886.0;1791.0;664
4087;Goes;2009;37094;8536;22033;6525;32077;2678;1070;1608;2339;1309;1030;518;267;251;128;75;53;297;145;152;307;150;157;1089;672;417;389.0;384.0;162.0;165.0;1849.0;1799.0;664
4088;Goes;2010;37150;8489;22037;6624;32032;2713;1079;1634;2405;1337;1068;514;267;247;132;76;56;336;160;176;316;151;165;1107;683;424;383.0;379.0;164.0;162.0;2053.0;1848.0;664
4089;Goes;2011;37366;8441;22222;6703;32155;2723;1084;1639;2488;1362;1126;534;276;258;151;91;60;358;163;195;338;161;177;1107;671;436;389.0;369.0;167.0;163.0;2059.0;1850.0;664
4090;Goes;2012;37604;8401;22269;6934;32288;2782;1113;1669;2534;1390;1144;536;282;254;164;91;73;388;186;202;359;171;188;1087;660;427;390.0;381.0;173.0;160.0;2088.0;1905.0;664
4091;Goes;2013;37811;8403;22227;7181;32379;2807;1106;1701;2625;1443;1182;547;295;252;169;97;72;423;193;230;370;180;190;1116;678;438;402.0;369.0;195.0;153.0;2012.0;1873.0;664
4092;Goes;2014;38033;8437;22268;7328;32481;2835;1128;1707;2717;1473;1244;546;299;247;178;99;79;458;206;252;400;200;200;1135;669;466;404.0;382.0;183.0;163.0;2051.0;1876.0;664
4093;Goes;2015;38255;8451;22292;7512;32578;2849;1145;1704;2828;1535;1293;548;304;244;204;112;92;483;218;265;418;208;210;1175;693;482;403.0;377.0;179.0;156.0;1815.0;1890.0;664
4094;Goes;2016;38233;8395;22183;7655;32517;2833;1136;1697;2883;1565;1318;554;306;248;209;112;97;502;231;271;427;206;221;1191;710;481;409.0;382.0;192.0;157.0;1897.0;1868.0;664
4095;Goes;2017;38329;8406;22108;7815;32485;2865;1140;1725;2979;1640;1339;558;309;249;214;119;95;514;248;266;440;210;230;1253;754;499;411.0;377.0;192.0;150.0;1970.0;1826.0;664
4096;Goes;2018;38551;8425;22181;7945;32543;2914;1154;1760;3094;1689;1405;566;321;245;236;130;106;567;271;296;456;212;244;1269;755;514;404.0;384.0;174.0;156.0;2013.0;1906.0;664
4097;Goes;2019;38700;8405;22168;8127;32631;2964;1171;1793;3105;1701;1404;563;321;242;236;132;104;568;272;296;463;221;242;1275;755;520;421.0;388.0;177.0;151.0;1840.0;1853.0;664
4098;Goes;2020;38746;8378;22076;8292;32607;3008;1206;1802;3131;1689;1442;576;325;251;232;127;105;579;284;295;473;212;261;1271;741;530;421.0;383.0;164.0;155.0;1899.0;1835.0;664
4099;Goes;2021;38861;8388;22022;8451;32697;2995;1190;1805;3169;1705;1464;590;324;266;233;125;108;592;288;304;468;208;260;1286;760;526;417.0;391.0;198.0;155.0;1899.0;1880.0;664
4100;Goes;2022;38951;8401;21943;8607;32679;3027;1209;1818;3245;1736;1509;602;328;274;252;138;114;607;297;310;477;210;267;1307;763;544;420.0;400.0;178.0;153.0;1916.0;1867.0;664
4101;Goes;2023;39049;8394;21896;8759;32668;3061;1233;1828;3320;1762;1558;592;325;267;261;138;123;638;310;328;483;215;268;1346;774;572;429.0;405.0;174.0;145.0;1889.0;1857.0;664
4102;Goes;2024;39136;8419;21795;8922;32659;3080;1236;1844;3397;1789;1608;595;326;269;275;139;136;661;320;341;507;230;277;1359;774;585;428.0;412.0;167.0;150.0;1873.0;1862.0;664
4103;Goes;2025;39183;8391;21676;9116;32648;3080;1251;1829;3455;1833;1622;601;332;269;283;140;143;675;326;349;508;234;274;1388;801;587;;;;;;;664
4104;Goirle;2008;22211;5043;13893;3275;19934;1491;425;1066;786;427;359;111;51;60;79;35;44;237;125;112;89;46;43;270;170;100;249.0;175.0;83.0;104.0;794.0;840.0;785
4105;Goirle;2009;22221;4948;13855;3418;19876;1488;433;1055;857;464;393;124;56;68;83;40;43;247;128;119;104;52;52;299;188;111;249.0;189.0;82.0;106.0;802.0;890.0;785
4106;Goirle;2010;22173;4889;13783;3501;19787;1474;417;1057;912;496;416;132;63;69;90;48;42;259;133;126;109;55;54;322;197;125;251.0;186.0;89.0;105.0;728.0;893.0;785
4107;Goirle;2011;22060;4772;13698;3590;19626;1477;418;1059;957;515;442;136;72;64;90;50;40;250;122;128;122;56;66;359;215;144;248.0;194.0;89.0;103.0;783.0;923.0;785
4108;Goirle;2012;21962;4659;13570;3733;19494;1455;413;1042;1013;541;472;144;78;66;92;52;40;259;125;134;126;54;72;392;232;160;247.0;193.0;94.0;109.0;809.0;918.0;785
4109;Goirle;2013;21894;4607;13369;3918;19356;1473;436;1037;1065;563;502;153;80;73;109;57;52;265;133;132;137;66;71;401;227;174;245.0;202.0;100.0;109.0;804.0;937.0;785
4110;Goirle;2014;21796;4550;13178;4068;19227;1467;422;1045;1102;585;517;159;85;74;105;53;52;279;137;142;140;65;75;419;245;174;254.0;206.0;94.0;101.0;786.0;936.0;785
4111;Goirle;2015;21688;4457;13024;4207;19094;1443;416;1027;1151;621;530;172;96;76;111;59;52;278;136;142;150;70;80;440;260;180;244.0;206.0;94.0;102.0;882.0;977.0;785
4112;Goirle;2016;21627;4408;12907;4312;19005;1428;415;1013;1194;624;570;167;92;75;127;68;59;301;135;166;158;70;88;441;259;182;239.0;214.0;99.0;101.0;857.0;929.0;785
4113;Goirle;2017;21579;4374;12815;4390;18933;1432;428;1004;1214;625;589;167;94;73;126;64;62;301;132;169;166;70;96;454;265;189;245.0;216.0;89.0;95.0;945.0;942.0;785
4114;Goirle;2018;21606;4357;12724;4525;18930;1417;434;983;1259;640;619;172;100;72;131;65;66;319;130;189;168;63;105;469;282;187;252.0;217.0;85.0;99.0;828.0;952.0;785
4115;Goirle;2019;21505;4355;12523;4627;18812;1400;434;966;1293;644;649;178;106;72;134;63;71;330;130;200;173;67;106;478;278;200;248.0;226.0;83.0;97.0;918.0;933.0;785
4116;Goirle;2020;21499;4344;12430;4725;18771;1381;427;954;1347;672;675;184;110;74;135;63;72;342;132;210;190;72;118;496;295;201;252.0;227.0;93.0;94.0;844.0;977.0;785
4117;Goirle;2021;21393;4302;12310;4781;18611;1375;432;943;1407;681;726;187;110;77;136;62;74;367;134;233;204;77;127;513;298;215;249.0;224.0;84.0;96.0;944.0;961.0;785
4118;Goirle;2022;21391;4312;12238;4841;18576;1360;414;946;1455;700;755;188;112;76;136;63;73;385;142;243;209;77;132;537;306;231;247.0;230.0;89.0;95.0;891.0;967.0;785
4119;Goirle;2023;21328;4301;12095;4932;18450;1376;423;953;1502;711;791;196;113;83;135;61;74;392;142;250;213;78;135;566;317;249;241.0;230.0;97.0;95.0;970.0;960.0;785
4120;Goirle;2024;21356;4319;12046;4991;18406;1399;438;961;1551;744;807;202;116;86;136;66;70;395;148;247;224;79;145;594;335;259;233.0;229.0;92.0;96.0;980.0;972.0;785
4121;Goirle;2025;21367;4293;12031;5043;18373;1402;458;944;1592;757;835;205;118;87;140;69;71;403;148;255;225;81;144;619;341;278;;;;;;;785
4122;Gorinchem;2008;34050;8312;20718;5020;26358;3093;1365;1728;4599;2519;2080;354;180;174;181;96;85;1667;874;793;1510;781;729;887;588;299;411.0;312.0;125.0;167.0;1322.0;1225.0;512
4123;Gorinchem;2009;34209;8382;20749;5078;26521;3093;1358;1735;4595;2518;2077;344;178;166;181;95;86;1647;857;790;1520;796;724;903;592;311;400.0;313.0;159.0;167.0;1342.0;1288.0;512
4124;Gorinchem;2010;34348;8455;20752;5141;26645;3059;1328;1731;4644;2559;2085;344;183;161;190;105;85;1634;861;773;1522;798;724;954;612;342;389.0;315.0;137.0;162.0;1258.0;1266.0;512
4125;Gorinchem;2011;34391;8430;20777;5184;26704;3038;1303;1735;4649;2578;2071;352;193;159;193;110;83;1605;847;758;1508;797;711;991;631;360;382.0;299.0;135.0;153.0;1328.0;1327.0;512
4126;Gorinchem;2012;34463;8412;20645;5406;26746;3030;1301;1729;4687;2594;2093;355;198;157;197;113;84;1590;842;748;1526;807;719;1019;634;385;377.0;313.0;138.0;157.0;1326.0;1293.0;512
4127;Gorinchem;2013;34542;8405;20546;5591;26860;3007;1268;1739;4675;2579;2096;349;198;151;198;106;92;1544;821;723;1525;809;716;1059;645;414;373.0;313.0;134.0;155.0;1462.0;1303.0;512
4128;Gorinchem;2014;34744;8445;20543;5756;27056;3011;1265;1746;4677;2603;2074;355;202;153;201;111;90;1516;818;698;1521;815;706;1084;657;427;374.0;326.0;136.0;147.0;1364.0;1321.0;512
4129;Gorinchem;2015;34827;8413;20515;5899;27111;3019;1266;1753;4697;2607;2090;352;202;150;209;117;92;1496;806;690;1530;820;710;1110;662;448;379.0;325.0;133.0;146.0;1414.0;1307.0;512
4130;Gorinchem;2016;34981;8453;20531;5997;27232;3037;1278;1759;4712;2620;2092;362;206;156;210;124;86;1474;792;682;1541;823;718;1125;675;450;371.0;329.0;133.0;146.0;1385.0;1302.0;512
4131;Gorinchem;2017;35095;8395;20547;6153;27302;3045;1275;1770;4748;2655;2093;367;212;155;207;122;85;1456;796;660;1539;825;714;1179;700;479;359.0;330.0;128.0;141.0;1349.0;1304.0;512
4132;Gorinchem;2018;35160;8352;20516;6292;27384;2999;1253;1746;4777;2663;2114;378;219;159;222;130;92;1429;784;645;1546;816;730;1202;714;488;358.0;337.0;134.0;144.0;1346.0;1352.0;512
4133;Gorinchem;2019;35170;8312;20478;6380;27389;3008;1240;1768;4773;2675;2098;387;220;167;226;130;96;1404;787;617;1546;822;724;1210;716;494;359.0;339.0;132.0;151.0;1428.0;1343.0;512
4134;Gorinchem;2020;35259;8283;20514;6462;27495;2983;1217;1766;4781;2698;2083;394;230;164;229;136;93;1384;783;601;1544;832;712;1230;717;513;365.0;331.0;131.0;146.0;1436.0;1344.0;512
4135;Gorinchem;2021;35372;8234;20549;6589;27600;2988;1214;1774;4784;2708;2076;390;230;160;245;146;99;1369;779;590;1527;830;697;1253;723;530;369.0;347.0;122.0;140.0;1315.0;1355.0;512
4136;Gorinchem;2022;35339;8198;20417;6724;27561;2999;1225;1774;4779;2702;2077;403;236;167;240;142;98;1349;770;579;1493;807;686;1294;747;547;358.0;347.0;120.0;141.0;1302.0;1381.0;512
4137;Gorinchem;2023;35252;8084;20323;6845;27526;2993;1210;1783;4733;2671;2062;415;243;172;235;133;102;1310;749;561;1470;787;683;1303;759;544;363.0;355.0;122.0;132.0;1423.0;1359.0;512
4138;Gorinchem;2024;35317;8064;20275;6978;27622;2969;1190;1779;4726;2679;2047;422;249;173;240;139;101;1276;737;539;1486;788;698;1302;766;536;360.0;358.0;124.0;131.0;1369.0;1383.0;512
4139;Gorinchem;2025;35304;7950;20214;7140;27636;2991;1197;1794;4677;2662;2015;428;251;177;246;138;108;1239;727;512;1467;770;697;1297;776;521;;;;;;;512
4140;Gouda;2008;70778;18279;42636;9863;55781;5225;2094;3131;9772;5243;4529;952;467;485;408;232;176;557;269;288;5886;3047;2839;1969;1228;741;931.0;563.0;305.0;484.0;2444.0;2870.0;513
4141;Gouda;2009;70550;18106;42397;10047;55527;5252;2122;3130;9771;5202;4569;958;467;491;424;244;180;605;294;311;5800;2958;2842;1984;1239;745;907.0;573.0;310.0;477.0;2468.0;2832.0;513
4142;Gouda;2010;70362;17948;42174;10240;55317;5280;2127;3153;9765;5156;4609;996;483;513;419;237;182;644;304;340;5706;2887;2819;2000;1245;755;894.0;570.0;321.0;468.0;2533.0;2819.0;513
4143;Gouda;2011;70262;17824;42090;10348;55192;5298;2140;3158;9772;5113;4659;998;482;516;430;248;182;695;321;374;5603;2803;2800;2046;1259;787;872.0;571.0;322.0;457.0;3100.0;2859.0;513
4144;Gouda;2012;70676;17762;42025;10889;55445;5350;2163;3187;9881;5151;4730;1023;486;537;438;255;183;760;335;425;5534;2766;2768;2126;1309;817;862.0;584.0;333.0;463.0;3031.0;2897.0;513
4145;Gouda;2013;70968;17637;41964;11367;55631;5445;2214;3231;9892;5144;4748;1037;493;544;445;260;185;791;336;455;5416;2699;2717;2203;1356;847;858.0;592.0;320.0;436.0;3164.0;2872.0;513
4146;Gouda;2014;71418;17621;42051;11746;55919;5494;2261;3233;10005;5151;4854;1053;495;558;475;268;207;854;348;506;5333;2646;2687;2290;1394;896;855.0;595.0;325.0;440.0;3295.0;2930.0;513
4147;Gouda;2015;71939;17598;42209;12132;56285;5591;2304;3287;10063;5199;4864;1101;511;590;496;286;210;891;368;523;5226;2609;2617;2349;1425;924;856.0;615.0;327.0;430.0;3153.0;2959.0;513
4148;Gouda;2016;72279;17525;42349;12405;56511;5644;2341;3303;10124;5238;4886;1149;536;613;522;296;226;925;390;535;5123;2565;2558;2405;1451;954;858.0;617.0;348.0;434.0;3276.0;2950.0;513
4149;Gouda;2017;72764;17486;42549;12729;56800;5746;2428;3318;10218;5305;4913;1164;539;625;541;307;234;955;404;551;5058;2552;2506;2500;1503;997;864.0;626.0;329.0;427.0;3388.0;2962.0;513
4150;Gouda;2018;73337;17503;42704;13130;57216;5840;2453;3387;10281;5313;4968;1179;544;635;554;309;245;1004;420;584;5004;2536;2468;2540;1504;1036;866.0;626.0;340.0;426.0;3260.0;3020.0;513
4151;Gouda;2019;73739;17556;42665;13518;57457;5940;2513;3427;10342;5347;4995;1199;550;649;579;328;251;1032;438;594;4926;2491;2435;2606;1540;1066;873.0;656.0;342.0;427.0;3337.0;3049.0;513
4152;Gouda;2020;74167;17465;42900;13802;57710;6047;2557;3490;10410;5375;5035;1193;539;654;601;346;255;1088;472;616;4834;2442;2392;2694;1576;1118;873.0;667.0;331.0;432.0;3373.0;3054.0;513
4153;Gouda;2021;74597;17458;43046;14093;57993;6126;2590;3536;10478;5370;5108;1209;546;663;665;363;302;1106;464;642;4754;2405;2349;2744;1592;1152;888.0;660.0;320.0;412.0;3311.0;3092.0;513
4154;Gouda;2022;74958;17446;43079;14433;58235;6222;2635;3587;10501;5357;5144;1221;550;671;670;358;312;1128;472;656;4686;2378;2308;2796;1599;1197;891.0;684.0;328.0;430.0;3450.0;3137.0;513
4155;Gouda;2023;75384;17387;43253;14744;58507;6337;2693;3644;10540;5369;5171;1251;558;693;691;371;320;1165;476;689;4583;2331;2252;2850;1633;1217;904.0;698.0;320.0;423.0;3244.0;3120.0;513
4156;Gouda;2024;75619;17314;43236;15069;58696;6361;2700;3661;10562;5351;5211;1263;562;701;694;369;325;1205;481;724;4496;2297;2199;2904;1642;1262;890.0;718.0;326.0;429.0;3181.0;3098.0;513
4157;Gouda;2025;75784;17267;43101;15416;58742;6421;2734;3687;10621;5408;5213;1275;574;701;704;369;335;1258;505;753;4384;2255;2129;3000;1705;1295;;;;;;;513
4158;Graafstroom;2008;9499;3016;5271;1212;9118;236;76;160;145;88;57;21;11;10;9;4;5;10;6;4;11;5;6;94;62;32;137.0;70.0;14.0;24.0;143.0;304.0;693
4159;Graafstroom;2009;9397;2964;5188;1245;8994;238;79;159;165;92;73;21;12;9;17;6;11;15;8;7;13;4;9;99;62;37;133.0;68.0;15.0;27.0;153.0;304.0;693
4160;Graafstroom;2010;9301;2897;5123;1281;8879;239;78;161;183;103;80;26;15;11;17;6;11;20;8;12;18;7;11;102;67;35;130.0;71.0;25.0;24.0;176.0;307.0;693
4161;Graafstroom;2011;9231;2838;5076;1317;8776;251;86;165;204;108;96;29;13;16;22;8;14;29;12;17;20;7;13;104;68;36;126.0;72.0;17.0;21.0;176.0;300.0;693
4162;Graafstroom;2012;9158;2792;4965;1401;8679;259;91;168;220;116;104;28;14;14;25;9;16;32;14;18;26;10;16;109;69;40;125.0;70.0;21.0;24.0;171.0;296.0;693
4163;Graafstroom;2013;9086;2738;4888;1460;8569;278;107;171;239;129;110;29;16;13;30;11;19;34;14;20;28;12;16;118;76;42;122.0;72.0;23.0;23.0;156.0;283.0;693
4164;Graafstroom;2014;9009;2692;4810;1507;8464;289;110;179;256;137;119;32;17;15;26;10;16;38;15;23;36;17;19;124;78;46;117.0;73.0;17.0;23.0;283.0;289.0;693
4165;Graafstroom;2015;9040;2672;4802;1566;8469;300;112;188;271;140;131;34;18;16;29;10;19;39;15;24;40;20;20;129;77;52;119.0;73.0;17.0;23.0;162.0;276.0;693
4166;Graafstroom;2016;8966;2610;4764;1592;8358;318;122;196;290;145;145;38;19;19;31;12;19;43;14;29;48;21;27;130;79;51;120.0;73.0;19.0;23.0;160.0;269.0;693
4167;Graafstroom;2017;8900;2556;4726;1618;8262;330;131;199;308;150;158;39;19;20;33;13;20;49;17;32;54;24;30;133;77;56;117.0;76.0;18.0;25.0;152.0;272.0;693
4168;Graafstroom;2018;8814;2496;4673;1645;8172;337;127;210;305;152;153;37;18;19;35;14;21;48;20;28;53;25;28;132;75;57;111.0;79.0;20.0;22.0;98.0;275.0;693
4169;Graafstroom;2019;8667;2429;4580;1658;8014;345;131;214;308;153;155;36;17;19;36;16;20;49;21;28;56;22;34;131;77;54;109.0;78.0;15.0;21.0;117.0;262.0;693
4170;Graafstroom;2020;8548;2369;4487;1692;7867;355;137;218;326;162;164;37;19;18;42;18;24;53;20;33;58;23;35;136;82;54;106.0;77.0;20.0;22.0;172.0;266.0;693
4171;Graafstroom;2021;8483;2309;4429;1745;7781;365;141;224;337;161;176;37;19;18;47;22;25;56;21;35;61;23;38;136;76;60;103.0;80.0;15.0;21.0;123.0;256.0;693
4172;Graafstroom;2022;8369;2273;4336;1760;7655;368;138;230;346;167;179;41;21;20;45;21;24;57;22;35;66;24;42;137;79;58;97.0;81.0;18.0;23.0;300.0;263.0;693
4173;Graafstroom;2023;8418;2253;4376;1789;7661;379;141;238;378;191;187;48;26;22;44;21;23;61;25;36;67;25;42;158;94;64;100.0;83.0;20.0;21.0;156.0;276.0;693
4174;Graafstroom;2024;8314;2200;4313;1801;7538;389;144;245;387;196;191;50;29;21;40;19;21;63;27;36;70;27;43;164;94;70;94.0;84.0;15.0;23.0;373.0;267.0;693
4175;Graafstroom;2025;8421;2235;4352;1834;7587;405;148;257;429;205;224;59;32;27;43;21;22;69;29;40;78;29;49;180;94;86;;;;;;;693
4176;Graft-De Rijp;2008;6511;1697;3854;960;5999;341;103;238;171;82;89;34;13;21;23;8;15;17;7;10;13;5;8;84;49;35;55.0;54.0;14.0;30.0;132.0;228.0;365
4177;Graft-De Rijp;2009;6401;1642;3759;1000;5880;342;104;238;179;87;92;36;12;24;22;9;13;20;8;12;14;6;8;87;52;35;52.0;54.0;31.0;31.0;225.0;227.0;365
4178;Graft-De Rijp;2010;6398;1641;3716;1041;5846;349;109;240;203;92;111;39;14;25;24;9;15;21;7;14;20;6;14;99;56;43;51.0;56.0;25.0;30.0;262.0;238.0;365
4179;Graft-De Rijp;2011;6414;1612;3729;1073;5847;343;108;235;224;98;126;43;14;29;22;7;15;29;8;21;21;7;14;109;62;47;49.0;55.0;28.0;31.0;252.0;240.0;365
4180;Graft-De Rijp;2012;6418;1592;3672;1154;5831;345;115;230;242;113;129;46;16;30;22;8;14;32;11;21;29;11;18;113;67;46;49.0;57.0;28.0;28.0;239.0;256.0;365
4181;Graft-De Rijp;2013;6395;1557;3633;1205;5787;349;122;227;259;117;142;52;16;36;24;8;16;32;10;22;32;13;19;119;70;49;50.0;56.0;26.0;29.0;241.0;242.0;365
4182;Graft-De Rijp;2014;6386;1498;3634;1254;5756;353;125;228;277;128;149;55;16;39;24;8;16;34;11;23;34;15;19;130;78;52;52.0;59.0;29.0;28.0;291.0;237.0;365
4183;Graft-De Rijp;2015;6435;1466;3673;1296;5764;361;132;229;310;143;167;61;17;44;30;11;19;41;12;29;35;16;19;143;87;56;52.0;60.0;25.0;31.0;241.0;266.0;365
4184;Graft-De Rijp;2016;6397;1412;3662;1323;5727;364;137;227;306;133;173;53;16;37;27;9;18;44;11;33;41;16;25;141;81;60;57.0;60.0;26.0;28.0;218.0;256.0;365
4185;Graft-De Rijp;2017;6355;1402;3610;1343;5672;353;133;220;330;148;182;54;16;38;25;10;15;44;11;33;44;19;25;163;92;71;58.0;63.0;25.0;27.0;260.0;257.0;365
4186;Graft-De Rijp;2018;6352;1363;3617;1372;5657;363;138;225;332;149;183;56;16;40;23;9;14;41;9;32;50;19;31;162;96;66;57.0;60.0;25.0;26.0;347.0;252.0;365
4187;Graft-De Rijp;2019;6444;1368;3681;1395;5722;366;137;229;356;155;201;58;15;43;26;9;17;49;12;37;51;21;30;172;98;74;60.0;64.0;24.0;26.0;288.0;272.0;365
4188;Graft-De Rijp;2020;6455;1327;3715;1413;5715;369;140;229;371;163;208;55;16;39;26;12;14;51;13;38;61;22;39;178;100;78;61.0;67.0;32.0;30.0;210.0;267.0;365
4189;Graft-De Rijp;2021;6395;1277;3685;1433;5647;365;144;221;383;171;212;55;16;39;25;12;13;52;14;38;66;23;43;185;106;79;61.0;69.0;29.0;30.0;290.0;245.0;365
4190;Graft-De Rijp;2022;6431;1274;3699;1458;5671;362;152;210;398;176;222;57;18;39;30;12;18;52;14;38;73;24;49;186;108;78;64.0;67.0;33.0;25.0;367.0;250.0;365
4191;Graft-De Rijp;2023;6554;1297;3749;1508;5732;382;163;219;440;185;255;58;17;41;31;13;18;55;14;41;84;28;56;212;113;99;66.0;70.0;30.0;29.0;283.0;277.0;365
4192;Graft-De Rijp;2024;6558;1295;3741;1522;5731;385;167;218;442;181;261;58;15;43;35;14;21;57;16;41;84;29;55;208;107;101;63.0;69.0;26.0;28.0;326.0;255.0;365
4193;Graft-De Rijp;2025;6622;1303;3762;1557;5765;378;166;212;479;203;276;65;19;46;34;14;20;64;18;46;86;28;58;230;124;106;;;;;;;365
4194;Grave;2008;12515;3130;7685;1700;10745;1151;446;705;619;392;227;63;32;31;27;10;17;60;36;24;47;16;31;422;298;124;117.0;92.0;46.0;72.0;564.0;683.0;786
4195;Grave;2009;12397;3071;7562;1764;10593;1169;458;711;635;393;242;76;39;37;32;13;19;64;33;31;53;18;35;410;290;120;119.0;93.0;49.0;74.0;556.0;714.0;786
4196;Grave;2010;12238;3008;7387;1843;10434;1144;444;700;660;406;254;80;41;39;36;15;21;76;38;38;67;21;46;401;291;110;112.0;93.0;49.0;75.0;609.0;716.0;786
4197;Grave;2011;12125;2933;7290;1902;10331;1105;416;689;689;413;276;83;44;39;38;12;26;82;40;42;75;26;49;411;291;120;108.0;103.0;54.0;78.0;571.0;708.0;786
4198;Grave;2012;11970;2842;7122;2006;10166;1094;404;690;710;411;299;84;44;40;45;16;29;86;42;44;82;30;52;413;279;134;115.0;99.0;52.0;73.0;595.0;698.0;786
4199;Grave;2013;11865;2765;7038;2062;9997;1111;413;698;757;437;320;85;45;40;48;18;30;93;43;50;91;34;57;440;297;143;109.0;103.0;52.0;74.0;670.0;716.0;786
4200;Grave;2014;11805;2726;6925;2154;9920;1119;414;705;766;452;314;79;44;35;45;18;27;98;46;52;90;36;54;454;308;146;112.0;101.0;52.0;72.0;656.0;748.0;786
4201;Grave;2015;11706;2688;6817;2201;9808;1121;420;701;777;451;326;86;44;42;51;21;30;97;47;50;97;36;61;446;303;143;109.0;104.0;52.0;67.0;696.0;736.0;786
4202;Grave;2016;11658;2643;6756;2259;9706;1155;436;719;797;444;353;100;44;56;52;22;30;106;49;57;97;36;61;442;293;149;109.0;103.0;56.0;65.0;712.0;724.0;786
4203;Grave;2017;11644;2578;6763;2303;9637;1185;447;738;822;449;373;104;45;59;59;29;30;105;44;61;104;36;68;450;295;155;117.0;111.0;56.0;68.0;683.0;723.0;786
4204;Grave;2018;11600;2539;6701;2360;9561;1190;456;734;849;483;366;102;48;54;58;30;28;112;52;60;101;41;60;476;312;164;116.0;110.0;54.0;68.0;640.0;736.0;786
4205;Grave;2019;11498;2519;6586;2393;9427;1201;469;732;870;489;381;109;50;59;57;29;28;119;50;69;100;41;59;485;319;166;115.0;110.0;52.0;62.0;692.0;707.0;786
4206;Grave;2020;11479;2482;6544;2453;9402;1190;462;728;887;505;382;108;48;60;62;34;28;125;54;71;101;40;61;491;329;162;116.0;115.0;64.0;63.0;696.0;728.0;786
4207;Grave;2021;11450;2459;6475;2516;9339;1216;483;733;895;511;384;102;50;52;66;34;32;140;62;78;106;43;63;481;322;159;122.0;118.0;49.0;58.0;736.0;734.0;786
4208;Grave;2022;11448;2477;6440;2531;9287;1240;513;727;921;525;396;113;57;56;65;29;36;140;61;79;108;46;62;495;332;163;121.0;116.0;60.0;59.0;780.0;744.0;786
4209;Grave;2023;11489;2457;6455;2577;9264;1280;533;747;945;543;402;110;57;53;69;28;41;147;68;79;117;49;68;502;341;161;122.0;119.0;48.0;61.0;747.0;734.0;786
4210;Grave;2024;11493;2456;6423;2614;9228;1283;531;752;982;558;424;120;62;58;74;33;41;162;68;94;128;55;73;498;340;158;127.0;125.0;55.0;62.0;746.0;736.0;786
4211;Grave;2025;11498;2445;6418;2635;9176;1308;552;756;1014;577;437;121;61;60;77;36;41;170;73;97;141;55;86;505;352;153;;;;;;;786
4212;'s-Gravenhage (gemeente);2008;477373;111170;301281;64922;263155;64388;34604;29784;149830;91068;58762;43854;26786;17068;10499;7398;3101;31775;17558;14217;24983;12798;12185;38719;26528;12191;6402.0;4345.0;9650.0;8109.0;17000.0;18885.0;518
4213;'s-Gravenhage (gemeente);2009;479151;111878;301645;65628;263683;66353;36147;30206;149115;89259;59856;43133;26207;16926;10460;7282;3178;31557;17002;14555;25165;12571;12594;38800;26197;12603;6296.0;4312.0;10053.0;7989.0;16042.0;18680.0;518
4214;'s-Gravenhage (gemeente);2010;480620;112152;301746;66722;263809;68329;37753;30576;148482;87723;60759;42384;25679;16705;10497;7253;3244;31413;16518;14895;25357;12396;12961;38831;25877;12954;6262.0;4370.0;10524.0;7943.0;16106.0;18346.0;518
4215;'s-Gravenhage (gemeente);2011;482914;112458;303227;67229;264345;70464;39480;30984;148105;86444;61661;41703;25172;16531;10501;7219;3282;31342;16179;15163;25622;12296;13326;38937;25578;13359;6257.0;4406.0;10760.0;7878.0;16180.0;18262.0;518
4216;'s-Gravenhage (gemeente);2012;485609;112911;302578;70120;265159;72678;41224;31454;147772;85174;62598;41037;24675;16362;10482;7174;3308;31339;15861;15478;25813;12164;13649;39101;25300;13801;6242.0;4390.0;10898.0;7829.0;15755.0;17861.0;518
4217;'s-Gravenhage (gemeente);2013;488465;113343;302641;72481;265801;75108;43015;32093;147556;84179;63377;40459;24263;16196;10482;7165;3317;31342;15588;15754;26018;12083;13935;39255;25080;14175;6234.0;4403.0;10999.0;7838.0;15200.0;17741.0;518
4218;'s-Gravenhage (gemeente);2014;490968;113490;303017;74461;266242;77469;44795;32674;147257;83172;64085;39847;23844;16003;10549;7158;3391;31335;15337;15998;26185;11948;14237;39341;24885;14456;6300.0;4413.0;11135.0;7780.0;14647.0;17793.0;518
4219;'s-Gravenhage (gemeente);2015;493123;113754;303048;76321;266538;79683;46443;33240;146902;82300;64602;39267;23436;15831;10573;7148;3425;31264;15160;16104;26349;11867;14482;39449;24689;14760;6316.0;4457.0;11144.0;7723.0;14529.0;17489.0;518
4220;'s-Gravenhage (gemeente);2016;495492;114313;303245;77934;266802;81961;48081;33880;146729;81494;65235;38673;23034;15639;10695;7163;3532;31150;14967;16183;26609;11819;14790;39602;24511;15091;6391.0;4496.0;11133.0;7724.0;14208.0;17618.0;518
4221;'s-Gravenhage (gemeente);2017;497430;114722;303167;79541;267014;84089;49591;34498;146327;80592;65735;38149;22655;15494;10672;7090;3582;30956;14759;16197;26753;11750;15003;39797;24338;15459;6460.0;4495.0;11164.0;7666.0;14229.0;17474.0;518
4222;'s-Gravenhage (gemeente);2018;499693;115003;303457;81233;267226;86409;51184;35225;146058;79868;66190;37570;22249;15321;10725;7092;3633;30887;14620;16267;26883;11684;15199;39993;24223;15770;6448.0;4522.0;11241.0;7630.0;13869.0;17603.0;518
4223;'s-Gravenhage (gemeente);2019;501549;115079;303538;82932;267357;88587;52682;35905;145605;79095;66510;37045;21889;15156;10724;7067;3657;30752;14470;16282;27004;11624;15380;40080;24045;16035;6566.0;4567.0;11321.0;7622.0;13374.0;17622.0;518
4224;'s-Gravenhage (gemeente);2020;503044;114997;303345;84702;267246;90662;54117;36545;145136;78286;66850;36509;21495;15014;10792;7089;3703;30543;14261;16282;27078;11559;15519;40214;23882;16332;6565.0;4588.0;11300.0;7568.0;13410.0;17641.0;518
4225;'s-Gravenhage (gemeente);2021;504558;114576;303552;86430;266932;92864;55554;37310;144762;77620;67142;35988;21133;14855;10803;7043;3760;30447;14148;16299;27162;11532;15630;40362;23764;16598;6502.0;4685.0;11388.0;7484.0;13620.0;17798.0;518
4226;'s-Gravenhage (gemeente);2022;506130;114115;303882;88133;266728;95061;57050;38011;144341;77063;67278;35444;20781;14663;10897;7054;3843;30270;14006;16264;27118;11464;15654;40612;23758;16854;6537.0;4703.0;11421.0;7495.0;13772.0;17872.0;518
4227;'s-Gravenhage (gemeente);2023;507829;113649;304264;89916;266532;97284;58508;38776;144013;76508;67505;35023;20453;14570;10922;7052;3870;30114;13878;16236;27097;11439;15658;40857;23686;17171;6520.0;4790.0;11437.0;7396.0;13614.0;18101.0;518
4228;'s-Gravenhage (gemeente);2024;509162;113043;304651;91468;265989;99429;59939;39490;143744;75932;67812;34539;20093;14446;10920;7039;3881;30040;13792;16248;27158;11355;15803;41087;23653;17434;6542.0;4847.0;11504.0;7397.0;13734.0;18169.0;518
4229;'s-Gravenhage (gemeente);2025;510562;112517;304944;93101;265532;101670;61378;40292;143360;75363;67997;34118;19746;14372;10900;6992;3908;29809;13658;16151;27150;11298;15852;41383;23669;17714;;;;;;;518
4230;Groesbeek;2008;18661;4216;11001;3444;16382;1817;480;1337;462;262;200;67;33;34;40;25;15;65;30;35;39;20;19;251;154;97;140.0;205.0;53.0;83.0;711.0;684.0;241
4231;Groesbeek;2009;18595;4081;11099;3415;16261;1809;487;1322;525;302;223;84;41;43;39;25;14;68;32;36;44;23;21;290;181;109;139.0;200.0;64.0;80.0;640.0;687.0;241
4232;Groesbeek;2010;18470;3993;10998;3479;16124;1787;501;1286;559;314;245;88;40;48;40;24;16;69;33;36;60;29;31;302;188;114;138.0;202.0;64.0;82.0;784.0;694.0;241
4233;Groesbeek;2011;18478;3851;11125;3502;16106;1762;508;1254;610;345;265;99;43;56;48;28;20;76;36;40;76;42;34;311;196;115;145.0;199.0;63.0;81.0;672.0;705.0;241
4234;Groesbeek;2012;18373;3753;11028;3592;15968;1741;502;1239;664;381;283;109;50;59;50;33;17;95;42;53;83;46;37;327;210;117;141.0;197.0;72.0;81.0;767.0;715.0;241
4235;Groesbeek;2013;18363;3649;11023;3691;15944;1709;502;1207;710;393;317;117;50;67;49;34;15;109;46;63;90;47;43;345;216;129;152.0;201.0;62.0;82.0;798.0;713.0;241
4236;Groesbeek;2014;18381;3596;11013;3772;15927;1691;505;1186;763;412;351;131;61;70;57;38;19;123;51;72;98;45;53;354;217;137;156.0;208.0;68.0;77.0;788.0;745.0;241
4237;Groesbeek;2015;18365;3509;11031;3825;15902;1662;500;1162;801;434;367;136;64;72;65;44;21;133;58;75;107;44;63;360;224;136;159.0;202.0;71.0;77.0;724.0;734.0;241
4238;Groesbeek;2016;18308;3484;10976;3848;15823;1648;507;1141;837;458;379;138;63;75;75;54;21;144;64;80;106;44;62;374;233;141;161.0;198.0;70.0;72.0;838.0;745.0;241
4239;Groesbeek;2017;18362;3463;10981;3918;15852;1635;514;1121;875;485;390;147;70;77;81;60;21;145;64;81;117;50;67;385;241;144;168.0;199.0;70.0;78.0;850.0;763.0;241
4240;Groesbeek;2018;18414;3443;10959;4012;15863;1626;508;1118;925;513;412;145;69;76;84;61;23;151;71;80;129;55;74;416;257;159;176.0;210.0;73.0;77.0;835.0;780.0;241
4241;Groesbeek;2019;18433;3447;10941;4045;15804;1625;524;1101;1004;537;467;158;73;85;85;59;26;173;79;94;146;60;86;442;266;176;182.0;213.0;75.0;79.0;818.0;777.0;241
4242;Groesbeek;2020;18443;3422;10926;4095;15793;1619;531;1088;1031;550;481;159;70;89;85;60;25;198;84;114;145;58;87;444;278;166;188.0;211.0;68.0;72.0;839.0;741.0;241
4243;Groesbeek;2021;18515;3398;10947;4170;15822;1610;531;1079;1083;570;513;164;75;89;96;64;32;207;86;121;147;55;92;469;290;179;194.0;210.0;66.0;72.0;845.0;759.0;241
4244;Groesbeek;2022;18582;3409;10968;4205;15885;1597;522;1075;1100;577;523;166;81;85;104;68;36;201;85;116;153;57;96;476;286;190;198.0;215.0;74.0;78.0;827.0;776.0;241
4245;Groesbeek;2023;18617;3413;10916;4288;15907;1572;530;1042;1138;598;540;170;82;88;111;76;35;216;90;126;158;61;97;483;289;194;193.0;211.0;66.0;76.0;826.0;779.0;241
4246;Groesbeek;2024;18638;3399;10864;4375;15909;1573;538;1035;1156;606;550;179;85;94;117;77;40;215;90;125;154;61;93;491;293;198;199.0;218.0;71.0;67.0;864.0;782.0;241
4247;Groesbeek;2025;18707;3405;10864;4438;15916;1584;560;1024;1207;642;565;175;83;92;127;80;47;229;94;135;163;69;94;513;316;197;;;;;;;241
4248;Groningen (gemeente);2008;182303;33691;127405;21207;148969;16775;7309;9466;16559;10212;6347;3150;1629;1521;2800;1850;950;1469;763;706;1256;569;687;7884;5401;2483;2176.0;1508.0;2153.0;2482.0;11614.0;10563.0;14
4249;Groningen (gemeente);2009;183754;34509;127776;21469;150211;16787;7323;9464;16756;10225;6531;3162;1644;1518;2747;1785;962;1567;786;781;1382;618;764;7898;5392;2506;2246.0;1496.0;2247.0;2453.0;11673.0;10483.0;14
4250;Groningen (gemeente);2010;185544;35409;128269;21866;151680;16843;7383;9460;17021;10307;6714;3147;1646;1501;2758;1798;960;1695;832;863;1503;657;846;7918;5374;2544;2339.0;1511.0;2276.0;2438.0;12063.0;10401.0;14
4251;Groningen (gemeente);2011;187931;36431;129183;22317;153656;16962;7433;9529;17313;10330;6983;3155;1648;1507;2744;1774;970;1828;871;957;1619;700;919;7967;5337;2630;2386.0;1539.0;2348.0;2417.0;11941.0;10387.0;14
4252;Groningen (gemeente);2012;190304;37237;129774;23293;155640;17099;7512;9587;17565;10380;7185;3168;1670;1498;2770;1797;973;1941;916;1025;1693;697;996;7993;5300;2693;2471.0;1560.0;2343.0;2384.0;11800.0;10343.0;14
4253;Groningen (gemeente);2013;192677;38195;130350;24132;157629;17190;7593;9597;17858;10476;7382;3183;1693;1490;2751;1778;973;2053;964;1089;1801;735;1066;8070;5306;2764;2528.0;1574.0;2316.0;2368.0;12079.0;10287.0;14
4254;Groningen (gemeente);2014;195415;39190;131280;24945;160016;17283;7639;9644;18116;10560;7556;3179;1698;1481;2758;1795;963;2144;994;1150;1906;760;1146;8129;5313;2816;2565.0;1599.0;2292.0;2339.0;12122.0;10313.0;14
4255;Groningen (gemeente);2015;198191;40187;132322;25682;162372;17397;7722;9675;18422;10625;7797;3178;1706;1472;2785;1797;988;2280;1048;1232;1984;787;1197;8195;5287;2908;2633.0;1618.0;2367.0;2314.0;11973.0;10378.0;14
4256;Groningen (gemeente);2016;200900;41158;133313;26429;164514;17543;7800;9743;18843;10792;8051;3250;1740;1510;2823;1821;1002;2380;1079;1301;2079;837;1242;8311;5315;2996;2652.0;1614.0;2315.0;2308.0;11733.0;10486.0;14
4257;Groningen (gemeente);2017;203246;42082;133984;27180;166447;17678;7862;9816;19121;10905;8216;3241;1739;1502;2843;1838;1005;2494;1121;1373;2139;856;1283;8404;5351;3053;2685.0;1651.0;2308.0;2301.0;11927.0;10428.0;14
4258;Groningen (gemeente);2018;205837;43057;134730;28050;168546;17768;7908;9860;19523;11029;8494;3260;1750;1510;2863;1834;1029;2617;1170;1447;2232;876;1356;8551;5399;3152;2729.0;1669.0;2290.0;2256.0;12042.0;10535.0;14
4259;Groningen (gemeente);2019;208490;43940;135636;28914;170725;17889;7965;9924;19876;11190;8686;3335;1775;1560;2873;1853;1020;2675;1190;1485;2303;915;1388;8690;5457;3233;2739.0;1703.0;2292.0;2271.0;12011.0;10594.0;14
4260;Groningen (gemeente);2020;211010;44744;136532;29734;172805;17990;8012;9978;20215;11263;8952;3383;1787;1596;2859;1855;1004;2767;1218;1549;2451;953;1498;8755;5450;3305;2756.0;1725.0;2304.0;2270.0;11982.0;10668.0;14
4261;Groningen (gemeente);2021;213428;45487;137394;30547;174710;18120;8080;10040;20598;11439;9159;3426;1809;1617;2892;1880;1012;2826;1251;1575;2572;984;1588;8882;5515;3367;2753.0;1759.0;2267.0;2248.0;11959.0;10681.0;14
4262;Groningen (gemeente);2022;215768;46111;138356;31301;176519;18246;8192;10054;21003;11562;9441;3462;1816;1646;2897;1884;1013;2948;1307;1641;2714;1026;1688;8982;5529;3453;2782.0;1785.0;2279.0;2243.0;11929.0;10785.0;14
4263;Groningen (gemeente);2023;217990;46759;139073;32158;178324;18309;8205;10104;21357;11717;9640;3483;1822;1661;2908;1879;1029;3037;1344;1693;2804;1043;1761;9125;5629;3496;2791.0;1820.0;2247.0;2251.0;12025.0;10833.0;14
4264;Groningen (gemeente);2024;220195;47419;139777;32999;179916;18469;8279;10190;21810;11827;9983;3518;1820;1698;2903;1845;1058;3168;1414;1754;2901;1065;1836;9320;5683;3637;2808.0;1849.0;2285.0;2239.0;12031.0;10931.0;14
4265;Groningen (gemeente);2025;222340;48092;140346;33902;181482;18639;8390;10249;22219;11992;10227;3539;1815;1724;2932;1844;1088;3217;1435;1782;3050;1107;1943;9481;5791;3690;;;;;;;14
4266;Grootegast;2008;12121;3389;7103;1629;11625;320;106;214;176;87;89;34;12;22;15;2;13;23;9;14;11;5;6;93;59;34;147.0;100.0;29.0;36.0;433.0;496.0;15
4267;Grootegast;2009;12101;3352;7075;1674;11565;324;118;206;212;122;90;42;20;22;15;3;12;25;11;14;19;10;9;111;78;33;142.0;99.0;34.0;39.0;515.0;498.0;15
4268;Grootegast;2010;12157;3313;7137;1707;11586;332;111;221;239;139;100;51;26;25;18;5;13;33;17;16;25;13;12;112;78;34;141.0;105.0;26.0;41.0;491.0;515.0;15
4269;Grootegast;2011;12155;3262;7142;1751;11561;340;113;227;254;146;108;57;30;27;19;10;9;41;19;22;25;11;14;112;76;36;136.0;104.0;23.0;38.0;535.0;497.0;15
4270;Grootegast;2012;12212;3196;7184;1832;11593;342;121;221;277;158;119;58;32;26;20;10;10;38;17;21;29;11;18;132;88;44;140.0;110.0;29.0;38.0;419.0;511.0;15
4271;Grootegast;2013;12143;3147;7142;1854;11493;349;112;237;301;161;140;61;30;31;21;13;8;48;18;30;35;16;19;136;84;52;140.0;105.0;30.0;37.0;461.0;501.0;15
4272;Grootegast;2014;12132;3113;7121;1898;11436;367;119;248;329;168;161;64;28;36;23;14;9;53;19;34;37;16;21;152;91;61;137.0;108.0;32.0;42.0;444.0;502.0;15
4273;Grootegast;2015;12094;3047;7076;1971;11384;365;123;242;345;178;167;67;30;37;26;16;10;50;19;31;40;18;22;162;95;67;135.0;107.0;36.0;40.0;443.0;500.0;15
4274;Grootegast;2016;12062;2956;7089;2017;11331;363;116;247;368;187;181;69;29;40;28;19;9;60;26;34;49;20;29;162;93;69;138.0;110.0;31.0;44.0;441.0;480.0;15
4275;Grootegast;2017;12041;2889;7087;2065;11283;358;118;240;400;209;191;73;32;41;30;19;11;67;28;39;51;21;30;179;109;70;129.0;110.0;27.0;37.0;486.0;494.0;15
4276;Grootegast;2018;12043;2887;7045;2111;11250;366;118;248;427;226;201;74;34;40;34;22;12;67;27;40;55;23;32;197;120;77;134.0;114.0;37.0;39.0;415.0;475.0;15
4277;Grootegast;2019;12002;2846;6981;2175;11206;362;126;236;434;227;207;74;37;37;39;21;18;73;29;44;57;23;34;191;117;74;131.0;115.0;30.0;40.0;511.0;499.0;15
4278;Grootegast;2020;12022;2813;6991;2218;11197;361;135;226;464;235;229;72;35;37;41;21;20;82;31;51;66;25;41;203;123;80;136.0;121.0;31.0;38.0;521.0;515.0;15
4279;Grootegast;2021;12038;2754;7028;2256;11180;359;136;223;499;256;243;76;38;38;41;22;19;86;32;54;76;26;50;220;138;82;134.0;118.0;33.0;40.0;414.0;481.0;15
4280;Grootegast;2022;11981;2710;6956;2315;11110;355;132;223;516;263;253;77;40;37;47;24;23;92;37;55;79;26;53;221;136;85;132.0;122.0;37.0;39.0;515.0;487.0;15
4281;Grootegast;2023;12018;2694;6967;2357;11131;373;148;225;514;263;251;74;37;37;43;23;20;95;38;57;86;30;56;216;135;81;133.0;121.0;29.0;38.0;436.0;497.0;15
4282;Grootegast;2024;11962;2627;6929;2406;11066;373;152;221;523;260;263;79;37;42;49;26;23;104;40;64;89;33;56;202;124;78;131.0;126.0;32.0;40.0;480.0;492.0;15
4283;Grootegast;2025;11948;2596;6866;2486;11032;378;145;233;538;263;275;85;40;45;48;24;24;107;42;65;89;32;57;209;125;84;;;;;;;15
4284;Gulpen-Wittem;2008;14653;3088;8948;2617;12632;1739;523;1216;282;182;100;27;16;11;19;7;12;22;10;12;41;19;22;173;130;43;99.0;143.0;70.0;105.0;488.0;560.0;1729
4285;Gulpen-Wittem;2009;14504;2995;8812;2697;12504;1696;516;1180;304;186;118;30;17;13;27;11;16;27;12;15;50;21;29;170;125;45;96.0;146.0;75.0;103.0;500.0;557.0;1729
4286;Gulpen-Wittem;2010;14370;2921;8663;2786;12358;1678;523;1155;334;198;136;36;23;13;28;13;15;31;15;16;57;23;34;182;124;58;94.0;151.0;82.0;97.0;511.0;571.0;1729
4287;Gulpen-Wittem;2011;14241;2808;8551;2882;12216;1662;531;1131;363;212;151;44;26;18;31;12;19;43;24;19;57;21;36;188;129;59;87.0;150.0;80.0;100.0;536.0;571.0;1729
4288;Gulpen-Wittem;2012;14126;2713;8437;2976;12086;1633;532;1101;407;239;168;54;32;22;35;13;22;45;25;20;67;22;45;206;147;59;94.0;154.0;80.0;100.0;505.0;563.0;1729
4289;Gulpen-Wittem;2013;13989;2643;8260;3086;11955;1609;530;1079;425;249;176;51;34;17;35;13;22;49;28;21;70;25;45;220;149;71;89.0;151.0;84.0;99.0;495.0;566.0;1729
4290;Gulpen-Wittem;2014;13843;2566;8111;3166;11796;1606;534;1072;441;254;187;64;37;27;30;13;17;53;30;23;73;27;46;221;147;74;88.0;162.0;85.0;90.0;514.0;575.0;1729
4291;Gulpen-Wittem;2015;13704;2494;7966;3244;11643;1591;535;1056;470;262;208;63;39;24;35;16;19;66;32;34;75;25;50;231;150;81;87.0;160.0;71.0;92.0;502.0;552.0;1729
4292;Gulpen-Wittem;2016;13562;2438;7825;3299;11474;1576;526;1050;512;283;229;69;41;28;43;21;22;83;37;46;80;28;52;237;156;81;88.0;167.0;84.0;86.0;495.0;560.0;1729
4293;Gulpen-Wittem;2017;13418;2364;7703;3351;11341;1567;539;1028;510;283;227;70;43;27;38;18;20;86;37;49;71;26;45;245;159;86;92.0;166.0;75.0;84.0;490.0;558.0;1729
4294;Gulpen-Wittem;2018;13269;2321;7563;3385;11184;1548;547;1001;537;290;247;73;45;28;45;27;18;87;35;52;75;24;51;257;159;98;91.0;165.0;84.0;87.0;448.0;541.0;1729
4295;Gulpen-Wittem;2019;13101;2270;7407;3424;11023;1542;551;991;536;292;244;77;50;27;46;25;21;87;36;51;82;26;56;244;155;89;90.0;165.0;69.0;85.0;471.0;519.0;1729
4296;Gulpen-Wittem;2020;12964;2205;7286;3473;10893;1510;543;967;561;310;251;79;53;26;46;26;20;90;42;48;86;29;57;260;160;100;87.0;166.0;61.0;88.0;449.0;536.0;1729
4297;Gulpen-Wittem;2021;12772;2143;7131;3498;10736;1470;511;959;566;302;264;79;51;28;42;20;22;102;47;55;86;33;53;257;151;106;89.0;170.0;67.0;79.0;442.0;510.0;1729
4298;Gulpen-Wittem;2022;12613;2065;6987;3561;10584;1446;508;938;583;315;268;87;56;31;42;19;23;107;49;58;86;31;55;261;160;101;87.0;175.0;66.0;81.0;435.0;505.0;1729
4299;Gulpen-Wittem;2023;12442;2025;6840;3577;10418;1438;514;924;586;311;275;88;54;34;53;27;26;107;47;60;93;32;61;245;151;94;87.0;173.0;56.0;75.0;434.0;502.0;1729
4300;Gulpen-Wittem;2024;12272;1966;6689;3617;10267;1391;495;896;614;322;292;89;58;31;52;26;26;108;44;64;100;31;69;265;163;102;90.0;174.0;60.0;74.0;453.0;494.0;1729
4301;Gulpen-Wittem;2025;12135;1920;6571;3644;10147;1368;488;880;620;328;292;90;57;33;60;30;30;111;45;66;92;29;63;267;167;100;;;;;;;1729
4302;Haaksbergen;2008;24172;5893;14229;4050;21273;1745;484;1261;1154;644;510;49;20;29;20;13;7;636;317;319;84;40;44;365;254;111;220.0;216.0;64.0;94.0;521.0;577.0;158
4303;Haaksbergen;2009;24093;5773;14157;4163;21176;1727;478;1249;1190;665;525;56;24;32;29;18;11;636;319;317;89;42;47;380;262;118;209.0;220.0;66.0;84.0;527.0;581.0;158
4304;Haaksbergen;2010;24013;5651;14124;4238;21075;1696;461;1235;1242;686;556;66;29;37;34;18;16;640;322;318;94;43;51;408;274;134;210.0;220.0;71.0;88.0;514.0;589.0;158
4305;Haaksbergen;2011;23913;5501;14108;4304;20967;1676;456;1220;1270;700;570;77;33;44;39;22;17;623;317;306;102;50;52;429;278;151;205.0;220.0;71.0;84.0;575.0;584.0;158
4306;Haaksbergen;2012;23878;5416;13999;4463;20920;1647;439;1208;1311;736;575;98;42;56;40;24;16;609;315;294;109;52;57;455;303;152;198.0;225.0;74.0;83.0;528.0;605.0;158
4307;Haaksbergen;2013;23770;5318;13831;4621;20794;1624;439;1185;1352;773;579;107;46;61;50;31;19;608;315;293;112;50;62;475;331;144;199.0;233.0;76.0;76.0;526.0;608.0;158
4308;Haaksbergen;2014;23655;5229;13680;4746;20673;1585;425;1160;1397;789;608;119;51;68;52;35;17;617;312;305;119;52;67;490;339;151;200.0;238.0;73.0;79.0;589.0;589.0;158
4309;Haaksbergen;2015;23616;5128;13662;4826;20589;1591;425;1166;1436;817;619;132;55;77;51;37;14;613;317;296;130;60;70;510;348;162;205.0;243.0;78.0;74.0;509.0;606.0;158
4310;Haaksbergen;2016;23488;5003;13564;4921;20423;1579;438;1141;1486;843;643;148;60;88;63;45;18;603;310;293;128;60;68;544;368;176;202.0;250.0;71.0;78.0;612.0;614.0;158
4311;Haaksbergen;2017;23437;4937;13497;5003;20361;1561;432;1129;1515;861;654;153;60;93;71;48;23;601;314;287;131;62;69;559;377;182;208.0;247.0;71.0;80.0;595.0;623.0;158
4312;Haaksbergen;2018;23363;4823;13437;5103;20274;1541;436;1105;1548;879;669;164;68;96;79;50;29;602;318;284;134;62;72;569;381;188;207.0;260.0;78.0;75.0;632.0;612.0;158
4313;Haaksbergen;2019;23333;4755;13388;5190;20183;1541;442;1099;1609;916;693;178;76;102;85;54;31;612;324;288;141;66;75;593;396;197;212.0;260.0;73.0;80.0;645.0;635.0;158
4314;Haaksbergen;2020;23291;4672;13378;5241;20124;1520;445;1075;1647;954;693;187;84;103;87;56;31;605;321;284;153;66;87;615;427;188;220.0;258.0;75.0;68.0;679.0;641.0;158
4315;Haaksbergen;2021;23302;4585;13369;5348;20100;1515;437;1078;1687;983;704;199;92;107;95;57;38;593;321;272;165;69;96;635;444;191;220.0;261.0;81.0;74.0;639.0;653.0;158
4316;Haaksbergen;2022;23256;4498;13337;5421;20019;1511;446;1065;1726;1012;714;201;94;107;97;59;38;599;326;273;166;71;95;663;462;201;223.0;273.0;71.0;73.0;630.0;624.0;158
4317;Haaksbergen;2023;23211;4425;13282;5504;19911;1515;460;1055;1785;1042;743;207;95;112;109;64;45;607;330;277;173;73;100;689;480;209;220.0;270.0;84.0;72.0;689.0;634.0;158
4318;Haaksbergen;2024;23229;4387;13260;5582;19905;1506;474;1032;1818;1057;761;222;105;117;116;67;49;597;323;274;189;76;113;694;486;208;227.0;278.0;85.0;74.0;646.0;648.0;158
4319;Haaksbergen;2025;23188;4354;13188;5646;19842;1471;462;1009;1875;1091;784;233;114;119;129;74;55;609;327;282;196;80;116;708;496;212;;;;;;;158
4320;Haaren;2008;13549;3440;8062;2047;12722;539;161;378;288;157;131;41;19;22;30;18;12;25;14;11;35;12;23;157;94;63;106.0;105.0;30.0;53.0;235.0;513.0;788
4321;Haaren;2009;13252;3285;7840;2127;12415;525;158;367;312;175;137;42;23;19;28;15;13;36;19;17;44;16;28;162;102;60;97.0;110.0;31.0;45.0;424.0;516.0;788
4322;Haaren;2010;13135;3152;7788;2195;12267;526;167;359;342;188;154;43;24;19;31;16;15;47;24;23;48;17;31;173;107;66;95.0;110.0;36.0;48.0;402.0;523.0;788
4323;Haaren;2011;12989;3010;7699;2280;12095;527;172;355;367;204;163;46;26;20;33;17;16;57;27;30;55;19;36;176;115;61;98.0;117.0;32.0;48.0;470.0;548.0;788
4324;Haaren;2012;12878;2896;7603;2379;11944;535;173;362;399;211;188;52;28;24;38;16;22;63;29;34;55;19;36;191;119;72;95.0;118.0;40.0;51.0;480.0;570.0;788
4325;Haaren;2013;12756;2770;7494;2492;11831;533;176;357;392;208;184;53;29;24;39;19;20;62;31;31;48;16;32;190;113;77;98.0;119.0;41.0;47.0;521.0;569.0;788
4326;Haaren;2014;12681;2694;7425;2562;11709;536;172;364;436;231;205;59;31;28;40;24;16;76;37;39;55;18;37;206;121;85;103.0;118.0;34.0;42.0;577.0;593.0;788
4327;Haaren;2015;12645;2635;7307;2703;11648;539;168;371;458;244;214;62;33;29;40;26;14;87;39;48;59;20;39;210;126;84;101.0;118.0;30.0;46.0;554.0;598.0;788
4328;Haaren;2016;12569;2536;7270;2763;11563;545;171;374;461;247;214;63;33;30;37;24;13;85;40;45;61;23;38;215;127;88;104.0;127.0;33.0;45.0;515.0;583.0;788
4329;Haaren;2017;12467;2444;7228;2795;11452;542;172;370;473;254;219;68;36;32;36;22;14;83;39;44;65;30;35;221;127;94;106.0;132.0;32.0;46.0;564.0;580.0;788
4330;Haaren;2018;12412;2386;7202;2824;11360;548;176;372;504;270;234;63;34;29;41;25;16;94;45;49;73;30;43;233;136;97;106.0;132.0;40.0;43.0;574.0;573.0;788
4331;Haaren;2019;12383;2313;7205;2865;11302;561;196;365;520;276;244;63;34;29;32;19;13;96;41;55;75;31;44;254;151;103;116.0;132.0;32.0;49.0;566.0;579.0;788
4332;Haaren;2020;12337;2269;7171;2897;11243;565;193;372;529;272;257;62;32;30;37;22;15;107;45;62;73;30;43;250;143;107;112.0;134.0;33.0;44.0;535.0;588.0;788
4333;Haaren;2021;12253;2201;7126;2926;11167;555;200;355;531;282;249;65;32;33;37;22;15;107;48;59;81;36;45;241;144;97;120.0;132.0;33.0;39.0;666.0;574.0;788
4334;Haaren;2022;12329;2191;7152;2986;11193;559;201;358;577;290;287;62;30;32;50;28;22;114;51;63;86;33;53;265;148;117;124.0;136.0;32.0;41.0;684.0;580.0;788
4335;Haaren;2023;12413;2190;7200;3023;11230;568;209;359;615;296;319;72;31;41;49;26;23;125;56;69;100;40;60;269;143;126;125.0;136.0;28.0;47.0;604.0;595.0;788
4336;Haaren;2024;12393;2200;7119;3074;11172;576;213;363;645;308;337;70;32;38;52;28;24;135;59;76;109;39;70;279;150;129;128.0;137.0;34.0;38.0;714.0;587.0;788
4337;Haaren;2025;12508;2244;7137;3127;11268;579;211;368;661;312;349;75;34;41;52;31;21;149;67;82;102;34;68;283;146;137;;;;;;;788
4338;Haarlem;2008;146275;32666;91138;22471;111570;15634;6271;9363;19071;10855;8216;2066;1053;1013;910;470;440;5872;3157;2715;4285;2325;1960;5938;3850;2088;1777.0;1374.0;1211.0;1156.0;6097.0;6452.0;392
4339;Haarlem;2009;146404;32835;90957;22612;111227;15907;6444;9463;19270;10868;8402;2121;1053;1068;931;490;441;5787;3127;2660;4282;2275;2007;6149;3923;2226;1747.0;1388.0;1283.0;1175.0;6121.0;6433.0;392
4340;Haarlem;2010;146575;33006;90747;22822;110940;16118;6599;9519;19517;10937;8580;2158;1065;1093;961;526;435;5719;3074;2645;4356;2246;2110;6323;4026;2297;1699.0;1387.0;1353.0;1163.0;5757.0;6384.0;392
4341;Haarlem;2011;146468;32925;90664;22879;110462;16376;6823;9553;19630;10935;8695;2188;1072;1116;998;556;442;5628;3024;2604;4378;2234;2144;6438;4049;2389;1648.0;1401.0;1371.0;1142.0;6209.0;6384.0;392
4342;Haarlem;2012;146789;32995;90066;23728;110311;16626;7004;9622;19852;10989;8863;2225;1080;1145;1034;579;455;5569;2998;2571;4404;2214;2190;6620;4118;2502;1603.0;1383.0;1372.0;1132.0;6000.0;6405.0;392
4343;Haarlem;2013;146862;32920;89409;24533;109993;16830;7176;9654;20039;11061;8978;2276;1103;1173;1086;607;479;5490;2955;2535;4437;2224;2213;6750;4172;2578;1552.0;1420.0;1373.0;1131.0;6056.0;6363.0;392
4344;Haarlem;2014;146948;32767;89091;25090;109669;17020;7356;9664;20259;11117;9142;2343;1133;1210;1112;623;489;5440;2931;2509;4469;2222;2247;6895;4208;2687;1513.0;1405.0;1359.0;1089.0;6015.0;6326.0;392
4345;Haarlem;2015;147034;32707;88713;25614;109409;17253;7535;9718;20372;11183;9189;2362;1148;1214;1141;653;488;5400;2913;2487;4487;2218;2269;6982;4251;2731;1498.0;1417.0;1394.0;1100.0;6313.0;6302.0;392
4346;Haarlem;2016;147439;32747;88628;26064;109330;17519;7702;9817;20590;11269;9321;2418;1161;1257;1172;680;492;5345;2882;2463;4529;2232;2297;7126;4314;2812;1474.0;1431.0;1338.0;1104.0;6301.0;6340.0;392
4347;Haarlem;2017;147695;32740;88576;26379;109140;17816;7928;9888;20739;11289;9450;2428;1166;1262;1217;701;516;5300;2840;2460;4515;2193;2322;7279;4389;2890;1474.0;1435.0;1371.0;1086.0;6161.0;6378.0;392
4348;Haarlem;2018;147816;32571;88528;26717;108902;18065;8146;9919;20849;11350;9499;2440;1171;1269;1292;746;546;5217;2816;2401;4525;2191;2334;7375;4426;2949;1464.0;1426.0;1405.0;1087.0;6333.0;6334.0;392
4349;Haarlem;2019;148189;32464;88645;27080;108798;18366;8334;10032;21025;11486;9539;2441;1176;1265;1347;788;559;5182;2787;2395;4523;2207;2316;7532;4528;3004;1483.0;1438.0;1372.0;1093.0;6297.0;6472.0;392
4350;Haarlem;2020;148352;32228;88679;27445;108579;18612;8509;10103;21161;11531;9630;2440;1162;1278;1401;822;579;5154;2773;2381;4507;2192;2315;7659;4582;3077;1478.0;1443.0;1384.0;1077.0;6372.0;6440.0;392
4351;Haarlem;2021;148641;32027;88733;27881;108440;18830;8690;10140;21371;11611;9760;2502;1196;1306;1463;859;604;5107;2729;2378;4503;2179;2324;7796;4648;3148;1464.0;1446.0;1344.0;1074.0;6441.0;6489.0;392
4352;Haarlem;2022;148897;31825;88801;28271;108342;19059;8844;10215;21496;11692;9804;2547;1194;1353;1488;877;611;5018;2677;2341;4481;2183;2298;7962;4761;3201;1462.0;1455.0;1344.0;1079.0;6586.0;6531.0;392
4353;Haarlem;2023;149246;31575;88855;28816;108284;19319;9043;10276;21643;11764;9879;2551;1184;1367;1532;896;636;5002;2672;2330;4506;2191;2315;8052;4821;3231;1443.0;1464.0;1364.0;1083.0;6379.0;6598.0;392
4354;Haarlem;2024;149306;31225;88771;29310;107988;19576;9190;10386;21742;11848;9894;2563;1188;1375;1567;921;646;4956;2653;2303;4485;2187;2298;8171;4899;3272;1438.0;1491.0;1329.0;1057.0;6255.0;6545.0;392
4355;Haarlem;2025;149256;30879;88505;29872;107684;19769;9316;10453;21803;11899;9904;2577;1199;1378;1625;954;671;4915;2624;2291;4451;2187;2264;8235;4935;3300;;;;;;;392
4356;Haarlemmerliede en Spaarnwoude;2008;5346;1337;3222;787;4729;368;124;244;249;140;109;66;31;35;8;4;4;30;19;11;14;6;8;131;80;51;39.0;41.0;31.0;36.0;300.0;326.0;393
4357;Haarlemmerliede en Spaarnwoude;2009;5312;1296;3198;818;4688;371;123;248;253;137;116;66;27;39;9;4;5;34;19;15;15;9;6;129;78;51;37.0;42.0;37.0;32.0;309.0;341.0;393
4358;Haarlemmerliede en Spaarnwoude;2010;5280;1246;3198;836;4637;366;125;241;277;147;130;68;30;38;11;4;7;39;20;19;24;11;13;135;82;53;40.0;43.0;42.0;36.0;287.0;332.0;393
4359;Haarlemmerliede en Spaarnwoude;2011;5238;1191;3197;850;4567;379;136;243;292;156;136;72;31;41;11;5;6;42;19;23;28;12;16;139;89;50;35.0;43.0;36.0;30.0;269.0;334.0;393
4360;Haarlemmerliede en Spaarnwoude;2012;5172;1129;3161;882;4502;375;134;241;295;145;150;74;28;46;12;4;8;47;21;26;29;12;17;133;80;53;40.0;45.0;36.0;32.0;310.0;340.0;393
4361;Haarlemmerliede en Spaarnwoude;2013;5141;1090;3131;920;4460;381;140;241;300;142;158;73;26;47;11;4;7;54;22;32;29;11;18;133;79;54;39.0;45.0;35.0;29.0;307.0;336.0;393
4362;Haarlemmerliede en Spaarnwoude;2014;5111;1034;3120;957;4417;387;141;246;307;148;159;67;27;40;14;7;7;59;25;34;37;11;26;130;78;52;41.0;50.0;36.0;30.0;283.0;324.0;393
4363;Haarlemmerliede en Spaarnwoude;2015;5068;999;3092;977;4363;386;144;242;319;151;168;67;25;42;17;9;8;62;23;39;38;13;25;135;81;54;41.0;48.0;37.0;32.0;293.0;310.0;393
4364;Haarlemmerliede en Spaarnwoude;2016;5049;978;3070;1001;4322;387;151;236;340;157;183;75;26;49;18;10;8;73;22;51;36;12;24;138;87;51;46.0;46.0;30.0;29.0;341.0;329.0;393
4365;Haarlemmerliede en Spaarnwoude;2017;5062;975;3068;1019;4294;408;160;248;360;161;199;77;27;50;18;11;7;77;20;57;38;12;26;150;91;59;44.0;48.0;36.0;33.0;294.0;330.0;393
4366;Haarlemmerliede en Spaarnwoude;2018;5026;950;3019;1057;4251;399;152;247;376;169;207;81;30;51;19;12;7;80;20;60;38;11;27;158;96;62;46.0;49.0;29.0;28.0;314.0;323.0;393
4367;Haarlemmerliede en Spaarnwoude;2019;5015;929;3000;1086;4247;395;158;237;373;171;202;82;32;50;24;14;10;77;19;58;32;10;22;158;96;62;47.0;50.0;37.0;27.0;282.0;318.0;393
4368;Haarlemmerliede en Spaarnwoude;2020;4987;903;2968;1116;4207;406;157;249;374;178;196;78;30;48;22;15;7;76;19;57;31;10;21;167;104;63;48.0;53.0;34.0;30.0;279.0;334.0;393
4369;Haarlemmerliede en Spaarnwoude;2021;4932;893;2906;1133;4151;407;163;244;374;180;194;77;30;47;22;15;7;72;16;56;33;10;23;170;109;61;50.0;50.0;34.0;31.0;332.0;305.0;393
4370;Haarlemmerliede en Spaarnwoude;2022;4963;893;2910;1160;4163;405;158;247;395;183;212;80;28;52;25;17;8;84;22;62;36;11;25;170;105;65;50.0;52.0;33.0;29.0;274.0;314.0;393
4371;Haarlemmerliede en Spaarnwoude;2023;4924;880;2876;1168;4114;420;162;258;390;178;212;79;28;51;25;16;9;85;21;64;37;14;23;164;99;65;49.0;52.0;32.0;26.0;307.0;323.0;393
4372;Haarlemmerliede en Spaarnwoude;2024;4912;870;2849;1193;4075;431;169;262;406;174;232;84;27;57;29;15;14;85;22;63;41;15;26;167;95;72;50.0;53.0;35.0;29.0;292.0;317.0;393
4373;Haarlemmerliede en Spaarnwoude;2025;4890;870;2824;1196;4035;450;177;273;405;168;237;86;28;58;31;18;13;88;21;67;42;13;29;158;88;70;;;;;;;393
4374;Haarlemmermeer;2008;138783;36983;86225;15575;108852;14010;5875;8135;15921;8555;7366;4060;1990;2070;1005;516;489;1960;949;1011;2440;1197;1243;6456;3903;2553;1852.0;812.0;911.0;864.0;4653.0;4140.0;394
4375;Haarlemmermeer;2009;140398;37353;86680;16365;109599;14310;6058;8252;16489;8720;7769;4142;1963;2179;1036;525;511;2071;990;1081;2598;1245;1353;6642;3997;2645;1823.0;844.0;968.0;903.0;4601.0;4207.0;394
4376;Haarlemmermeer;2010;141850;37597;87076;17177;110122;14615;6243;8372;17113;8935;8178;4202;1952;2250;1062;539;523;2186;1027;1159;2799;1314;1485;6864;4103;2761;1780.0;877.0;1034.0;892.0;4454.0;4216.0;394
4377;Haarlemmermeer;2011;143155;37772;87473;17910;110549;14878;6383;8495;17728;9149;8579;4279;1957;2322;1078;553;525;2298;1074;1224;2956;1371;1585;7117;4194;2923;1737.0;914.0;1047.0;880.0;4861.0;4259.0;394
4378;Haarlemmermeer;2012;144762;37966;87470;19326;111111;15235;6580;8655;18416;9409;9007;4358;1971;2387;1112;564;548;2410;1113;1297;3115;1422;1693;7421;4339;3082;1738.0;953.0;1073.0;881.0;4797.0;4300.0;394
4379;Haarlemmermeer;2013;146250;38152;87522;20576;111628;15534;6767;8767;19088;9608;9480;4439;1980;2459;1135;593;542;2537;1153;1384;3320;1479;1841;7657;4403;3254;1702.0;990.0;1066.0;868.0;4769.0;4329.0;394
4380;Haarlemmermeer;2014;147608;38233;87616;21759;112089;15880;6940;8940;19639;9825;9814;4492;1980;2512;1164;610;554;2660;1223;1437;3461;1514;1947;7862;4498;3364;1700.0;1018.0;1077.0;886.0;4882.0;4284.0;394
4381;Haarlemmermeer;2015;149097;38323;88037;22737;112590;16227;7116;9111;20280;10069;10211;4564;1981;2583;1187;619;568;2774;1274;1500;3610;1570;2040;8145;4625;3520;1696.0;1047.0;1085.0;883.0;4885.0;4308.0;394
4382;Haarlemmermeer;2016;150543;38490;88409;23644;113059;16599;7313;9286;20885;10281;10604;4626;2000;2626;1228;629;599;2892;1326;1566;3735;1602;2133;8404;4724;3680;1712.0;1082.0;1117.0;871.0;4884.0;4340.0;394
4383;Haarlemmermeer;2017;151973;38653;88753;24567;113531;16942;7506;9436;21500;10478;11022;4710;2004;2706;1261;647;614;3018;1380;1638;3911;1665;2246;8600;4782;3818;1708.0;1110.0;1114.0;889.0;4852.0;4365.0;394
4384;Haarlemmermeer;2018;153297;38646;89170;25481;113900;17317;7763;9554;22080;10676;11404;4767;2018;2749;1290;661;629;3151;1428;1723;4042;1707;2335;8830;4862;3968;1719.0;1137.0;1166.0;894.0;4827.0;4387.0;394
4385;Haarlemmermeer;2019;154610;38671;89527;26412;114289;17701;8001;9700;22620;10871;11749;4846;2046;2800;1315;677;638;3263;1475;1788;4135;1730;2405;9061;4943;4118;1731.0;1185.0;1137.0;893.0;4989.0;4468.0;394
4386;Haarlemmermeer;2020;155933;38608;89976;27349;114712;18044;8203;9841;23177;11063;12114;4887;2044;2843;1339;696;643;3400;1523;1877;4218;1761;2457;9333;5039;4294;1757.0;1216.0;1159.0;892.0;5118.0;4534.0;394
4387;Haarlemmermeer;2021;157340;38565;90567;28208;115213;18406;8444;9962;23721;11254;12467;4912;2056;2856;1361;704;657;3517;1571;1946;4369;1801;2568;9562;5122;4440;1773.0;1271.0;1151.0;892.0;5329.0;4577.0;394
4388;Haarlemmermeer;2022;158871;38473;91251;29147;115842;18750;8646;10104;24279;11457;12822;4954;2059;2895;1401;733;668;3642;1614;2028;4491;1860;2631;9791;5191;4600;1788.0;1290.0;1155.0;881.0;5356.0;4621.0;394
4389;Haarlemmermeer;2023;160388;38406;91936;30046;116435;19196;8891;10305;24757;11651;13106;4967;2065;2902;1443;765;678;3748;1650;2098;4568;1887;2681;10031;5284;4747;1809.0;1337.0;1173.0;905.0;5221.0;4694.0;394
4390;Haarlemmermeer;2024;161664;38332;92392;30940;116853;19546;9082;10464;25265;11852;13413;5021;2092;2929;1481;779;702;3846;1700;2146;4669;1925;2744;10248;5356;4892;1846.0;1376.0;1145.0;902.0;5265.0;4782.0;394
4391;Haarlemmermeer;2025;162868;38389;92579;31900;117249;19928;9318;10610;25691;12000;13691;5041;2097;2944;1522;793;729;3919;1720;2199;4784;1971;2813;10425;5419;5006;;;;;;;394
4392;Halderberge;2008;29176;6607;17825;4744;25718;1595;636;959;1863;1023;840;203;102;101;98;52;46;314;189;125;754;373;381;494;307;187;236.0;262.0;110.0;157.0;837.0;1002.0;1655
4393;Halderberge;2009;28940;6484;17579;4877;25447;1590;630;960;1903;1042;861;217;113;104;106;58;48;343;199;144;744;368;376;493;304;189;226.0;263.0;121.0;153.0;903.0;992.0;1655
4394;Halderberge;2010;28787;6371;17349;5067;25269;1573;616;957;1945;1062;883;224;119;105;116;62;54;369;209;160;737;366;371;499;306;193;220.0;269.0;123.0;151.0;925.0;943.0;1655
4395;Halderberge;2011;28696;6269;17214;5213;25099;1587;630;957;2010;1092;918;228;120;108;125;64;61;392;214;178;736;363;373;529;331;198;217.0;275.0;128.0;150.0;959.0;951.0;1655
4396;Halderberge;2012;28626;6154;17019;5453;24979;1594;634;960;2053;1111;942;235;126;109;137;67;70;401;219;182;737;362;375;543;337;206;226.0;277.0;128.0;148.0;970.0;995.0;1655
4397;Halderberge;2013;28534;6121;16729;5684;24829;1613;653;960;2092;1124;968;237;125;112;143;68;75;406;220;186;742;366;376;564;345;219;216.0;282.0;126.0;144.0;967.0;987.0;1655
4398;Halderberge;2014;28433;6011;16529;5893;24655;1635;678;957;2143;1138;1005;239;125;114;148;69;79;421;230;191;752;367;385;583;347;236;225.0;289.0;124.0;141.0;869.0;986.0;1655
4399;Halderberge;2015;28240;5876;16335;6029;24470;1630;685;945;2140;1142;998;245;127;118;158;75;83;429;234;195;741;370;371;567;336;231;219.0;291.0;127.0;137.0;1007.0;962.0;1655
4400;Halderberge;2016;28204;5828;16230;6146;24378;1631;688;943;2195;1160;1035;246;124;122;165;73;92;442;242;200;752;365;387;590;356;234;216.0;303.0;118.0;138.0;958.0;976.0;1655
4401;Halderberge;2017;28082;5739;16086;6257;24198;1653;693;960;2231;1167;1064;249;125;124;167;75;92;466;251;215;760;361;399;589;355;234;225.0;305.0;117.0;140.0;955.0;966.0;1655
4402;Halderberge;2018;27970;5644;15966;6360;24077;1648;687;961;2245;1155;1090;255;123;132;165;67;98;478;256;222;769;357;412;578;352;226;228.0;305.0;123.0;129.0;1040.0;982.0;1655
4403;Halderberge;2019;27948;5578;15854;6516;23981;1679;708;971;2288;1170;1118;251;123;128;168;69;99;495;262;233;786;364;422;588;352;236;234.0;317.0;121.0;135.0;950.0;969.0;1655
4404;Halderberge;2020;27835;5485;15751;6599;23850;1691;724;967;2294;1171;1123;252;124;128;167;66;101;486;259;227;793;362;431;596;360;236;240.0;320.0;125.0;126.0;1027.0;985.0;1655
4405;Halderberge;2021;27799;5439;15668;6692;23769;1697;720;977;2333;1185;1148;267;132;135;177;70;107;499;257;242;791;362;429;599;364;235;239.0;328.0;125.0;128.0;1122.0;993.0;1655
4406;Halderberge;2022;27839;5423;15624;6792;23741;1721;737;984;2377;1198;1179;268;136;132;181;74;107;532;274;258;791;356;435;605;358;247;245.0;325.0;118.0;132.0;982.0;991.0;1655
4407;Halderberge;2023;27739;5355;15513;6871;23592;1721;731;990;2426;1227;1199;278;142;136;178;74;104;531;280;251;805;361;444;634;370;264;250.0;336.0;112.0;127.0;1093.0;962.0;1655
4408;Halderberge;2024;27770;5321;15445;7004;23549;1736;744;992;2485;1256;1229;286;149;137;184;81;103;539;279;260;813;360;453;663;387;276;246.0;348.0;121.0;126.0;989.0;1026.0;1655
4409;Halderberge;2025;27630;5275;15269;7086;23371;1756;747;1009;2503;1272;1231;288;146;142;187;84;103;554;286;268;798;355;443;676;401;275;;;;;;;1655
4410;Hardenberg;2008;57622;15725;33617;8280;54279;2190;534;1656;1153;731;422;127;72;55;109;66;43;130;73;57;95;51;44;692;469;223;629.0;474.0;146.0;156.0;990.0;1229.0;160
4411;Hardenberg;2009;57542;15564;33521;8457;54119;2177;543;1634;1246;770;476;142;79;63;118;73;45;156;83;73;112;59;53;718;476;242;610.0;478.0;141.0;156.0;933.0;1212.0;160
4412;Hardenberg;2010;57389;15374;33368;8647;53852;2208;560;1648;1329;807;522;155;88;67;132;86;46;184;88;96;128;62;66;730;483;247;603.0;490.0;145.0;152.0;1037.0;1234.0;160
4413;Hardenberg;2011;57304;15146;33337;8821;53676;2207;563;1644;1421;854;567;170;93;77;148;98;50;206;93;113;130;66;64;767;504;263;590.0;499.0;149.0;143.0;770.0;1241.0;160
4414;Hardenberg;2012;56938;14864;32982;9092;53231;2195;558;1637;1512;888;624;191;99;92;157;106;51;224;99;125;152;72;80;788;512;276;575.0;507.0;154.0;144.0;957.0;1214.0;160
4415;Hardenberg;2013;56763;14635;32750;9378;52944;2204;567;1637;1615;931;684;208;111;97;166;112;54;251;108;143;180;81;99;810;519;291;558.0;516.0;152.0;146.0;946.0;1227.0;160
4416;Hardenberg;2014;56535;14322;32580;9633;52607;2240;587;1653;1688;966;722;216;119;97;173;121;52;262;108;154;202;86;116;835;532;303;558.0;513.0;147.0;141.0;999.0;1196.0;160
4417;Hardenberg;2015;56394;14084;32446;9864;52386;2275;605;1670;1733;994;739;227;124;103;179;129;50;271;113;158;215;93;122;841;535;306;553.0;526.0;175.0;145.0;985.0;1211.0;160
4418;Hardenberg;2016;56237;13921;32248;10068;52097;2267;611;1656;1873;1062;811;254;137;117;193;139;54;290;120;170;237;99;138;899;567;332;551.0;533.0;149.0;141.0;1170.0;1192.0;160
4419;Hardenberg;2017;56248;13720;32224;10304;51955;2297;615;1682;1996;1112;884;272;145;127;209;148;61;313;134;179;260;106;154;942;579;363;562.0;535.0;153.0;141.0;1030.0;1236.0;160
4420;Hardenberg;2018;56085;13519;31974;10592;51625;2317;631;1686;2143;1176;967;290;151;139;233;162;71;335;145;190;285;116;169;1000;602;398;549.0;548.0;147.0;142.0;1206.0;1204.0;160
4421;Hardenberg;2019;56100;13275;32005;10820;51499;2338;635;1703;2263;1234;1029;304;160;144;251;172;79;352;154;198;317;124;193;1039;624;415;561.0;556.0;161.0;136.0;1069.0;1232.0;160
4422;Hardenberg;2020;55975;13051;31890;11034;51242;2354;662;1692;2379;1277;1102;313;158;155;274;179;95;394;175;219;334;127;207;1064;638;426;559.0;555.0;146.0;140.0;1103.0;1285.0;160
4423;Hardenberg;2021;55812;12785;31724;11303;50958;2371;689;1682;2483;1319;1164;335;164;171;280;189;91;427;181;246;357;130;227;1084;655;429;565.0;576.0;160.0;138.0;1222.0;1243.0;160
4424;Hardenberg;2022;55809;12531;31695;11583;50830;2384;704;1680;2595;1381;1214;344;163;181;294;204;90;451;191;260;377;137;240;1129;686;443;575.0;591.0;149.0;135.0;1163.0;1222.0;160
4425;Hardenberg;2023;55755;12331;31572;11852;50608;2408;714;1694;2739;1443;1296;358;168;190;309;216;93;481;200;281;405;146;259;1186;713;473;580.0;590.0;164.0;133.0;1166.0;1210.0;160
4426;Hardenberg;2024;55735;12197;31395;12143;50431;2422;727;1695;2882;1528;1354;371;172;199;326;225;101;504;204;300;424;159;265;1257;768;489;584.0;592.0;143.0;136.0;1155.0;1204.0;160
4427;Hardenberg;2025;55693;12066;31278;12349;50255;2461;746;1715;2977;1583;1394;387;185;202;339;232;107;531;218;313;427;159;268;1293;789;504;;;;;;;160
4428;Harderwijk;2008;41505;10732;25093;5680;35010;2463;817;1646;4032;2226;1806;207;92;115;89;39;50;1844;1041;803;986;494;492;906;560;346;534.0;326.0;197.0;213.0;1650.0;1568.0;243
4429;Harderwijk;2009;41784;10684;25254;5846;35228;2491;838;1653;4065;2236;1829;218;96;122;98;43;55;1834;1025;809;962;478;484;953;594;359;539.0;340.0;210.0;211.0;1640.0;1603.0;243
4430;Harderwijk;2010;42024;10690;25268;6066;35405;2496;836;1660;4123;2277;1846;243;106;137;107;51;56;1813;1019;794;964;475;489;996;626;370;524.0;344.0;220.0;210.0;1792.0;1605.0;243
4431;Harderwijk;2011;42403;10686;25478;6239;35686;2519;857;1662;4198;2302;1896;263;119;144;124;56;68;1810;1010;800;959;468;491;1042;649;393;519.0;356.0;210.0;209.0;1759.0;1607.0;243
4432;Harderwijk;2012;42722;10710;25500;6512;35909;2571;892;1679;4242;2314;1928;280;127;153;129;62;67;1795;994;801;947;463;484;1091;668;423;517.0;362.0;225.0;209.0;1678.0;1666.0;243
4433;Harderwijk;2013;42911;10653;25481;6777;36046;2596;898;1698;4269;2321;1948;292;130;162;145;66;79;1785;983;802;954;469;485;1093;673;420;506.0;366.0;223.0;207.0;1545.0;1638.0;243
4434;Harderwijk;2014;42980;10579;25345;7056;36083;2640;913;1727;4257;2295;1962;305;134;171;156;73;83;1761;961;800;937;457;480;1098;670;428;492.0;379.0;221.0;203.0;1660.0;1596.0;243
4435;Harderwijk;2015;43178;10567;25313;7298;36252;2656;923;1733;4270;2307;1963;329;144;185;159;82;77;1741;950;791;918;442;476;1123;689;434;488.0;378.0;211.0;199.0;1599.0;1623.0;243
4436;Harderwijk;2016;43279;10525;25267;7487;36273;2689;935;1754;4317;2316;2001;346;142;204;173;88;85;1707;942;765;928;434;494;1163;710;453;471.0;395.0;207.0;208.0;1686.0;1626.0;243
4437;Harderwijk;2017;43421;10496;25164;7761;36385;2692;940;1752;4344;2341;2003;374;155;219;177;91;86;1666;931;735;930;428;502;1197;736;461;479.0;402.0;225.0;198.0;1714.0;1666.0;243
4438;Harderwijk;2018;43576;10421;25145;8010;36483;2707;950;1757;4386;2357;2029;401;161;240;192;98;94;1648;928;720;923;428;495;1222;742;480;474.0;413.0;217.0;198.0;1782.0;1688.0;243
4439;Harderwijk;2019;43753;10369;25120;8264;36609;2724;960;1764;4420;2379;2041;418;166;252;212;110;102;1623;920;703;915;425;490;1252;758;494;481.0;413.0;221.0;186.0;1813.0;1702.0;243
4440;Harderwijk;2020;43973;10364;25069;8540;36741;2738;977;1761;4494;2421;2073;437;180;257;230;120;110;1606;914;692;917;420;497;1304;787;517;475.0;418.0;228.0;195.0;1674.0;1681.0;243
4441;Harderwijk;2021;44060;10224;25086;8750;36820;2731;992;1739;4509;2438;2071;461;190;271;246;125;121;1568;904;664;891;410;481;1343;809;534;478.0;429.0;222.0;186.0;1707.0;1673.0;243
4442;Harderwijk;2022;44184;10124;25068;8992;36923;2762;1020;1742;4499;2458;2041;456;190;266;270;133;137;1536;898;638;889;417;472;1348;820;528;472.0;437.0;217.0;186.0;1810.0;1641.0;243
4443;Harderwijk;2023;44424;10152;24991;9281;37096;2778;1031;1747;4550;2479;2071;464;192;272;281;137;144;1545;904;641;877;415;462;1383;831;552;482.0;445.0;210.0;199.0;1779.0;1637.0;243
4444;Harderwijk;2024;44616;10145;24954;9517;37166;2842;1042;1800;4608;2498;2110;480;199;281;290;140;150;1511;883;628;886;415;471;1441;861;580;477.0;458.0;216.0;195.0;1714.0;1676.0;243
4445;Harderwijk;2025;44701;10095;24849;9757;37243;2819;1028;1791;4639;2500;2139;484;200;284;297;144;153;1501;875;626;886;416;470;1471;865;606;;;;;;;243
4446;Hardinxveld-Giessendam;2008;17491;4943;10063;2485;16603;508;176;332;380;205;175;32;17;15;21;7;14;49;22;27;76;34;42;202;125;77;250.0;150.0;30.0;49.0;482.0;531.0;523
4447;Hardinxveld-Giessendam;2009;17526;4934;10079;2513;16565;532;189;343;429;226;203;39;20;19;24;8;16;59;30;29;90;40;50;217;128;89;252.0;147.0;41.0;46.0;445.0;541.0;523
4448;Hardinxveld-Giessendam;2010;17530;4901;10072;2557;16514;554;194;360;462;234;228;48;21;27;27;9;18;65;33;32;96;40;56;226;131;95;245.0;149.0;43.0;49.0;362.0;545.0;523
4449;Hardinxveld-Giessendam;2011;17437;4854;9995;2588;16354;567;192;375;516;259;257;56;25;31;33;14;19;71;37;34;109;46;63;247;137;110;239.0;150.0;40.0;46.0;518.0;544.0;523
4450;Hardinxveld-Giessendam;2012;17498;4821;9964;2713;16363;583;204;379;552;273;279;56;24;32;38;19;19;88;43;45;110;46;64;260;141;119;228.0;152.0;42.0;43.0;514.0;542.0;523
4451;Hardinxveld-Giessendam;2013;17548;4778;9950;2820;16357;608;213;395;583;283;300;60;23;37;40;16;24;89;42;47;119;51;68;275;151;124;225.0;151.0;39.0;50.0;498.0;527.0;523
4452;Hardinxveld-Giessendam;2014;17585;4754;9932;2899;16339;629;222;407;617;302;315;60;25;35;45;21;24;103;48;55;124;54;70;285;154;131;232.0;150.0;31.0;47.0;484.0;556.0;523
4453;Hardinxveld-Giessendam;2015;17582;4697;9884;3001;16289;647;241;406;646;308;338;72;31;41;49;22;27;109;49;60;123;52;71;293;154;139;231.0;154.0;42.0;49.0;473.0;548.0;523
4454;Hardinxveld-Giessendam;2016;17578;4678;9842;3058;16234;656;246;410;688;318;370;76;30;46;49;23;26;115;52;63;132;51;81;316;162;154;229.0;156.0;37.0;47.0;453.0;525.0;523
4455;Hardinxveld-Giessendam;2017;17571;4633;9825;3113;16183;683;259;424;705;321;384;79;31;48;51;22;29;121;52;69;133;55;78;321;161;160;232.0;154.0;37.0;47.0;517.0;550.0;523
4456;Hardinxveld-Giessendam;2018;17609;4659;9769;3181;16135;703;263;440;771;350;421;80;32;48;57;27;30;143;59;84;150;58;92;341;174;167;228.0;157.0;34.0;48.0;498.0;539.0;523
4457;Hardinxveld-Giessendam;2019;17625;4605;9785;3235;16106;710;261;449;809;360;449;85;33;52;62;28;34;151;61;90;154;59;95;357;179;178;225.0;158.0;42.0;45.0;516.0;541.0;523
4458;Hardinxveld-Giessendam;2020;17667;4590;9766;3311;16088;735;264;471;844;377;467;89;35;54;59;25;34;151;63;88;156;63;93;389;191;198;231.0;164.0;42.0;47.0;490.0;554.0;523
4459;Hardinxveld-Giessendam;2021;17667;4544;9742;3381;16055;763;277;486;849;380;469;92;37;55;60;26;34;155;66;89;152;63;89;390;188;202;234.0;168.0;42.0;47.0;512.0;564.0;523
4460;Hardinxveld-Giessendam;2022;17677;4529;9736;3412;16005;781;280;501;891;399;492;99;42;57;66;32;34;162;67;95;164;66;98;400;192;208;231.0;169.0;48.0;50.0;480.0;549.0;523
4461;Hardinxveld-Giessendam;2023;17670;4497;9701;3472;15930;788;283;505;952;418;534;97;41;56;79;37;42;178;67;111;176;70;106;422;203;219;231.0;177.0;40.0;47.0;520.0;541.0;523
4462;Hardinxveld-Giessendam;2024;17696;4494;9683;3519;15930;802;282;520;964;418;546;97;43;54;87;41;46;177;64;113;171;70;101;432;200;232;230.0;175.0;46.0;47.0;508.0;546.0;523
4463;Hardinxveld-Giessendam;2025;17714;4468;9635;3611;15904;824;292;532;986;431;555;99;44;55;91;47;44;187;67;120;168;71;97;441;202;239;;;;;;;523
4464;Haren;2008;19090;4384;10550;4156;16776;1559;674;885;755;481;274;79;36;43;63;26;37;50;27;23;33;14;19;530;378;152;152.0;234.0;95.0;121.0;1388.0;1239.0;17
4465;Haren;2009;19133;4208;10763;4162;16789;1550;660;890;794;506;288;92;40;52;66;28;38;52;33;19;46;22;24;538;383;155;155.0;231.0;96.0;123.0;1272.0;1255.0;17
4466;Haren;2010;19048;4063;10819;4166;16716;1533;652;881;799;489;310;97;42;55;64;26;38;59;34;25;51;23;28;528;364;164;166.0;229.0;98.0;113.0;1403.0;1278.0;17
4467;Haren;2011;19097;3944;11012;4141;16737;1517;657;860;843;508;335;110;47;63;76;37;39;76;43;33;56;24;32;525;357;168;177.0;222.0;106.0;118.0;1248.0;1288.0;17
4468;Haren;2012;19001;3813;10976;4212;16633;1497;639;858;871;523;348;114;51;63;83;45;38;93;45;48;65;27;38;516;355;161;176.0;221.0;100.0;108.0;1299.0;1291.0;17
4469;Haren;2013;18958;3726;10956;4276;16574;1475;619;856;909;543;366;120;59;61;92;51;41;109;54;55;71;24;47;517;355;162;186.0;211.0;112.0;106.0;1281.0;1315.0;17
4470;Haren;2014;18908;3643;10962;4303;16515;1460;608;852;933;564;369;127;62;65;104;61;43;109;57;52;76;27;49;517;357;160;197.0;211.0;97.0;111.0;1322.0;1279.0;17
4471;Haren;2015;18924;3586;10982;4356;16526;1453;614;839;945;565;380;137;68;69;100;61;39;117;60;57;81;31;50;510;345;165;201.0;207.0;101.0;108.0;1283.0;1292.0;17
4472;Haren;2016;18903;3567;10998;4338;16485;1459;627;832;959;558;401;144;71;73;97;61;36;125;64;61;85;30;55;508;332;176;209.0;209.0;100.0;101.0;1346.0;1298.0;17
4473;Haren;2017;18952;3585;11034;4333;16501;1451;629;822;1000;587;413;145;75;70;102;67;35;143;71;72;91;29;62;519;345;174;214.0;206.0;98.0;102.0;1332.0;1310.0;17
4474;Haren;2018;18977;3582;11030;4365;16529;1435;622;813;1013;590;423;141;74;67;118;75;43;153;71;82;94;35;59;507;335;172;215.0;201.0;95.0;101.0;1254.0;1309.0;17
4475;Haren;2019;18930;3525;11030;4375;16467;1427;619;808;1036;598;438;148;77;71;120;77;43;155;66;89;104;38;66;509;340;169;224.0;208.0;93.0;99.0;1378.0;1274.0;17
4476;Haren;2020;19044;3562;11056;4426;16567;1428;630;798;1049;605;444;151;78;73;122;86;36;158;67;91;104;42;62;514;332;182;225.0;204.0;108.0;96.0;1378.0;1309.0;17
4477;Haren;2021;19149;3604;11112;4433;16614;1441;644;797;1094;631;463;150;76;74;132;92;40;167;76;91;104;44;60;541;343;198;225.0;199.0;94.0;97.0;1360.0;1305.0;17
4478;Haren;2022;19228;3609;11110;4509;16648;1476;663;813;1104;639;465;157;79;78;127;86;41;170;81;89;105;43;62;545;350;195;225.0;210.0;94.0;97.0;1384.0;1294.0;17
4479;Haren;2023;19334;3661;11143;4530;16705;1500;688;812;1129;645;484;156;80;76;134;85;49;178;87;91;114;44;70;547;349;198;224.0;207.0;97.0;95.0;1349.0;1330.0;17
4480;Haren;2024;19374;3661;11133;4580;16705;1497;684;813;1172;664;508;166;85;81;144;88;56;181;81;100;116;44;72;565;366;199;230.0;201.0;99.0;97.0;1246.0;1304.0;17
4481;Haren;2025;19349;3670;11065;4614;16674;1491;678;813;1184;662;522;181;91;90;147;87;60;179;82;97;115;45;70;562;357;205;;;;;;;17
4482;Harenkarspel;2008;15872;4271;9652;1949;14727;786;319;467;359;205;154;67;25;42;25;12;13;31;13;18;29;15;14;207;140;67;166.0;117.0;42.0;68.0;620.0;687.0;395
4483;Harenkarspel;2009;15830;4191;9595;2044;14632;819;322;497;379;205;174;69;24;45;35;16;19;32;15;17;35;16;19;208;134;74;156.0;118.0;50.0;66.0;631.0;687.0;395
4484;Harenkarspel;2010;15800;4128;9533;2139;14546;822;321;501;432;232;200;84;32;52;36;15;21;46;20;26;38;18;20;228;147;81;153.0;119.0;57.0;63.0;730.0;708.0;395
4485;Harenkarspel;2011;15852;4067;9541;2244;14538;842;330;512;472;246;226;93;35;58;38;16;22;57;24;33;46;19;27;238;152;86;154.0;124.0;45.0;69.0;858.0;706.0;395
4486;Harenkarspel;2012;16011;4028;9561;2422;14654;850;331;519;507;265;242;101;37;64;42;17;25;54;23;31;57;21;36;253;167;86;154.0;127.0;49.0;65.0;853.0;737.0;395
4487;Harenkarspel;2013;16139;3979;9572;2588;14728;886;348;538;525;277;248;102;40;62;44;21;23;58;23;35;64;28;36;257;165;92;156.0;135.0;49.0;65.0;741.0;745.0;395
4488;Harenkarspel;2014;16141;3879;9525;2737;14688;873;329;544;580;299;281;114;46;68;49;24;25;60;20;40;77;33;44;280;176;104;156.0;139.0;47.0;65.0;766.0;732.0;395
4489;Harenkarspel;2015;16176;3795;9526;2855;14647;888;339;549;641;326;315;117;46;71;50;24;26;72;24;48;90;39;51;312;193;119;157.0;137.0;45.0;68.0;781.0;725.0;395
4490;Harenkarspel;2016;16230;3739;9505;2986;14649;904;347;557;677;343;334;116;47;69;51;24;27;84;28;56;88;37;51;338;207;131;154.0;143.0;50.0;65.0;662.0;753.0;395
4491;Harenkarspel;2017;16140;3635;9437;3068;14524;916;349;567;700;352;348;121;50;71;53;24;29;93;35;58;97;46;51;336;197;139;156.0;145.0;56.0;63.0;781.0;715.0;395
4492;Harenkarspel;2018;16212;3578;9490;3144;14528;950;366;584;734;366;368;130;55;75;56;27;29;103;39;64;103;45;58;342;200;142;160.0;151.0;50.0;63.0;705.0;746.0;395
4493;Harenkarspel;2019;16166;3520;9391;3255;14461;949;361;588;756;382;374;136;57;79;59;28;31;110;40;70;107;46;61;344;211;133;158.0;150.0;50.0;65.0;749.0;736.0;395
4494;Harenkarspel;2020;16174;3488;9345;3341;14457;948;347;601;769;385;384;137;60;77;69;32;37;118;44;74;105;47;58;340;202;138;166.0;154.0;56.0;63.0;735.0;730.0;395
4495;Harenkarspel;2021;16187;3440;9312;3435;14447;946;351;595;794;401;393;144;64;80;76;35;41;112;43;69;108;47;61;354;212;142;154.0;161.0;52.0;64.0;798.0;730.0;395
4496;Harenkarspel;2022;16237;3389;9314;3534;14449;967;368;599;821;397;424;143;62;81;84;38;46;131;46;85;108;44;64;355;207;148;162.0;162.0;53.0;64.0;775.0;739.0;395
4497;Harenkarspel;2023;16265;3343;9329;3593;14449;972;370;602;844;406;438;151;68;83;86;39;47;132;43;89;106;47;59;369;209;160;158.0;169.0;55.0;67.0;835.0;770.0;395
4498;Harenkarspel;2024;16308;3303;9347;3658;14483;968;372;596;857;412;445;153;70;83;80;36;44;141;46;95;102;44;58;381;216;165;163.0;170.0;53.0;59.0;923.0;755.0;395
4499;Harenkarspel;2025;16464;3334;9335;3795;14585;980;384;596;899;444;455;164;78;86;81;39;42;147;52;95;110;45;65;397;230;167;;;;;;;395
4500;Harlingen;2008;15305;3641;9158;2506;13532;1140;426;714;633;382;251;70;38;32;35;26;9;70;40;30;115;61;54;343;217;126;156.0;164.0;64.0;81.0;740.0;849.0;72
4501;Harlingen;2009;15173;3579;9041;2553;13433;1104;413;691;636;381;255;68;40;28;42;30;12;66;35;31;120;63;57;340;213;127;154.0;163.0;48.0;82.0;736.0;793.0;72
4502;Harlingen;2010;15077;3511;8964;2602;13335;1083;404;679;659;387;272;80;42;38;40;30;10;71;35;36;127;65;62;341;215;126;152.0;165.0;47.0;73.0;788.0;803.0;72
4503;Harlingen;2011;15025;3404;8948;2673;13279;1065;390;675;681;397;284;84;40;44;39;29;10;74;34;40;128;63;65;356;231;125;148.0;165.0;65.0;75.0;653.0;779.0;72
4504;Harlingen;2012;14874;3278;8811;2785;13155;1042;377;665;677;392;285;86;43;43;40;31;9;78;36;42;123;60;63;350;222;128;147.0;161.0;54.0;76.0;726.0;762.0;72
4505;Harlingen;2013;14804;3211;8696;2897;13067;1046;384;662;691;394;297;102;50;52;38;28;10;85;39;46;124;60;64;342;217;125;149.0;164.0;49.0;74.0;695.0;771.0;72
4506;Harlingen;2014;14690;3121;8595;2974;12938;1054;385;669;698;398;300;102;49;53;41;29;12;78;34;44;125;58;67;352;228;124;147.0;162.0;51.0;71.0;754.0;777.0;72
4507;Harlingen;2015;14635;3075;8518;3042;12903;1017;355;662;715;411;304;103;51;52;47;31;16;82;38;44;124;58;66;359;233;126;141.0;162.0;52.0;63.0;688.0;732.0;72
4508;Harlingen;2016;14561;3035;8429;3097;12835;985;331;654;741;423;318;108;55;53;51;35;16;96;44;52;130;58;72;356;231;125;140.0;176.0;46.0;70.0;707.0;750.0;72
4509;Harlingen;2017;14461;2969;8361;3131;12740;971;322;649;750;431;319;118;60;58;52;35;17;97;46;51;128;58;70;355;232;123;138.0;163.0;47.0;66.0;650.0;725.0;72
4510;Harlingen;2018;14344;2933;8259;3152;12634;966;322;644;744;416;328;119;60;59;55;37;18;102;47;55;125;56;69;343;216;127;136.0;168.0;43.0;56.0;812.0;782.0;72
4511;Harlingen;2019;14331;2889;8217;3225;12621;947;316;631;763;420;343;121;60;61;57;38;19;104;45;59;138;62;76;343;215;128;139.0;167.0;39.0;64.0;678.0;741.0;72
4512;Harlingen;2020;14215;2849;8095;3271;12510;929;310;619;776;431;345;119;63;56;55;37;18;111;43;68;137;63;74;354;225;129;142.0;173.0;48.0;59.0;740.0;774.0;72
4513;Harlingen;2021;14139;2795;8043;3301;12457;917;310;607;765;427;338;120;61;59;59;40;19;108;46;62;124;57;67;354;223;131;144.0;173.0;37.0;60.0;720.0;763.0;72
4514;Harlingen;2022;14047;2744;7950;3353;12374;905;306;599;768;436;332;116;62;54;65;45;20;98;44;54;135;57;78;354;228;126;138.0;178.0;42.0;57.0;794.0;733.0;72
4515;Harlingen;2023;14054;2714;7950;3390;12376;901;305;596;777;440;337;122;68;54;68;49;19;102;45;57;135;55;80;350;223;127;145.0;183.0;39.0;58.0;782.0;743.0;72
4516;Harlingen;2024;14036;2716;7879;3441;12381;867;292;575;788;445;343;125;67;58;72;53;19;103;47;56;131;50;81;357;228;129;147.0;180.0;42.0;55.0;670.0;748.0;72
4517;Harlingen;2025;13913;2657;7775;3481;12233;879;300;579;801;447;354;129;66;63;73;56;17;109;48;61;138;53;85;352;224;128;;;;;;;72
4518;Hattem;2008;11607;2941;6707;1959;10810;497;160;337;300;172;128;25;12;13;20;12;8;60;28;32;19;9;10;176;111;65;131.0;105.0;37.0;48.0;352.0;424.0;244
4519;Hattem;2009;11551;2860;6685;2006;10734;503;162;341;314;178;136;28;13;15;21;13;8;60;26;34;27;14;13;178;112;66;129.0;104.0;44.0;46.0;312.0;429.0;244
4520;Hattem;2010;11458;2799;6611;2048;10629;497;160;337;332;186;146;31;12;19;25;14;11;59;27;32;29;14;15;188;119;69;127.0;108.0;44.0;46.0;397.0;439.0;244
4521;Hattem;2011;11433;2738;6630;2065;10586;497;168;329;350;196;154;30;10;20;26;13;13;62;30;32;34;18;16;198;125;73;125.0;109.0;44.0;45.0;432.0;427.0;244
4522;Hattem;2012;11456;2713;6583;2160;10569;498;162;336;389;213;176;37;14;23;30;14;16;65;32;33;38;21;17;219;132;87;130.0;111.0;47.0;46.0;407.0;447.0;244
4523;Hattem;2013;11438;2650;6566;2222;10500;500;170;330;438;234;204;42;17;25;40;21;19;72;31;41;42;21;21;242;144;98;129.0;110.0;49.0;47.0;431.0;446.0;244
4524;Hattem;2014;11445;2616;6562;2267;10463;510;193;317;472;248;224;44;16;28;45;25;20;78;30;48;41;22;19;264;155;109;130.0;109.0;50.0;43.0;389.0;450.0;244
4525;Hattem;2015;11412;2599;6500;2313;10390;518;187;331;504;263;241;42;16;26;51;28;23;79;33;46;51;23;28;281;163;118;128.0;112.0;46.0;45.0;435.0;449.0;244
4526;Hattem;2016;11417;2568;6503;2346;10367;519;189;330;531;280;251;50;20;30;47;26;21;81;35;46;52;19;33;301;180;121;129.0;115.0;58.0;47.0;460.0;456.0;244
4527;Hattem;2017;11448;2578;6499;2371;10368;517;190;327;563;300;263;55;24;31;51;28;23;83;36;47;54;19;35;320;193;127;128.0;110.0;54.0;44.0;415.0;455.0;244
4528;Hattem;2018;11436;2529;6487;2420;10336;524;197;327;576;315;261;58;25;33;48;27;21;87;36;51;57;21;36;326;206;120;132.0;115.0;54.0;48.0;410.0;470.0;244
4529;Hattem;2019;11399;2495;6478;2426;10289;519;199;320;591;320;271;61;25;36;50;31;19;85;33;52;57;20;37;338;211;127;131.0;113.0;47.0;43.0;382.0;459.0;244
4530;Hattem;2020;11345;2470;6424;2451;10207;521;198;323;617;329;288;64;27;37;49;30;19;91;34;57;60;21;39;353;217;136;130.0;114.0;49.0;45.0;431.0;452.0;244
4531;Hattem;2021;11344;2460;6401;2483;10185;526;194;332;633;335;298;67;29;38;50;30;20;93;36;57;62;22;40;361;218;143;131.0;114.0;50.0;44.0;465.0;451.0;244
4532;Hattem;2022;11383;2467;6417;2499;10180;536;199;337;667;351;316;68;31;37;59;35;24;101;39;62;61;21;40;378;225;153;131.0;115.0;53.0;47.0;484.0;459.0;244
4533;Hattem;2023;11432;2444;6461;2527;10203;547;204;343;682;356;326;71;31;40;59;36;23;110;41;69;63;20;43;379;228;151;128.0;115.0;51.0;44.0;454.0;456.0;244
4534;Hattem;2024;11451;2430;6464;2557;10198;548;206;342;705;365;340;70;30;40;60;34;26;112;43;69;74;23;51;389;235;154;124.0;114.0;46.0;46.0;336.0;458.0;244
4535;Hattem;2025;11339;2382;6390;2567;10080;547;194;353;712;362;350;73;31;42;63;36;27;115;44;71;76;23;53;385;228;157;;;;;;;244
4536;Heemskerk;2008;38488;9343;22689;6456;31691;3551;1484;2067;3246;1925;1321;348;175;173;130;64;66;1051;591;460;260;130;130;1457;965;492;345.0;357.0;150.0;183.0;2029.0;1628.0;396
4537;Heemskerk;2009;38847;9307;22967;6573;31952;3520;1450;2070;3375;1976;1399;356;170;186;136;64;72;1118;636;482;285;139;146;1480;967;513;348.0;361.0;157.0;183.0;2007.0;1697.0;396
4538;Heemskerk;2010;39122;9263;23170;6689;32124;3525;1441;2084;3473;2003;1470;385;180;205;151;71;80;1173;676;497;288;136;152;1476;940;536;355.0;365.0;170.0;180.0;1652.0;1718.0;396
4539;Heemskerk;2011;39039;9090;23199;6750;32023;3489;1427;2062;3527;2023;1504;393;185;208;161;77;84;1209;690;519;296;137;159;1468;934;534;356.0;370.0;157.0;171.0;1634.0;1682.0;396
4540;Heemskerk;2012;38968;8905;23070;6993;31910;3463;1422;2041;3595;2041;1554;413;202;211;176;84;92;1209;680;529;304;141;163;1493;934;559;360.0;379.0;170.0;173.0;1659.0;1651.0;396
4541;Heemskerk;2013;38958;8786;23050;7122;31822;3462;1406;2056;3674;2064;1610;425;212;213;191;90;101;1237;682;555;324;150;174;1497;930;567;358.0;384.0;178.0;167.0;1678.0;1665.0;396
4542;Heemskerk;2014;38960;8634;23049;7277;31792;3467;1423;2044;3701;2077;1624;417;207;210;195;94;101;1263;696;567;333;152;181;1493;928;565;363.0;393.0;160.0;175.0;1593.0;1613.0;396
4543;Heemskerk;2015;38897;8557;22937;7403;31699;3440;1420;2020;3758;2093;1665;426;212;214;187;87;100;1265;703;562;360;160;200;1520;931;589;373.0;397.0;164.0;161.0;1689.0;1593.0;396
4544;Heemskerk;2016;38975;8510;22950;7515;31734;3421;1422;1999;3820;2128;1692;434;214;220;187;93;94;1296;725;571;374;167;207;1529;929;600;365.0;390.0;161.0;156.0;1669.0;1641.0;396
4545;Heemskerk;2017;38988;8482;22869;7637;31734;3403;1421;1982;3851;2138;1713;451;227;224;199;101;98;1302;717;585;362;171;191;1537;922;615;360.0;408.0;162.0;153.0;1656.0;1592.0;396
4546;Heemskerk;2018;39015;8442;22834;7739;31687;3395;1426;1969;3933;2165;1768;454;227;227;203;101;102;1333;732;601;379;170;209;1564;935;629;374.0;405.0;149.0;153.0;1619.0;1591.0;396
4547;Heemskerk;2019;39012;8417;22760;7835;31643;3379;1418;1961;3990;2176;1814;468;231;237;199;102;97;1344;736;608;396;173;223;1583;934;649;370.0;411.0;158.0;155.0;1840.0;1585.0;396
4548;Heemskerk;2020;39230;8431;22842;7957;31739;3397;1429;1968;4094;2220;1874;482;233;249;204;106;98;1385;755;630;413;183;230;1610;943;667;376.0;416.0;166.0;148.0;1567.0;1630.0;396
4549;Heemskerk;2021;39148;8344;22710;8094;31586;3398;1419;1979;4164;2247;1917;497;245;252;206;110;96;1411;769;642;423;186;237;1627;937;690;383.0;425.0;162.0;147.0;1642.0;1632.0;396
4550;Heemskerk;2022;39134;8297;22590;8247;31494;3402;1411;1991;4238;2278;1960;511;255;256;215;113;102;1403;760;643;440;189;251;1669;961;708;385.0;422.0;154.0;148.0;1747.0;1608.0;396
4551;Heemskerk;2023;39243;8289;22510;8444;31499;3401;1404;1997;4343;2317;2026;522;258;264;224;115;109;1439;782;657;449;188;261;1709;974;735;382.0;435.0;154.0;153.0;1730.0;1627.0;396
4552;Heemskerk;2024;39298;8261;22441;8596;31448;3416;1425;1991;4434;2333;2101;536;262;274;236;120;116;1462;780;682;468;197;271;1732;974;758;389.0;432.0;153.0;140.0;1664.0;1620.0;396
4553;Heemskerk;2025;39315;8243;22228;8844;31388;3428;1403;2025;4499;2383;2116;547;275;272;249;132;117;1488;808;680;472;195;277;1743;973;770;;;;;;;396
4554;Heemstede;2008;25458;5869;14141;5448;21129;3008;1050;1958;1321;702;619;201;92;109;121;55;66;145;66;79;145;60;85;709;429;280;182.0;281.0;185.0;203.0;1676.0;1568.0;397
4555;Heemstede;2009;25451;5762;14235;5454;21068;2982;1036;1946;1401;741;660;216;96;120;129;58;71;162;80;82;166;69;97;728;438;290;185.0;284.0;193.0;192.0;1697.0;1629.0;397
4556;Heemstede;2010;25423;5596;14362;5465;21005;2957;1057;1900;1461;774;687;223;100;123;139;66;73;174;85;89;172;72;100;753;451;302;186.0;275.0;204.0;196.0;1653.0;1632.0;397
4557;Heemstede;2011;25365;5455;14462;5448;20899;2969;1071;1898;1497;810;687;233;111;122;142;71;71;178;89;89;174;72;102;770;467;303;205.0;279.0;217.0;192.0;1674.0;1666.0;397
4558;Heemstede;2012;25327;5393;14361;5573;20820;2955;1074;1881;1552;812;740;243;109;134;146;73;73;187;90;97;188;73;115;788;467;321;197.0;272.0;209.0;179.0;1616.0;1683.0;397
4559;Heemstede;2013;25219;5333;14174;5712;20682;2929;1081;1848;1608;827;781;259;109;150;150;77;73;195;94;101;195;71;124;809;476;333;206.0;273.0;221.0;191.0;1634.0;1698.0;397
4560;Heemstede;2014;25121;5218;14082;5821;20602;2903;1080;1823;1616;836;780;258;115;143;151;73;78;196;97;99;197;71;126;814;480;334;202.0;269.0;230.0;174.0;1627.0;1678.0;397
4561;Heemstede;2015;25061;5151;14026;5884;20507;2900;1093;1807;1654;834;820;260;115;145;165;76;89;191;96;95;224;73;151;814;474;340;211.0;269.0;189.0;174.0;1647.0;1658.0;397
4562;Heemstede;2016;25009;5068;14016;5925;20435;2879;1091;1788;1695;856;839;262;113;149;171;82;89;204;105;99;228;68;160;830;488;342;212.0;266.0;205.0;169.0;1680.0;1653.0;397
4563;Heemstede;2017;25021;5028;14025;5968;20381;2903;1133;1770;1737;850;887;273;111;162;183;85;98;215;110;105;232;65;167;834;479;355;225.0;268.0;224.0;165.0;1649.0;1652.0;397
4564;Heemstede;2018;25035;5021;14044;5970;20299;2911;1141;1770;1825;894;931;284;114;170;184;80;104;230;121;109;238;72;166;889;507;382;231.0;270.0;200.0;178.0;1695.0;1645.0;397
4565;Heemstede;2019;25071;4990;14048;6033;20266;2957;1167;1790;1848;891;957;287;116;171;186;80;106;247;125;122;248;77;171;880;493;387;235.0;267.0;194.0;163.0;1705.0;1694.0;397
4566;Heemstede;2020;25079;4927;14055;6097;20242;2978;1191;1787;1859;912;947;289;122;167;195;83;112;248;125;123;241;82;159;886;500;386;230.0;272.0;203.0;166.0;1636.0;1707.0;397
4567;Heemstede;2021;25005;4889;13987;6129;20157;2920;1167;1753;1928;944;984;295;126;169;188;78;110;259;129;130;252;87;165;934;524;410;232.0;265.0;203.0;172.0;1630.0;1651.0;397
4568;Heemstede;2022;24985;4840;13982;6163;20117;2930;1182;1748;1938;940;998;289;127;162;191;73;118;270;125;145;251;85;166;937;530;407;232.0;275.0;196.0;163.0;1619.0;1658.0;397
4569;Heemstede;2023;24937;4838;13920;6179;20017;2918;1193;1725;2002;963;1039;295;127;168;206;83;123;277;130;147;254;85;169;970;538;432;224.0;267.0;197.0;166.0;1747.0;1694.0;397
4570;Heemstede;2024;24980;4825;13919;6236;19986;2930;1202;1728;2064;981;1083;304;133;171;212;84;128;292;130;162;266;90;176;990;544;446;231.0;267.0;184.0;170.0;1694.0;1710.0;397
4571;Heemstede;2025;24944;4817;13798;6329;19931;2935;1225;1710;2078;989;1089;309;133;176;212;79;133;289;135;154;263;85;178;1005;557;448;;;;;;;397
4572;Heerde;2008;18044;4292;10704;3048;16692;681;297;384;671;488;183;29;16;13;21;15;6;102;51;51;21;13;8;498;393;105;159.0;173.0;71.0;80.0;774.0;986.0;246
4573;Heerde;2009;17813;4133;10590;3090;16448;694;301;393;671;477;194;34;21;13;24;18;6;101;52;49;28;17;11;484;369;115;159.0;175.0;81.0;89.0;908.0;983.0;246
4574;Heerde;2010;17716;4025;10549;3142;16296;722;311;411;698;479;219;50;29;21;32;23;9;103;52;51;37;19;18;476;356;120;159.0;180.0;76.0;80.0;847.0;976.0;246
4575;Heerde;2011;17564;3910;10501;3153;16107;719;317;402;738;485;253;60;32;28;36;23;13;107;51;56;44;18;26;491;361;130;160.0;176.0;71.0;78.0;835.0;957.0;246
4576;Heerde;2012;17422;3819;10322;3281;15910;752;330;422;760;491;269;66;40;26;34;21;13;118;56;62;48;19;29;494;355;139;155.0;171.0;87.0;79.0;866.0;959.0;246
4577;Heerde;2013;17322;3737;10224;3361;15767;767;330;437;788;496;292;80;46;34;38;21;17;129;62;67;48;20;28;493;347;146;156.0;175.0;76.0;76.0;885.0;933.0;246
4578;Heerde;2014;17257;3660;10154;3443;15640;797;345;452;820;505;315;90;54;36;37;19;18;138;69;69;58;29;29;497;334;163;156.0;171.0;82.0;73.0;796.0;959.0;246
4579;Heerde;2015;17090;3557;10052;3481;15419;797;352;445;874;528;346;100;57;43;44;21;23;136;68;68;71;31;40;523;351;172;153.0;175.0;77.0;72.0;824.0;925.0;246
4580;Heerde;2016;16972;3466;9982;3524;15268;790;347;443;914;548;366;105;61;44;49;24;25;152;75;77;73;30;43;535;358;177;151.0;178.0;73.0;71.0;784.0;946.0;246
4581;Heerde;2017;16785;3370;9888;3527;15074;787;347;440;924;552;372;110;60;50;50;25;25;158;80;78;78;30;48;528;357;171;151.0;176.0;66.0;73.0;778.0;916.0;246
4582;Heerde;2018;16618;3297;9729;3592;14907;782;332;450;929;550;379;108;54;54;55;31;24;159;80;79;79;32;47;528;353;175;149.0;175.0;74.0;67.0;818.0;915.0;246
4583;Heerde;2019;16504;3200;9677;3627;14756;802;334;468;946;560;386;109;53;56;62;32;30;176;88;88;78;33;45;521;354;167;151.0;176.0;70.0;69.0;819.0;881.0;246
4584;Heerde;2020;16421;3138;9646;3637;14649;799;334;465;973;574;399;115;57;58;73;39;34;183;86;97;84;34;50;518;358;160;155.0;181.0;73.0;70.0;758.0;920.0;246
4585;Heerde;2021;16237;3044;9477;3716;14476;794;339;455;967;563;404;117;56;61;73;38;35;185;87;98;83;35;48;509;347;162;156.0;178.0;67.0;71.0;791.0;902.0;246
4586;Heerde;2022;16102;2972;9365;3765;14337;785;329;456;980;584;396;109;56;53;76;41;35;188;93;95;83;36;47;524;358;166;158.0;180.0;73.0;65.0;812.0;897.0;246
4587;Heerde;2023;16003;2919;9265;3819;14228;768;327;441;1007;603;404;104;52;52;79;39;40;189;93;96;89;40;49;546;379;167;159.0;178.0;73.0;62.0;795.0;855.0;246
4588;Heerde;2024;15935;2893;9159;3883;14125;772;333;439;1038;613;425;113;55;58;89;46;43;201;98;103;87;39;48;548;375;173;158.0;182.0;65.0;61.0;709.0;839.0;246
4589;Heerde;2025;15786;2856;8977;3953;13969;781;333;448;1036;611;425;111;57;54;90;49;41;204;99;105;90;38;52;541;368;173;;;;;;;246
4590;Heerenveen;2008;42730;9991;25209;7530;38270;2277;865;1412;2183;1308;875;311;168;143;150;92;58;468;257;211;328;176;152;926;615;311;405.0;417.0;126.0;242.0;2053.0;1929.0;74
4591;Heerenveen;2009;42727;9915;25196;7616;38256;2280;849;1431;2191;1310;881;318;167;151;161;99;62;481;272;209;335;176;159;896;596;300;400.0;414.0;146.0;232.0;2168.0;1926.0;74
4592;Heerenveen;2010;42874;9792;25330;7752;38338;2294;849;1445;2242;1313;929;323;166;157;180;111;69;489;280;209;355;179;176;895;577;318;407.0;413.0;149.0;230.0;2038.0;1938.0;74
4593;Heerenveen;2011;42893;9690;25355;7848;38325;2265;816;1449;2303;1347;956;342;178;164;182;114;68;499;292;207;369;177;192;911;586;325;401.0;415.0;157.0;227.0;2004.0;1893.0;74
4594;Heerenveen;2012;42923;9581;25261;8081;38272;2282;837;1445;2369;1351;1018;365;184;181;191;118;73;524;298;226;368;175;193;921;576;345;400.0;413.0;155.0;214.0;2083.0;1919.0;74
4595;Heerenveen;2013;43016;9498;25245;8273;38312;2307;854;1453;2397;1353;1044;368;182;186;211;132;79;520;291;229;386;181;205;912;567;345;395.0;418.0;144.0;214.0;1979.0;1949.0;74
4596;Heerenveen;2014;42956;9396;25097;8463;38255;2263;830;1433;2438;1385;1053;364;187;177;225;136;89;525;287;238;394;177;217;930;598;332;397.0;415.0;144.0;217.0;1999.0;1908.0;74
4597;Heerenveen;2015;42961;9297;25036;8628;38199;2258;810;1448;2504;1406;1098;374;191;183;235;141;94;543;289;254;393;175;218;959;610;349;401.0;428.0;153.0;203.0;2053.0;1952.0;74
4598;Heerenveen;2016;42990;9206;25034;8750;38161;2274;811;1463;2555;1426;1129;395;203;192;245;149;96;543;291;252;403;178;225;969;605;364;399.0;417.0;155.0;208.0;1934.0;1946.0;74
4599;Heerenveen;2017;42912;9097;24958;8857;38030;2285;814;1471;2597;1438;1159;403;208;195;257;150;107;559;296;263;398;174;224;980;610;370;409.0;427.0;152.0;208.0;1917.0;1940.0;74
4600;Heerenveen;2018;42820;8977;24829;9014;37884;2286;808;1478;2650;1462;1188;420;211;209;274;162;112;551;291;260;406;176;230;999;622;377;405.0;420.0;141.0;193.0;1958.0;1933.0;74
4601;Heerenveen;2019;42782;8870;24761;9151;37777;2306;822;1484;2699;1476;1223;429;217;212;277;167;110;569;299;270;423;179;244;1001;614;387;413.0;423.0;157.0;194.0;2013.0;1926.0;74
4602;Heerenveen;2020;42824;8806;24710;9308;37745;2325;829;1496;2754;1496;1258;439;223;216;296;173;123;581;300;281;435;179;256;1003;621;382;407.0;433.0;152.0;185.0;2024.0;1948.0;74
4603;Heerenveen;2021;42847;8738;24623;9486;37712;2321;814;1507;2814;1499;1315;457;230;227;304;177;127;592;302;290;446;173;273;1015;617;398;420.0;427.0;155.0;194.0;2031.0;1941.0;74
4604;Heerenveen;2022;42895;8668;24550;9677;37691;2340;816;1524;2864;1525;1339;467;235;232;318;184;134;602;307;295;439;175;264;1038;624;414;421.0;437.0;157.0;190.0;2071.0;1929.0;74
4605;Heerenveen;2023;42993;8606;24558;9829;37731;2352;838;1514;2910;1547;1363;493;240;253;324;183;141;613;314;299;441;171;270;1039;639;400;422.0;447.0;160.0;185.0;1963.0;1967.0;74
4606;Heerenveen;2024;42945;8506;24458;9981;37595;2356;847;1509;2994;1589;1405;513;245;268;320;185;135;618;313;305;459;176;283;1084;670;414;439.0;444.0;153.0;190.0;1869.0;1918.0;74
4607;Heerenveen;2025;42862;8512;24233;10117;37472;2350;864;1486;3040;1607;1433;511;244;267;334;192;142;615;311;304;471;178;293;1109;682;427;;;;;;;74
4608;Heerhugowaard;2008;49770;13253;31012;5505;41560;3829;1396;2433;4381;2456;1925;735;373;362;459;265;194;896;440;456;577;317;260;1714;1061;653;636.0;306.0;226.0;218.0;2009.0;1878.0;398
4609;Heerhugowaard;2009;50246;13348;31045;5853;41861;3862;1393;2469;4523;2500;2023;743;366;377;475;274;201;936;456;480;620;323;297;1749;1081;668;638.0;318.0;249.0;216.0;1916.0;1970.0;398
4610;Heerhugowaard;2010;50552;13338;30951;6263;41988;3878;1411;2467;4686;2584;2102;752;377;375;495;289;206;979;466;513;647;343;304;1813;1109;704;618.0;321.0;248.0;206.0;2190.0;1983.0;398
4611;Heerhugowaard;2011;51106;13333;31130;6643;42399;3910;1437;2473;4797;2622;2175;770;384;386;508;298;210;1004;471;533;665;354;311;1850;1115;735;603.0;347.0;268.0;208.0;2256.0;2032.0;398
4612;Heerhugowaard;2012;51654;13332;31145;7177;42715;3947;1464;2483;4992;2731;2261;778;381;397;559;325;234;1039;493;546;700;372;328;1916;1160;756;608.0;353.0;280.0;212.0;2257.0;2049.0;398
4613;Heerhugowaard;2013;52194;13316;31220;7658;43074;4009;1497;2512;5111;2794;2317;767;379;388;602;344;258;1048;503;545;741;395;346;1953;1173;780;614.0;372.0;285.0;204.0;2297.0;2070.0;398
4614;Heerhugowaard;2014;52749;13405;31292;8052;43404;4111;1569;2542;5234;2837;2397;780;382;398;615;343;272;1068;513;555;784;412;372;1987;1187;800;614.0;380.0;267.0;212.0;2475.0;2096.0;398
4615;Heerhugowaard;2015;53423;13479;31487;8457;43795;4202;1638;2564;5426;2895;2531;800;386;414;622;351;271;1114;527;587;831;422;409;2059;1209;850;613.0;396.0;274.0;206.0;2327.0;2133.0;398
4616;Heerhugowaard;2016;53911;13473;31657;8781;44078;4287;1688;2599;5546;2944;2602;804;390;414;639;358;281;1137;526;611;873;444;429;2093;1226;867;633.0;404.0;264.0;213.0;2458.0;2161.0;398
4617;Heerhugowaard;2017;54493;13518;31930;9045;44435;4329;1722;2607;5729;3019;2710;827;401;426;663;368;295;1178;548;630;914;460;454;2147;1242;905;638.0;424.0;281.0;210.0;2391.0;2209.0;398
4618;Heerhugowaard;2018;54964;13470;32138;9356;44693;4365;1756;2609;5906;3106;2800;835;403;432;676;377;299;1228;559;669;949;474;475;2218;1293;925;637.0;441.0;262.0;202.0;2410.0;2191.0;398
4619;Heerhugowaard;2019;55446;13484;32323;9639;44951;4439;1787;2652;6056;3169;2887;870;417;453;675;394;281;1263;564;699;989;479;510;2259;1315;944;658.0;450.0;266.0;206.0;2444.0;2219.0;398
4620;Heerhugowaard;2020;55948;13552;32469;9927;45250;4471;1768;2703;6227;3233;2994;883;420;463;706;412;294;1300;572;728;1011;494;517;2327;1335;992;657.0;461.0;292.0;214.0;2239.0;2248.0;398
4621;Heerhugowaard;2021;56220;13392;32624;10204;45337;4519;1797;2722;6364;3291;3073;909;431;478;720;421;299;1332;581;751;1054;512;542;2349;1346;1003;681.0;479.0;275.0;210.0;2377.0;2247.0;398
4622;Heerhugowaard;2022;56624;13323;32876;10425;45573;4548;1813;2735;6503;3339;3164;923;430;493;740;433;307;1360;590;770;1068;509;559;2412;1377;1035;679.0;499.0;258.0;204.0;2467.0;2268.0;398
4623;Heerhugowaard;2023;57062;13273;33118;10671;45871;4553;1838;2715;6638;3402;3236;929;442;487;759;432;327;1392;613;779;1133;530;603;2425;1385;1040;706.0;514.0;291.0;183.0;2500.0;2288.0;398
4624;Heerhugowaard;2024;57580;13320;33342;10918;46124;4637;1906;2731;6819;3466;3353;968;455;513;774;436;338;1452;611;841;1156;544;612;2469;1420;1049;685.0;531.0;282.0;202.0;2406.0;2255.0;398
4625;Heerhugowaard;2025;57969;13313;33507;11149;46281;4705;1957;2748;6983;3549;3434;987;455;532;800;447;353;1503;638;865;1192;559;633;2501;1450;1051;;;;;;;398
4626;Heerlen;2008;90519;18252;55822;16445;65965;17751;5608;12143;6803;4033;2770;469;230;239;624;404;220;728;376;352;2272;1194;1078;2710;1829;881;766.0;1032.0;470.0;779.0;4424.0;4413.0;917
4627;Heerlen;2009;89968;18109;55411;16448;65671;17343;5529;11814;6954;4089;2865;515;254;261;645;409;236;764;387;377;2240;1175;1065;2790;1864;926;753.0;1025.0;448.0;773.0;4419.0;4391.0;917
4628;Heerlen;2010;89412;17876;55025;16511;65426;16969;5432;11537;7017;4100;2917;538;274;264;644;403;241;813;400;413;2207;1147;1060;2815;1876;939;752.0;1020.0;484.0;728.0;4485.0;4439.0;917
4629;Heerlen;2011;88957;17626;54671;16660;65129;16628;5366;11262;7200;4176;3024;604;305;299;657;408;249;878;435;443;2192;1137;1055;2869;1891;978;752.0;1024.0;443.0;724.0;4306.0;4399.0;917
4630;Heerlen;2012;88320;17308;54136;16876;64792;16241;5268;10973;7287;4159;3128;633;321;312;659;410;249;940;436;504;2181;1111;1070;2874;1881;993;749.0;1018.0;437.0;694.0;4365.0;4349.0;917
4631;Heerlen;2013;87820;17169;53587;17064;64572;15835;5163;10672;7413;4226;3187;651;342;309;670;417;253;998;473;525;2163;1091;1072;2931;1903;1028;755.0;1032.0;459.0;690.0;4240.0;4324.0;917
4632;Heerlen;2014;87241;16964;53037;17240;64192;15529;5125;10404;7520;4251;3269;674;358;316;686;433;253;1081;504;577;2134;1077;1057;2945;1879;1066;739.0;1028.0;438.0;659.0;4231.0;4289.0;917
4633;Heerlen;2015;86683;16732;52506;17445;63816;15199;5038;10161;7668;4296;3372;704;370;334;718;449;269;1135;530;605;2123;1052;1071;2988;1895;1093;744.0;1032.0;437.0;658.0;4190.0;4181.0;917
4634;Heerlen;2016;86193;16626;51982;17585;63501;14908;5019;9889;7784;4321;3463;748;384;364;732;454;278;1191;550;641;2080;1020;1060;3033;1913;1120;726.0;1023.0;424.0;634.0;4186.0;4210.0;917
4635;Heerlen;2017;85672;16508;51453;17711;63227;14561;4950;9611;7884;4319;3565;802;398;404;720;446;274;1247;555;692;2056;1002;1054;3059;1918;1141;744.0;1029.0;427.0;639.0;4170.0;4171.0;917
4636;Heerlen;2018;85186;16342;50886;17958;62928;14278;4881;9397;7980;4344;3636;832;414;418;726;450;276;1302;563;739;2030;986;1044;3090;1931;1159;748.0;1036.0;413.0;614.0;4130.0;4090.0;917
4637;Heerlen;2019;84758;16236;50361;18161;62687;14010;4852;9158;8061;4362;3699;865;427;438;745;451;294;1348;589;759;2014;977;1037;3089;1918;1171;747.0;1032.0;414.0;595.0;4092.0;4094.0;917
4638;Heerlen;2020;84297;16119;49856;18322;62427;13717;4815;8902;8153;4377;3776;911;436;475;748;448;300;1379;601;778;2017;984;1033;3098;1908;1190;730.0;1026.0;414.0;601.0;4120.0;4048.0;917
4639;Heerlen;2021;83896;16003;49374;18519;62194;13422;4758;8664;8280;4421;3859;945;446;499;788;478;310;1422;616;806;1992;971;1021;3133;1910;1223;731.0;1016.0;378.0;573.0;4049.0;3993.0;917
4640;Heerlen;2022;83484;15937;48715;18832;61884;13157;4705;8452;8443;4445;3998;971;451;520;818;483;335;1486;634;852;1987;966;1021;3181;1911;1270;718.0;1048.0;376.0;573.0;4082.0;3992.0;917
4641;Heerlen;2023;83054;15840;48194;19020;61624;12870;4659;8211;8560;4491;4069;986;451;535;816;473;343;1528;644;884;1990;961;1029;3240;1962;1278;721.0;1032.0;390.0;542.0;4010.0;3915.0;917
4642;Heerlen;2024;82699;15689;47764;19246;61327;12699;4647;8052;8673;4551;4122;991;456;535;844;487;357;1595;672;923;1978;968;1010;3265;1968;1297;733.0;1047.0;397.0;551.0;3981.0;3910.0;917
4643;Heerlen;2025;82311;15652;47195;19464;61067;12498;4605;7893;8746;4580;4166;1009;472;537;838;483;355;1658;683;975;1956;958;998;3285;1984;1301;;;;;;;917
4644;Heeze-Leende;2008;15110;3623;8772;2715;13811;933;296;637;366;213;153;20;9;11;29;11;18;31;15;16;39;15;24;247;163;84;112.0;127.0;58.0;86.0;440.0;465.0;1658
4645;Heeze-Leende;2009;15042;3554;8730;2758;13681;946;291;655;415;247;168;24;11;13;35;14;21;43;17;26;48;21;27;265;184;81;107.0;130.0;66.0;83.0;443.0;477.0;1658
4646;Heeze-Leende;2010;14969;3488;8665;2816;13552;959;306;653;458;274;184;29;13;16;33;13;20;49;22;27;60;24;36;287;202;85;109.0;138.0;73.0;82.0;400.0;496.0;1658
4647;Heeze-Leende;2011;14838;3390;8579;2869;13372;957;311;646;509;306;203;36;15;21;35;14;21;60;30;30;71;28;43;307;219;88;107.0;138.0;72.0;79.0;463.0;513.0;1658
4648;Heeze-Leende;2012;14750;3308;8488;2954;13244;976;314;662;530;308;222;43;21;22;34;13;21;65;33;32;77;30;47;311;211;100;103.0;140.0;77.0;80.0;431.0;516.0;1658
4649;Heeze-Leende;2013;14626;3200;8370;3056;13086;970;319;651;570;326;244;49;22;27;39;18;21;72;34;38;83;34;49;327;218;109;111.0;142.0;75.0;78.0;513.0;518.0;1658
4650;Heeze-Leende;2014;14587;3109;8333;3145;13014;970;331;639;603;336;267;47;21;26;40;19;21;80;38;42;92;38;54;344;220;124;114.0;149.0;72.0;79.0;430.0;537.0;1658
4651;Heeze-Leende;2015;14439;3014;8241;3184;12830;973;330;643;636;359;277;58;27;31;42;21;21;88;41;47;92;42;50;356;228;128;111.0;148.0;70.0;79.0;478.0;525.0;1658
4652;Heeze-Leende;2016;14347;2952;8152;3243;12686;978;332;646;683;383;300;59;30;29;48;24;24;96;39;57;106;46;60;374;244;130;111.0;152.0;73.0;78.0;542.0;537.0;1658
4653;Heeze-Leende;2017;14307;2887;8123;3297;12587;980;319;661;740;406;334;68;35;33;46;23;23;110;43;67;122;51;71;394;254;140;119.0;152.0;79.0;76.0;563.0;517.0;1658
4654;Heeze-Leende;2018;14324;2853;8135;3336;12523;993;332;661;808;443;365;77;38;39;50;26;24;117;47;70;133;58;75;431;274;157;121.0;153.0;80.0;78.0;556.0;536.0;1658
4655;Heeze-Leende;2019;14315;2832;8080;3403;12469;995;332;663;851;463;388;83;41;42;55;29;26;122;49;73;147;64;83;444;280;164;126.0;156.0;77.0;74.0;546.0;535.0;1658
4656;Heeze-Leende;2020;14301;2805;8029;3467;12390;1013;336;677;898;487;411;94;44;50;61;31;30;132;54;78;149;67;82;462;291;171;124.0;162.0;73.0;75.0;633.0;548.0;1658
4657;Heeze-Leende;2021;14346;2776;8045;3525;12396;1018;356;662;932;498;434;94;46;48;69;34;35;142;57;85;158;71;87;469;290;179;136.0;161.0;74.0;73.0;511.0;544.0;1658
4658;Heeze-Leende;2022;14288;2761;7949;3578;12284;1042;366;676;962;508;454;93;49;44;64;30;34;147;58;89;166;71;95;492;300;192;137.0;166.0;73.0;69.0;500.0;535.0;1658
4659;Heeze-Leende;2023;14230;2721;7886;3623;12191;1043;368;675;996;526;470;94;48;46;70;33;37;143;57;86;179;73;106;510;315;195;144.0;163.0;73.0;77.0;487.0;532.0;1658
4660;Heeze-Leende;2024;14164;2706;7788;3670;12101;1052;378;674;1011;526;485;98;50;48;69;30;39;152;59;93;192;76;116;500;311;189;146.0;160.0;80.0;73.0;506.0;539.0;1658
4661;Heeze-Leende;2025;14125;2715;7685;3725;12024;1049;383;666;1052;555;497;98;49;49;68;32;36;161;62;99;201;81;120;524;331;193;;;;;;;1658
4662;Heiloo;2008;22160;5234;12444;4482;19771;1596;564;1032;793;459;334;98;45;53;89;37;52;42;22;20;52;26;26;512;329;183;177.0;196.0;77.0;114.0;934.0;948.0;399
4663;Heiloo;2009;22090;5136;12398;4556;19661;1598;576;1022;831;466;365;102;47;55;95;40;55;61;34;27;65;33;32;508;312;196;173.0;198.0;79.0;110.0;991.0;952.0;399
4664;Heiloo;2010;22076;5031;12415;4630;19626;1581;567;1014;869;477;392;107;45;62;101;46;55;72;37;35;80;37;43;509;312;197;175.0;199.0;85.0;101.0;1204.0;1003.0;399
4665;Heiloo;2011;22237;4980;12572;4685;19710;1600;571;1029;927;503;424;119;54;65;96;45;51;83;45;38;102;42;60;527;317;210;170.0;204.0;83.0;102.0;1206.0;1032.0;399
4666;Heiloo;2012;22361;4906;12636;4819;19736;1645;591;1054;980;524;456;128;56;72;99;47;52;103;51;52;113;47;66;537;323;214;176.0;204.0;103.0;107.0;1194.0;1072.0;399
4667;Heiloo;2013;22454;4836;12679;4939;19772;1661;607;1054;1021;527;494;147;65;82;104;50;54;110;54;56;116;46;70;544;312;232;181.0;211.0;86.0;104.0;1287.0;1083.0;399
4668;Heiloo;2014;22612;4759;12780;5073;19867;1673;613;1060;1072;551;521;148;69;79;106;51;55;128;63;65;128;49;79;562;319;243;192.0;220.0;98.0;106.0;1305.0;1093.0;399
4669;Heiloo;2015;22793;4715;12884;5194;19943;1720;620;1100;1130;588;542;155;75;80;106;51;55;145;66;79;135;51;84;589;345;244;192.0;224.0;85.0;103.0;1188.0;1138.0;399
4670;Heiloo;2016;22794;4622;12938;5234;19926;1724;614;1110;1144;601;543;155;76;79;110;59;51;144;66;78;142;52;90;593;348;245;199.0;223.0;87.0;105.0;1153.0;1142.0;399
4671;Heiloo;2017;22765;4555;12913;5297;19844;1730;612;1118;1191;636;555;164;80;84;109;59;50;157;69;88;155;60;95;606;368;238;202.0;224.0;88.0;105.0;1309.0;1118.0;399
4672;Heiloo;2018;22919;4529;13014;5376;19907;1741;612;1129;1271;672;599;176;91;85;122;70;52;171;75;96;167;61;106;635;375;260;212.0;228.0;94.0;108.0;1197.0;1148.0;399
4673;Heiloo;2019;22940;4476;13071;5393;19877;1736;593;1143;1327;691;636;188;92;96;122;70;52;183;78;105;182;68;114;652;383;269;219.0;228.0;87.0;97.0;1194.0;1125.0;399
4674;Heiloo;2020;22991;4407;13130;5454;19887;1740;601;1139;1364;713;651;205;98;107;126;71;55;197;85;112;185;74;111;651;385;266;222.0;228.0;89.0;101.0;1261.0;1112.0;399
4675;Heiloo;2021;23124;4421;13180;5523;19956;1766;621;1145;1402;718;684;206;101;105;135;74;61;206;86;120;187;74;113;668;383;285;229.0;234.0;92.0;93.0;1310.0;1137.0;399
4676;Heiloo;2022;23292;4424;13278;5590;20054;1784;636;1148;1454;741;713;217;99;118;135;76;59;219;94;125;188;72;116;695;400;295;236.0;233.0;86.0;94.0;1149.0;1149.0;399
4677;Heiloo;2023;23289;4360;13235;5694;20020;1781;650;1131;1488;743;745;226;105;121;129;69;60;226;91;135;183;70;113;724;408;316;225.0;238.0;86.0;100.0;1208.0;1144.0;399
4678;Heiloo;2024;23330;4329;13225;5776;20020;1771;650;1121;1539;755;784;229;109;120;138;74;64;240;93;147;180;70;110;752;409;343;233.0;240.0;98.0;99.0;1088.0;1130.0;399
4679;Heiloo;2025;23283;4329;13150;5804;19956;1758;640;1118;1569;764;805;229;112;117;145;78;67;249;94;155;199;76;123;747;404;343;;;;;;;399
4680;Helden;2008;19239;4865;11510;2864;17336;1050;370;680;853;460;393;41;16;25;18;7;11;282;126;156;335;181;154;177;130;47;165.0;156.0;50.0;73.0;317.0;497.0;918
4681;Helden;2009;19046;4739;11394;2913;17137;1030;361;669;879;485;394;45;19;26;19;11;8;276;127;149;324;175;149;215;153;62;155.0;161.0;56.0;71.0;329.0;511.0;918
4682;Helden;2010;18845;4579;11274;2992;16914;1025;365;660;906;488;418;54;25;29;20;11;9;298;134;164;303;161;142;231;157;74;156.0;157.0;59.0;68.0;408.0;532.0;918
4683;Helden;2011;18711;4447;11191;3073;16731;1019;348;671;961;516;445;60;30;30;27;17;10;313;144;169;316;160;156;245;165;80;155.0;165.0;66.0;73.0;444.0;541.0;918
4684;Helden;2012;18597;4303;11068;3226;16556;1021;345;676;1020;534;486;68;35;33;33;20;13;332;151;181;315;152;163;272;176;96;159.0;171.0;60.0;70.0;426.0;554.0;918
4685;Helden;2013;18448;4161;10931;3356;16393;1016;340;676;1039;558;481;77;42;35;32;20;12;340;158;182;305;147;158;285;191;94;157.0;173.0;61.0;65.0;455.0;547.0;918
4686;Helden;2014;18338;4042;10835;3461;16250;1012;333;679;1076;578;498;82;47;35;38;22;16;361;165;196;303;152;151;292;192;100;165.0;177.0;72.0;63.0;455.0;561.0;918
4687;Helden;2015;18230;3932;10740;3558;16102;1006;328;678;1122;595;527;83;48;35;41;25;16;367;169;198;309;144;165;322;209;113;172.0;182.0;66.0;63.0;505.0;568.0;918
4688;Helden;2016;18160;3865;10647;3648;15988;1000;327;673;1172;626;546;93;53;40;54;35;19;363;165;198;309;145;164;353;228;125;176.0;183.0;58.0;60.0;543.0;558.0;918
4689;Helden;2017;18138;3814;10587;3737;15906;1013;336;677;1219;641;578;99;56;43;60;39;21;381;168;213;313;142;171;366;236;130;181.0;183.0;64.0;65.0;587.0;565.0;918
4690;Helden;2018;18158;3762;10622;3774;15875;1009;347;662;1274;666;608;112;65;47;64;42;22;379;165;214;322;145;177;397;249;148;188.0;189.0;63.0;63.0;599.0;561.0;918
4691;Helden;2019;18198;3725;10611;3862;15856;1028;353;675;1314;667;647;114;68;46;69;45;24;389;164;225;322;145;177;420;245;175;196.0;195.0;78.0;64.0;600.0;566.0;918
4692;Helden;2020;18255;3718;10556;3981;15857;1030;351;679;1368;690;678;116;71;45;79;49;30;413;173;240;318;139;179;442;258;184;201.0;200.0;64.0;64.0;619.0;573.0;918
4693;Helden;2021;18305;3711;10514;4080;15785;1075;373;702;1445;714;731;123;73;50;77;49;28;426;174;252;336;139;197;483;279;204;201.0;204.0;65.0;63.0;551.0;576.0;918
4694;Helden;2022;18281;3686;10468;4127;15657;1122;394;728;1502;728;774;128;76;52;86;53;33;434;172;262;348;141;207;506;286;220;209.0;204.0;66.0;62.0;557.0;592.0;918
4695;Helden;2023;18257;3667;10375;4215;15590;1119;390;729;1548;751;797;136;78;58;94;58;36;438;171;267;350;138;212;530;306;224;208.0;212.0;65.0;65.0;656.0;576.0;918
4696;Helden;2024;18334;3704;10316;4314;15611;1118;390;728;1605;776;829;138;80;58;96;62;34;458;172;286;359;138;221;554;324;230;219.0;215.0;73.0;65.0;629.0;581.0;918
4697;Helden;2025;18396;3719;10263;4414;15608;1138;402;736;1650;798;852;142;82;60;104;66;38;474;183;291;352;138;214;578;329;249;;;;;;;918
4698;Den Helder;2008;58036;13256;35958;8822;47498;5647;2097;3550;4891;2960;1931;750;405;345;1217;704;513;325;173;152;238;102;136;2361;1576;785;557.0;569.0;445.0;634.0;1839.0;1915.0;400
4699;Den Helder;2009;57767;13118;35652;8997;47279;5575;2075;3500;4913;2953;1960;757;408;349;1195;690;505;363;195;168;264;120;144;2334;1540;794;566.0;568.0;474.0;617.0;1799.0;1945.0;400
4700;Den Helder;2010;57481;12937;35341;9203;46945;5553;2070;3483;4983;2946;2037;762;407;355;1188;689;499;395;205;190;300;135;165;2338;1510;828;564.0;574.0;468.0;599.0;1686.0;1940.0;400
4701;Den Helder;2011;57090;12658;35096;9336;46581;5526;2052;3474;4983;2947;2036;756;411;345;1178;697;481;430;223;207;318;142;176;2301;1474;827;546.0;588.0;497.0;572.0;1621.0;1914.0;400
4702;Den Helder;2012;56687;12464;34532;9691;46116;5530;2062;3468;5041;2955;2086;768;414;354;1172;693;479;442;235;207;350;158;192;2309;1455;854;540.0;591.0;476.0;558.0;1634.0;1896.0;400
4703;Den Helder;2013;56300;12303;33967;10030;45731;5520;2087;3433;5049;2940;2109;776;426;350;1156;685;471;473;247;226;366;162;204;2278;1420;858;537.0;593.0;469.0;543.0;1651.0;1863.0;400
4704;Den Helder;2014;55966;12083;33557;10326;45430;5481;2069;3412;5055;2933;2122;775;423;352;1129;679;450;506;263;243;397;173;224;2248;1395;853;531.0;593.0;446.0;530.0;1653.0;1843.0;400
4705;Den Helder;2015;55637;11905;33217;10515;45061;5480;2075;3405;5096;2904;2192;794;433;361;1133;682;451;530;262;268;429;178;251;2210;1349;861;508.0;589.0;437.0;503.0;1649.0;1847.0;400
4706;Den Helder;2016;55295;11765;32842;10688;44723;5489;2107;3382;5083;2849;2234;823;441;382;1112;666;446;554;266;288;437;175;262;2157;1301;856;528.0;607.0;438.0;493.0;1613.0;1805.0;400
4707;Den Helder;2017;54975;11635;32550;10790;44430;5457;2110;3347;5088;2838;2250;819;435;384;1089;653;436;573;272;301;450;181;269;2157;1297;860;526.0;607.0;424.0;482.0;1646.0;1772.0;400
4708;Den Helder;2018;54715;11559;32180;10976;44129;5438;2095;3343;5148;2851;2297;821;433;388;1107;668;439;587;282;305;453;179;274;2180;1289;891;530.0;612.0;426.0;487.0;1625.0;1809.0;400
4709;Den Helder;2019;54391;11412;31841;11138;43781;5410;2110;3300;5200;2840;2360;831;437;394;1104;662;442;619;286;333;473;189;284;2173;1266;907;526.0;606.0;423.0;474.0;1643.0;1792.0;400
4710;Den Helder;2020;54115;11320;31452;11343;43407;5443;2125;3318;5265;2841;2424;837;448;389;1102;665;437;646;290;356;495;201;294;2185;1237;948;528.0;630.0;392.0;455.0;1710.0;1779.0;400
4711;Den Helder;2021;53886;11192;31180;11514;43087;5482;2159;3323;5317;2875;2442;840;445;395;1078;662;416;660;296;364;514;213;301;2225;1259;966;525.0;629.0;404.0;465.0;1682.0;1779.0;400
4712;Den Helder;2022;53627;11083;30888;11656;42750;5474;2175;3299;5403;2903;2500;872;461;411;1079;657;422;666;292;374;538;227;311;2248;1266;982;552.0;635.0;401.0;454.0;1626.0;1792.0;400
4713;Den Helder;2023;53332;11035;30501;11796;42460;5460;2177;3283;5412;2874;2538;862;454;408;1058;634;424;683;296;387;556;223;333;2253;1267;986;546.0;623.0;388.0;443.0;1630.0;1728.0;400
4714;Den Helder;2024;53107;10931;30240;11936;42152;5466;2201;3265;5489;2914;2575;859;446;413;1053;633;420;709;306;403;583;239;344;2285;1290;995;557.0;642.0;380.0;435.0;1617.0;1753.0;400
4715;Den Helder;2025;52839;10877;29923;12039;41826;5465;2202;3263;5548;2927;2621;866;450;416;1042;625;417;697;301;396;597;247;350;2346;1304;1042;;;;;;;400
4716;Hellendoorn;2008;35791;8902;21174;5715;33504;1496;439;1057;791;455;336;77;42;35;29;14;15;207;102;105;58;32;26;420;265;155;387.0;305.0;80.0;104.0;820.0;1098.0;163
4717;Hellendoorn;2009;35574;8773;21000;5801;33201;1499;451;1048;874;481;393;87;45;42;39;18;21;227;105;122;82;40;42;439;273;166;381.0;315.0;82.0;104.0;847.0;1141.0;163
4718;Hellendoorn;2010;35330;8664;20756;5910;32927;1484;444;1040;919;503;416;98;56;42;42;18;24;234;108;126;83;37;46;462;284;178;374.0;326.0;90.0;95.0;1019.0;1157.0;163
4719;Hellendoorn;2011;35241;8578;20655;6008;32716;1496;444;1052;1029;567;462;116;69;47;47;22;25;266;119;147;94;39;55;506;318;188;362.0;325.0;111.0;102.0;869.0;1136.0;163
4720;Hellendoorn;2012;35022;8486;20298;6238;32410;1516;462;1054;1096;608;488;125;73;52;54;27;27;278;124;154;106;44;62;533;340;193;357.0;327.0;91.0;98.0;973.0;1168.0;163
4721;Hellendoorn;2013;34855;8373;20062;6420;32142;1522;459;1063;1191;660;531;139;83;56;59;31;28;299;131;168;117;45;72;577;370;207;347.0;338.0;99.0;97.0;1076.0;1176.0;163
4722;Hellendoorn;2014;34771;8312;19866;6593;31971;1534;467;1067;1266;705;561;153;93;60;65;35;30;293;132;161;132;46;86;623;399;224;351.0;338.0;96.0;97.0;879.0;1162.0;163
4723;Hellendoorn;2015;34502;8174;19598;6730;31637;1552;493;1059;1313;727;586;177;100;77;71;38;33;298;142;156;139;51;88;628;396;232;347.0;340.0;93.0;87.0;1181.0;1157.0;163
4724;Hellendoorn;2016;34544;8153;19529;6862;31570;1582;508;1074;1392;767;625;188;104;84;82;46;36;319;149;170;155;53;102;648;415;233;342.0;351.0;96.0;91.0;1184.0;1188.0;163
4725;Hellendoorn;2017;34541;8082;19449;7010;31456;1600;512;1088;1485;810;675;203;111;92;92;50;42;330;150;180;168;52;116;692;447;245;345.0;359.0;95.0;100.0;1148.0;1212.0;163
4726;Hellendoorn;2018;34461;8059;19263;7139;31257;1630;529;1101;1574;871;703;215;126;89;102;60;42;338;151;187;186;60;126;733;474;259;353.0;364.0;103.0;97.0;1167.0;1205.0;163
4727;Hellendoorn;2019;34420;7966;19183;7271;31139;1630;539;1091;1651;920;731;221;135;86;113;68;45;354;164;190;195;65;130;768;488;280;350.0;366.0;112.0;95.0;1241.0;1186.0;163
4728;Hellendoorn;2020;34479;7902;19158;7419;31076;1657;539;1118;1746;970;776;231;136;95;127;82;45;369;177;192;213;68;145;806;507;299;361.0;364.0;105.0;96.0;1124.0;1211.0;163
4729;Hellendoorn;2021;34403;7828;19027;7548;30902;1684;555;1129;1817;1004;813;247;148;99;133;85;48;380;182;198;219;70;149;838;519;319;359.0;372.0;99.0;92.0;1147.0;1227.0;163
4730;Hellendoorn;2022;34319;7714;18952;7653;30733;1684;556;1128;1902;1039;863;259;156;103;135;86;49;390;190;200;231;75;156;887;532;355;356.0;371.0;97.0;96.0;1148.0;1225.0;163
4731;Hellendoorn;2023;34232;7611;18824;7797;30539;1710;566;1144;1983;1067;916;269;154;115;143;91;52;398;195;203;252;80;172;921;547;374;359.0;372.0;104.0;98.0;1101.0;1233.0;163
4732;Hellendoorn;2024;34096;7493;18655;7948;30351;1699;577;1122;2046;1090;956;276;155;121;151;92;59;419;206;213;250;76;174;950;561;389;352.0;382.0;98.0;93.0;1235.0;1208.0;163
4733;Hellendoorn;2025;34102;7435;18585;8082;30287;1684;567;1117;2131;1118;1013;283;152;131;164;100;64;420;205;215;278;86;192;986;575;411;;;;;;;163
4734;Hellevoetsluis;2008;39712;9523;25284;4905;32991;3574;1401;2173;3147;1757;1390;554;272;282;574;347;227;769;400;369;172;66;106;1078;672;406;412.0;296.0;133.0;190.0;1693.0;1779.0;530
4735;Hellevoetsluis;2009;39690;9426;25135;5129;32901;3581;1411;2170;3208;1771;1437;578;284;294;558;334;224;751;393;358;207;73;134;1114;687;427;406.0;310.0;136.0;187.0;1677.0;1775.0;530
4736;Hellevoetsluis;2010;39645;9332;24960;5353;32807;3566;1414;2152;3272;1767;1505;595;282;313;547;326;221;761;395;366;222;78;144;1147;686;461;394.0;314.0;149.0;184.0;1586.0;1771.0;530
4737;Hellevoetsluis;2011;39511;9111;24881;5519;32659;3545;1390;2155;3307;1797;1510;599;278;321;542;324;218;769;410;359;246;88;158;1151;697;454;389.0;311.0;144.0;170.0;1687.0;1724.0;530
4738;Hellevoetsluis;2012;39529;9012;24540;5977;32581;3556;1405;2151;3392;1812;1580;618;288;330;530;312;218;766;406;360;276;89;187;1202;717;485;376.0;329.0;145.0;169.0;1416.0;1761.0;530
4739;Hellevoetsluis;2013;39213;8819;24004;6390;32271;3527;1395;2132;3415;1793;1622;630;292;338;533;310;223;768;402;366;289;93;196;1195;696;499;371.0;331.0;151.0;161.0;1548.0;1718.0;530
4740;Hellevoetsluis;2014;39075;8711;23635;6729;32150;3485;1368;2117;3440;1824;1616;649;303;346;534;310;224;744;396;348;307;108;199;1206;707;499;358.0;338.0;135.0;160.0;1665.0;1691.0;530
4741;Hellevoetsluis;2015;39048;8618;23383;7047;32121;3465;1367;2098;3462;1823;1639;658;314;344;515;298;217;747;383;364;320;112;208;1222;716;506;360.0;354.0;145.0;163.0;1565.0;1683.0;530
4742;Hellevoetsluis;2016;38921;8452;23159;7310;31977;3438;1381;2057;3506;1828;1678;666;319;347;508;292;216;760;393;367;335;115;220;1237;709;528;363.0;354.0;138.0;159.0;1688.0;1670.0;530
4743;Hellevoetsluis;2017;38929;8407;22977;7545;31886;3469;1404;2065;3574;1837;1737;669;318;351;502;281;221;763;392;371;366;117;249;1274;729;545;352.0;355.0;131.0;160.0;1691.0;1687.0;530
4744;Hellevoetsluis;2018;38906;8373;22708;7825;31802;3482;1425;2057;3622;1839;1783;685;323;362;491;275;216;755;387;368;396;124;272;1295;730;565;352.0;370.0;129.0;155.0;1690.0;1706.0;530
4745;Hellevoetsluis;2019;38850;8275;22539;8036;31685;3503;1460;2043;3662;1848;1814;689;322;367;490;268;222;759;392;367;421;130;291;1303;736;567;352.0;377.0;125.0;158.0;1736.0;1625.0;530
4746;Hellevoetsluis;2020;38905;8226;22392;8287;31684;3524;1475;2049;3697;1833;1864;703;330;373;486;257;229;754;396;358;436;130;306;1318;720;598;351.0;391.0;125.0;148.0;1654.0;1674.0;530
4747;Hellevoetsluis;2021;38823;8129;22196;8498;31544;3516;1482;2034;3763;1856;1907;713;324;389;472;257;215;761;395;366;449;132;317;1368;748;620;346.0;401.0;132.0;150.0;1837.0;1688.0;530
4748;Hellevoetsluis;2022;38904;8079;22134;8691;31549;3550;1496;2054;3805;1871;1934;725;328;397;470;253;217;757;389;368;463;135;328;1390;766;624;356.0;402.0;129.0;153.0;1855.0;1668.0;530
4749;Hellevoetsluis;2023;39026;8066;22068;8892;31598;3566;1519;2047;3862;1889;1973;719;322;397;472;250;222;747;386;361;502;139;363;1422;792;630;354.0;407.0;139.0;148.0;1760.0;1712.0;530
4750;Hellevoetsluis;2024;39016;8025;21871;9120;31505;3591;1511;2080;3920;1922;1998;718;323;395;481;247;234;746;395;351;524;148;376;1451;809;642;359.0;419.0;132.0;142.0;1722.0;1729.0;530
4751;Hellevoetsluis;2025;38941;7954;21673;9314;31418;3569;1510;2059;3954;1924;2030;706;313;393;480;241;239;763;399;364;542;155;387;1463;816;647;;;;;;;530
4752;Helmond;2008;87357;22407;53711;11239;69050;8591;3574;5017;9716;5466;4250;695;340;355;668;387;281;2297;1221;1076;3194;1633;1561;2862;1885;977;1130.0;657.0;517.0;657.0;3691.0;3087.0;794
4753;Helmond;2009;88314;22747;53874;11693;69800;8665;3628;5037;9849;5458;4391;733;347;386;665;373;292;2291;1195;1096;3187;1614;1573;2973;1929;1044;1122.0;680.0;531.0;661.0;3688.0;3192.0;794
4754;Helmond;2010;89131;22935;54135;12061;70449;8664;3622;5042;10018;5517;4501;749;350;399;677;376;301;2271;1184;1087;3212;1604;1608;3109;2003;1106;1096.0;694.0;560.0;644.0;3390.0;3247.0;794
4755;Helmond;2011;89601;22971;54110;12520;70718;8654;3637;5017;10229;5575;4654;777;362;415;700;393;307;2293;1178;1115;3223;1588;1635;3236;2054;1182;1094.0;714.0;563.0;644.0;3489.0;3268.0;794
4756;Helmond;2012;90130;23103;53950;13077;71119;8687;3673;5014;10324;5630;4694;810;388;422;729;402;327;2266;1167;1099;3232;1594;1638;3287;2079;1208;1056.0;724.0;564.0;628.0;3485.0;3324.0;794
4757;Helmond;2013;90571;23150;53850;13571;71460;8698;3666;5032;10413;5671;4742;835;402;433;724;410;314;2251;1154;1097;3226;1572;1654;3377;2133;1244;1060.0;755.0;566.0;619.0;3597.0;3325.0;794
4758;Helmond;2014;91106;23203;53759;14144;71859;8689;3690;4999;10558;5718;4840;870;410;460;735;421;314;2222;1127;1095;3217;1564;1653;3514;2196;1318;1045.0;777.0;558.0;616.0;3377.0;3361.0;794
4759;Helmond;2015;91343;23158;53573;14612;72042;8675;3709;4966;10626;5727;4899;894;424;470;756;422;334;2199;1114;1085;3219;1548;1671;3558;2219;1339;1041.0;796.0;555.0;608.0;3418.0;3311.0;794
4760;Helmond;2016;91650;23154;53469;15027;72231;8664;3725;4939;10755;5796;4959;931;441;490;778;429;349;2176;1096;1080;3201;1544;1657;3669;2286;1383;1038.0;804.0;553.0;601.0;3401.0;3350.0;794
4761;Helmond;2017;91896;23082;53453;15361;72362;8680;3753;4927;10854;5854;5000;950;448;502;778;432;346;2189;1100;1089;3204;1546;1658;3733;2328;1405;1031.0;814.0;556.0;589.0;3402.0;3371.0;794
4762;Helmond;2018;92117;23068;53313;15736;72469;8642;3749;4893;11006;5962;5044;979;467;512;804;449;355;2198;1107;1091;3192;1543;1649;3833;2396;1437;1007.0;824.0;567.0;578.0;3326.0;3391.0;794
4763;Helmond;2019;92241;22931;53219;16091;72481;8636;3777;4859;11124;6021;5103;1013;494;519;847;465;382;2214;1119;1095;3156;1520;1636;3894;2423;1471;1020.0;836.0;542.0;578.0;3491.0;3372.0;794
4764;Helmond;2020;92522;22798;53273;16451;72673;8641;3795;4846;11208;6097;5111;1047;508;539;850;473;377;2207;1117;1090;3136;1523;1613;3968;2476;1492;1035.0;862.0;532.0;561.0;3316.0;3451.0;794
4765;Helmond;2021;92539;22518;53188;16833;72611;8621;3800;4821;11307;6167;5140;1072;522;550;861;483;378;2186;1106;1080;3125;1531;1594;4063;2525;1538;1029.0;870.0;527.0;566.0;3453.0;3427.0;794
4766;Helmond;2022;92698;22390;53114;17194;72643;8647;3858;4789;11408;6205;5203;1100;534;566;865;483;382;2184;1104;1080;3110;1522;1588;4149;2562;1587;1029.0;887.0;515.0;556.0;3348.0;3433.0;794
4767;Helmond;2023;92729;22204;52887;17638;72548;8681;3900;4781;11500;6266;5234;1117;558;559;894;492;402;2182;1100;1082;3086;1506;1580;4221;2610;1611;1042.0;917.0;555.0;549.0;3203.0;3419.0;794
4768;Helmond;2024;92651;21988;52670;17993;72354;8717;3961;4756;11580;6307;5273;1134;560;574;905;514;391;2175;1093;1082;3067;1487;1580;4299;2653;1646;1032.0;924.0;523.0;544.0;3377.0;3446.0;794
4769;Helmond;2025;92682;21910;52429;18343;72293;8688;3964;4724;11701;6362;5339;1147;572;575;925;528;397;2188;1090;1098;3054;1481;1573;4387;2691;1696;;;;;;;794
4770;Hendrik-Ido-Ambacht;2008;25461;7133;14892;3436;22466;1611;530;1081;1384;713;671;289;140;149;124;66;58;259;116;143;213;78;135;499;313;186;340.0;163.0;68.0;96.0;1515.0;1087.0;531
4771;Hendrik-Ido-Ambacht;2009;26041;7222;15269;3550;22850;1699;564;1135;1492;744;748;295;142;153;138;69;69;308;130;178;217;75;142;534;328;206;344.0;169.0;70.0;96.0;1506.0;1116.0;531
4772;Hendrik-Ido-Ambacht;2010;26585;7305;15571;3709;23251;1745;572;1173;1589;772;817;305;142;163;157;72;85;340;135;205;222;75;147;565;348;217;361.0;176.0;74.0;95.0;1314.0;1165.0;531
4773;Hendrik-Ido-Ambacht;2011;26901;7281;15781;3839;23463;1755;561;1194;1683;789;894;331;146;185;170;78;92;348;128;220;230;81;149;604;356;248;355.0;187.0;79.0;98.0;1322.0;1138.0;531
4774;Hendrik-Ido-Ambacht;2012;27236;7317;15849;4070;23688;1786;570;1216;1762;828;934;328;143;185;176;84;92;383;149;234;241;87;154;634;365;269;356.0;193.0;77.0;107.0;1305.0;1119.0;531
4775;Hendrik-Ido-Ambacht;2013;27557;7301;15959;4297;23902;1816;587;1229;1839;855;984;337;140;197;180;86;94;395;158;237;255;88;167;672;383;289;357.0;197.0;77.0;102.0;1147.0;1130.0;531
4776;Hendrik-Ido-Ambacht;2014;27712;7217;16012;4483;23980;1846;616;1230;1886;846;1040;345;135;210;178;82;96;412;162;250;253;88;165;698;379;319;355.0;203.0;76.0;97.0;1233.0;1148.0;531
4777;Hendrik-Ido-Ambacht;2015;27931;7219;16094;4618;24135;1866;603;1263;1930;858;1072;349;141;208;182;83;99;426;163;263;256;89;167;717;382;335;353.0;208.0;92.0;100.0;1231.0;1133.0;531
4778;Hendrik-Ido-Ambacht;2016;28168;7250;16155;4763;24287;1878;597;1281;2003;885;1118;346;144;202;189;89;100;460;175;285;280;98;182;728;379;349;353.0;210.0;78.0;98.0;1396.0;1129.0;531
4779;Hendrik-Ido-Ambacht;2017;28560;7316;16287;4957;24560;1911;610;1301;2089;916;1173;358;144;214;205;94;111;480;178;302;284;96;188;762;404;358;358.0;220.0;91.0;100.0;1215.0;1168.0;531
4780;Hendrik-Ido-Ambacht;2018;28740;7284;16320;5136;24665;1935;626;1309;2140;924;1216;362;151;211;210;90;120;500;188;312;299;96;203;769;399;370;361.0;224.0;83.0;100.0;1412.0;1151.0;531
4781;Hendrik-Ido-Ambacht;2019;29125;7327;16493;5305;24901;1971;623;1348;2253;968;1285;384;156;228;210;88;122;519;196;323;317;105;212;823;423;400;374.0;233.0;84.0;99.0;1292.0;1139.0;531
4782;Hendrik-Ido-Ambacht;2020;29406;7315;16645;5446;25047;2025;652;1373;2334;974;1360;377;155;222;217;95;122;552;196;356;345;108;237;843;420;423;374.0;242.0;85.0;102.0;1172.0;1172.0;531
4783;Hendrik-Ido-Ambacht;2021;29525;7285;16647;5593;25107;2030;655;1375;2388;995;1393;388;158;230;210;96;114;581;211;370;353;105;248;856;425;431;375.0;245.0;83.0;96.0;1374.0;1222.0;531
4784;Hendrik-Ido-Ambacht;2022;29796;7294;16771;5731;25304;2042;649;1393;2450;1004;1446;388;156;232;210;91;119;609;219;390;359;109;250;884;429;455;369.0;247.0;86.0;98.0;1219.0;1220.0;531
4785;Hendrik-Ido-Ambacht;2023;29909;7271;16739;5899;25324;2065;645;1420;2520;1024;1496;401;161;240;220;92;128;612;220;392;368;117;251;919;434;485;374.0;254.0;88.0;98.0;1218.0;1202.0;531
4786;Hendrik-Ido-Ambacht;2024;30040;7278;16666;6096;25405;2078;644;1434;2557;1041;1516;406;169;237;227;96;131;614;212;402;388;130;258;922;434;488;361.0;262.0;84.0;98.0;1253.0;1216.0;531
4787;Hendrik-Ido-Ambacht;2025;30162;7279;16608;6275;25446;2102;666;1436;2614;1068;1546;418;180;238;222;93;129;631;217;414;398;130;268;945;448;497;;;;;;;531
4788;Hengelo (O.);2008;82200;20062;49495;12643;65494;8048;2855;5193;8658;4852;3806;501;261;240;508;302;206;4520;2330;2190;333;152;181;2796;1807;989;1007.0;780.0;316.0;468.0;3066.0;2840.0;164
4789;Hengelo (O.);2009;82510;20141;49577;12792;65787;8018;2863;5155;8705;4857;3848;532;271;261;510;307;203;4432;2303;2129;362;153;209;2869;1823;1046;987.0;783.0;311.0;473.0;2873.0;2797.0;164
4790;Hengelo (O.);2010;82640;20214;49456;12970;65918;7988;2882;5106;8734;4843;3891;574;285;289;518;318;200;4320;2239;2081;398;165;233;2924;1836;1088;974.0;793.0;348.0;478.0;2981.0;2811.0;164
4791;Hengelo (O.);2011;82869;20163;49620;13086;66099;7958;2879;5079;8812;4887;3925;604;301;303;510;317;193;4247;2221;2026;453;176;277;2998;1872;1126;967.0;801.0;331.0;463.0;2982.0;2709.0;164
4792;Hengelo (O.);2012;83188;20190;49486;13512;66299;7953;2875;5078;8936;4940;3996;636;317;319;529;325;204;4182;2188;1994;506;192;314;3083;1918;1165;943.0;816.0;326.0;455.0;2928.0;2809.0;164
4793;Hengelo (O.);2013;83312;20137;49390;13785;66326;7905;2875;5030;9081;4990;4091;660;333;327;551;329;222;4142;2170;1972;581;217;364;3147;1941;1206;924.0;802.0;341.0;445.0;2848.0;2795.0;164
4794;Hengelo (O.);2014;83395;20009;49319;14067;66286;7888;2884;5004;9221;5063;4158;689;351;338;568;334;234;4118;2164;1954;621;230;391;3225;1984;1241;930.0;807.0;330.0;425.0;2845.0;2677.0;164
4795;Hengelo (O.);2015;83599;19949;49304;14346;66399;7848;2880;4968;9352;5099;4253;719;363;356;589;341;248;4055;2123;1932;689;252;437;3300;2020;1280;910.0;816.0;335.0;422.0;2796.0;2813.0;164
4796;Hengelo (O.);2016;83602;19816;49176;14610;66300;7819;2902;4917;9483;5189;4294;737;378;359;600;349;251;4005;2094;1911;745;270;475;3396;2098;1298;912.0;823.0;359.0;427.0;2922.0;2875.0;164
4797;Hengelo (O.);2017;83680;19721;49078;14881;66265;7845;2928;4917;9570;5227;4343;777;393;384;607;359;248;3953;2054;1899;772;269;503;3461;2152;1309;895.0;838.0;334.0;404.0;2881.0;2829.0;164
4798;Hengelo (O.);2018;83730;19645;48920;15165;66234;7812;2898;4914;9684;5298;4386;801;395;406;637;383;254;3913;2034;1879;787;281;506;3546;2205;1341;884.0;840.0;337.0;404.0;2822.0;2886.0;164
4799;Hengelo (O.);2019;83654;19427;48736;15491;66104;7757;2924;4833;9793;5335;4458;830;404;426;662;391;271;3862;2009;1853;817;287;530;3622;2244;1378;893.0;842.0;356.0;402.0;2864.0;2853.0;164
4800;Hengelo (O.);2020;83684;19239;48721;15724;66019;7759;2936;4823;9906;5389;4517;843;410;433;677;402;275;3845;2006;1839;884;314;570;3657;2257;1400;884.0;839.0;329.0;405.0;2894.0;2865.0;164
4801;Hengelo (O.);2021;83693;19012;48645;16036;65924;7747;2964;4783;10022;5407;4615;858;419;439;684;405;279;3819;1972;1847;923;311;612;3738;2300;1438;870.0;855.0;318.0;405.0;2907.0;2861.0;164
4802;Hengelo (O.);2022;83677;18797;48491;16389;65877;7684;2946;4738;10116;5451;4665;883;425;458;700;414;286;3780;1954;1826;959;325;634;3794;2333;1461;887.0;862.0;336.0;404.0;2852.0;2840.0;164
4803;Hengelo (O.);2023;83657;18663;48271;16723;65774;7673;2949;4724;10210;5481;4729;915;434;481;693;404;289;3741;1922;1819;1007;346;661;3854;2375;1479;857.0;875.0;317.0;378.0;2892.0;2870.0;164
4804;Hengelo (O.);2024;83610;18472;48126;17012;65692;7649;2965;4684;10269;5539;4730;936;446;490;729;427;302;3654;1886;1768;1040;359;681;3910;2421;1489;847.0;894.0;312.0;385.0;2819.0;2870.0;164
4805;Hengelo (O.);2025;83450;18214;47975;17261;65532;7599;2974;4625;10319;5553;4766;974;456;518;744;433;311;3579;1841;1738;1071;370;701;3951;2453;1498;;;;;;;164
4806;'s-Hertogenbosch;2008;136598;31731;86315;18552;111290;11753;4557;7196;13555;7597;5958;1894;994;900;918;505;413;2787;1459;1328;4099;2055;2044;3857;2584;1273;1651.0;1116.0;754.0;960.0;5328.0;4597.0;796
4807;'s-Hertogenbosch;2009;137681;32038;86675;18968;112018;11915;4647;7268;13748;7641;6107;1934;1000;934;941;510;431;2838;1474;1364;4094;2059;2035;3941;2598;1343;1650.0;1163.0;797.0;949.0;5531.0;4627.0;796
4808;'s-Hertogenbosch;2010;138934;32362;87087;19485;112844;12128;4764;7364;13962;7701;6261;1956;1006;950;945;506;439;2904;1501;1403;4144;2062;2082;4013;2626;1387;1637.0;1172.0;844.0;956.0;5757.0;4723.0;796
4809;'s-Hertogenbosch;2011;140342;32643;87673;20026;113769;12334;4874;7460;14239;7818;6421;1999;1020;979;962;512;450;2934;1510;1424;4204;2083;2121;4140;2693;1447;1606.0;1196.0;891.0;941.0;5853.0;4832.0;796
4810;'s-Hertogenbosch;2012;141740;32935;87962;20843;114738;12510;4992;7518;14492;7913;6579;2030;1035;995;988;529;459;2976;1525;1451;4230;2084;2146;4268;2740;1528;1615.0;1217.0;886.0;933.0;5275.0;4894.0;796
4811;'s-Hertogenbosch;2013;142489;33079;87747;21663;115206;12588;5025;7563;14695;7995;6700;2081;1077;1004;981;515;466;2982;1525;1457;4256;2086;2170;4395;2792;1603;1589.0;1248.0;853.0;911.0;5414.0;4819.0;796
4812;'s-Hertogenbosch;2014;143380;33255;87662;22463;115721;12700;5079;7621;14959;8064;6895;2132;1101;1031;978;509;469;3025;1547;1478;4296;2079;2217;4528;2828;1700;1553.0;1285.0;857.0;928.0;5392.0;4826.0;796
4813;'s-Hertogenbosch;2015;144161;33311;87791;23059;116210;12840;5140;7700;15111;8110;7001;2142;1112;1030;992;505;487;3031;1539;1492;4312;2084;2228;4634;2870;1764;1560.0;1290.0;887.0;908.0;5215.0;4819.0;796
4814;'s-Hertogenbosch;2016;144822;33468;87620;23734;116497;13000;5273;7727;15325;8200;7125;2187;1140;1047;999;505;494;3065;1558;1507;4332;2090;2242;4742;2907;1835;1547.0;1312.0;877.0;914.0;5317.0;4810.0;796
4815;'s-Hertogenbosch;2017;145541;33461;87739;24341;116886;13169;5416;7753;15486;8291;7195;2214;1147;1067;1047;546;501;3058;1564;1494;4339;2100;2239;4828;2934;1894;1526.0;1342.0;855.0;900.0;5327.0;4834.0;796
4816;'s-Hertogenbosch;2018;146198;33448;87724;25026;117179;13339;5526;7813;15680;8449;7231;2249;1171;1078;1068;561;507;3065;1575;1490;4360;2131;2229;4938;3011;1927;1499.0;1356.0;858.0;893.0;5339.0;4886.0;796
4817;'s-Hertogenbosch;2019;146776;33481;87695;25600;117402;13489;5578;7911;15885;8543;7342;2285;1199;1086;1089;563;526;3086;1565;1521;4372;2127;2245;5053;3089;1964;1500.0;1378.0;842.0;898.0;5293.0;4879.0;796
4818;'s-Hertogenbosch;2020;147271;33348;87733;26190;117555;13645;5651;7994;16071;8624;7447;2323;1210;1113;1107;565;542;3090;1563;1527;4384;2147;2237;5167;3139;2028;1500.0;1393.0;856.0;883.0;5316.0;4911.0;796
4819;'s-Hertogenbosch;2021;147776;33177;87847;26752;117767;13817;5771;8046;16192;8698;7494;2328;1221;1107;1123;558;565;3104;1586;1518;4391;2155;2236;5246;3178;2068;1492.0;1435.0;846.0;888.0;5407.0;4894.0;796
4820;'s-Hertogenbosch;2022;148323;33028;88076;27219;117989;13934;5849;8085;16400;8819;7581;2356;1221;1135;1155;570;585;3123;1598;1525;4381;2154;2227;5385;3276;2109;1506.0;1430.0;857.0;887.0;5270.0;4971.0;796
4821;'s-Hertogenbosch;2023;148692;32896;87986;27810;117973;14117;5940;8177;16602;8929;7673;2380;1224;1156;1177;587;590;3147;1607;1540;4429;2170;2259;5469;3341;2128;1478.0;1463.0;837.0;888.0;5386.0;4932.0;796
4822;'s-Hertogenbosch;2024;149124;32758;87961;28405;118068;14214;6052;8162;16842;9027;7815;2426;1249;1177;1195;594;601;3161;1613;1548;4431;2160;2271;5629;3411;2218;1478.0;1480.0;851.0;869.0;5108.0;4974.0;796
4823;'s-Hertogenbosch;2025;149258;32531;87725;29002;117968;14341;6179;8162;16949;9117;7832;2470;1264;1206;1205;600;605;3169;1624;1545;4392;2137;2255;5713;3492;2221;;;;;;;796
4824;Heumen;2008;16628;4288;9797;2543;14649;1453;463;990;526;283;243;52;25;27;75;28;47;63;33;30;32;14;18;304;183;121;133.0;123.0;54.0;81.0;698.0;782.0;252
4825;Heumen;2009;16530;4184;9739;2607;14543;1438;456;982;549;296;253;58;29;29;72;30;42;71;36;35;38;16;22;310;185;125;132.0;124.0;58.0;78.0;710.0;770.0;252
4826;Heumen;2010;16460;4054;9714;2692;14435;1464;471;993;561;310;251;62;32;30;77;36;41;71;41;30;47;19;28;304;182;122;134.0;130.0;54.0;73.0;817.0;784.0;252
4827;Heumen;2011;16479;3933;9748;2798;14410;1471;471;1000;598;327;271;70;35;35;79;38;41;98;50;48;50;21;29;301;183;118;125.0;136.0;54.0;73.0;772.0;805.0;252
4828;Heumen;2012;16418;3770;9727;2921;14323;1462;485;977;633;344;289;76;34;42;82;38;44;113;58;55;51;20;31;311;194;117;125.0;137.0;70.0;69.0;788.0;848.0;252
4829;Heumen;2013;16349;3630;9701;3018;14212;1461;489;972;676;359;317;82;38;44;84;41;43;138;66;72;56;22;34;316;192;124;129.0;144.0;69.0;73.0;815.0;869.0;252
4830;Heumen;2014;16277;3510;9676;3091;14130;1431;486;945;716;384;332;91;42;49;82;39;43;140;70;70;64;25;39;339;208;131;129.0;143.0;62.0;73.0;791.0;846.0;252
4831;Heumen;2015;16199;3405;9644;3150;14048;1427;494;933;724;392;332;92;46;46;86;44;42;145;75;70;62;25;37;339;202;137;131.0;144.0;61.0;71.0;787.0;864.0;252
4832;Heumen;2016;16101;3292;9569;3240;13943;1409;486;923;749;407;342;96;50;46;87;41;46;150;77;73;69;28;41;347;211;136;139.0;144.0;64.0;63.0;804.0;843.0;252
4833;Heumen;2017;16059;3199;9572;3288;13851;1422;497;925;786;426;360;109;61;48;88;46;42;154;76;78;85;33;52;350;210;140;145.0;147.0;63.0;68.0;754.0;884.0;252
4834;Heumen;2018;15925;3099;9508;3318;13747;1396;497;899;782;429;353;113;64;49;87;46;41;154;77;77;79;29;50;349;213;136;146.0;151.0;52.0;66.0;813.0;855.0;252
4835;Heumen;2019;15866;3005;9473;3388;13667;1397;486;911;802;435;367;115;66;49;88;47;41;168;82;86;77;26;51;354;214;140;147.0;157.0;54.0;69.0;768.0;853.0;252
4836;Heumen;2020;15757;2952;9343;3462;13548;1381;489;892;828;459;369;124;68;56;94;50;44;175;90;85;73;27;46;362;224;138;141.0;159.0;55.0;66.0;798.0;844.0;252
4837;Heumen;2021;15684;2904;9247;3533;13451;1380;489;891;853;464;389;138;71;67;95;47;48;183;93;90;79;32;47;358;221;137;143.0;159.0;53.0;61.0;825.0;832.0;252
4838;Heumen;2022;15653;2835;9189;3629;13379;1396;493;903;878;478;400;143;75;68;94;53;41;196;95;101;86;32;54;359;223;136;143.0;164.0;52.0;59.0;786.0;832.0;252
4839;Heumen;2023;15580;2804;9094;3682;13306;1392;512;880;882;478;404;141;74;67;92;53;39;194;91;103;87;31;56;368;229;139;145.0;165.0;56.0;60.0;776.0;839.0;252
4840;Heumen;2024;15492;2766;9002;3724;13212;1378;513;865;902;494;408;139;74;65;90;51;39;198;98;100;87;32;55;388;239;149;146.0;164.0;51.0;60.0;791.0;809.0;252
4841;Heumen;2025;15447;2739;8917;3791;13166;1374;517;857;907;497;410;142;73;69;91;55;36;199;99;100;99;37;62;376;233;143;;;;;;;252
4842;Heusden;2008;42870;10863;25975;6032;37983;2392;874;1518;2495;1356;1139;195;97;98;151;75;76;1117;572;545;338;158;180;694;454;240;394.0;297.0;129.0;210.0;1234.0;1403.0;797
4843;Heusden;2009;42721;10622;25837;6262;37818;2374;865;1509;2529;1369;1160;219;112;107;149;76;73;1090;560;530;357;161;196;714;460;254;392.0;304.0;135.0;197.0;1271.0;1477.0;797
4844;Heusden;2010;42546;10433;25615;6498;37653;2363;850;1513;2530;1362;1168;209;104;105;158;88;70;1082;551;531;369;164;205;712;455;257;381.0;312.0;154.0;195.0;1384.0;1475.0;797
4845;Heusden;2011;42485;10127;25627;6731;37563;2343;851;1492;2579;1388;1191;207;105;102;168;89;79;1076;541;535;385;171;214;743;482;261;375.0;330.0;151.0;191.0;1471.0;1523.0;797
4846;Heusden;2012;42445;9888;25508;7049;37431;2379;883;1496;2635;1397;1238;220;108;112;180;97;83;1076;540;536;418;179;239;741;473;268;380.0;342.0;145.0;185.0;1476.0;1535.0;797
4847;Heusden;2013;42386;9690;25380;7316;37338;2382;894;1488;2666;1404;1262;228;109;119;190;104;86;1067;538;529;429;181;248;752;472;280;377.0;340.0;160.0;194.0;1431.0;1557.0;797
4848;Heusden;2014;42270;9478;25235;7557;37177;2385;900;1485;2708;1427;1281;245;117;128;196;109;87;1058;535;523;436;184;252;773;482;291;382.0;356.0;141.0;178.0;1529.0;1553.0;797
4849;Heusden;2015;42237;9310;25107;7820;37112;2383;916;1467;2742;1421;1321;244;114;130;197;108;89;1055;525;530;455;187;268;791;487;304;389.0;367.0;139.0;180.0;1541.0;1598.0;797
4850;Heusden;2016;42165;9168;24933;8064;36975;2377;911;1466;2813;1436;1377;252;118;134;195;109;86;1061;515;546;491;203;288;814;491;323;392.0;377.0;154.0;187.0;1644.0;1587.0;797
4851;Heusden;2017;42210;9006;24902;8302;36941;2391;916;1475;2878;1445;1433;273;128;145;217;121;96;1059;507;552;497;200;297;832;489;343;406.0;384.0;138.0;179.0;1617.0;1580.0;797
4852;Heusden;2018;42236;8879;24835;8522;36893;2387;909;1478;2956;1461;1495;293;143;150;219;121;98;1052;501;551;527;206;321;865;490;375;415.0;389.0;144.0;177.0;1665.0;1608.0;797
4853;Heusden;2019;42289;8768;24796;8725;36846;2386;911;1475;3057;1491;1566;306;153;153;234;127;107;1076;503;573;531;203;328;910;505;405;415.0;398.0;145.0;178.0;1723.0;1601.0;797
4854;Heusden;2020;42399;8738;24742;8919;36876;2386;918;1468;3137;1534;1603;335;169;166;236;120;116;1080;500;580;543;213;330;943;532;411;444.0;401.0;149.0;179.0;1623.0;1626.0;797
4855;Heusden;2021;42412;8682;24625;9105;36822;2365;904;1461;3225;1576;1649;343;172;171;242;123;119;1072;490;582;567;219;348;1001;572;429;446.0;409.0;141.0;180.0;1664.0;1615.0;797
4856;Heusden;2022;42459;8613;24552;9294;36824;2352;893;1459;3283;1586;1697;351;170;181;255;129;126;1074;481;593;580;221;359;1023;585;438;452.0;412.0;152.0;175.0;1820.0;1605.0;797
4857;Heusden;2023;42696;8604;24521;9571;36963;2393;901;1492;3340;1610;1730;353;174;179;267;135;132;1075;469;606;590;221;369;1055;611;444;456.0;422.0;173.0;171.0;1763.0;1603.0;797
4858;Heusden;2024;42912;8647;24509;9756;37068;2419;933;1486;3425;1628;1797;370;183;187;278;144;134;1090;468;622;610;229;381;1077;604;473;468.0;434.0;174.0;173.0;1779.0;1636.0;797
4859;Heusden;2025;43095;8716;24435;9944;37129;2428;954;1474;3538;1651;1887;377;191;186;291;148;143;1115;463;652;646;239;407;1109;610;499;;;;;;;797
4860;Hillegom;2008;20107;4738;12221;3148;17414;1651;746;905;1042;574;468;109;45;64;79;31;48;129;67;62;228;112;116;497;319;178;191.0;208.0;127.0;128.0;881.0;996.0;534
4861;Hillegom;2009;19975;4672;12128;3175;17250;1650;754;896;1075;610;465;116;51;65;79;36;43;141;76;65;226;116;110;513;331;182;189.0;213.0;131.0;120.0;908.0;977.0;534
4862;Hillegom;2010;19895;4633;12039;3223;17114;1663;750;913;1118;633;485;133;58;75;85;40;45;147;80;67;227;113;114;526;342;184;176.0;206.0;133.0;121.0;908.0;961.0;534
4863;Hillegom;2011;19829;4546;12022;3261;16988;1684;761;923;1157;643;514;136;60;76;95;44;51;156;84;72;246;122;124;524;333;191;174.0;206.0;137.0;119.0;960.0;979.0;534
4864;Hillegom;2012;19799;4456;11938;3405;16892;1701;769;932;1206;676;530;141;64;77;103;55;48;165;88;77;254;126;128;543;343;200;179.0;203.0;149.0;122.0;994.0;984.0;534
4865;Hillegom;2013;19813;4438;11852;3523;16825;1768;796;972;1220;668;552;144;66;78;99;57;42;177;90;87;262;120;142;538;335;203;178.0;207.0;141.0;118.0;939.0;981.0;534
4866;Hillegom;2014;19767;4398;11800;3569;16749;1788;813;975;1230;676;554;143;60;83;103;58;45;179;99;80;259;123;136;546;336;210;177.0;205.0;140.0;120.0;930.0;960.0;534
4867;Hillegom;2015;19732;4339;11744;3649;16661;1814;832;982;1257;691;566;158;71;87;101;57;44;195;102;93;264;127;137;539;334;205;178.0;209.0;143.0;110.0;993.0;944.0;534
4868;Hillegom;2016;19787;4351;11682;3754;16659;1847;835;1012;1281;693;588;163;76;87;96;53;43;209;106;103;263;126;137;550;332;218;183.0;218.0;141.0;121.0;957.0;958.0;534
4869;Hillegom;2017;19772;4353;11594;3825;16584;1885;850;1035;1303;704;599;171;80;91;97;49;48;215;111;104;271;130;141;549;334;215;181.0;215.0;141.0;114.0;983.0;953.0;534
4870;Hillegom;2018;19798;4347;11551;3900;16560;1904;859;1045;1334;717;617;173;77;96;105;58;47;213;110;103;275;129;146;568;343;225;186.0;219.0;136.0;113.0;993.0;942.0;534
4871;Hillegom;2019;19841;4334;11530;3977;16536;1918;870;1048;1387;754;633;185;85;100;104;56;48;225;121;104;280;135;145;593;357;236;184.0;219.0;145.0;111.0;989.0;971.0;534
4872;Hillegom;2020;19859;4278;11519;4062;16473;1938;884;1054;1448;780;668;190;84;106;109;60;49;240;128;112;291;144;147;618;364;254;187.0;221.0;140.0;112.0;984.0;947.0;534
4873;Hillegom;2021;19892;4239;11532;4121;16446;1975;892;1083;1471;790;681;193;88;105;121;69;52;246;128;118;296;144;152;615;361;254;191.0;227.0;138.0;113.0;1066.0;973.0;534
4874;Hillegom;2022;19974;4253;11514;4207;16452;1997;909;1088;1525;831;694;198;95;103;125;72;53;263;140;123;303;147;156;636;377;259;190.0;230.0;145.0;112.0;951.0;971.0;534
4875;Hillegom;2023;19947;4197;11466;4284;16386;2016;918;1098;1545;844;701;199;95;104;127;78;49;270;140;130;301;148;153;648;383;265;188.0;231.0;138.0;111.0;1028.0;986.0;534
4876;Hillegom;2024;19972;4163;11442;4367;16339;2036;916;1120;1597;876;721;204;97;107;136;82;54;279;144;135;294;148;146;684;405;279;188.0;234.0;142.0;114.0;924.0;974.0;534
4877;Hillegom;2025;19906;4146;11317;4443;16271;2024;914;1110;1611;882;729;206;97;109;142;88;54;275;142;133;292;140;152;696;415;281;;;;;;;534
4878;Hilvarenbeek;2008;15061;3910;8964;2187;14039;774;233;541;248;161;87;24;11;13;17;4;13;25;15;10;14;5;9;168;126;42;143.0;107.0;46.0;68.0;297.0;404.0;798
4879;Hilvarenbeek;2009;14970;3825;8888;2257;13911;789;243;546;270;168;102;27;12;15;21;6;15;37;21;16;17;6;11;168;123;45;137.0;110.0;48.0;63.0;400.0;424.0;798
4880;Hilvarenbeek;2010;14959;3735;8889;2335;13836;809;248;561;314;198;116;28;14;14;25;9;16;46;25;21;21;8;13;194;142;52;137.0;112.0;51.0;67.0;387.0;445.0;798
4881;Hilvarenbeek;2011;14911;3612;8838;2461;13744;812;253;559;355;219;136;33;21;12;31;9;22;57;27;30;27;11;16;207;151;56;131.0;116.0;55.0;64.0;399.0;456.0;798
4882;Hilvarenbeek;2012;14861;3508;8810;2543;13629;824;259;565;408;252;156;44;26;18;34;15;19;61;30;31;36;15;21;233;166;67;132.0;117.0;56.0;65.0;381.0;462.0;798
4883;Hilvarenbeek;2013;14785;3412;8736;2637;13513;829;262;567;443;267;176;56;29;27;37;18;19;66;31;35;41;15;26;243;174;69;131.0;120.0;59.0;65.0;453.0;475.0;798
4884;Hilvarenbeek;2014;14769;3330;8690;2749;13445;839;256;583;485;291;194;59;31;28;48;25;23;68;31;37;47;18;29;263;186;77;136.0;127.0;54.0;63.0;486.0;472.0;798
4885;Hilvarenbeek;2015;14783;3254;8675;2854;13437;830;247;583;516;300;216;64;30;34;46;24;22;80;35;45;52;20;32;274;191;83;138.0;130.0;63.0;67.0;454.0;497.0;798
4886;Hilvarenbeek;2016;14745;3204;8630;2911;13362;833;242;591;550;310;240;71;33;38;47;25;22;92;38;54;51;21;30;289;193;96;143.0;132.0;64.0;62.0;451.0;485.0;798
4887;Hilvarenbeek;2017;14725;3114;8631;2980;13296;850;253;597;579;333;246;70;33;37;50;25;25;97;40;57;53;21;32;309;214;95;140.0;134.0;61.0;65.0;478.0;481.0;798
4888;Hilvarenbeek;2018;14725;3058;8603;3064;13264;852;258;594;609;347;262;78;38;40;57;28;29;103;42;61;56;23;33;315;216;99;147.0;140.0;65.0;64.0;504.0;490.0;798
4889;Hilvarenbeek;2019;14745;3007;8582;3156;13227;862;261;601;656;370;286;84;40;44;59;29;30;105;43;62;63;22;41;345;236;109;148.0;142.0;70.0;65.0;417.0;505.0;798
4890;Hilvarenbeek;2020;14671;2931;8501;3239;13119;861;265;596;691;393;298;89;47;42;56;25;31;107;45;62;70;23;47;369;253;116;149.0;144.0;57.0;62.0;508.0;474.0;798
4891;Hilvarenbeek;2021;14707;2872;8550;3285;13118;871;275;596;718;397;321;97;50;47;56;24;32;110;46;64;76;24;52;379;253;126;153.0;147.0;61.0;64.0;525.0;491.0;798
4892;Hilvarenbeek;2022;14745;2856;8547;3342;13114;876;285;591;755;412;343;104;51;53;57;23;34;125;50;75;79;27;52;390;261;129;155.0;153.0;61.0;62.0;544.0;506.0;798
4893;Hilvarenbeek;2023;14786;2857;8510;3419;13103;890;289;601;793;429;364;105;52;53;60;26;34;136;52;84;89;31;58;403;268;135;156.0;160.0;63.0;65.0;532.0;485.0;798
4894;Hilvarenbeek;2024;14828;2846;8493;3489;13088;892;296;596;848;449;399;109;52;57;65;29;36;144;56;88;95;34;61;435;278;157;154.0;160.0;67.0;62.0;478.0;494.0;798
4895;Hilvarenbeek;2025;14810;2832;8438;3540;13028;893;306;587;889;478;411;115;55;60;71;31;40;153;60;93;90;34;56;460;298;162;;;;;;;798
4896;Hilversum;2008;84695;19051;50889;14755;66743;9239;3732;5507;8713;5004;3709;745;323;422;536;258;278;2212;1203;1009;2212;1265;947;3008;1955;1053;939.0;828.0;733.0;955.0;4375.0;3954.0;402
4897;Hilversum;2009;85022;19160;51039;14823;66745;9342;3818;5524;8935;5065;3870;789;341;448;576;284;292;2229;1199;1030;2251;1257;994;3090;1984;1106;918.0;822.0;789.0;938.0;4345.0;3960.0;402
4898;Hilversum;2010;85369;19268;51175;14926;66850;9394;3849;5545;9125;5129;3996;830;349;481;601;302;299;2259;1227;1032;2266;1248;1018;3169;2003;1166;903.0;833.0;816.0;943.0;4344.0;4026.0;402
4899;Hilversum;2011;85644;19287;51475;14882;66873;9491;3931;5560;9280;5178;4102;862;373;489;594;290;304;2273;1225;1048;2307;1263;1044;3244;2027;1217;900.0;820.0;809.0;932.0;4158.0;4003.0;402
4900;Hilversum;2012;85768;19266;51121;15381;66704;9591;3985;5606;9473;5264;4209;904;395;509;631;321;310;2290;1230;1060;2362;1267;1095;3286;2051;1235;904.0;838.0;789.0;925.0;4336.0;4002.0;402
4901;Hilversum;2013;86040;19225;50987;15828;66712;9632;4017;5615;9696;5351;4345;944;415;529;669;351;318;2309;1225;1084;2392;1274;1118;3382;2086;1296;890.0;824.0;814.0;931.0;4479.0;4053.0;402
4902;Hilversum;2014;86423;19256;51093;16074;66862;9718;4099;5619;9843;5360;4483;982;419;563;681;358;323;2316;1229;1087;2424;1272;1152;3440;2082;1358;899.0;823.0;817.0;903.0;4274.0;4013.0;402
4903;Hilversum;2015;86681;19272;51152;16257;66879;9787;4129;5658;10015;5401;4614;1013;424;589;713;374;339;2331;1221;1110;2472;1295;1177;3486;2087;1399;893.0;822.0;810.0;880.0;4143.0;4050.0;402
4904;Hilversum;2016;86782;19243;51097;16442;66703;9852;4174;5678;10227;5508;4719;1070;462;608;742;400;342;2325;1202;1123;2504;1314;1190;3586;2130;1456;898.0;826.0;821.0;880.0;4276.0;3995.0;402
4905;Hilversum;2017;87089;19268;51173;16648;66739;9951;4230;5721;10399;5582;4817;1093;466;627;771;406;365;2332;1217;1115;2508;1316;1192;3695;2177;1518;901.0;831.0;823.0;894.0;4290.0;3999.0;402
4906;Hilversum;2018;87386;19299;51182;16905;66788;10039;4272;5767;10559;5597;4962;1121;473;648;797;415;382;2360;1223;1137;2530;1314;1216;3751;2172;1579;904.0;827.0;800.0;887.0;4232.0;4012.0;402
4907;Hilversum;2019;87606;19199;51284;17123;66736;10156;4323;5833;10714;5628;5086;1139;487;652;808;428;380;2389;1214;1175;2556;1314;1242;3822;2185;1637;903.0;824.0;817.0;880.0;4258.0;4001.0;402
4908;Hilversum;2020;87888;19126;51439;17323;66757;10250;4379;5871;10881;5717;5164;1162;502;660;830;438;392;2406;1196;1210;2554;1311;1243;3929;2270;1659;902.0;838.0;817.0;878.0;4223.0;4054.0;402
4909;Hilversum;2021;88070;19087;51460;17523;66755;10348;4498;5850;10967;5731;5236;1162;505;657;835;450;385;2406;1186;1220;2560;1308;1252;4004;2282;1722;904.0;831.0;835.0;877.0;4263.0;4058.0;402
4910;Hilversum;2022;88324;19046;51566;17712;66759;10438;4556;5882;11127;5814;5313;1196;534;662;869;464;405;2430;1204;1226;2556;1298;1258;4076;2314;1762;889.0;845.0;820.0;871.0;4307.0;4102.0;402
4911;Hilversum;2023;88534;18915;51662;17957;66755;10545;4632;5913;11234;5840;5394;1212;533;679;879;465;414;2457;1199;1258;2585;1304;1281;4101;2339;1762;896.0;853.0;799.0;865.0;4457.0;4144.0;402
4912;Hilversum;2024;88830;18829;51754;18247;66844;10676;4735;5941;11310;5849;5461;1227;544;683;895;458;437;2460;1195;1265;2593;1313;1280;4135;2339;1796;902.0;863.0;808.0;859.0;4235.0;4118.0;402
4913;Hilversum;2025;88945;18755;51537;18653;66789;10762;4807;5955;11394;5870;5524;1260;558;702;903;458;445;2454;1192;1262;2582;1304;1278;4195;2358;1837;;;;;;;402
4914;Hof van Twente;2008;35261;8617;20109;6535;31894;2006;733;1273;1361;817;544;75;32;43;51;25;26;429;221;208;46;21;25;760;518;242;330.0;334.0;91.0;132.0;946.0;1080.0;1735
4915;Hof van Twente;2009;35084;8563;19849;6672;31569;2032;736;1296;1483;879;604;89;43;46;65;30;35;451;230;221;62;30;32;816;546;270;314.0;343.0;106.0;130.0;1073.0;1084.0;1735
4916;Hof van Twente;2010;35026;8517;19710;6799;31353;2061;753;1308;1612;918;694;96;47;49;86;40;46;464;229;235;67;25;42;899;577;322;310.0;347.0;99.0;133.0;925.0;1090.0;1735
4917;Hof van Twente;2011;34788;8454;19414;6920;31010;2074;743;1331;1704;957;747;118;61;57;97;43;54;462;227;235;82;31;51;945;595;350;293.0;348.0;101.0;132.0;947.0;1064.0;1735
4918;Hof van Twente;2012;34596;8352;19082;7162;30685;2083;743;1340;1828;1006;822;138;71;67;93;43;50;477;229;248;101;36;65;1019;627;392;289.0;356.0;126.0;126.0;1056.0;1076.0;1735
4919;Hof van Twente;2013;34511;8263;18881;7367;30450;2117;773;1344;1944;1053;891;155;77;78;102;50;52;489;228;261;111;38;73;1087;660;427;287.0;356.0;110.0;127.0;1105.0;1093.0;1735
4920;Hof van Twente;2014;34438;8140;18759;7539;30227;2138;778;1360;2073;1096;977;174;80;94;120;57;63;508;232;276;132;50;82;1139;677;462;283.0;360.0;122.0;126.0;971.0;1068.0;1735
4921;Hof van Twente;2015;34261;8001;18581;7679;29873;2177;809;1368;2211;1142;1069;186;84;102;131;60;71;515;237;278;161;55;106;1218;706;512;290.0;375.0;119.0;125.0;1007.0;1105.0;1735
4922;Hof van Twente;2016;34073;7887;18408;7778;29562;2199;818;1381;2312;1202;1110;206;96;110;140;59;81;507;240;267;179;61;118;1280;746;534;284.0;373.0;112.0;124.0;1059.0;1129.0;1735
4923;Hof van Twente;2017;33902;7791;18222;7889;29269;2200;803;1397;2433;1249;1184;225;102;123;153;66;87;523;244;279;184;59;125;1348;778;570;286.0;385.0;115.0;126.0;960.0;1120.0;1735
4924;Hof van Twente;2018;33635;7628;18052;7955;28905;2210;821;1389;2520;1282;1238;251;110;141;153;65;88;517;235;282;203;63;140;1396;809;587;284.0;381.0;123.0;120.0;1146.0;1097.0;1735
4925;Hof van Twente;2019;33593;7510;18032;8051;28705;2239;848;1391;2649;1344;1305;278;129;149;176;76;100;520;238;282;203;67;136;1472;834;638;284.0;390.0;132.0;131.0;1154.0;1085.0;1735
4926;Hof van Twente;2020;33560;7410;18035;8115;28516;2284;889;1395;2760;1393;1367;301;140;161;180;79;101;534;244;290;214;70;144;1531;860;671;301.0;394.0;125.0;124.0;1084.0;1115.0;1735
4927;Hof van Twente;2021;33439;7238;18017;8184;28282;2275;903;1372;2882;1434;1448;318;147;171;190;79;111;531;246;285;237;78;159;1606;884;722;299.0;397.0;120.0;124.0;1040.0;1124.0;1735
4928;Hof van Twente;2022;33254;7114;17897;8243;28032;2281;915;1366;2941;1462;1479;323;150;173;200;84;116;549;246;303;249;81;168;1620;901;719;304.0;400.0;127.0;120.0;1136.0;1108.0;1735
4929;Hof van Twente;2023;33196;7039;17852;8305;27879;2315;948;1367;3002;1485;1517;337;150;187;200;85;115;549;245;304;254;80;174;1662;925;737;318.0;401.0;119.0;118.0;1129.0;1124.0;1735
4930;Hof van Twente;2024;33121;6933;17796;8392;27675;2354;977;1377;3092;1519;1573;353;165;188;218;92;126;549;245;304;282;92;190;1690;925;765;316.0;408.0;114.0;124.0;1180.0;1102.0;1735
4931;Hof van Twente;2025;33099;6854;17794;8451;27539;2381;996;1385;3179;1549;1630;369;178;191;228;94;134;548;248;300;293;90;203;1741;939;802;;;;;;;1735
4932;Hoogeveen;2008;54051;13189;32075;8787;49249;2916;1104;1812;1886;1053;833;209;89;120;135;70;65;327;158;169;114;60;54;1101;676;425;645.0;503.0;115.0;154.0;1440.0;1610.0;118
4933;Hoogeveen;2009;53989;13142;31915;8932;49127;2916;1097;1819;1946;1082;864;217;94;123;138;73;65;354;173;181;129;66;63;1108;676;432;651.0;506.0;126.0;139.0;1539.0;1637.0;118
4934;Hoogeveen;2010;54032;13110;31851;9071;49049;2921;1092;1829;2062;1144;918;239;108;131;144;76;68;370;183;187;163;77;86;1146;700;446;626.0;524.0;121.0;140.0;1653.0;1632.0;118
4935;Hoogeveen;2011;54136;13075;31795;9266;49090;2901;1069;1832;2145;1188;957;266;119;147;153;86;67;398;195;203;178;82;96;1150;706;444;628.0;531.0;124.0;134.0;1706.0;1603.0;118
4936;Hoogeveen;2012;54332;13079;31661;9592;49172;2897;1069;1828;2263;1246;1017;282;124;158;167;99;68;427;211;216;192;88;104;1195;724;471;630.0;538.0;130.0;133.0;1699.0;1652.0;118
4937;Hoogeveen;2013;54471;13080;31431;9960;49219;2885;1058;1827;2367;1285;1082;299;132;167;182;112;70;461;212;249;210;95;115;1215;734;481;619.0;536.0;127.0;140.0;1729.0;1625.0;118
4938;Hoogeveen;2014;54649;13137;31277;10235;49301;2909;1056;1853;2439;1299;1140;312;145;167;201;124;77;475;216;259;239;102;137;1212;712;500;625.0;535.0;130.0;129.0;1702.0;1624.0;118
4939;Hoogeveen;2015;54822;13106;31288;10428;49358;2930;1051;1879;2534;1332;1202;343;156;187;209;131;78;502;220;282;252;107;145;1228;718;510;623.0;548.0;139.0;130.0;1696.0;1675.0;118
4940;Hoogeveen;2016;54931;13142;31212;10577;49373;2926;1034;1892;2632;1379;1253;361;164;197;219;141;78;529;229;300;267;112;155;1256;733;523;619.0;545.0;141.0;131.0;1867.0;1671.0;118
4941;Hoogeveen;2017;55216;13191;31247;10778;49513;2950;1056;1894;2753;1451;1302;379;175;204;224;150;74;545;223;322;288;119;169;1317;784;533;617.0;563.0;129.0;132.0;1817.0;1719.0;118
4942;Hoogeveen;2018;55370;13141;31274;10955;49531;2982;1069;1913;2857;1520;1337;413;195;218;233;157;76;547;226;321;293;120;173;1371;822;549;625.0;557.0;134.0;129.0;1866.0;1701.0;118
4943;Hoogeveen;2019;55613;13059;31365;11189;49650;2984;1065;1919;2979;1559;1420;435;197;238;251;166;85;579;233;346;312;127;185;1402;836;566;631.0;579.0;135.0;127.0;1720.0;1725.0;118
4944;Hoogeveen;2020;55673;12951;31363;11359;49548;3000;1064;1936;3125;1632;1493;449;205;244;270;176;94;602;252;350;348;133;215;1456;866;590;621.0;576.0;135.0;133.0;1915.0;1711.0;118
4945;Hoogeveen;2021;55930;12936;31405;11589;49659;2995;1069;1926;3276;1692;1584;481;214;267;291;187;104;647;266;381;357;137;220;1500;888;612;636.0;586.0;147.0;133.0;1822.0;1727.0;118
4946;Hoogeveen;2022;56097;12937;31335;11825;49697;3000;1090;1910;3400;1751;1649;482;216;266;315;195;120;660;270;390;378;142;236;1565;928;637;637.0;593.0;132.0;128.0;1870.0;1728.0;118
4947;Hoogeveen;2023;56295;12938;31261;12096;49777;3037;1110;1927;3481;1763;1718;491;216;275;343;210;133;675;274;401;379;140;239;1593;923;670;633.0;591.0;137.0;128.0;1804.0;1730.0;118
4948;Hoogeveen;2024;56426;12870;31245;12311;49820;3040;1116;1924;3566;1797;1769;504;219;285;347;213;134;702;288;414;396;146;250;1617;931;686;651.0;609.0;132.0;129.0;1878.0;1728.0;118
4949;Hoogeveen;2025;56627;12912;31206;12509;49886;3049;1111;1938;3692;1843;1849;527;228;299;365;220;145;717;297;420;422;148;274;1661;950;711;;;;;;;118
4950;Hoogezand-Sappemeer;2008;34148;7818;20586;5744;28304;2294;925;1369;3550;2082;1468;1274;772;502;363;230;133;1039;550;489;266;126;140;608;404;204;370.0;331.0;134.0;152.0;1476.0;1434.0;18
4951;Hoogezand-Sappemeer;2009;34214;7828;20542;5844;28318;2287;932;1355;3609;2122;1487;1269;764;505;365;231;134;1031;539;492;281;142;139;663;446;217;367.0;339.0;144.0;146.0;1529.0;1449.0;18
4952;Hoogezand-Sappemeer;2010;34324;7831;20590;5903;28392;2300;927;1373;3632;2147;1485;1245;752;493;374;240;134;1018;538;480;302;152;150;693;465;228;374.0;339.0;153.0;150.0;1460.0;1491.0;18
4953;Hoogezand-Sappemeer;2011;34338;7763;20521;6054;28373;2312;939;1373;3653;2143;1510;1230;738;492;389;253;136;997;524;473;328;165;163;709;463;246;377.0;337.0;150.0;145.0;1515.0;1480.0;18
4954;Hoogezand-Sappemeer;2012;34420;7702;20393;6325;28397;2328;947;1381;3695;2188;1507;1214;726;488;394;264;130;991;521;470;334;172;162;762;505;257;369.0;351.0;155.0;145.0;1569.0;1490.0;18
4955;Hoogezand-Sappemeer;2013;34533;7688;20332;6513;28483;2329;946;1383;3721;2220;1501;1195;717;478;395;273;122;975;517;458;356;176;180;800;537;263;378.0;353.0;153.0;143.0;1505.0;1495.0;18
4956;Hoogezand-Sappemeer;2014;34580;7664;20267;6649;28473;2327;937;1390;3780;2257;1523;1182;711;471;402;276;126;978;521;457;379;184;195;839;565;274;377.0;350.0;174.0;143.0;1527.0;1492.0;18
4957;Hoogezand-Sappemeer;2015;34676;7689;20230;6757;28474;2353;934;1419;3849;2293;1556;1162;702;460;416;284;132;992;528;464;392;185;207;887;594;293;382.0;354.0;154.0;144.0;1537.0;1462.0;18
4958;Hoogezand-Sappemeer;2016;34795;7678;20257;6860;28523;2358;939;1419;3914;2325;1589;1154;693;461;427;287;140;1009;547;462;405;189;216;919;609;310;389.0;355.0;155.0;146.0;1479.0;1502.0;18
4959;Hoogezand-Sappemeer;2017;34818;7653;20235;6930;28465;2391;949;1442;3962;2368;1594;1129;684;445;442;299;143;1000;546;454;413;195;218;978;644;334;403.0;352.0;162.0;149.0;1486.0;1508.0;18
4960;Hoogezand-Sappemeer;2018;34863;7619;20198;7046;28519;2355;923;1432;3989;2378;1611;1115;673;442;454;306;148;992;547;445;429;209;220;999;643;356;402.0;364.0;160.0;147.0;1519.0;1514.0;18
4961;Hoogezand-Sappemeer;2019;34924;7586;20170;7168;28549;2339;935;1404;4036;2409;1627;1118;673;445;454;308;146;998;550;448;448;217;231;1018;661;357;411.0;364.0;165.0;143.0;1460.0;1531.0;18
4962;Hoogezand-Sappemeer;2020;34926;7504;20179;7243;28485;2336;934;1402;4105;2443;1662;1111;671;440;477;323;154;997;563;434;477;227;250;1043;659;384;411.0;371.0;171.0;141.0;1509.0;1512.0;18
4963;Hoogezand-Sappemeer;2021;34995;7497;20150;7348;28508;2368;962;1406;4119;2428;1691;1089;653;436;481;323;158;1005;567;438;487;231;256;1057;654;403;417.0;378.0;168.0;140.0;1499.0;1497.0;18
4964;Hoogezand-Sappemeer;2022;35070;7513;20147;7410;28490;2381;956;1425;4199;2475;1724;1080;640;440;473;320;153;1018;563;455;500;243;257;1128;709;419;427.0;374.0;184.0;145.0;1557.0;1516.0;18
4965;Hoogezand-Sappemeer;2023;35208;7512;20137;7559;28561;2396;966;1430;4251;2510;1741;1072;630;442;479;322;157;1021;575;446;520;258;262;1159;725;434;425.0;390.0;166.0;140.0;1534.0;1545.0;18
4966;Hoogezand-Sappemeer;2024;35263;7540;20066;7657;28605;2382;963;1419;4276;2520;1756;1051;619;432;482;317;165;1025;583;442;540;268;272;1178;733;445;437.0;395.0;158.0;138.0;1457.0;1520.0;18
4967;Hoogezand-Sappemeer;2025;35265;7579;19915;7771;28583;2386;955;1431;4296;2551;1745;1043;616;427;496;322;174;1028;595;433;545;264;281;1184;754;430;;;;;;;18
4968;Hoorn;2008;68141;17292;42359;8490;54769;5280;2013;3267;8092;4496;3596;1885;952;933;769;440;329;1488;734;754;1161;599;562;2789;1771;1018;796.0;529.0;350.0;376.0;2213.0;2284.0;405
4969;Hoorn;2009;68321;17302;42255;8764;54848;5279;1997;3282;8194;4546;3648;1851;933;918;768;433;335;1499;742;757;1197;606;591;2879;1832;1047;762.0;535.0;356.0;365.0;2278.0;2238.0;405
4970;Hoorn;2010;68590;17308;42182;9100;55006;5294;1999;3295;8290;4593;3697;1835;913;922;756;425;331;1523;765;758;1231;615;616;2945;1875;1070;756.0;534.0;374.0;361.0;2364.0;2334.0;405
4971;Hoorn;2011;68860;17313;42110;9437;55082;5358;2032;3326;8420;4654;3766;1836;909;927;751;417;334;1523;768;755;1242;610;632;3068;1950;1118;736.0;550.0;382.0;361.0;2436.0;2329.0;405
4972;Hoorn;2012;69179;17240;41904;10035;55211;5388;2060;3328;8580;4724;3856;1837;904;933;747;418;329;1538;779;759;1272;617;655;3186;2006;1180;724.0;552.0;385.0;350.0;2610.0;2340.0;405
4973;Hoorn;2013;69662;17252;41713;10697;55354;5523;2113;3410;8785;4808;3977;1856;898;958;757;426;331;1561;783;778;1295;624;671;3316;2077;1239;731.0;574.0;399.0;357.0;2478.0;2339.0;405
4974;Hoorn;2014;70004;17221;41541;11242;55555;5560;2156;3404;8889;4839;4050;1827;873;954;760;418;342;1586;789;797;1300;620;680;3416;2139;1277;725.0;583.0;381.0;340.0;2392.0;2361.0;405
4975;Hoorn;2015;70224;17173;41342;11709;55566;5599;2184;3415;9059;4940;4119;1839;861;978;777;444;333;1604;815;789;1317;621;696;3522;2199;1323;716.0;589.0;379.0;344.0;2288.0;2351.0;405
4976;Hoorn;2016;70330;17077;41103;12150;55623;5589;2210;3379;9118;5004;4114;1802;853;949;793;449;344;1620;825;795;1306;622;684;3597;2255;1342;707.0;602.0;417.0;340.0;2346.0;2356.0;405
4977;Hoorn;2017;70514;17112;40826;12576;55621;5624;2240;3384;9269;5074;4195;1777;844;933;811;463;348;1646;830;816;1313;620;693;3722;2317;1405;701.0;614.0;396.0;345.0;2412.0;2365.0;405
4978;Hoorn;2018;70705;17028;40707;12970;55704;5594;2249;3345;9407;5129;4278;1757;831;926;814;459;355;1658;830;828;1347;623;724;3831;2386;1445;703.0;629.0;384.0;338.0;2501.0;2364.0;405
4979;Hoorn;2019;70976;16965;40603;13408;55772;5686;2303;3383;9518;5188;4330;1768;824;944;802;444;358;1673;842;831;1360;628;732;3915;2450;1465;708.0;654.0;386.0;325.0;2308.0;2426.0;405
4980;Hoorn;2020;70980;16798;40403;13779;55632;5698;2312;3386;9650;5273;4377;1762;821;941;822;463;359;1686;844;842;1353;628;725;4027;2517;1510;712.0;661.0;384.0;338.0;2407.0;2370.0;405
4981;Hoorn;2021;71127;16626;40350;14151;55641;5684;2329;3355;9802;5320;4482;1770;814;956;826;460;366;1686;846;840;1373;623;750;4147;2577;1570;712.0;673.0;391.0;327.0;2485.0;2373.0;405
4982;Hoorn;2022;71349;16516;40388;14445;55615;5765;2392;3373;9969;5420;4549;1781;820;961;835;467;368;1718;869;849;1389;620;769;4246;2644;1602;717.0;688.0;394.0;332.0;2424.0;2421.0;405
4983;Hoorn;2023;71447;16383;40344;14720;55548;5755;2395;3360;10144;5536;4608;1756;818;938;863;477;386;1757;890;867;1422;634;788;4346;2717;1629;721.0;703.0;389.0;328.0;2614.0;2425.0;405
4984;Hoorn;2024;71725;16307;40462;14956;55584;5866;2459;3407;10275;5586;4689;1765;811;954;873;474;399;1765;893;872;1452;636;816;4420;2772;1648;736.0;721.0;395.0;320.0;2477.0;2426.0;405
4985;Hoorn;2025;71871;16224;40388;15259;55579;5908;2491;3417;10384;5655;4729;1756;797;959;894;486;408;1787;911;876;1456;630;826;4491;2831;1660;;;;;;;405
4986;Horst aan de Maas;2008;28949;7457;17150;4342;26478;1657;608;1049;814;502;312;77;35;42;46;21;25;102;55;47;84;35;49;505;356;149;255.0;226.0;82.0;109.0;784.0;830.0;1507
4987;Horst aan de Maas;2009;28908;7324;17143;4441;26354;1661;608;1053;893;554;339;85;41;44;49;23;26;111;60;51;95;38;57;553;392;161;248.0;231.0;76.0;108.0;903.0;868.0;1507
4988;Horst aan de Maas;2010;28931;7202;17177;4552;26271;1683;626;1057;977;602;375;100;51;49;61;31;30;129;69;60;111;46;65;576;405;171;246.0;238.0;91.0;107.0;796.0;912.0;1507
4989;Horst aan de Maas;2011;28810;7000;17122;4688;26111;1674;616;1058;1025;633;392;107;61;46;64;33;31;140;74;66;120;50;70;594;415;179;241.0;246.0;87.0;104.0;852.0;919.0;1507
4990;Horst aan de Maas;2012;28725;6833;17024;4868;25957;1657;610;1047;1111;679;432;115;62;53;70;38;32;151;76;75;132;54;78;643;449;194;233.0;248.0;94.0;106.0;905.0;931.0;1507
4991;Horst aan de Maas;2013;28675;6639;16976;5060;25824;1680;628;1052;1171;712;459;124;66;58;76;43;33;164;76;88;138;57;81;669;470;199;249.0;258.0;87.0;110.0;860.0;945.0;1507
4992;Horst aan de Maas;2014;28562;6468;16853;5241;25622;1696;643;1053;1244;739;505;131;70;61;84;46;38;182;86;96;150;57;93;697;480;217;244.0;259.0;93.0;111.0;948.0;938.0;1507
4993;Horst aan de Maas;2015;28540;6305;16847;5388;25564;1680;640;1040;1296;767;529;132;71;61;86;50;36;193;88;105;163;60;103;722;498;224;248.0;264.0;113.0;102.0;870.0;939.0;1507
4994;Horst aan de Maas;2016;28471;6179;16746;5546;25421;1691;660;1031;1359;814;545;137;73;64;87;49;38;207;96;111;158;60;98;770;536;234;251.0;281.0;94.0;100.0;964.0;935.0;1507
4995;Horst aan de Maas;2017;28467;6111;16617;5739;25354;1710;683;1027;1403;822;581;141;77;64;86;52;34;227;100;127;175;62;113;774;531;243;254.0;286.0;87.0;100.0;974.0;918.0;1507
4996;Horst aan de Maas;2018;28480;6031;16540;5909;25287;1708;683;1025;1485;869;616;147;80;67;100;57;43;241;109;132;190;74;116;807;549;258;269.0;285.0;91.0;98.0;1017.0;925.0;1507
4997;Horst aan de Maas;2019;28551;5941;16579;6031;25317;1713;684;1029;1521;890;631;156;83;73;102;60;42;244;110;134;202;82;120;817;555;262;279.0;298.0;92.0;96.0;969.0;939.0;1507
4998;Horst aan de Maas;2020;28558;5853;16530;6175;25204;1724;691;1033;1630;948;682;163;87;76;108;65;43;263;113;150;213;88;125;883;595;288;273.0;299.0;97.0;95.0;883.0;944.0;1507
4999;Horst aan de Maas;2021;28476;5738;16448;6290;25076;1730;702;1028;1670;976;694;170;96;74;112;69;43;269;119;150;230;92;138;889;600;289;281.0;312.0;88.0;99.0;902.0;935.0;1507
5000;Horst aan de Maas;2022;28404;5643;16327;6434;24922;1744;727;1017;1738;1015;723;181;106;75;130;81;49;281;122;159;245;96;149;901;610;291;281.0;314.0;114.0;97.0;912.0;948.0;1507
5001;Horst aan de Maas;2023;28353;5615;16172;6566;24768;1777;760;1017;1808;1042;766;192;114;78;135;82;53;300;132;168;252;95;157;929;619;310;290.0;310.0;95.0;99.0;940.0;930.0;1507
5002;Horst aan de Maas;2024;28343;5553;16087;6703;24659;1794;752;1042;1890;1080;810;206;120;86;142;85;57;317;140;177;258;99;159;967;636;331;297.0;318.0;90.0;100.0;946.0;921.0;1507
5003;Horst aan de Maas;2025;28341;5544;15909;6888;24610;1803;745;1058;1928;1106;822;205;119;86;147;86;61;325;143;182;260;98;162;991;660;331;;;;;;;1507
5004;Houten;2008;45651;13577;27890;4184;39721;3093;980;2113;2837;1482;1355;749;361;388;268;128;140;210;98;112;433;194;239;1177;701;476;620.0;226.0;167.0;184.0;1153.0;1364.0;321
5005;Houten;2009;45822;13378;28118;4326;39803;3123;1001;2122;2896;1517;1379;751;361;390;270;131;139;243;108;135;457;210;247;1175;707;468;593.0;230.0;173.0;176.0;1046.0;1399.0;321
5006;Houten;2010;45834;13104;28229;4501;39779;3137;1038;2099;2918;1519;1399;744;362;382;271;135;136;257;111;146;489;225;264;1157;686;471;560.0;244.0;206.0;171.0;1082.0;1375.0;321
5007;Houten;2011;45901;12935;28330;4636;39763;3147;1046;2101;2991;1537;1454;742;361;381;272;134;138;276;117;159;515;231;284;1186;694;492;547.0;240.0;181.0;172.0;1078.0;1386.0;321
5008;Houten;2012;45914;12682;28274;4958;39693;3159;1078;2081;3062;1565;1497;735;368;367;268;136;132;306;126;180;557;246;311;1196;689;507;522.0;249.0;180.0;173.0;1011.0;1355.0;321
5009;Houten;2013;45854;12428;28168;5258;39539;3175;1104;2071;3140;1605;1535;731;370;361;277;142;135;333;138;195;586;258;328;1213;697;516;514.0;256.0;185.0;155.0;1010.0;1355.0;321
5010;Houten;2014;45801;12187;28096;5518;39445;3173;1124;2049;3183;1613;1570;737;373;364;268;136;132;345;140;205;609;266;343;1224;698;526;504.0;261.0;179.0;153.0;1234.0;1354.0;321
5011;Houten;2015;45954;12019;28114;5821;39523;3167;1145;2022;3264;1636;1628;744;379;365;274;137;137;357;142;215;649;284;365;1240;694;546;500.0;278.0;179.0;162.0;1110.0;1341.0;321
5012;Houten;2016;45966;11838;27974;6154;39504;3166;1171;1995;3296;1660;1636;751;383;368;272;134;138;363;148;215;670;296;374;1240;699;541;503.0;286.0;166.0;148.0;1230.0;1330.0;321
5013;Houten;2017;46103;11727;27909;6467;39521;3207;1194;2013;3375;1689;1686;754;382;372;279;138;141;372;149;223;701;311;390;1269;709;560;502.0;294.0;169.0;154.0;1149.0;1351.0;321
5014;Houten;2018;46127;11558;27793;6776;39473;3186;1183;2003;3468;1743;1725;758;391;367;282;142;140;385;150;235;721;321;400;1322;739;583;504.0;290.0;163.0;144.0;1073.0;1312.0;321
5015;Houten;2019;46125;11389;27550;7186;39414;3207;1197;2010;3504;1755;1749;760;396;364;295;153;142;396;153;243;734;320;414;1319;733;586;500.0;305.0;168.0;155.0;1176.0;1288.0;321
5016;Houten;2020;46224;11198;27413;7613;39415;3245;1207;2038;3564;1801;1763;754;393;361;295;156;139;420;169;251;754;331;423;1341;752;589;497.0;312.0;159.0;152.0;1208.0;1342.0;321
5017;Houten;2021;46287;11060;27224;8003;39383;3259;1218;2041;3645;1844;1801;776;404;372;301;154;147;447;185;262;766;335;431;1355;766;589;500.0;332.0;164.0;137.0;1201.0;1337.0;321
5018;Houten;2022;46347;10944;26916;8487;39335;3296;1245;2051;3716;1874;1842;789;402;387;296;152;144;459;193;266;774;342;432;1398;785;613;488.0;336.0;164.0;141.0;1270.0;1383.0;321
5019;Houten;2023;46414;10767;26675;8972;39321;3294;1259;2035;3799;1909;1890;795;408;387;307;155;152;474;207;267;804;350;454;1419;789;630;500.0;345.0;175.0;144.0;1294.0;1364.0;321
5020;Houten;2024;46533;10595;26524;9414;39331;3325;1297;2028;3877;1955;1922;803;415;388;318;156;162;488;209;279;823;364;459;1445;811;634;491.0;358.0;174.0;146.0;1220.0;1379.0;321
5021;Houten;2025;46541;10456;26273;9812;39266;3338;1314;2024;3937;1991;1946;804;420;384;324;154;170;517;222;295;840;374;466;1452;821;631;;;;;;;321
5022;Huizen;2008;42314;10532;25795;5987;34510;4134;1525;2609;3670;1983;1687;330;159;171;226;102;124;654;365;289;1224;618;606;1236;739;497;399.0;305.0;213.0;205.0;1800.0;1930.0;406
5023;Huizen;2009;42292;10316;25775;6201;34442;4150;1544;2606;3700;1990;1710;356;174;182;223;101;122;668;366;302;1228;613;615;1225;736;489;379.0;328.0;219.0;204.0;1795.0;1944.0;406
5024;Huizen;2010;42217;10081;25723;6413;34287;4168;1574;2594;3762;2040;1722;378;182;196;229;104;125;680;377;303;1218;615;603;1257;762;495;388.0;329.0;223.0;201.0;1758.0;1966.0;406
5025;Huizen;2011;42095;9864;25681;6550;34140;4185;1607;2578;3770;2044;1726;398;192;206;224;105;119;687;387;300;1194;597;597;1267;763;504;380.0;340.0;235.0;207.0;1797.0;1975.0;406
5026;Huizen;2012;41990;9670;25398;6922;34038;4172;1627;2545;3780;2033;1747;423;206;217;225;112;113;691;382;309;1193;589;604;1248;744;504;379.0;343.0;241.0;202.0;1869.0;1942.0;406
5027;Huizen;2013;41995;9497;25275;7223;33982;4189;1657;2532;3824;2040;1784;438;217;221;235;116;119;703;387;316;1165;571;594;1283;749;534;377.0;348.0;221.0;197.0;1873.0;1965.0;406
5028;Huizen;2014;41959;9353;25089;7517;33874;4204;1655;2549;3881;2084;1797;448;229;219;238;120;118;736;396;340;1148;564;584;1311;775;536;383.0;358.0;239.0;192.0;1838.0;1944.0;406
5029;Huizen;2015;41938;9180;25006;7752;33778;4230;1692;2538;3930;2092;1838;489;245;244;242;123;119;754;400;354;1137;558;579;1308;766;542;390.0;352.0;227.0;187.0;1778.0;1928.0;406
5030;Huizen;2016;41871;9078;24733;8060;33664;4240;1698;2542;3967;2102;1865;515;249;266;249;132;117;744;405;339;1127;552;575;1332;764;568;390.0;365.0;246.0;191.0;1774.0;1915.0;406
5031;Huizen;2017;41813;8958;24541;8314;33564;4241;1731;2510;4008;2104;1904;536;262;274;245;123;122;760;406;354;1116;550;566;1351;763;588;394.0;378.0;227.0;179.0;1931.0;1897.0;406
5032;Huizen;2018;41912;8943;24414;8555;33538;4287;1764;2523;4087;2144;1943;558;270;288;254;125;129;776;421;355;1099;546;553;1400;782;618;404.0;372.0;223.0;182.0;1792.0;1947.0;406
5033;Huizen;2019;41836;8885;24129;8822;33415;4293;1784;2509;4128;2163;1965;564;273;291;254;127;127;787;429;358;1090;537;553;1433;797;636;402.0;380.0;226.0;186.0;1850.0;1922.0;406
5034;Huizen;2020;41830;8814;23998;9018;33313;4312;1799;2513;4205;2173;2032;580;282;298;269;131;138;814;421;393;1110;538;572;1432;801;631;420.0;386.0;230.0;180.0;1837.0;1905.0;406
5035;Huizen;2021;41852;8770;23882;9200;33310;4314;1803;2511;4228;2204;2024;602;295;307;270;135;135;814;425;389;1095;530;565;1447;819;628;412.0;391.0;223.0;177.0;1816.0;1912.0;406
5036;Huizen;2022;41829;8680;23752;9397;33201;4356;1823;2533;4272;2215;2057;618;304;314;285;144;141;818;419;399;1113;531;582;1438;817;621;425.0;397.0;201.0;177.0;1945.0;1884.0;406
5037;Huizen;2023;41945;8662;23669;9614;33238;4397;1862;2535;4310;2232;2078;635;317;318;291;151;140;836;425;411;1100;515;585;1448;824;624;422.0;410.0;220.0;177.0;1833.0;1926.0;406
5038;Huizen;2024;41911;8597;23493;9821;33150;4377;1854;2523;4384;2256;2128;637;324;313;291;150;141;844;426;418;1109;509;600;1503;847;656;424.0;415.0;211.0;169.0;1768.0;1924.0;406
5039;Huizen;2025;41812;8524;23254;10034;32998;4408;1871;2537;4406;2230;2176;636;314;322;293;151;142;863;425;438;1092;481;611;1522;859;663;;;;;;;406
5040;Hulst;2008;28070;6185;16815;5070;21586;5798;2872;2926;686;397;289;71;32;39;51;25;26;96;40;56;84;44;40;384;256;128;262.0;284.0;285.0;255.0;814.0;677.0;677
5041;Hulst;2009;28219;6206;16799;5214;21664;5814;2906;2908;741;412;329;85;40;45;55;29;26;111;46;65;106;49;57;384;248;136;265.0;281.0;302.0;265.0;805.0;728.0;677
5042;Hulst;2010;28322;6209;16757;5356;21719;5813;2928;2885;790;425;365;100;50;50;61;32;29;121;53;68;124;53;71;384;237;147;261.0;291.0;306.0;251.0;780.0;707.0;677
5043;Hulst;2011;28422;6173;16755;5494;21761;5835;2957;2878;826;440;386;102;50;52;62;32;30;132;62;70;141;59;82;389;237;152;266.0;286.0;312.0;259.0;780.0;712.0;677
5044;Hulst;2012;28525;6135;16727;5663;21794;5855;2984;2871;876;470;406;109;51;58;75;44;31;148;69;79;143;63;80;401;243;158;270.0;298.0;320.0;245.0;804.0;714.0;677
5045;Hulst;2013;28665;6107;16696;5862;21828;5902;3030;2872;935;501;434;121;59;62;85;49;36;157;82;75;153;62;91;419;249;170;272.0;298.0;309.0;248.0;772.0;726.0;677
5046;Hulst;2014;28748;6081;16622;6045;21876;5915;3061;2854;957;504;453;131;60;71;84;48;36;157;77;80;166;69;97;419;250;169;270.0;296.0;313.0;241.0;755.0;755.0;677
5047;Hulst;2015;28799;6028;16576;6195;21866;5934;3077;2857;999;538;461;139;65;74;94;57;37;163;81;82;175;78;97;428;257;171;270.0;302.0;300.0;242.0;807.0;764.0;677
5048;Hulst;2016;28870;5995;16565;6310;21860;5932;3105;2827;1078;575;503;145;69;76;101;61;40;189;90;99;194;90;104;449;265;184;277.0;312.0;306.0;243.0;872.0;788.0;677
5049;Hulst;2017;28984;5964;16547;6473;21915;5944;3127;2817;1125;606;519;157;76;81;101;62;39;195;90;105;206;91;115;466;287;179;275.0;312.0;317.0;247.0;844.0;798.0;677
5050;Hulst;2018;29070;5915;16545;6610;21927;5970;3145;2825;1173;612;561;159;75;84;110;67;43;212;100;112;228;88;140;464;282;182;284.0;316.0;298.0;235.0;841.0;799.0;677
5051;Hulst;2019;29145;5837;16572;6736;21951;5971;3152;2819;1223;632;591;167;81;86;120;71;49;205;91;114;249;92;157;482;297;185;295.0;319.0;300.0;244.0;822.0;766.0;677
5052;Hulst;2020;29232;5849;16502;6881;22022;5951;3159;2792;1259;648;611;173;89;84;131;72;59;218;98;120;255;99;156;482;290;192;298.0;327.0;303.0;246.0;806.0;803.0;677
5053;Hulst;2021;29272;5843;16422;7007;21999;5970;3174;2796;1303;659;644;181;91;90;139;72;67;241;109;132;262;102;160;480;285;195;295.0;336.0;297.0;236.0;866.0;803.0;677
5054;Hulst;2022;29353;5846;16346;7161;21995;5986;3188;2798;1372;699;673;186;96;90;144;82;62;253;115;138;286;111;175;503;295;208;300.0;340.0;285.0;231.0;863.0;799.0;677
5055;Hulst;2023;29433;5882;16247;7304;22013;6009;3198;2811;1411;710;701;202;102;100;153;86;67;260;116;144;297;107;190;499;299;200;304.0;343.0;281.0;237.0;861.0;797.0;677
5056;Hulst;2024;29505;5863;16235;7407;22010;6017;3192;2825;1478;737;741;210;107;103;155;86;69;270;119;151;315;111;204;528;314;214;310.0;351.0;290.0;227.0;871.0;795.0;677
5057;Hulst;2025;29604;5887;16153;7564;22044;6025;3207;2818;1535;764;771;217;111;106;163;92;71;272;118;154;328;115;213;555;328;227;;;;;;;677
5058;IJsselstein;2008;33851;9498;20821;3532;27486;2349;827;1522;4016;2197;1819;1083;585;498;250;136;114;416;234;182;1287;617;670;980;625;355;451.0;197.0;148.0;170.0;1576.0;1817.0;353
5059;IJsselstein;2009;33852;9460;20711;3681;27467;2346;821;1525;4039;2206;1833;1084;579;505;257;145;112;429;246;183;1278;606;672;991;630;361;427.0;207.0;130.0;168.0;1579.0;1844.0;353
5060;IJsselstein;2010;33772;9331;20603;3838;27371;2370;841;1529;4031;2189;1842;1066;568;498;250;143;107;450;254;196;1273;599;674;992;625;367;411.0;217.0;142.0;176.0;1578.0;1814.0;353
5061;IJsselstein;2011;33699;9178;20578;3943;27244;2350;846;1504;4105;2216;1889;1060;560;500;262;152;110;462;255;207;1274;596;678;1047;653;394;402.0;213.0;146.0;170.0;1621.0;1838.0;353
5062;IJsselstein;2012;33649;9030;20467;4152;27133;2358;846;1512;4158;2247;1911;1034;550;484;274;164;110;495;260;235;1281;589;692;1074;684;390;385.0;222.0;154.0;169.0;1639.0;1830.0;353
5063;IJsselstein;2013;33610;8885;20353;4372;27071;2372;851;1521;4167;2240;1927;1032;549;483;275;164;111;529;275;254;1263;573;690;1068;679;389;374.0;227.0;153.0;160.0;1591.0;1819.0;353
5064;IJsselstein;2014;33530;8723;20203;4604;26956;2400;889;1511;4174;2230;1944;1009;536;473;273;163;110;555;292;263;1248;561;687;1089;678;411;363.0;236.0;150.0;153.0;1635.0;1766.0;353
5065;IJsselstein;2015;33525;8598;20126;4801;26894;2414;898;1516;4217;2241;1976;1000;530;470;281;171;110;586;297;289;1233;554;679;1117;689;428;353.0;235.0;144.0;159.0;1603.0;1810.0;353
5066;IJsselstein;2016;33426;8474;19966;4986;26726;2432;917;1515;4268;2270;1998;986;529;457;289;179;110;625;312;313;1237;549;688;1131;701;430;342.0;239.0;148.0;157.0;1642.0;1755.0;353
5067;IJsselstein;2017;33412;8308;19969;5135;26661;2466;949;1517;4285;2271;2014;977;524;453;300;188;112;631;308;323;1230;547;683;1147;704;443;351.0;256.0;149.0;149.0;1668.0;1784.0;353
5068;IJsselstein;2018;33395;8215;19884;5296;26556;2489;945;1544;4350;2305;2045;963;514;449;293;183;110;671;320;351;1225;541;684;1198;747;451;348.0;253.0;136.0;152.0;1660.0;1765.0;353
5069;IJsselstein;2019;33373;8105;19811;5457;26461;2539;971;1568;4373;2293;2080;931;490;441;312;186;126;696;337;359;1236;527;709;1198;753;445;343.0;264.0;143.0;152.0;1731.0;1772.0;353
5070;IJsselstein;2020;33408;7963;19908;5537;26409;2551;979;1572;4448;2333;2115;942;493;449;316;194;122;723;347;376;1229;537;692;1238;762;476;338.0;273.0;133.0;152.0;1733.0;1801.0;353
5071;IJsselstein;2021;33391;7791;19920;5680;26288;2592;1008;1584;4511;2364;2147;939;492;447;320;196;124;742;353;389;1196;523;673;1314;800;514;343.0;272.0;136.0;147.0;1785.0;1816.0;353
5072;IJsselstein;2022;33425;7649;19938;5838;26239;2628;1026;1602;4558;2356;2202;945;484;461;322;193;129;750;352;398;1183;516;667;1358;811;547;341.0;282.0;132.0;151.0;1697.0;1818.0;353
5073;IJsselstein;2023;33347;7482;19827;6038;26118;2637;1018;1619;4592;2366;2226;948;488;460;332;196;136;757;348;409;1171;512;659;1384;822;562;340.0;286.0;144.0;150.0;1712.0;1804.0;353
5074;IJsselstein;2024;33307;7399;19682;6226;26030;2654;1029;1625;4623;2364;2259;919;477;442;342;200;142;772;356;416;1166;490;676;1424;841;583;337.0;292.0;134.0;140.0;1806.0;1828.0;353
5075;IJsselstein;2025;33328;7297;19641;6390;25972;2697;1049;1648;4659;2372;2287;914;470;444;333;194;139;792;363;429;1167;493;674;1453;852;601;;;;;;;353
5076;Jacobswoude;2008;10722;2638;6542;1542;9839;572;209;363;311;170;141;39;15;24;21;8;13;15;9;6;22;8;14;214;130;84;111.0;77.0;24.0;38.0;409.0;452.0;645
5077;Jacobswoude;2009;10700;2579;6516;1605;9747;618;225;393;335;176;159;50;19;31;22;9;13;21;9;12;23;7;16;219;132;87;111.0;76.0;27.0;37.0;453.0;441.0;645
5078;Jacobswoude;2010;10738;2542;6503;1693;9714;649;231;418;375;192;183;55;23;32;29;13;16;26;11;15;29;7;22;236;138;98;111.0;78.0;34.0;38.0;443.0;452.0;645
5079;Jacobswoude;2011;10759;2519;6481;1759;9697;653;225;428;409;196;213;62;26;36;31;13;18;38;14;24;35;10;25;243;133;110;112.0;82.0;33.0;35.0;398.0;444.0;645
5080;Jacobswoude;2012;10744;2465;6423;1856;9622;658;239;419;464;217;247;70;29;41;38;16;22;50;19;31;45;13;32;261;140;121;105.0;82.0;33.0;38.0;367.0;450.0;645
5081;Jacobswoude;2013;10680;2433;6286;1961;9557;663;241;422;460;213;247;71;30;41;42;18;24;47;17;30;49;14;35;251;134;117;107.0;85.0;31.0;41.0;378.0;431.0;645
5082;Jacobswoude;2014;10640;2385;6205;2050;9509;662;234;428;469;209;260;74;30;44;42;17;25;54;19;35;51;15;36;248;128;120;105.0;87.0;29.0;38.0;350.0;418.0;645
5083;Jacobswoude;2015;10584;2359;6131;2094;9440;661;234;427;483;207;276;80;31;49;42;18;24;61;22;39;61;17;44;239;119;120;102.0;89.0;31.0;34.0;375.0;433.0;645
5084;Jacobswoude;2016;10537;2317;6065;2155;9391;655;240;415;491;214;277;79;30;49;44;19;25;67;24;43;60;18;42;241;123;118;101.0;94.0;33.0;37.0;418.0;428.0;645
5085;Jacobswoude;2017;10530;2292;6028;2210;9330;678;248;430;522;236;286;88;35;53;47;21;26;74;28;46;64;19;45;249;133;116;103.0;97.0;31.0;34.0;354.0;420.0;645
5086;Jacobswoude;2018;10468;2267;5961;2240;9253;669;241;428;546;240;306;91;36;55;53;26;27;78;27;51;70;18;52;254;133;121;97.0;100.0;30.0;34.0;351.0;420.0;645
5087;Jacobswoude;2019;10393;2185;5917;2291;9152;685;256;429;556;251;305;94;35;59;50;26;24;78;28;50;71;21;50;263;141;122;99.0;98.0;32.0;35.0;450.0;420.0;645
5088;Jacobswoude;2020;10421;2187;5886;2348;9123;704;260;444;594;266;328;104;39;65;52;28;24;81;26;55;82;24;58;275;149;126;97.0;101.0;27.0;33.0;413.0;428.0;645
5089;Jacobswoude;2021;10395;2154;5847;2394;9078;723;269;454;594;274;320;106;38;68;54;32;22;77;27;50;79;23;56;278;154;124;99.0;105.0;31.0;37.0;337.0;409.0;645
5090;Jacobswoude;2022;10311;2101;5783;2427;8966;729;272;457;616;281;335;110;40;70;55;31;24;84;30;54;84;25;59;283;155;128;93.0;104.0;25.0;34.0;418.0;397.0;645
5091;Jacobswoude;2023;10313;2097;5752;2464;8938;731;267;464;644;296;348;117;43;74;59;34;25;86;30;56;97;30;67;285;159;126;98.0;104.0;23.0;33.0;349.0;408.0;645
5092;Jacobswoude;2024;10238;2062;5674;2502;8840;753;279;474;645;301;344;121;50;71;60;35;25;88;30;58;93;31;62;283;155;128;95.0;109.0;29.0;33.0;408.0;416.0;645
5093;Jacobswoude;2025;10213;2048;5633;2532;8777;770;291;479;666;307;359;119;51;68;58;32;26;91;33;58;105;34;71;293;157;136;;;;;;;645
5094;Kampen;2008;49828;13947;29196;6685;45717;1842;714;1128;2269;1287;982;123;61;62;118;63;55;997;496;501;79;34;45;952;633;319;720.0;369.0;127.0;192.0;1195.0;1472.0;166
5095;Kampen;2009;49846;13908;29133;6805;45615;1855;712;1143;2376;1324;1052;146;71;75;129;71;58;1006;496;510;101;41;60;994;645;349;709.0;379.0;135.0;182.0;1174.0;1440.0;166
5096;Kampen;2010;49868;13833;29063;6972;45526;1884;702;1182;2458;1368;1090;161;82;79;135;75;60;993;485;508;124;49;75;1045;677;368;699.0;385.0;131.0;178.0;1301.0;1418.0;166
5097;Kampen;2011;50026;13797;29143;7086;45581;1884;698;1186;2561;1406;1155;176;89;87;147;79;68;1020;497;523;141;51;90;1077;690;387;695.0;395.0;145.0;185.0;1265.0;1424.0;166
5098;Kampen;2012;50130;13743;29029;7358;45583;1894;685;1209;2653;1444;1209;193;97;96;151;79;72;1027;490;537;141;55;86;1141;723;418;675.0;406.0;153.0;188.0;1450.0;1458.0;166
5099;Kampen;2013;50360;13766;29021;7573;45701;1918;695;1223;2741;1465;1276;223;109;114;152;83;69;1012;472;540;163;61;102;1191;740;451;678.0;398.0;192.0;191.0;1284.0;1462.0;166
5100;Kampen;2014;50473;13758;28945;7770;45700;1936;709;1227;2837;1520;1317;244;125;119;178;96;82;986;464;522;189;72;117;1240;763;477;660.0;407.0;155.0;180.0;1330.0;1445.0;166
5101;Kampen;2015;50587;13752;28874;7961;45715;1946;704;1242;2926;1563;1363;264;140;124;184;99;85;976;463;513;215;86;129;1287;775;512;663.0;413.0;159.0;181.0;1418.0;1435.0;166
5102;Kampen;2016;50804;13772;28901;8131;45802;1973;708;1265;3029;1605;1424;274;139;135;195;105;90;967;464;503;241;91;150;1352;806;546;653.0;414.0;170.0;181.0;1348.0;1437.0;166
5103;Kampen;2017;50949;13793;28827;8329;45822;1997;705;1292;3130;1653;1477;291;147;144;211;114;97;973;468;505;253;96;157;1402;828;574;643.0;423.0;158.0;178.0;1317.0;1445.0;166
5104;Kampen;2018;51028;13703;28779;8546;45740;2006;707;1299;3282;1727;1555;323;162;161;218;117;101;998;473;525;276;106;170;1467;869;598;646.0;435.0;169.0;173.0;1453.0;1418.0;166
5105;Kampen;2019;51282;13691;28880;8711;45816;2051;724;1327;3415;1778;1637;333;165;168;241;122;119;995;472;523;291;112;179;1555;907;648;641.0;434.0;161.0;187.0;1480.0;1471.0;166
5106;Kampen;2020;51477;13584;28973;8920;45898;2069;750;1319;3510;1824;1686;356;178;178;251;124;127;994;473;521;303;122;181;1606;927;679;649.0;445.0;167.0;182.0;1438.0;1463.0;166
5107;Kampen;2021;51645;13475;29043;9127;45903;2122;756;1366;3620;1881;1739;389;199;190;271;138;133;998;474;524;320;128;192;1642;942;700;651.0;452.0;169.0;172.0;1421.0;1484.0;166
5108;Kampen;2022;51783;13399;29045;9339;45895;2145;772;1373;3743;1948;1795;414;215;199;300;150;150;1006;488;518;346;137;209;1677;958;719;648.0;454.0;160.0;188.0;1396.0;1501.0;166
5109;Kampen;2023;51849;13285;28990;9574;45851;2156;764;1392;3842;1995;1847;439;236;203;319;157;162;1015;485;530;356;135;221;1713;982;731;651.0;461.0;185.0;180.0;1314.0;1478.0;166
5110;Kampen;2024;51894;13190;28885;9819;45764;2187;778;1409;3943;2065;1878;463;260;203;324;156;168;1016;492;524;382;143;239;1758;1014;744;643.0;474.0;158.0;177.0;1403.0;1469.0;166
5111;Kampen;2025;51983;13150;28816;10017;45748;2207;783;1424;4028;2108;1920;482;276;206;324;157;167;1015;493;522;405;152;253;1802;1030;772;;;;;;;166
5112;Kapelle;2008;12014;3242;7012;1760;11094;616;234;382;304;161;143;49;28;21;34;10;24;39;19;20;24;12;12;158;92;66;141.0;100.0;34.0;43.0;673.0;548.0;678
5113;Kapelle;2009;12173;3290;7073;1810;11185;642;236;406;346;189;157;60;31;29;35;11;24;39;20;19;31;18;13;181;109;72;142.0;102.0;42.0;43.0;617.0;574.0;678
5114;Kapelle;2010;12257;3288;7109;1860;11187;669;242;427;401;211;190;68;35;33;38;14;24;52;26;26;41;20;21;202;116;86;143.0;103.0;44.0;45.0;631.0;591.0;678
5115;Kapelle;2011;12337;3243;7179;1915;11200;697;258;439;440;217;223;76;37;39;36;14;22;63;28;35;53;23;30;212;115;97;145.0;104.0;44.0;41.0;683.0;598.0;678
5116;Kapelle;2012;12467;3231;7225;2011;11277;715;264;451;475;235;240;81;38;43;46;20;26;73;30;43;57;25;32;218;122;96;151.0;100.0;41.0;44.0;622.0;622.0;678
5117;Kapelle;2013;12515;3177;7246;2092;11245;744;277;467;526;264;262;89;40;49;47;22;25;82;32;50;63;28;35;245;142;103;155.0;108.0;47.0;46.0;665.0;601.0;678
5118;Kapelle;2014;12628;3184;7270;2174;11289;755;272;483;584;287;297;104;48;56;57;24;33;88;30;58;74;30;44;261;155;106;149.0;110.0;48.0;43.0;726.0;625.0;678
5119;Kapelle;2015;12774;3206;7318;2250;11381;790;293;497;603;285;318;104;49;55;53;24;29;90;34;56;80;31;49;276;147;129;159.0;111.0;51.0;40.0;686.0;631.0;678
5120;Kapelle;2016;12891;3217;7342;2332;11444;825;312;513;622;290;332;110;48;62;55;28;27;95;34;61;87;31;56;275;149;126;156.0;115.0;49.0;45.0;668.0;646.0;678
5121;Kapelle;2017;12962;3213;7352;2397;11482;837;307;530;643;308;335;109;48;61;55;28;27;99;37;62;96;37;59;284;158;126;161.0;113.0;45.0;47.0;677.0;634.0;678
5122;Kapelle;2018;13052;3230;7359;2463;11495;855;307;548;702;326;376;121;49;72;63;32;31;110;42;68;94;37;57;314;166;148;162.0;117.0;48.0;48.0;732.0;656.0;678
5123;Kapelle;2019;13174;3253;7353;2568;11532;901;333;568;741;334;407;124;54;70;64;33;31;116;44;72;101;36;65;336;167;169;162.0;116.0;59.0;50.0;605.0;638.0;678
5124;Kapelle;2020;13197;3245;7307;2645;11514;909;330;579;774;344;430;126;58;68;70;34;36;123;47;76;109;37;72;346;168;178;163.0;119.0;58.0;48.0;675.0;629.0;678
5125;Kapelle;2021;13297;3256;7321;2720;11561;913;330;583;823;368;455;132;63;69;80;37;43;129;51;78;115;39;76;367;178;189;164.0;124.0;48.0;44.0;661.0;646.0;678
5126;Kapelle;2022;13358;3254;7291;2813;11605;923;338;585;830;379;451;128;64;64;83;42;41;136;54;82;115;39;76;368;180;188;165.0;125.0;49.0;48.0;639.0;646.0;678
5127;Kapelle;2023;13393;3260;7250;2883;11603;927;345;582;863;383;480;125;63;62;85;42;43;152;55;97;123;40;83;378;183;195;163.0;127.0;51.0;44.0;644.0;646.0;678
5128;Kapelle;2024;13434;3248;7255;2931;11610;946;360;586;878;380;498;129;61;68;88;38;50;155;56;99;125;40;85;381;185;196;162.0;131.0;54.0;43.0;679.0;637.0;678
5129;Kapelle;2025;13520;3254;7260;3006;11662;958;371;587;900;393;507;129;63;66;84;38;46;159;59;100;128;40;88;400;193;207;;;;;;;678
5130;Katwijk;2008;60097;16686;35328;8083;54733;2796;1223;1573;2568;1536;1032;203;106;97;126;64;62;392;187;205;414;207;207;1433;972;461;791.0;459.0;214.0;137.0;678.0;1532.0;537
5131;Katwijk;2009;59661;16461;34958;8242;54111;2813;1219;1594;2737;1638;1099;225;125;100;143;73;70;417;194;223;429;210;219;1523;1036;487;767.0;472.0;221.0;142.0;871.0;1547.0;537
5132;Katwijk;2010;59366;16226;34634;8506;53620;2865;1271;1594;2881;1719;1162;240;135;105;151;79;72;443;203;240;448;218;230;1599;1084;515;758.0;475.0;243.0;133.0;1215.0;1526.0;537
5133;Katwijk;2011;59456;16159;34625;8672;53402;2985;1331;1654;3069;1820;1249;259;141;118;161;92;69;468;210;258;488;227;261;1693;1150;543;737.0;483.0;243.0;135.0;1197.0;1520.0;537
5134;Katwijk;2012;59501;15998;34392;9111;53158;3084;1369;1715;3259;1926;1333;282;149;133;180;107;73;497;226;271;524;233;291;1776;1211;565;735.0;476.0;253.0;144.0;1232.0;1481.0;537
5135;Katwijk;2013;59623;15871;34257;9495;52998;3158;1414;1744;3467;2031;1436;307;165;142;217;123;94;522;243;279;551;240;311;1870;1260;610;723.0;493.0;278.0;139.0;1449.0;1520.0;537
5136;Katwijk;2014;59931;15873;34233;9825;53016;3253;1482;1771;3662;2141;1521;331;178;153;229;130;99;556;259;297;583;256;327;1963;1318;645;730.0;509.0;266.0;140.0;1407.0;1493.0;537
5137;Katwijk;2015;60199;15822;34242;10135;52974;3363;1538;1825;3862;2276;1586;349;189;160;245;139;106;573;267;306;608;264;344;2087;1417;670;727.0;517.0;280.0;145.0;1419.0;1561.0;537
5138;Katwijk;2016;60405;15775;34225;10405;52888;3512;1629;1883;4005;2354;1651;367;194;173;249;146;103;572;262;310;641;271;370;2176;1481;695;733.0;529.0;289.0;152.0;1624.0;1533.0;537
5139;Katwijk;2017;60844;15793;34386;10665;52995;3608;1688;1920;4241;2496;1745;389;208;181;274;166;108;602;274;328;657;276;381;2319;1572;747;737.0;532.0;287.0;147.0;1490.0;1551.0;537
5140;Katwijk;2018;61137;15841;34346;10950;52994;3728;1764;1964;4415;2612;1803;400;219;181;290;172;118;624;281;343;660;281;379;2441;1659;782;749.0;553.0;301.0;149.0;1565.0;1569.0;537
5141;Katwijk;2019;61488;15833;34471;11184;53122;3819;1819;2000;4547;2702;1845;416;225;191;306;179;127;630;288;342;673;286;387;2522;1724;798;747.0;561.0;305.0;150.0;1540.0;1568.0;537
5142;Katwijk;2020;61806;15779;34522;11505;53128;3943;1903;2040;4735;2803;1932;443;230;213;339;205;134;655;296;359;681;293;388;2617;1779;838;748.0;576.0;305.0;151.0;1506.0;1579.0;537
5143;Katwijk;2021;62067;15729;34617;11721;53092;4092;2002;2090;4883;2892;1991;462;239;223;360;215;145;676;317;359;712;298;414;2673;1823;850;755.0;582.0;328.0;156.0;1559.0;1598.0;537
5144;Katwijk;2022;62388;15715;34698;11975;53062;4217;2080;2137;5109;2996;2113;483;250;233;387;225;162;699;321;378;740;306;434;2800;1894;906;766.0;599.0;337.0;159.0;1688.0;1599.0;537
5145;Katwijk;2023;62828;15749;34846;12233;53177;4367;2185;2182;5284;3096;2188;502;259;243;406;239;167;739;347;392;764;313;451;2873;1938;935;770.0;608.0;335.0;169.0;1468.0;1615.0;537
5146;Katwijk;2024;63012;15716;34754;12542;53067;4504;2252;2252;5441;3192;2249;530;274;256;443;259;184;750;360;390;775;320;455;2943;1979;964;764.0;623.0;311.0;160.0;1490.0;1627.0;537
5147;Katwijk;2025;63176;15695;34688;12793;52957;4577;2301;2276;5642;3312;2330;540;277;263;472;276;196;781;366;415;780;330;450;3069;2063;1006;;;;;;;537
5148;Kerkrade;2008;48827;9240;30403;9184;33164;13606;6166;7440;2057;1292;765;102;64;38;236;161;75;299;168;131;475;220;255;945;679;266;392.0;607.0;450.0;532.0;1941.0;1951.0;928
5149;Kerkrade;2009;48525;9102;30219;9204;33114;13258;6020;7238;2153;1318;835;118;73;45;244;163;81;326;169;157;496;221;275;969;692;277;401.0;604.0;426.0;522.0;1956.0;1951.0;928
5150;Kerkrade;2010;48234;8974;30058;9202;33155;12859;5839;7020;2220;1339;881;149;90;59;253;169;84;340;173;167;508;229;279;970;678;292;404.0;605.0;449.0;508.0;1961.0;2006.0;928
5151;Kerkrade;2011;47935;8889;29761;9285;33100;12548;5703;6845;2287;1359;928;177;111;66;250;169;81;364;179;185;498;220;278;998;680;318;406.0;610.0;437.0;481.0;2022.0;1976.0;928
5152;Kerkrade;2012;47738;8787;29537;9414;33074;12257;5571;6686;2407;1412;995;194;117;77;254;170;84;399;194;205;511;222;289;1049;709;340;402.0;608.0;441.0;482.0;1970.0;1937.0;928
5153;Kerkrade;2013;47529;8754;29199;9576;33049;11985;5463;6522;2495;1454;1041;218;130;88;260;169;91;411;197;214;544;232;312;1062;726;336;400.0;614.0;419.0;461.0;1876.0;1923.0;928
5154;Kerkrade;2014;47229;8643;28842;9744;33015;11659;5310;6349;2555;1467;1088;239;146;93;270;175;95;434;197;237;553;231;322;1059;718;341;412.0;606.0;404.0;458.0;1934.0;1904.0;928
5155;Kerkrade;2015;47016;8604;28490;9922;33038;11343;5163;6180;2635;1503;1132;261;158;103;268;174;94;469;208;261;564;233;331;1073;730;343;408.0;615.0;395.0;442.0;1887.0;1899.0;928
5156;Kerkrade;2016;46752;8603;28118;10031;32961;11084;5035;6049;2707;1534;1173;278;166;112;265;169;96;493;225;268;576;235;341;1095;739;356;412.0;621.0;379.0;438.0;1883.0;1887.0;928
5157;Kerkrade;2017;46487;8631;27722;10134;32916;10802;4907;5895;2769;1546;1223;288;171;117;286;174;112;512;236;276;579;230;349;1104;735;369;413.0;604.0;359.0;422.0;1909.0;1861.0;928
5158;Kerkrade;2018;46285;8633;27351;10301;32928;10531;4779;5752;2826;1573;1253;305;180;125;295;183;112;544;246;298;572;220;352;1110;744;366;406.0;608.0;345.0;410.0;1850.0;1822.0;928
5159;Kerkrade;2019;46050;8626;26941;10483;32857;10301;4673;5628;2892;1600;1292;314;185;129;303;185;118;569;262;307;588;228;360;1118;740;378;413.0;607.0;346.0;404.0;1839.0;1822.0;928
5160;Kerkrade;2020;45819;8623;26623;10573;32824;10021;4555;5466;2974;1650;1324;328;193;135;310;190;120;608;266;342;578;223;355;1150;778;372;415.0;612.0;339.0;379.0;1823.0;1817.0;928
5161;Kerkrade;2021;45594;8578;26332;10684;32746;9804;4457;5347;3044;1691;1353;341;202;139;306;185;121;628;276;352;571;216;355;1198;812;386;406.0;622.0;317.0;390.0;1773.0;1802.0;928
5162;Kerkrade;2022;45278;8539;25945;10794;32612;9597;4349;5248;3069;1691;1378;356;213;143;316;192;124;638;278;360;562;210;352;1197;798;399;413.0;621.0;306.0;370.0;1721.0;1774.0;928
5163;Kerkrade;2023;44960;8503;25588;10869;32477;9368;4245;5123;3115;1703;1412;367;221;146;315;186;129;640;285;355;574;205;369;1219;806;413;410.0;614.0;305.0;354.0;1741.0;1771.0;928
5164;Kerkrade;2024;44685;8497;25253;10935;32374;9166;4162;5004;3145;1708;1437;380;217;163;312;183;129;650;291;359;579;212;367;1224;805;419;416.0;618.0;292.0;343.0;1726.0;1754.0;928
5165;Kerkrade;2025;44410;8506;24859;11045;32213;8965;4059;4906;3232;1753;1479;403;239;164;333;203;130;682;312;370;596;211;385;1218;788;430;;;;;;;928
5166;Kessel;2008;4272;1035;2595;642;3894;307;107;200;71;49;22;8;4;4;4;3;1;5;1;4;4;1;3;50;40;10;52.0;34.0;12.0;17.0;96.0;138.0;929
5167;Kessel;2009;4243;1034;2550;659;3858;306;103;203;79;54;25;10;6;4;5;4;1;6;1;5;5;2;3;53;41;12;48.0;35.0;13.0;16.0;111.0;133.0;929
5168;Kessel;2010;4231;1030;2528;673;3844;306;106;200;81;56;25;10;6;4;6;4;2;8;3;5;6;2;4;51;41;10;49.0;39.0;12.0;15.0;147.0;146.0;929
5169;Kessel;2011;4239;1011;2545;683;3845;309;110;199;85;59;26;10;5;5;6;4;2;9;3;6;8;5;3;52;42;10;50.0;37.0;13.0;14.0;138.0;151.0;929
5170;Kessel;2012;4237;1006;2514;717;3849;301;107;194;87;60;27;11;5;6;6;4;2;6;3;3;10;5;5;54;43;11;49.0;37.0;11.0;14.0;136.0;155.0;929
5171;Kessel;2013;4227;1004;2489;734;3812;312;112;200;103;68;35;14;6;8;9;7;2;13;6;7;15;6;9;52;43;9;51.0;39.0;13.0;11.0;140.0;153.0;929
5172;Kessel;2014;4229;980;2499;750;3803;315;119;196;111;70;41;15;7;8;9;6;3;11;5;6;15;5;10;61;47;14;50.0;39.0;16.0;14.0;118.0;161.0;929
5173;Kessel;2015;4199;951;2481;767;3774;304;123;181;121;73;48;16;9;7;10;5;5;12;4;8;20;7;13;63;48;15;48.0;38.0;11.0;15.0;138.0;152.0;929
5174;Kessel;2016;4191;941;2463;787;3756;309;123;186;126;77;49;18;9;9;9;4;5;13;4;9;20;9;11;66;51;15;51.0;40.0;13.0;14.0;187.0;152.0;929
5175;Kessel;2017;4236;948;2481;807;3764;323;131;192;149;86;63;21;10;11;11;4;7;17;4;13;26;12;14;74;56;18;53.0;42.0;14.0;14.0;126.0;158.0;929
5176;Kessel;2018;4215;935;2458;822;3743;320;133;187;152;82;70;23;10;13;11;5;6;19;4;15;27;12;15;72;51;21;53.0;41.0;12.0;15.0;145.0;160.0;929
5177;Kessel;2019;4209;945;2429;835;3723;316;127;189;170;97;73;22;11;11;12;5;7;19;5;14;29;13;16;88;63;25;53.0;43.0;13.0;16.0;170.0;154.0;929
5178;Kessel;2020;4233;944;2428;861;3739;314;127;187;180;104;76;23;12;11;17;7;10;20;5;15;27;14;13;93;66;27;53.0;42.0;15.0;15.0;170.0;150.0;929
5179;Kessel;2021;4264;949;2428;887;3773;312;126;186;179;107;72;24;14;10;16;8;8;23;6;17;29;15;14;87;64;23;55.0;43.0;14.0;14.0;192.0;158.0;929
5180;Kessel;2022;4310;963;2453;894;3784;330;140;190;196;107;89;26;14;12;21;12;9;26;6;20;34;14;20;89;61;28;57.0;43.0;14.0;14.0;157.0;161.0;929
5181;Kessel;2023;4320;955;2447;918;3786;334;141;193;200;112;88;26;14;12;22;13;9;26;7;19;35;15;20;91;63;28;58.0;45.0;12.0;15.0;180.0;157.0;929
5182;Kessel;2024;4354;973;2421;960;3797;349;143;206;208;121;87;27;15;12;21;14;7;27;8;19;36;14;22;97;70;27;56.0;44.0;14.0;17.0;179.0;152.0;929
5183;Kessel;2025;4390;984;2412;994;3815;357;142;215;218;123;95;27;15;12;20;12;8;27;8;19;41;15;26;103;73;30;;;;;;;929
5184;Koggenland;2008;20963;5609;12698;2656;19692;827;275;552;444;240;204;81;40;41;33;19;14;45;24;21;38;19;19;247;138;109;212.0;153.0;49.0;82.0;732.0;688.0;1598
5185;Koggenland;2009;21037;5534;12718;2785;19701;828;272;556;508;276;232;97;45;52;35;20;15;58;35;23;51;25;26;267;151;116;209.0;155.0;55.0;77.0;689.0;692.0;1598
5186;Koggenland;2010;21067;5426;12719;2922;19669;826;271;555;572;306;266;109;52;57;37;19;18;67;37;30;52;28;24;307;170;137;211.0;160.0;56.0;85.0;674.0;729.0;1598
5187;Koggenland;2011;21037;5328;12730;2979;19592;832;272;560;613;324;289;124;58;66;38;22;16;76;44;32;61;31;30;314;169;145;208.0;163.0;57.0;73.0;816.0;728.0;1598
5188;Koggenland;2012;21158;5270;12725;3163;19648;837;278;559;673;352;321;136;64;72;51;28;23;81;44;37;73;36;37;332;180;152;207.0;162.0;55.0;80.0;829.0;734.0;1598
5189;Koggenland;2013;21277;5199;12735;3343;19680;863;291;572;734;377;357;144;72;72;59;34;25;91;43;48;87;38;49;353;190;163;206.0;159.0;58.0;80.0;800.0;728.0;1598
5190;Koggenland;2014;21377;5165;12697;3515;19706;875;285;590;796;411;385;154;75;79;63;37;26;107;49;58;97;41;56;375;209;166;205.0;168.0;61.0;80.0;816.0;749.0;1598
5191;Koggenland;2015;21465;5127;12672;3666;19725;905;294;611;835;427;408;159;81;78;72;38;34;115;50;65;110;47;63;379;211;168;210.0;172.0;66.0;82.0;874.0;733.0;1598
5192;Koggenland;2016;21629;5065;12723;3841;19803;933;314;619;893;452;441;171;87;84;80;42;38;129;55;74;114;48;66;399;220;179;207.0;178.0;76.0;79.0;862.0;748.0;1598
5193;Koggenland;2017;21772;5014;12771;3987;19874;966;324;642;932;452;480;171;80;91;85;46;39;142;55;87;120;47;73;414;224;190;215.0;183.0;62.0;77.0;902.0;786.0;1598
5194;Koggenland;2018;21908;4984;12837;4087;19949;972;323;649;987;465;522;190;85;105;84;42;42;156;59;97;130;50;80;427;229;198;218.0;186.0;58.0;82.0;813.0;804.0;1598
5195;Koggenland;2019;21928;4914;12774;4240;19915;967;310;657;1046;483;563;190;90;100;87;43;44;168;64;104;138;50;88;463;236;227;226.0;195.0;68.0;83.0;826.0;779.0;1598
5196;Koggenland;2020;21994;4831;12819;4344;19910;983;326;657;1101;509;592;189;89;100;95;48;47;183;71;112;148;53;95;486;248;238;224.0;206.0;61.0;79.0;835.0;781.0;1598
5197;Koggenland;2021;22051;4787;12827;4437;19921;972;326;646;1158;531;627;200;92;108;101;52;49;193;70;123;148;50;98;516;267;249;227.0;207.0;74.0;76.0;884.0;810.0;1598
5198;Koggenland;2022;22148;4715;12883;4550;19943;983;331;652;1222;550;672;205;87;118;103;59;44;204;72;132;161;56;105;549;276;273;234.0;210.0;78.0;81.0;888.0;806.0;1598
5199;Koggenland;2023;22255;4709;12883;4663;19937;1029;360;669;1289;580;709;214;87;127;117;71;46;217;79;138;155;57;98;586;286;300;228.0;217.0;72.0;86.0;865.0;798.0;1598
5200;Koggenland;2024;22323;4707;12830;4786;19970;1047;370;677;1306;592;714;214;92;122;119;68;51;213;80;133;156;56;100;604;296;308;233.0;219.0;73.0;86.0;829.0;797.0;1598
5201;Koggenland;2025;22360;4665;12778;4917;19978;1031;355;676;1351;611;740;217;93;124;123;66;57;224;85;139;161;57;104;626;310;316;;;;;;;1598
5202;Kollumerland en Nieuwkruisland;2008;13066;3366;7819;1881;12575;325;106;219;166;92;74;28;14;14;15;5;10;16;9;7;21;9;12;86;55;31;172.0;113.0;21.0;38.0;453.0;554.0;79
5203;Kollumerland en Nieuwkruisland;2009;13007;3314;7772;1921;12474;330;108;222;203;112;91;32;16;16;15;6;9;26;15;11;28;12;16;102;63;39;166.0;110.0;28.0;41.0;507.0;546.0;79
5204;Kollumerland en Nieuwkruisland;2010;13014;3290;7746;1978;12446;345;114;231;223;130;93;37;22;15;17;9;8;33;17;16;26;9;17;110;73;37;161.0;109.0;30.0;37.0;540.0;534.0;79
5205;Kollumerland en Nieuwkruisland;2011;13067;3270;7733;2064;12454;360;128;232;253;151;102;41;25;16;21;10;11;41;21;20;33;16;17;117;79;38;160.0;115.0;30.0;39.0;505.0;551.0;79
5206;Kollumerland en Nieuwkruisland;2012;13059;3232;7689;2138;12413;354;124;230;292;169;123;49;30;19;26;15;11;52;26;26;42;20;22;123;78;45;162.0;119.0;26.0;37.0;561.0;557.0;79
5207;Kollumerland en Nieuwkruisland;2013;13095;3221;7699;2175;12423;372;136;236;300;168;132;54;29;25;32;20;12;60;29;31;36;15;21;118;75;43;165.0;121.0;26.0;39.0;510.0;558.0;79
5208;Kollumerland en Nieuwkruisland;2014;13079;3206;7659;2214;12397;363;131;232;319;181;138;58;33;25;31;19;12;58;28;30;39;16;23;133;85;48;166.0;123.0;32.0;39.0;597.0;553.0;79
5209;Kollumerland en Nieuwkruisland;2015;13161;3185;7674;2302;12408;397;148;249;356;198;158;63;35;28;33;22;11;71;35;36;43;16;27;146;90;56;162.0;124.0;33.0;42.0;496.0;543.0;79
5210;Kollumerland en Nieuwkruisland;2016;13144;3157;7619;2368;12349;411;151;260;384;215;169;68;39;29;40;25;15;74;36;38;51;19;32;151;96;55;166.0;125.0;30.0;41.0;520.0;546.0;79
5211;Kollumerland en Nieuwkruisland;2017;13150;3147;7579;2424;12313;422;154;268;415;231;184;70;42;28;46;28;18;84;38;46;62;24;38;153;99;54;160.0;128.0;31.0;45.0;550.0;553.0;79
5212;Kollumerland en Nieuwkruisland;2018;13165;3162;7537;2466;12290;446;162;284;429;231;198;73;44;29;44;27;17;83;37;46;69;24;45;160;99;61;159.0;128.0;27.0;41.0;525.0;530.0;79
5213;Kollumerland en Nieuwkruisland;2019;13177;3152;7500;2525;12283;445;155;290;449;238;211;70;44;26;46;27;19;79;37;42;76;25;51;178;105;73;157.0;127.0;36.0;43.0;531.0;556.0;79
5214;Kollumerland en Nieuwkruisland;2020;13177;3143;7465;2569;12270;465;168;297;442;233;209;71;43;28;46;30;16;75;36;39;75;21;54;175;103;72;159.0;129.0;28.0;41.0;503.0;564.0;79
5215;Kollumerland en Nieuwkruisland;2021;13134;3101;7392;2641;12198;479;173;306;457;246;211;78;47;31;51;33;18;75;35;40;74;19;55;179;112;67;158.0;133.0;30.0;42.0;570.0;538.0;79
5216;Kollumerland en Nieuwkruisland;2022;13180;3110;7360;2710;12214;489;177;312;477;253;224;81;48;33;59;36;23;74;34;40;79;22;57;184;113;71;159.0;129.0;35.0;43.0;546.0;553.0;79
5217;Kollumerland en Nieuwkruisland;2023;13198;3087;7337;2774;12211;493;187;306;494;261;233;81;50;31;60;35;25;80;36;44;84;22;62;189;118;71;160.0;137.0;33.0;40.0;519.0;523.0;79
5218;Kollumerland en Nieuwkruisland;2024;13209;3075;7268;2866;12197;494;185;309;518;270;248;84;51;33;64;37;27;74;31;43;92;24;68;204;127;77;158.0;139.0;31.0;42.0;524.0;534.0;79
5219;Kollumerland en Nieuwkruisland;2025;13208;3063;7213;2932;12164;505;194;311;539;279;260;88;53;35;69;41;28;69;29;40;97;25;72;216;131;85;;;;;;;79
5220;Korendijk;2008;10597;2721;6356;1520;9894;444;167;277;259;136;123;43;18;25;38;12;26;21;11;10;20;10;10;137;85;52;121.0;88.0;20.0;33.0;349.0;462.0;588
5221;Korendijk;2009;10507;2648;6295;1564;9774;452;165;287;281;147;134;50;20;30;43;16;27;19;9;10;25;13;12;144;89;55;118.0;87.0;24.0;36.0;393.0;451.0;588
5222;Korendijk;2010;10469;2620;6215;1634;9693;463;166;297;313;165;148;56;23;33;47;19;28;22;11;11;28;13;15;160;99;61;115.0;90.0;24.0;36.0;434.0;454.0;588
5223;Korendijk;2011;10464;2566;6201;1697;9650;465;171;294;349;177;172;61;26;35;42;19;23;27;13;14;34;15;19;185;104;81;114.0;90.0;26.0;30.0;382.0;479.0;588
5224;Korendijk;2012;10388;2521;6085;1782;9532;476;169;307;380;191;189;64;25;39;45;20;25;36;17;19;36;14;22;199;115;84;108.0;91.0;29.0;35.0;429.0;457.0;588
5225;Korendijk;2013;10372;2453;6043;1876;9487;475;170;305;410;203;207;68;26;42;45;21;24;46;21;25;42;17;25;209;118;91;110.0;94.0;28.0;31.0;371.0;456.0;588
5226;Korendijk;2014;10302;2384;5984;1934;9387;489;186;303;426;214;212;71;26;45;41;20;21;46;20;26;41;17;24;227;131;96;110.0;96.0;29.0;31.0;411.0;472.0;588
5227;Korendijk;2015;10255;2366;5907;1982;9304;506;188;318;445;228;217;72;28;44;46;23;23;52;25;27;44;19;25;231;133;98;111.0;95.0;25.0;31.0;425.0;444.0;588
5228;Korendijk;2016;10247;2348;5849;2050;9276;510;194;316;461;220;241;75;26;49;53;26;27;58;27;31;55;22;33;220;119;101;111.0;98.0;28.0;31.0;401.0;473.0;588
5229;Korendijk;2017;10187;2306;5788;2093;9173;526;202;324;488;238;250;82;31;51;57;25;32;62;27;35;60;26;34;227;129;98;110.0;100.0;28.0;30.0;402.0;446.0;588
5230;Korendijk;2018;10152;2274;5772;2106;9098;534;205;329;520;247;273;88;33;55;64;25;39;64;28;36;58;25;33;246;136;110;109.0;101.0;28.0;30.0;446.0;470.0;588
5231;Korendijk;2019;10134;2239;5756;2139;9050;540;202;338;544;262;282;78;30;48;69;27;42;73;29;44;61;30;31;263;146;117;108.0;99.0;25.0;33.0;443.0;453.0;588
5232;Korendijk;2020;10126;2228;5720;2178;8986;565;207;358;575;271;304;86;31;55;72;32;40;78;27;51;60;30;30;279;151;128;110.0;104.0;30.0;31.0;399.0;441.0;588
5233;Korendijk;2021;10090;2183;5664;2243;8920;583;215;368;587;285;302;90;35;55;79;38;41;83;36;47;58;27;31;277;149;128;110.0;106.0;28.0;33.0;388.0;456.0;588
5234;Korendijk;2022;10023;2138;5610;2275;8832;585;212;373;606;293;313;86;33;53;72;37;35;89;38;51;72;27;45;287;158;129;113.0;108.0;25.0;32.0;389.0;450.0;588
5235;Korendijk;2023;9960;2117;5533;2310;8753;611;223;388;596;281;315;79;30;49;68;35;33;92;38;54;84;27;57;273;151;122;108.0;108.0;28.0;28.0;428.0;437.0;588
5236;Korendijk;2024;9953;2099;5494;2360;8724;628;217;411;601;291;310;79;32;47;69;38;31;96;39;57;81;28;53;276;154;122;109.0;113.0;27.0;31.0;400.0;443.0;588
5237;Korendijk;2025;9903;2078;5438;2387;8648;644;223;421;611;299;312;81;32;49;71;39;32;100;42;58;75;27;48;284;159;125;;;;;;;588
5238;Krimpen aan den IJssel;2008;28466;7051;16351;5064;24808;2156;839;1317;1502;894;608;289;144;145;151;90;61;193;105;88;178;92;86;691;463;228;276.0;232.0;82.0;112.0;1174.0;1158.0;542
5239;Krimpen aan den IJssel;2009;28499;6944;16366;5189;24770;2113;825;1288;1616;950;666;301;143;158;174;104;70;213;113;100;198;102;96;730;488;242;283.0;240.0;83.0;120.0;1219.0;1143.0;542
5240;Krimpen aan den IJssel;2010;28582;6849;16428;5305;24754;2097;807;1290;1731;1013;718;302;143;159;191;115;76;232;122;110;218;115;103;788;518;270;274.0;240.0;93.0;117.0;1258.0;1154.0;542
5241;Krimpen aan den IJssel;2011;28699;6760;16574;5365;24745;2100;834;1266;1854;1048;806;319;149;170;210;124;86;247;119;128;241;123;118;837;533;304;273.0;243.0;92.0;116.0;1222.0;1183.0;542
5242;Krimpen aan den IJssel;2012;28744;6659;16402;5683;24740;2080;833;1247;1924;1071;853;332;152;180;202;121;81;269;124;145;251;127;124;870;547;323;284.0;252.0;94.0;114.0;1217.0;1175.0;542
5243;Krimpen aan den IJssel;2013;28801;6568;16336;5897;24770;2050;825;1225;1981;1093;888;339;156;183;217;131;86;281;128;153;260;132;128;884;546;338;285.0;259.0;102.0;116.0;1208.0;1179.0;542
5244;Krimpen aan den IJssel;2014;28844;6504;16254;6086;24740;2059;825;1234;2045;1110;935;353;162;191;216;126;90;294;131;163;270;134;136;912;557;355;279.0;268.0;99.0;114.0;1193.0;1157.0;542
5245;Krimpen aan den IJssel;2015;28876;6424;16229;6223;24740;2039;813;1226;2097;1118;979;345;155;190;221;128;93;311;138;173;286;140;146;934;557;377;285.0;268.0;103.0;102.0;1186.0;1127.0;542
5246;Krimpen aan den IJssel;2016;28958;6377;16290;6291;24754;2042;816;1226;2162;1120;1042;363;163;200;214;126;88;322;138;184;306;146;160;957;547;410;287.0;276.0;87.0;109.0;1179.0;1164.0;542
5247;Krimpen aan den IJssel;2017;28963;6322;16254;6387;24701;2035;819;1216;2227;1145;1082;373;164;209;229;145;84;345;149;196;310;153;157;970;534;436;294.0;281.0;87.0;111.0;1225.0;1177.0;542
5248;Krimpen aan den IJssel;2018;29003;6260;16297;6446;24693;2041;818;1223;2269;1180;1089;386;174;212;225;144;81;354;150;204;324;165;159;980;547;433;288.0;278.0;94.0;109.0;1183.0;1194.0;542
5249;Krimpen aan den IJssel;2019;28993;6212;16224;6557;24626;2056;825;1231;2311;1192;1119;399;174;225;233;147;86;358;147;211;328;176;152;993;548;445;296.0;281.0;92.0;99.0;1219.0;1157.0;542
5250;Krimpen aan den IJssel;2020;29065;6143;16276;6646;24651;2066;839;1227;2348;1195;1153;393;170;223;246;154;92;384;150;234;345;184;161;980;537;443;299.0;294.0;85.0;105.0;1189.0;1159.0;542
5251;Krimpen aan den IJssel;2021;29081;6102;16209;6770;24631;2049;836;1213;2401;1218;1183;395;174;221;242;154;88;385;154;231;355;186;169;1024;550;474;291.0;290.0;86.0;98.0;1210.0;1165.0;542
5252;Krimpen aan den IJssel;2022;29117;6037;16228;6852;24584;2058;836;1222;2475;1244;1231;403;177;226;249;151;98;397;158;239;374;196;178;1052;562;490;293.0;297.0;87.0;99.0;1127.0;1179.0;542
5253;Krimpen aan den IJssel;2023;29051;5951;16188;6912;24469;2048;837;1211;2534;1267;1267;408;182;226;247;150;97;403;158;245;389;198;191;1087;579;508;296.0;301.0;94.0;100.0;1170.0;1167.0;542
5254;Krimpen aan den IJssel;2024;29046;5917;16137;6992;24397;2078;843;1235;2571;1294;1277;419;184;235;254;150;104;388;159;229;396;203;193;1114;598;516;291.0;303.0;82.0;101.0;1217.0;1195.0;542
5255;Krimpen aan den IJssel;2025;29040;5930;16049;7061;24368;2076;848;1228;2596;1293;1303;421;183;238;255;151;104;394;155;239;413;209;204;1113;595;518;;;;;;;542
5256;Laarbeek;2008;21404;5288;12929;3187;19913;1083;419;664;408;253;155;58;27;31;37;19;18;51;22;29;26;14;12;236;171;65;204.0;150.0;74.0;112.0;436.0;606.0;1659
5257;Laarbeek;2009;21250;5179;12793;3278;19752;1060;395;665;438;270;168;65;30;35;43;24;19;55;27;28;32;14;18;243;175;68;194.0;149.0;104.0;103.0;543.0;610.0;1659
5258;Laarbeek;2010;21239;5166;12678;3395;19678;1050;399;651;511;310;201;74;36;38;48;28;20;71;38;33;48;21;27;270;187;83;191.0;161.0;93.0;106.0;546.0;643.0;1659
5259;Laarbeek;2011;21161;5108;12522;3531;19550;1055;406;649;556;337;219;77;39;38;50;29;21;83;45;38;55;23;32;291;201;90;184.0;162.0;93.0;106.0;614.0;645.0;1659
5260;Laarbeek;2012;21140;5016;12420;3704;19480;1062;413;649;598;346;252;85;45;40;53;34;19;95;54;41;69;23;46;296;190;106;182.0;169.0;94.0;95.0;724.0;643.0;1659
5261;Laarbeek;2013;21237;4972;12402;3863;19495;1084;434;650;658;370;288;100;54;46;56;33;23;109;59;50;81;25;56;312;199;113;188.0;179.0;96.0;97.0;646.0;681.0;1659
5262;Laarbeek;2014;21211;4899;12310;4002;19411;1094;438;656;706;400;306;109;60;49;63;37;26;116;62;54;84;27;57;334;214;120;186.0;178.0;100.0;97.0;708.0;684.0;1659
5263;Laarbeek;2015;21248;4856;12214;4178;19389;1102;440;662;757;430;327;118;61;57;67;39;28;116;61;55;84;27;57;372;242;130;192.0;185.0;107.0;101.0;676.0;689.0;1659
5264;Laarbeek;2016;21252;4859;12111;4282;19309;1112;442;670;831;463;368;131;64;67;76;42;34;127;61;66;91;32;59;406;264;142;193.0;196.0;88.0;95.0;662.0;691.0;1659
5265;Laarbeek;2017;21218;4788;12033;4397;19236;1107;436;671;875;483;392;131;67;64;73;42;31;143;63;80;102;35;67;426;276;150;198.0;191.0;95.0;96.0;733.0;673.0;1659
5266;Laarbeek;2018;21284;4775;12015;4494;19241;1123;434;689;920;495;425;128;63;65;84;47;37;154;64;90;105;33;72;449;288;161;208.0;195.0;96.0;96.0;684.0;693.0;1659
5267;Laarbeek;2019;21290;4713;12006;4571;19203;1134;426;708;953;517;436;137;71;66;86;51;35;156;66;90;122;40;82;452;289;163;209.0;199.0;95.0;98.0;752.0;721.0;1659
5268;Laarbeek;2020;21331;4657;11982;4692;19176;1144;437;707;1011;559;452;148;79;69;85;51;34;175;75;100;134;53;81;469;301;168;217.0;208.0;94.0;98.0;716.0;709.0;1659
5269;Laarbeek;2021;21347;4579;11977;4791;19136;1148;441;707;1063;575;488;146;78;68;87;52;35;188;77;111;142;54;88;500;314;186;219.0;212.0;90.0;98.0;704.0;690.0;1659
5270;Laarbeek;2022;21362;4579;11899;4884;19099;1160;448;712;1103;597;506;148;78;70;88;53;35;195;83;112;153;54;99;519;329;190;216.0;219.0;95.0;98.0;746.0;706.0;1659
5271;Laarbeek;2023;21398;4540;11882;4976;19092;1167;435;732;1139;624;515;153;83;70;90;54;36;202;86;116;156;56;100;538;345;193;223.0;219.0;99.0;96.0;693.0;704.0;1659
5272;Laarbeek;2024;21394;4522;11811;5061;19029;1202;455;747;1163;625;538;167;89;78;90;53;37;209;89;120;159;57;102;538;337;201;227.0;221.0;96.0;94.0;706.0;698.0;1659
5273;Laarbeek;2025;21414;4529;11745;5140;18987;1222;459;763;1205;643;562;170;88;82;91;53;38;211;91;120;157;55;102;576;356;220;;;;;;;1659
5274;Landerd;2008;14548;3798;8784;1966;13571;613;204;409;364;236;128;49;27;22;21;11;10;39;16;23;31;18;13;224;164;60;129.0;131.0;39.0;60.0;541.0;558.0;1685
5275;Landerd;2009;14511;3738;8731;2042;13471;642;206;436;398;260;138;60;31;29;24;16;8;51;23;28;37;23;14;226;167;59;127.0;132.0;37.0;56.0;548.0;573.0;1685
5276;Landerd;2010;14464;3671;8711;2082;13363;649;205;444;452;282;170;65;33;32;26;16;10;59;26;33;56;30;26;246;177;69;127.0;133.0;38.0;54.0;547.0;590.0;1685
5277;Landerd;2011;14402;3626;8631;2145;13280;652;198;454;470;291;179;71;36;35;28;16;12;67;30;37;61;34;27;243;175;68;122.0;137.0;39.0;55.0;613.0;590.0;1685
5278;Landerd;2012;14397;3569;8590;2238;13208;673;200;473;516;318;198;73;40;33;33;19;14;77;33;44;75;47;28;258;179;79;121.0;138.0;46.0;59.0;523.0;601.0;1685
5279;Landerd;2013;14290;3495;8448;2347;13087;667;189;478;536;327;209;76;44;32;30;15;15;84;38;46;77;43;34;269;187;82;118.0;140.0;37.0;54.0;624.0;588.0;1685
5280;Landerd;2014;14288;3424;8443;2421;13053;677;194;483;558;329;229;79;47;32;31;15;16;94;42;52;94;50;44;260;175;85;119.0;144.0;45.0;56.0;587.0;604.0;1685
5281;Landerd;2015;14236;3390;8342;2504;12957;693;198;495;586;340;246;78;46;32;39;21;18;97;42;55;106;59;47;266;172;94;122.0;143.0;34.0;48.0;608.0;623.0;1685
5282;Landerd;2016;14189;3311;8301;2577;12876;697;204;493;616;362;254;82;48;34;41;22;19;100;45;55;109;67;42;284;180;104;117.0;143.0;47.0;48.0;594.0;610.0;1685
5283;Landerd;2017;14148;3238;8228;2682;12802;696;199;497;650;379;271;85;53;32;45;23;22;106;44;62;111;68;43;303;191;112;123.0;151.0;39.0;52.0;713.0;602.0;1685
5284;Landerd;2018;14217;3203;8259;2755;12822;725;203;522;670;389;281;90;58;32;50;27;23;107;44;63;116;64;52;307;196;111;123.0;157.0;41.0;49.0;584.0;611.0;1685
5285;Landerd;2019;14149;3097;8245;2807;12723;738;197;541;688;407;281;95;64;31;50;29;21;110;44;66;124;69;55;309;201;108;129.0;156.0;37.0;50.0;609.0;616.0;1685
5286;Landerd;2020;14103;3044;8191;2868;12645;755;204;551;703;400;303;98;61;37;55;31;24;113;38;75;123;66;57;314;204;110;127.0;160.0;43.0;54.0;626.0;613.0;1685
5287;Landerd;2021;14072;2990;8149;2933;12575;763;216;547;734;398;336;99;62;37;66;30;36;124;37;87;135;68;67;310;201;109;138.0;161.0;40.0;50.0;646.0;624.0;1685
5288;Landerd;2022;14063;2940;8130;2993;12546;764;217;547;753;412;341;103;67;36;70;29;41;127;39;88;134;73;61;319;204;115;131.0;165.0;46.0;47.0;640.0;635.0;1685
5289;Landerd;2023;14035;2907;8069;3059;12486;785;223;562;764;432;332;103;65;38;72;31;41;130;47;83;141;74;67;318;215;103;134.0;169.0;40.0;49.0;598.0;632.0;1685
5290;Landerd;2024;13959;2866;7980;3113;12378;799;228;571;782;436;346;110;70;40;71;29;42;130;44;86;148;76;72;323;217;106;142.0;166.0;39.0;49.0;672.0;594.0;1685
5291;Landerd;2025;14005;2850;7957;3198;12381;809;248;561;815;439;376;109;69;40;72;28;44;140;42;98;148;81;67;346;219;127;;;;;;;1685
5292;Landgraaf;2008;39069;8113;24361;6595;29730;8080;2401;5679;1259;740;519;83;44;39;81;42;39;217;116;101;135;56;79;743;482;261;319.0;363.0;255.0;265.0;1762.0;1865.0;882
5293;Landgraaf;2009;38916;7944;24211;6761;29682;7898;2379;5519;1336;777;559;103;57;46;92;49;43;237;122;115;145;57;88;759;492;267;320.0;389.0;249.0;262.0;1787.0;1880.0;882
5294;Landgraaf;2010;38745;7792;24061;6892;29615;7743;2353;5390;1387;798;589;112;59;53;93;45;48;240;117;123;160;70;90;782;507;275;317.0;384.0;257.0;248.0;1729.0;1934.0;882
5295;Landgraaf;2011;38485;7663;23736;7086;29519;7542;2302;5240;1424;812;612;128;69;59;94;42;52;243;119;124;173;69;104;786;513;273;317.0;387.0;256.0;244.0;1750.0;1876.0;882
5296;Landgraaf;2012;38305;7532;23473;7300;29408;7394;2288;5106;1503;833;670;149;82;67;104;45;59;261;123;138;195;72;123;794;511;283;328.0;401.0;251.0;239.0;1840.0;1877.0;882
5297;Landgraaf;2013;38212;7476;23254;7482;29367;7271;2279;4992;1574;867;707;168;94;74;100;51;49;292;139;153;208;74;134;806;509;297;328.0;407.0;240.0;232.0;1790.0;1910.0;882
5298;Landgraaf;2014;38024;7387;22997;7640;29262;7109;2262;4847;1653;906;747;184;102;82;118;59;59;306;146;160;226;78;148;819;521;298;320.0;418.0;239.0;237.0;1746.0;1894.0;882
5299;Landgraaf;2015;37786;7295;22664;7827;29139;6955;2227;4728;1692;923;769;206;112;94;127;60;67;310;151;159;231;84;147;818;516;302;325.0;416.0;233.0;221.0;1681.0;1865.0;882
5300;Landgraaf;2016;37527;7248;22305;7974;28987;6771;2177;4594;1769;960;809;219;122;97;135;68;67;324;158;166;241;87;154;850;525;325;330.0;411.0;230.0;207.0;1695.0;1855.0;882
5301;Landgraaf;2017;37312;7195;21992;8125;28882;6626;2181;4445;1804;976;828;228;132;96;132;63;69;340;169;171;253;91;162;851;521;330;324.0;431.0;217.0;207.0;1688.0;1813.0;882
5302;Landgraaf;2018;37096;7123;21702;8271;28785;6451;2178;4273;1860;998;862;247;139;108;146;67;79;345;170;175;259;95;164;863;527;336;336.0;431.0;215.0;204.0;1661.0;1797.0;882
5303;Landgraaf;2019;36879;7050;21430;8399;28677;6276;2132;4144;1926;1024;902;261;143;118;144;67;77;360;173;187;273;98;175;888;543;345;340.0;433.0;201.0;198.0;1658.0;1760.0;882
5304;Landgraaf;2020;36693;7041;21112;8540;28582;6151;2101;4050;1960;1036;924;270;150;120;142;73;69;373;177;196;282;96;186;893;540;353;335.0;425.0;207.0;189.0;1624.0;1788.0;882
5305;Landgraaf;2021;36461;6983;20824;8654;28443;6012;2081;3931;2006;1053;953;289;161;128;143;72;71;383;182;201;293;97;196;898;541;357;336.0;436.0;201.0;194.0;1642.0;1776.0;882
5306;Landgraaf;2022;36235;6945;20512;8778;28293;5895;2073;3822;2047;1082;965;283;153;130;158;85;73;392;182;210;309;106;203;905;556;349;334.0;432.0;191.0;187.0;1651.0;1788.0;882
5307;Landgraaf;2023;36008;6909;20217;8882;28125;5803;2046;3757;2080;1094;986;285;161;124;172;91;81;403;190;213;319;114;205;901;538;363;335.0;436.0;188.0;183.0;1616.0;1745.0;882
5308;Landgraaf;2024;35789;6865;19896;9028;28000;5697;2037;3660;2092;1110;982;287;159;128;185;104;81;402;185;217;312;114;198;906;548;358;336.0;440.0;190.0;178.0;1556.0;1721.0;882
5309;Landgraaf;2025;35532;6801;19581;9150;27834;5565;2016;3549;2133;1133;1000;292;160;132;192;109;83;410;196;214;322;117;205;917;551;366;;;;;;;882
5310;Landsmeer;2008;10115;2335;6065;1715;8888;772;272;500;455;232;223;136;61;75;26;13;13;35;17;18;31;7;24;227;134;93;59.0;93.0;42.0;53.0;385.0;405.0;415
5311;Landsmeer;2009;10051;2271;6047;1733;8791;780;281;499;480;241;239;135;59;76;33;18;15;36;17;19;37;10;27;239;137;102;62.0;93.0;47.0;50.0;462.0;424.0;415
5312;Landsmeer;2010;10056;2208;6089;1759;8727;822;308;514;507;246;261;148;59;89;35;19;16;39;18;21;45;15;30;240;135;105;65.0;100.0;47.0;56.0;523.0;437.0;415
5313;Landsmeer;2011;10098;2177;6131;1790;8696;862;321;541;540;256;284;159;59;100;40;22;18;44;19;25;52;18;34;245;138;107;63.0;95.0;52.0;57.0;541.0;425.0;415
5314;Landsmeer;2012;10177;2150;6162;1865;8727;902;346;556;548;259;289;152;55;97;38;21;17;52;20;32;57;18;39;249;145;104;69.0;100.0;53.0;55.0;466.0;445.0;415
5315;Landsmeer;2013;10166;2085;6156;1925;8636;937;377;560;593;261;332;159;55;104;41;22;19;59;18;41;65;21;44;269;145;124;69.0;97.0;58.0;56.0;535.0;449.0;415
5316;Landsmeer;2014;10228;2060;6175;1993;8632;953;385;568;643;270;373;167;55;112;42;19;23;70;21;49;74;24;50;290;151;139;74.0;101.0;54.0;59.0;552.0;475.0;415
5317;Landsmeer;2015;10274;2008;6237;2029;8625;994;403;591;655;272;383;181;58;123;42;18;24;72;21;51;76;23;53;284;152;132;79.0;104.0;61.0;55.0;533.0;451.0;415
5318;Landsmeer;2016;10337;1984;6281;2072;8614;1026;426;600;697;289;408;188;59;129;42;18;24;80;24;56;84;28;56;303;160;143;79.0;101.0;59.0;58.0;529.0;455.0;415
5319;Landsmeer;2017;10391;1940;6323;2128;8619;1043;435;608;729;304;425;200;65;135;46;18;28;80;25;55;88;28;60;315;168;147;81.0;105.0;59.0;59.0;525.0;442.0;415
5320;Landsmeer;2018;10451;1933;6334;2184;8622;1095;461;634;734;311;423;193;63;130;48;19;29;81;24;57;89;26;63;323;179;144;88.0;107.0;64.0;58.0;485.0;464.0;415
5321;Landsmeer;2019;10460;1896;6334;2230;8588;1117;465;652;755;318;437;198;62;136;41;19;22;89;26;63;98;30;68;329;181;148;90.0;109.0;61.0;59.0;533.0;475.0;415
5322;Landsmeer;2020;10503;1879;6349;2275;8581;1139;470;669;783;333;450;210;71;139;39;18;21;95;25;70;97;30;67;342;189;153;93.0;108.0;64.0;62.0;549.0;473.0;415
5323;Landsmeer;2021;10567;1871;6383;2313;8605;1156;490;666;806;343;463;218;73;145;46;23;23;100;29;71;96;29;67;346;189;157;99.0;112.0;61.0;61.0;549.0;470.0;415
5324;Landsmeer;2022;10633;1862;6373;2398;8634;1179;513;666;820;354;466;221;73;148;45;24;21;102;31;71;94;30;64;358;196;162;104.0;112.0;69.0;58.0;497.0;473.0;415
5325;Landsmeer;2023;10662;1873;6328;2461;8627;1206;530;676;829;358;471;214;71;143;52;28;24;109;32;77;92;31;61;362;196;166;105.0;115.0;67.0;64.0;535.0;493.0;415
5326;Landsmeer;2024;10699;1916;6284;2499;8621;1242;542;700;836;348;488;216;69;147;54;32;22;113;32;81;93;26;67;360;189;171;111.0;117.0;63.0;63.0;564.0;472.0;415
5327;Landsmeer;2025;10788;1953;6274;2561;8685;1251;548;703;852;343;509;209;68;141;57;28;29;118;33;85;99;29;70;369;185;184;;;;;;;415
5328;Langedijk;2008;25949;6996;15848;3105;23428;1476;518;958;1045;529;516;122;55;67;121;46;75;76;35;41;253;115;138;473;278;195;263.0;156.0;83.0;126.0;892.0;1114.0;416
5329;Langedijk;2009;25794;6808;15716;3270;23245;1470;503;967;1079;545;534;123;59;64;124;49;75;87;39;48;259;115;144;486;283;203;248.0;161.0;94.0;120.0;962.0;1155.0;416
5330;Langedijk;2010;25665;6645;15588;3432;23100;1458;498;960;1107;564;543;127;65;62;122;50;72;95;44;51;253;111;142;510;294;216;245.0;165.0;97.0;120.0;1217.0;1112.0;416
5331;Langedijk;2011;25828;6509;15725;3594;23196;1472;514;958;1160;597;563;139;72;67;131;57;74;116;53;63;248;113;135;526;302;224;253.0;175.0;102.0;119.0;1136.0;1157.0;416
5332;Langedijk;2012;25871;6390;15622;3859;23165;1496;528;968;1210;635;575;146;76;70;139;68;71;130;63;67;253;116;137;542;312;230;247.0;177.0;93.0;114.0;1205.0;1164.0;416
5333;Langedijk;2013;25966;6283;15581;4102;23211;1504;526;978;1251;644;607;154;77;77;141;74;67;145;64;81;249;116;133;562;313;249;250.0;186.0;109.0;116.0;1232.0;1165.0;416
5334;Langedijk;2014;26092;6195;15552;4345;23287;1532;531;1001;1273;663;610;166;85;81;142;79;63;168;70;98;238;109;129;559;320;239;250.0;190.0;100.0;112.0;1289.0;1172.0;416
5335;Langedijk;2015;26260;6124;15609;4527;23380;1571;549;1022;1309;672;637;176;94;82;160;85;75;189;75;114;237;112;125;547;306;241;258.0;195.0;125.0;114.0;1313.0;1198.0;416
5336;Langedijk;2016;26452;6060;15616;4776;23459;1615;560;1055;1378;695;683;187;97;90;161;85;76;201;76;125;240;113;127;589;324;265;267.0;201.0;107.0;112.0;1332.0;1230.0;416
5337;Langedijk;2017;26619;5996;15615;5008;23529;1650;574;1076;1440;723;717;195;98;97;171;96;75;232;85;147;246;116;130;596;328;268;274.0;210.0;132.0;118.0;1342.0;1220.0;416
5338;Langedijk;2018;26823;5986;15621;5216;23629;1684;565;1119;1510;753;757;211;105;106;183;99;84;242;90;152;244;114;130;630;345;285;276.0;211.0;107.0;120.0;1373.0;1221.0;416
5339;Langedijk;2019;27029;5959;15669;5401;23740;1696;570;1126;1593;788;805;228;105;123;187;99;88;250;96;154;252;119;133;676;369;307;285.0;230.0;111.0;117.0;1331.0;1246.0;416
5340;Langedijk;2020;27166;5923;15683;5560;23796;1736;595;1141;1634;807;827;242;113;129;193;108;85;268;103;165;248;113;135;683;370;313;289.0;234.0;104.0;115.0;1462.0;1257.0;416
5341;Langedijk;2021;27419;5879;15809;5731;23972;1763;614;1149;1684;829;855;242;114;128;202;113;89;276;106;170;254;114;140;710;382;328;301.0;241.0;106.0;116.0;1422.0;1291.0;416
5342;Langedijk;2022;27604;5879;15817;5908;24126;1768;606;1162;1710;850;860;247;118;129;193;112;81;276;109;167;260;118;142;734;393;341;299.0;251.0;108.0;106.0;1357.0;1298.0;416
5343;Langedijk;2023;27718;5852;15798;6068;24191;1806;625;1181;1721;871;850;254;118;136;192;120;72;270;110;160;255;119;136;750;404;346;309.0;255.0;113.0;114.0;1390.0;1295.0;416
5344;Langedijk;2024;27870;5838;15835;6197;24292;1812;632;1180;1766;888;878;268;121;147;195;119;76;284;116;168;248;120;128;771;412;359;319.0;258.0;100.0;116.0;1465.0;1263.0;416
5345;Langedijk;2025;28120;5905;15841;6374;24462;1797;631;1166;1861;932;929;280;126;154;211;129;82;303;126;177;263;124;139;804;427;377;;;;;;;416
5346;Lansingerland;2008;48465;13856;28924;5685;41788;3214;1185;2029;3463;1763;1700;826;382;444;233;88;145;379;170;209;779;394;385;1246;729;517;587.0;304.0;128.0;207.0;2875.0;1673.0;1621
5347;Lansingerland;2009;49879;14053;29809;6017;42789;3333;1222;2111;3757;1874;1883;878;383;495;243;88;155;441;199;242;839;419;420;1356;785;571;592.0;319.0;147.0;212.0;2903.0;1766.0;1621
5348;Lansingerland;2010;51228;14276;30557;6395;43762;3459;1277;2182;4007;1946;2061;928;393;535;259;89;170;501;217;284;891;447;444;1428;800;628;588.0;342.0;151.0;206.0;2459.0;1774.0;1621
5349;Lansingerland;2011;52113;14299;31178;6636;44352;3559;1320;2239;4202;2023;2179;932;391;541;276;101;175;537;233;304;944;465;479;1513;833;680;597.0;350.0;176.0;211.0;2689.0;1796.0;1621
5350;Lansingerland;2012;53223;14386;31638;7199;45169;3654;1358;2296;4400;2060;2340;960;392;568;286;101;185;579;249;330;972;464;508;1603;854;749;601.0;365.0;186.0;215.0;2481.0;1768.0;1621
5351;Lansingerland;2013;54153;14429;32077;7647;45809;3779;1417;2362;4565;2122;2443;1013;404;609;287;106;181;600;267;333;994;478;516;1671;867;804;610.0;383.0;182.0;208.0;2387.0;1723.0;1621
5352;Lansingerland;2014;55025;14526;32436;8063;46412;3900;1449;2451;4713;2176;2537;1052;419;633;312;120;192;613;266;347;1036;499;537;1700;872;828;609.0;398.0;178.0;209.0;1790.0;1668.0;1621
5353;Lansingerland;2015;55327;14401;32547;8379;46578;3929;1456;2473;4820;2212;2608;1053;419;634;322;124;198;652;283;369;1043;501;542;1750;885;865;602.0;415.0;188.0;211.0;1986.0;1689.0;1621
5354;Lansingerland;2016;55794;14375;32684;8735;46878;3995;1496;2499;4921;2259;2662;1056;417;639;335;122;213;681;300;381;1048;510;538;1801;910;891;610.0;429.0;177.0;224.0;2103.0;1686.0;1621
5355;Lansingerland;2017;56351;14340;32871;9140;47271;4070;1520;2550;5010;2297;2713;1054;417;637;335;126;209;704;315;389;1082;519;563;1835;920;915;605.0;440.0;180.0;218.0;1778.0;1665.0;1621
5356;Lansingerland;2018;56594;14232;32900;9462;47413;4100;1526;2574;5081;2332;2749;1061;422;639;342;127;215;727;321;406;1084;518;566;1867;944;923;613.0;453.0;168.0;209.0;1919.0;1682.0;1621
5357;Lansingerland;2019;56955;14111;33051;9793;47633;4133;1545;2588;5189;2380;2809;1086;437;649;357;134;223;754;337;417;1091;520;571;1901;952;949;618.0;478.0;171.0;204.0;1918.0;1729.0;1621
5358;Lansingerland;2020;57257;13958;33207;10092;47765;4192;1591;2601;5300;2435;2865;1096;441;655;371;141;230;780;341;439;1105;530;575;1948;982;966;615.0;486.0;182.0;212.0;2063.0;1709.0;1621
5359;Lansingerland;2021;57715;13925;33394;10396;48030;4270;1622;2648;5415;2484;2931;1108;446;662;381;147;234;789;347;442;1121;523;598;2016;1021;995;621.0;502.0;178.0;211.0;1958.0;1746.0;1621
5360;Lansingerland;2022;58021;13825;33473;10723;48245;4310;1644;2666;5466;2493;2973;1101;451;650;393;150;243;827;359;468;1116;521;595;2029;1012;1017;610.0;511.0;181.0;206.0;1952.0;1762.0;1621
5361;Lansingerland;2023;58288;13712;33502;11074;48376;4328;1639;2689;5584;2560;3024;1096;448;648;413;160;253;850;365;485;1127;529;598;2098;1058;1040;615.0;520.0;174.0;198.0;1949.0;1762.0;1621
5362;Lansingerland;2024;58553;13616;33531;11406;48528;4353;1640;2713;5672;2602;3070;1113;452;661;415;161;254;882;374;508;1139;539;600;2123;1076;1047;624.0;535.0;176.0;200.0;1833.0;1749.0;1621
5363;Lansingerland;2025;58703;13447;33510;11746;48643;4336;1636;2700;5724;2631;3093;1097;450;647;408;161;247;892;372;520;1160;549;611;2167;1099;1068;;;;;;;1621
5364;Laren (NH.);2008;10726;2225;5826;2675;8944;1342;523;819;440;231;209;68;29;39;46;23;23;38;20;18;37;17;20;251;142;109;70.0;175.0;81.0;78.0;799.0;878.0;417
5365;Laren (NH.);2009;10546;2148;5803;2595;8794;1298;495;803;454;228;226;72;29;43;37;17;20;44;23;21;49;20;29;252;139;113;71.0;165.0;81.0;73.0;821.0;868.0;417
5366;Laren (NH.);2010;10414;2082;5781;2551;8681;1254;463;791;479;233;246;81;34;47;42;18;24;52;24;28;59;25;34;245;132;113;68.0;160.0;66.0;74.0;975.0;848.0;417
5367;Laren (NH.);2011;10442;2044;5894;2504;8706;1231;441;790;505;248;257;83;39;44;43;20;23;65;25;40;63;26;37;251;138;113;73.0;156.0;71.0;71.0;939.0;890.0;417
5368;Laren (NH.);2012;10409;2003;5872;2534;8665;1220;426;794;524;262;262;92;45;47;46;23;23;74;29;45;58;27;31;254;138;116;73.0;153.0;89.0;69.0;935.0;925.0;417
5369;Laren (NH.);2013;10360;1978;5825;2557;8609;1203;406;797;548;268;280;101;49;52;43;21;22;85;40;45;72;28;44;247;130;117;77.0;150.0;69.0;65.0;999.0;908.0;417
5370;Laren (NH.);2014;10383;1947;5883;2553;8628;1188;408;780;567;269;298;113;52;61;45;22;23;84;35;49;80;28;52;245;132;113;81.0;138.0;78.0;62.0;861.0;907.0;417
5371;Laren (NH.);2015;10298;1879;5830;2589;8543;1174;412;762;581;275;306;111;52;59;60;33;27;84;34;50;78;28;50;248;128;120;80.0;133.0;72.0;64.0;861.0;877.0;417
5372;Laren (NH.);2016;10237;1868;5786;2583;8481;1173;417;756;583;271;312;117;54;63;55;31;24;91;35;56;85;30;55;235;121;114;81.0;138.0;65.0;61.0;895.0;861.0;417
5373;Laren (NH.);2017;10218;1839;5810;2569;8464;1142;410;732;612;280;332;121;54;67;64;33;31;93;37;56;87;28;59;247;128;119;83.0;138.0;68.0;62.0;900.0;882.0;417
5374;Laren (NH.);2018;10188;1862;5782;2544;8408;1129;393;736;651;296;355;126;50;76;63;34;29;98;43;55;97;32;65;267;137;130;92.0;135.0;64.0;60.0;937.0;886.0;417
5375;Laren (NH.);2019;10201;1864;5805;2532;8402;1120;369;751;679;295;384;125;53;72;63;32;31;105;42;63;108;31;77;278;137;141;93.0;134.0;62.0;60.0;931.0;883.0;417
5376;Laren (NH.);2020;10212;1868;5801;2543;8420;1103;372;731;689;305;384;122;56;66;67;32;35;107;46;61;102;30;72;291;141;150;94.0;133.0;78.0;56.0;883.0;884.0;417
5377;Laren (NH.);2021;10196;1863;5777;2556;8426;1086;363;723;684;305;379;116;51;65;64;33;31;98;40;58;110;35;75;296;146;150;93.0;133.0;62.0;57.0;879.0;871.0;417
5378;Laren (NH.);2022;10169;1842;5762;2565;8384;1080;360;720;705;309;396;119;61;58;63;32;31;101;39;62;116;38;78;306;139;167;90.0;132.0;68.0;59.0;906.0;892.0;417
5379;Laren (NH.);2023;10153;1835;5719;2599;8374;1080;363;717;699;317;382;125;67;58;63;33;30;99;39;60;121;46;75;291;132;159;92.0;132.0;63.0;56.0;922.0;867.0;417
5380;Laren (NH.);2024;10176;1850;5702;2624;8393;1094;359;735;689;318;371;126;64;62;58;30;28;102;41;61;116;48;68;287;135;152;93.0;134.0;53.0;54.0;911.0;849.0;417
5381;Laren (NH.);2025;10197;1836;5731;2630;8400;1098;361;737;699;305;394;128;63;65;63;31;32;114;43;71;121;46;75;273;122;151;;;;;;;417
5382;Leek;2008;19052;4701;11443;2908;17672;867;328;539;513;280;233;103;57;46;40;19;21;70;36;34;34;10;24;266;158;108;206.0;158.0;47.0;79.0;1156.0;1128.0;22
5383;Leek;2009;19098;4655;11481;2962;17656;872;339;533;570;303;267;115;62;53;46;26;20;85;38;47;44;12;32;280;165;115;208.0;158.0;52.0;81.0;1092.0;1137.0;22
5384;Leek;2010;19078;4599;11428;3051;17602;861;336;525;615;318;297;114;61;53;61;35;26;85;33;52;50;11;39;305;178;127;210.0;161.0;58.0;80.0;1131.0;1153.0;22
5385;Leek;2011;19086;4537;11420;3129;17547;892;352;540;647;341;306;130;69;61;65;37;28;95;44;51;59;17;42;298;174;124;207.0;162.0;61.0;78.0;1101.0;1139.0;22
5386;Leek;2012;19077;4477;11327;3273;17493;906;356;550;678;353;325;134;73;61;79;44;35;104;50;54;61;16;45;300;170;130;206.0;166.0;57.0;79.0;1193.0;1118.0;22
5387;Leek;2013;19175;4438;11328;3409;17569;885;331;554;721;381;340;140;77;63;80;45;35;113;52;61;66;19;47;322;188;134;212.0;165.0;59.0;77.0;1152.0;1147.0;22
5388;Leek;2014;19212;4396;11289;3527;17556;902;333;569;754;391;363;147;80;67;84;48;36;113;51;62;74;23;51;336;189;147;219.0;169.0;61.0;79.0;1114.0;1156.0;22
5389;Leek;2015;19204;4330;11294;3580;17519;903;339;564;782;402;380;148;81;67;83;47;36;115;53;62;83;26;57;353;195;158;211.0;168.0;68.0;76.0;1114.0;1152.0;22
5390;Leek;2016;19202;4309;11225;3668;17502;897;350;547;803;431;372;157;91;66;83;48;35;110;54;56;84;28;56;369;210;159;221.0;175.0;60.0;80.0;1142.0;1153.0;22
5391;Leek;2017;19218;4274;11179;3765;17494;899;353;546;825;449;376;162;91;71;79;45;34;107;56;51;87;30;57;390;227;163;210.0;176.0;62.0;84.0;1149.0;1130.0;22
5392;Leek;2018;19249;4238;11164;3847;17500;900;348;552;849;459;390;173;95;78;95;56;39;115;55;60;82;28;54;384;225;159;218.0;184.0;65.0;78.0;1121.0;1143.0;22
5393;Leek;2019;19248;4193;11101;3954;17470;901;338;563;877;472;405;171;96;75;100;63;37;127;61;66;86;32;54;393;220;173;216.0;182.0;69.0;75.0;1157.0;1177.0;22
5394;Leek;2020;19259;4150;11074;4035;17452;902;330;572;905;486;419;174;100;74;102;64;38;128;59;69;95;34;61;406;229;177;219.0;191.0;61.0;75.0;1164.0;1170.0;22
5395;Leek;2021;19270;4135;10998;4137;17449;892;330;562;929;489;440;170;99;71;107;57;50;135;64;71;105;35;70;412;234;178;222.0;186.0;52.0;70.0;1075.0;1146.0;22
5396;Leek;2022;19218;4088;10877;4253;17351;899;321;578;968;515;453;176;104;72;119;61;58;148;67;81;100;36;64;425;247;178;214.0;193.0;66.0;75.0;1131.0;1128.0;22
5397;Leek;2023;19236;4082;10772;4382;17324;885;322;563;1027;528;499;172;101;71;133;67;66;160;74;86;111;41;70;451;245;206;215.0;196.0;63.0;78.0;1193.0;1149.0;22
5398;Leek;2024;19284;4096;10729;4459;17348;897;329;568;1039;519;520;183;105;78;145;73;72;160;68;92;115;38;77;436;235;201;221.0;201.0;52.0;74.0;1130.0;1149.0;22
5399;Leek;2025;19264;4096;10631;4537;17323;886;311;575;1055;525;530;187;111;76;147;74;73;167;75;92;114;39;75;440;226;214;;;;;;;22
5400;Leerdam;2008;20395;5264;12121;3010;16275;1556;503;1053;2564;1365;1199;104;54;50;38;23;15;1708;872;836;316;156;160;398;260;138;234.0;186.0;66.0;87.0;513.0;696.0;545
5401;Leerdam;2009;20243;5174;12018;3051;16147;1557;519;1038;2539;1336;1203;103;51;52;41;24;17;1643;838;805;325;155;170;427;268;159;226.0;184.0;60.0;86.0;742.0;704.0;545
5402;Leerdam;2010;20299;5156;12037;3106;16209;1537;510;1027;2553;1336;1217;118;57;61;42;24;18;1605;815;790;333;159;174;455;281;174;229.0;182.0;62.0;78.0;626.0;709.0;545
5403;Leerdam;2011;20251;5082;12005;3164;16151;1544;514;1030;2556;1327;1229;123;60;63;52;36;16;1579;799;780;349;156;193;453;276;177;219.0;185.0;69.0;77.0;671.0;731.0;545
5404;Leerdam;2012;20219;5003;11910;3306;16158;1530;518;1012;2531;1315;1216;133;67;66;57;37;20;1521;781;740;340;144;196;480;286;194;226.0;188.0;65.0;75.0;680.0;708.0;545
5405;Leerdam;2013;20221;4926;11826;3469;16205;1495;513;982;2521;1341;1180;143;75;68;59;39;20;1474;758;716;337;152;185;508;317;191;223.0;185.0;65.0;74.0;700.0;705.0;545
5406;Leerdam;2014;20247;4861;11808;3578;16234;1484;503;981;2529;1349;1180;154;82;72;69;41;28;1435;746;689;336;152;184;535;328;207;225.0;188.0;64.0;72.0;706.0;723.0;545
5407;Leerdam;2015;20258;4816;11776;3666;16246;1485;509;976;2527;1332;1195;159;79;80;75;39;36;1411;732;679;343;159;184;539;323;216;231.0;195.0;66.0;68.0;744.0;751.0;545
5408;Leerdam;2016;20289;4763;11757;3769;16267;1499;516;983;2523;1322;1201;164;82;82;75;41;34;1384;722;662;354;160;194;546;317;229;227.0;193.0;63.0;74.0;730.0;723.0;545
5409;Leerdam;2017;20321;4741;11745;3835;16293;1515;521;994;2513;1319;1194;169;87;82;82;42;40;1354;705;649;358;168;190;550;317;233;220.0;192.0;63.0;76.0;775.0;730.0;545
5410;Leerdam;2018;20382;4703;11738;3941;16362;1510;527;983;2510;1333;1177;182;92;90;83;46;37;1314;697;617;365;177;188;566;321;245;226.0;195.0;66.0;71.0;715.0;723.0;545
5411;Leerdam;2019;20400;4662;11712;4026;16354;1514;536;978;2532;1350;1182;195;98;97;83;50;33;1283;685;598;372;174;198;599;343;256;231.0;196.0;55.0;70.0;696.0;735.0;545
5412;Leerdam;2020;20384;4610;11661;4113;16350;1505;539;966;2529;1345;1184;201;100;101;92;53;39;1246;674;572;379;173;206;611;345;266;228.0;202.0;66.0;70.0;725.0;740.0;545
5413;Leerdam;2021;20392;4537;11658;4197;16358;1517;545;972;2517;1347;1170;215;104;111;95;56;39;1199;651;548;384;179;205;624;357;267;227.0;208.0;56.0;76.0;742.0;743.0;545
5414;Leerdam;2022;20390;4483;11615;4292;16399;1532;559;973;2459;1324;1135;218;103;115;95;58;37;1156;631;525;376;180;196;614;352;262;229.0;210.0;57.0;69.0;769.0;748.0;545
5415;Leerdam;2023;20422;4463;11554;4405;16454;1539;551;988;2429;1313;1116;232;109;123;96;59;37;1109;614;495;378;182;196;614;349;265;233.0;220.0;57.0;66.0;723.0;735.0;545
5416;Leerdam;2024;20416;4429;11480;4507;16463;1539;553;986;2414;1312;1102;228;109;119;101;64;37;1077;606;471;380;183;197;628;350;278;230.0;219.0;58.0;60.0;808.0;742.0;545
5417;Leerdam;2025;20494;4459;11426;4609;16532;1538;557;981;2424;1313;1111;231;107;124;102;61;41;1055;600;455;388;184;204;648;361;287;;;;;;;545
5418;Leeuwarden;2008;95098;20437;61178;13483;80108;6579;2511;4068;8411;5284;3127;1373;722;651;888;583;305;595;303;292;1086;517;569;4469;3159;1310;1152.0;907.0;732.0;875.0;4198.0;2960.0;80
5419;Leeuwarden;2009;96459;20659;62230;13570;81277;6627;2526;4101;8555;5260;3295;1413;746;667;927;585;342;639;328;311;1163;542;621;4413;3059;1354;1214.0;907.0;734.0;864.0;3623.0;2920.0;80
5420;Leeuwarden;2010;97358;20873;62768;13717;81931;6698;2572;4126;8729;5266;3463;1445;765;680;963;605;358;726;354;372;1230;568;662;4365;2974;1391;1241.0;900.0;724.0;848.0;3411.0;2934.0;80
5421;Leeuwarden;2011;98072;21096;63163;13813;82498;6689;2527;4162;8885;5294;3591;1445;762;683;1001;637;364;781;366;415;1291;597;694;4367;2932;1435;1306.0;895.0;762.0;858.0;3244.0;2972.0;80
5422;Leeuwarden;2012;98673;21278;63218;14177;83010;6703;2514;4189;8960;5285;3675;1449;754;695;1022;656;366;825;380;445;1337;606;731;4327;2889;1438;1345.0;887.0;751.0;817.0;3253.0;2954.0;80
5423;Leeuwarden;2013;99386;21577;63255;14554;83540;6723;2541;4182;9123;5322;3801;1460;754;706;1038;661;377;917;416;501;1388;629;759;4320;2862;1458;1378.0;907.0;746.0;807.0;3234.0;2948.0;80
5424;Leeuwarden;2014;100102;21834;63452;14816;84123;6765;2543;4222;9214;5299;3915;1472;754;718;1030;642;388;986;441;545;1452;665;787;4274;2797;1477;1440.0;888.0;762.0;793.0;3237.0;2942.0;80
5425;Leeuwarden;2015;100944;22251;63690;15003;84764;6824;2570;4254;9356;5318;4038;1488;765;723;1055;661;394;1061;460;601;1518;690;828;4234;2742;1492;1459.0;905.0;725.0;789.0;3196.0;2947.0;80
5426;Leeuwarden;2016;101697;22636;63793;15268;85346;6836;2572;4264;9515;5365;4150;1486;764;722;1098;683;415;1117;481;636;1563;703;860;4251;2734;1517;1504.0;897.0;717.0;765.0;3233.0;2945.0;80
5427;Leeuwarden;2017;102565;23126;63937;15502;85987;6899;2599;4300;9679;5439;4240;1515;784;731;1131;700;431;1182;518;664;1604;709;895;4247;2728;1519;1518.0;902.0;753.0;764.0;3231.0;2969.0;80
5428;Leeuwarden;2018;103443;23659;64030;15754;86610;6946;2636;4310;9887;5489;4398;1540;798;742;1186;719;467;1219;538;681;1655;722;933;4287;2712;1575;1544.0;903.0;736.0;761.0;3268.0;2981.0;80
5429;Leeuwarden;2019;104366;24222;64167;15977;87369;6971;2641;4330;10026;5507;4519;1554;796;758;1215;737;478;1243;533;710;1697;730;967;4317;2711;1606;1583.0;917.0;736.0;746.0;3286.0;3005.0;80
5430;Leeuwarden;2020;105320;24747;64337;16236;88090;7007;2664;4343;10223;5570;4653;1568;795;773;1261;765;496;1270;559;711;1778;745;1033;4346;2706;1640;1609.0;904.0;704.0;759.0;3301.0;3040.0;80
5431;Leeuwarden;2021;106246;25289;64471;16486;88854;7050;2664;4386;10342;5594;4748;1563;788;775;1305;776;529;1295;574;721;1827;761;1066;4352;2695;1657;1617.0;912.0;717.0;736.0;3300.0;3031.0;80
5432;Leeuwarden;2022;107221;25862;64597;16762;89639;7057;2644;4413;10525;5626;4899;1553;777;776;1351;809;542;1375;592;783;1863;766;1097;4383;2682;1701;1646.0;924.0;715.0;752.0;3292.0;3004.0;80
5433;Leeuwarden;2023;108208;26358;64795;17055;90408;7093;2670;4423;10707;5632;5075;1587;778;809;1379;822;557;1423;606;817;1923;778;1145;4395;2648;1747;1649.0;933.0;709.0;735.0;3261.0;2998.0;80
5434;Leeuwarden;2024;109177;26875;64966;17336;91177;7093;2688;4405;10907;5722;5185;1610;784;826;1411;844;567;1499;647;852;1986;793;1193;4401;2654;1747;1672.0;932.0;689.0;725.0;3238.0;3038.0;80
5435;Leeuwarden;2025;110093;27376;65098;17619;91823;7151;2706;4445;11119;5780;5339;1650;807;843;1417;845;572;1544;660;884;2047;802;1245;4461;2666;1795;;;;;;;80
5436;Leeuwarderadeel;2008;10427;2726;6285;1416;9714;423;124;299;290;159;131;34;16;18;32;16;16;27;10;17;30;15;15;167;102;65;86.0;79.0;25.0;46.0;412.0;510.0;81
5437;Leeuwarderadeel;2009;10319;2601;6254;1464;9582;432;122;310;305;167;138;38;19;19;39;23;16;28;10;18;32;17;15;168;98;70;86.0;84.0;29.0;41.0;400.0;453.0;81
5438;Leeuwarderadeel;2010;10259;2529;6192;1538;9521;433;125;308;305;168;137;34;18;16;41;24;17;28;14;14;31;17;14;171;95;76;89.0;84.0;25.0;41.0;425.0;443.0;81
5439;Leeuwarderadeel;2011;10230;2426;6221;1583;9473;427;125;302;330;186;144;37;16;21;42;26;16;30;17;13;34;16;18;187;111;76;88.0;89.0;32.0;38.0;402.0;389.0;81
5440;Leeuwarderadeel;2012;10237;2364;6201;1672;9475;421;122;299;341;192;149;41;18;23;47;25;22;32;18;14;33;16;17;188;115;73;92.0;89.0;30.0;43.0;415.0;394.0;81
5441;Leeuwarderadeel;2013;10249;2281;6231;1737;9467;417;121;296;365;210;155;43;20;23;47;27;20;42;23;19;37;18;19;196;122;74;94.0;89.0;33.0;38.0;412.0;433.0;81
5442;Leeuwarderadeel;2014;10229;2209;6210;1810;9433;409;119;290;387;222;165;48;22;26;53;32;21;46;24;22;40;20;20;200;124;76;98.0;88.0;33.0;39.0;390.0;437.0;81
5443;Leeuwarderadeel;2015;10188;2144;6173;1871;9373;399;120;279;416;230;186;48;25;23;63;36;27;51;22;29;38;21;17;216;126;90;100.0;93.0;34.0;39.0;392.0;450.0;81
5444;Leeuwarderadeel;2016;10133;2057;6135;1941;9302;391;116;275;440;251;189;54;29;25;63;38;25;53;21;32;38;22;16;232;141;91;107.0;94.0;36.0;46.0;416.0;471.0;81
5445;Leeuwarderadeel;2017;10081;2017;6073;1991;9229;399;119;280;453;252;201;57;29;28;68;41;27;59;22;37;42;24;18;227;136;91;105.0;90.0;27.0;40.0;427.0;433.0;81
5446;Leeuwarderadeel;2018;10079;1991;6042;2046;9214;392;116;276;473;262;211;56;28;28;71;42;29;61;24;37;42;21;21;243;147;96;109.0;94.0;41.0;44.0;414.0;514.0;81
5447;Leeuwarderadeel;2019;9993;1968;5911;2114;9126;379;108;271;488;270;218;58;31;27;79;44;35;65;29;36;53;25;28;233;141;92;106.0;97.0;35.0;36.0;407.0;469.0;81
5448;Leeuwarderadeel;2020;9941;1928;5839;2174;9051;373;110;263;517;273;244;60;31;29;88;46;42;64;25;39;61;25;36;244;146;98;112.0;99.0;31.0;42.0;402.0;480.0;81
5449;Leeuwarderadeel;2021;9867;1915;5739;2213;8965;374;107;267;528;273;255;62;34;28;90;45;45;67;24;43;61;26;35;248;144;104;109.0;100.0;34.0;35.0;392.0;466.0;81
5450;Leeuwarderadeel;2022;9801;1908;5632;2261;8896;372;114;258;533;275;258;71;37;34;97;49;48;66;25;41;60;25;35;239;139;100;108.0;103.0;37.0;36.0;408.0;473.0;81
5451;Leeuwarderadeel;2023;9741;1895;5556;2290;8822;378;112;266;541;273;268;70;36;34;102;56;46;67;26;41;64;26;38;238;129;109;111.0;105.0;30.0;39.0;410.0;459.0;81
5452;Leeuwarderadeel;2024;9691;1881;5493;2317;8759;384;117;267;548;281;267;70;37;33;108;65;43;76;26;50;65;29;36;229;124;105;109.0;105.0;29.0;36.0;392.0;447.0;81
5453;Leeuwarderadeel;2025;9634;1884;5401;2349;8689;385;114;271;560;285;275;73;40;33;113;69;44;72;24;48;68;30;38;234;122;112;;;;;;;81
5454;Leiden;2008;118241;24742;79182;14317;87462;13916;6812;7104;16863;10160;6703;2038;1111;927;1253;759;494;2346;1272;1074;4908;2574;2334;6318;4444;1874;1416.0;892.0;1837.0;1813.0;5743.0;6181.0;546
5455;Leiden;2009;118369;24938;78709;14722;87534;13985;6848;7137;16850;10057;6793;2069;1115;954;1242;747;495;2387;1258;1129;4840;2528;2312;6312;4409;1903;1432.0;900.0;1896.0;1784.0;5202.0;6082.0;546
5456;Leiden;2010;118154;24886;78184;15084;87168;14125;6977;7148;16861;9994;6867;2088;1106;982;1215;747;468;2426;1254;1172;4801;2492;2309;6331;4395;1936;1415.0;908.0;1940.0;1770.0;5351.0;5965.0;546
5457;Leiden;2011;118235;24732;78156;15347;87111;14289;7050;7239;16835;9945;6890;2098;1110;988;1215;754;461;2441;1275;1166;4725;2435;2290;6356;4371;1985;1412.0;920.0;1978.0;1744.0;5092.0;5851.0;546
5458;Leiden;2012;118223;24619;77421;16183;86914;14423;7152;7271;16886;9891;6995;2130;1119;1011;1256;778;478;2460;1268;1192;4682;2397;2285;6358;4329;2029;1400.0;936.0;1985.0;1712.0;5157.0;5810.0;546
5459;Leiden;2013;118325;24614;76825;16886;86763;14597;7278;7319;16965;9839;7126;2157;1144;1013;1281;794;487;2500;1276;1224;4664;2336;2328;6363;4289;2074;1367.0;945.0;1977.0;1709.0;5081.0;5704.0;546
5460;Leiden;2014;118408;24546;76403;17459;86688;14727;7373;7354;16993;9822;7171;2148;1127;1021;1294;808;486;2547;1308;1239;4627;2310;2317;6377;4269;2108;1362.0;958.0;1954.0;1701.0;5048.0;5564.0;546
5461;Leiden;2015;118565;24441;76117;18007;86649;14851;7476;7375;17065;9770;7295;2169;1131;1038;1328;818;510;2573;1301;1272;4617;2291;2326;6378;4229;2149;1345.0;975.0;1930.0;1672.0;5014.0;5561.0;546
5462;Leiden;2016;118663;24365;75797;18501;86483;14994;7584;7410;17186;9766;7420;2220;1144;1076;1346;829;517;2605;1296;1309;4592;2280;2312;6423;4217;2206;1341.0;969.0;1906.0;1637.0;5170.0;5539.0;546
5463;Leiden;2017;118954;24372;75543;19039;86529;15176;7668;7508;17249;9784;7465;2268;1170;1098;1375;853;522;2611;1294;1317;4538;2251;2287;6457;4216;2241;1319.0;1001.0;1907.0;1629.0;5092.0;5501.0;546
5464;Leiden;2018;119160;24318;75244;19598;86554;15352;7827;7525;17254;9719;7535;2280;1169;1111;1371;862;509;2647;1305;1342;4486;2201;2285;6470;4182;2288;1289.0;1024.0;1893.0;1594.0;4957.0;5536.0;546
5465;Leiden;2019;119163;24131;74959;20073;86391;15458;7911;7547;17314;9717;7597;2279;1150;1129;1377;866;511;2639;1325;1314;4460;2160;2300;6559;4216;2343;1274.0;1011.0;1875.0;1583.0;5053.0;5497.0;546
5466;Leiden;2020;119293;23896;74821;20576;86301;15635;8058;7577;17357;9751;7606;2271;1152;1119;1397;874;523;2686;1356;1330;4396;2146;2250;6607;4223;2384;1273.0;1042.0;1863.0;1568.0;4981.0;5501.0;546
5467;Leiden;2021;119315;23734;74578;21003;86133;15766;8154;7612;17416;9773;7643;2291;1163;1128;1405;876;529;2706;1367;1339;4355;2117;2238;6659;4250;2409;1267.0;1054.0;1857.0;1567.0;5015.0;5511.0;546
5468;Leiden;2022;119336;23570;74229;21537;86003;15830;8227;7603;17503;9788;7715;2299;1171;1128;1441;907;534;2719;1369;1350;4369;2106;2263;6675;4235;2440;1241.0;1076.0;1823.0;1521.0;5003.0;5478.0;546
5469;Leiden;2023;119349;23368;73983;21998;85800;15990;8327;7663;17559;9815;7744;2276;1164;1112;1456;912;544;2759;1378;1381;4336;2096;2240;6732;4265;2467;1219.0;1100.0;1837.0;1517.0;5111.0;5512.0;546
5470;Leiden;2024;119404;23150;73742;22512;85598;16172;8440;7732;17634;9793;7841;2305;1161;1144;1498;924;574;2754;1383;1371;4280;2063;2217;6797;4262;2535;1187.0;1109.0;1821.0;1500.0;5028.0;5514.0;546
5471;Leiden;2025;119333;22976;73409;22948;85347;16278;8543;7735;17708;9809;7899;2300;1175;1125;1507;916;591;2751;1364;1387;4290;2072;2218;6860;4282;2578;;;;;;;546
5472;Leiderdorp;2008;26116;6469;15568;4079;21273;2534;1053;1481;2309;1297;1012;493;265;228;133;55;78;545;280;265;311;170;141;827;527;300;247.0;204.0;157.0;175.0;1446.0;1501.0;547
5473;Leiderdorp;2009;26087;6345;15581;4161;21194;2547;1061;1486;2346;1313;1033;483;258;225;139;59;80;556;289;267;347;195;152;821;512;309;247.0;210.0;159.0;177.0;1464.0;1551.0;547
5474;Leiderdorp;2010;26022;6233;15526;4263;21112;2552;1062;1490;2358;1324;1034;476;256;220;140;64;76;559;292;267;370;206;164;813;506;307;242.0;214.0;173.0;173.0;1471.0;1541.0;547
5475;Leiderdorp;2011;25981;6116;15565;4300;21002;2575;1091;1484;2404;1348;1056;467;249;218;140;63;77;576;307;269;384;207;177;837;522;315;243.0;210.0;171.0;163.0;1489.0;1538.0;547
5476;Leiderdorp;2012;25976;5981;15480;4515;20949;2580;1101;1479;2447;1379;1068;470;251;219;149;72;77;582;312;270;399;214;185;847;530;317;247.0;219.0;169.0;170.0;1424.0;1522.0;547
5477;Leiderdorp;2013;25907;5850;15407;4650;20872;2586;1105;1481;2449;1386;1063;465;255;210;139;66;73;584;316;268;418;223;195;843;526;317;249.0;219.0;172.0;172.0;1454.0;1530.0;547
5478;Leiderdorp;2014;25866;5726;15352;4788;20780;2584;1091;1493;2502;1410;1092;462;256;206;150;75;75;593;321;272;445;230;215;852;528;324;251.0;225.0;167.0;161.0;1362.0;1487.0;547
5479;Leiderdorp;2015;25776;5671;15211;4894;20615;2627;1115;1512;2534;1421;1113;464;250;214;158;78;80;598;324;274;454;235;219;860;534;326;243.0;226.0;168.0;162.0;1396.0;1474.0;547
5480;Leiderdorp;2016;25723;5564;15170;4989;20526;2638;1103;1535;2559;1454;1105;451;247;204;162;85;77;593;325;268;468;237;231;885;560;325;256.0;229.0;167.0;165.0;1352.0;1481.0;547
5481;Leiderdorp;2017;25623;5525;15033;5065;20353;2659;1130;1529;2611;1465;1146;451;245;206;172;87;85;613;331;282;476;242;234;899;560;339;256.0;233.0;157.0;153.0;1419.0;1496.0;547
5482;Leiderdorp;2018;25577;5482;14957;5138;20274;2683;1162;1521;2620;1476;1144;430;243;187;178;90;88;621;334;287;490;254;236;901;555;346;261.0;231.0;166.0;160.0;1383.0;1472.0;547
5483;Leiderdorp;2019;25525;5390;14918;5217;20176;2697;1192;1505;2652;1495;1157;437;246;191;177;85;92;619;331;288;498;257;241;921;576;345;263.0;241.0;159.0;150.0;1393.0;1528.0;547
5484;Leiderdorp;2020;25423;5292;14836;5295;20062;2696;1210;1486;2665;1496;1169;426;246;180;174;83;91;635;332;303;512;261;251;918;574;344;258.0;233.0;162.0;160.0;1392.0;1488.0;547
5485;Leiderdorp;2021;25357;5223;14781;5353;19943;2744;1240;1504;2670;1496;1174;420;241;179;176;91;85;635;336;299;527;268;259;912;560;352;260.0;241.0;161.0;154.0;1366.0;1487.0;547
5486;Leiderdorp;2022;25264;5166;14667;5431;19808;2755;1247;1508;2701;1482;1219;410;236;174;175;90;85;640;335;305;528;267;261;948;554;394;264.0;246.0;165.0;152.0;1366.0;1449.0;547
5487;Leiderdorp;2023;25219;5114;14574;5531;19688;2778;1270;1508;2753;1492;1261;409;235;174;182;92;90;651;335;316;545;266;279;966;564;402;267.0;243.0;164.0;148.0;1470.0;1474.0;547
5488;Leiderdorp;2024;25258;5078;14551;5629;19642;2808;1286;1522;2808;1527;1281;411;235;176;190;96;94;650;336;314;559;269;290;998;591;407;268.0;252.0;192.0;151.0;1381.0;1438.0;547
5489;Leiderdorp;2025;25272;5095;14455;5722;19530;2854;1299;1555;2888;1577;1311;418;242;176;196;102;94;685;353;332;577;279;298;1012;601;411;;;;;;;547
5490;Leidschendam-Voorburg;2008;74372;15995;44327;14050;54252;10277;4884;5393;9843;5888;3955;2387;1210;1177;926;564;362;797;439;358;1202;588;614;4531;3087;1444;779.0;755.0;674.0;933.0;5310.0;4560.0;1916
5491;Leidschendam-Voorburg;2009;74895;16117;44708;14070;54236;10398;4995;5403;10261;5952;4309;2474;1195;1279;920;541;379;874;467;407;1295;619;676;4698;3130;1568;821.0;759.0;750.0;951.0;5240.0;4654.0;1916
5492;Leidschendam-Voorburg;2010;75344;16155;45110;14079;54220;10594;5111;5483;10530;5974;4556;2506;1199;1307;947;554;393;945;480;465;1389;651;738;4743;3090;1653;812.0;760.0;760.0;941.0;5395.0;4640.0;1916
5493;Leidschendam-Voorburg;2011;75977;16265;45671;14041;54301;10848;5276;5572;10828;5981;4847;2556;1197;1359;983;570;413;1038;509;529;1471;661;810;4780;3044;1736;828.0;761.0;765.0;935.0;5527.0;4716.0;1916
5494;Leidschendam-Voorburg;2012;76690;16476;45682;14532;54457;11114;5439;5675;11119;5979;5140;2633;1199;1434;1003;561;442;1093;521;572;1524;676;848;4866;3022;1844;838.0;764.0;781.0;916.0;5370.0;4639.0;1916
5495;Leidschendam-Voorburg;2013;77366;16610;45858;14898;54641;11382;5609;5773;11343;6012;5331;2681;1208;1473;999;575;424;1150;539;611;1569;688;881;4944;3002;1942;862.0;748.0;784.0;922.0;5331.0;4598.0;1916
5496;Leidschendam-Voorburg;2014;78081;16759;46120;15202;54815;11664;5752;5912;11602;6012;5590;2719;1200;1519;996;566;430;1187;545;642;1654;703;951;5046;2998;2048;863.0;758.0;787.0;954.0;5497.0;4503.0;1916
5497;Leidschendam-Voorburg;2015;79016;16956;46624;15436;55166;12016;5938;6078;11834;6018;5816;2743;1189;1554;1026;583;443;1246;563;683;1700;722;978;5119;2961;2158;900.0;765.0;804.0;948.0;5376.0;4496.0;1916
5498;Leidschendam-Voorburg;2016;79891;17261;46948;15682;55434;12345;6099;6246;12112;6062;6050;2781;1184;1597;1065;604;461;1311;582;729;1727;732;995;5228;2960;2268;897.0;753.0;831.0;925.0;5263.0;4517.0;1916
5499;Leidschendam-Voorburg;2017;80693;17456;47324;15913;55629;12734;6312;6422;12330;6088;6242;2808;1172;1636;1080;613;467;1355;598;757;1783;745;1038;5304;2960;2344;907.0;756.0;826.0;942.0;5470.0;4488.0;1916
5500;Leidschendam-Voorburg;2018;81716;17809;47796;16111;55979;13093;6505;6588;12644;6157;6487;2865;1180;1685;1098;611;487;1402;599;803;1886;790;1096;5393;2977;2416;929.0;771.0;831.0;945.0;5368.0;4581.0;1916
5501;Leidschendam-Voorburg;2019;82555;17967;48215;16373;56253;13516;6704;6812;12786;6160;6626;2871;1177;1694;1113;605;508;1458;617;841;1918;795;1123;5426;2966;2460;943.0;771.0;821.0;957.0;5269.0;4493.0;1916
5502;Leidschendam-Voorburg;2020;83372;18151;48578;16643;56479;13919;6922;6997;12974;6176;6798;2904;1193;1711;1127;606;521;1514;626;888;1960;807;1153;5469;2944;2525;956.0;787.0;826.0;946.0;5299.0;4530.0;1916
5503;Leidschendam-Voorburg;2021;84193;18360;48966;16867;56712;14317;7124;7193;13164;6219;6945;2923;1192;1731;1145;620;525;1562;643;919;1998;806;1192;5536;2958;2578;951.0;792.0;853.0;938.0;5424.0;4693.0;1916
5504;Leidschendam-Voorburg;2022;85004;18484;49405;17115;56884;14746;7309;7437;13374;6231;7143;2947;1201;1746;1161;636;525;1621;645;976;2049;813;1236;5596;2936;2660;969.0;789.0;845.0;936.0;5420.0;4651.0;1916
5505;Leidschendam-Voorburg;2023;85866;18713;49707;17446;57071;15208;7530;7678;13587;6274;7313;2981;1198;1783;1137;619;518;1664;665;999;2089;818;1271;5716;2974;2742;968.0;809.0;842.0;961.0;5465.0;4777.0;1916
5506;Leidschendam-Voorburg;2024;86602;18862;50030;17710;57206;15631;7763;7868;13765;6324;7441;2998;1192;1806;1136;607;529;1669;665;1004;2122;829;1293;5840;3031;2809;966.0;804.0;858.0;956.0;5583.0;4796.0;1916
5507;Leidschendam-Voorburg;2025;87457;19023;50466;17968;57411;16046;7989;8057;14000;6406;7594;3021;1195;1826;1167;608;559;1701;683;1018;2165;855;1310;5946;3065;2881;;;;;;;1916
5508;Lelystad;2008;73231;19478;46180;7573;53272;6744;2585;4159;13215;7201;6014;4268;2263;2005;1484;866;618;1937;1031;906;2126;1020;1106;3400;2021;1379;1006.0;499.0;448.0;510.0;2742.0;2409.0;995
5509;Lelystad;2009;74015;19912;46030;8073;53642;6876;2618;4258;13497;7203;6294;4295;2237;2058;1483;852;631;2027;1037;990;2169;1037;1132;3523;2040;1483;988.0;512.0;510.0;514.0;2782.0;2365.0;995
5510;Lelystad;2010;74911;20261;46039;8611;54004;7014;2635;4379;13893;7284;6609;4372;2234;2138;1461;843;618;2096;1049;1047;2271;1072;1199;3693;2086;1607;982.0;537.0;525.0;506.0;2873.0;2398.0;995
5511;Lelystad;2011;75856;20593;46156;9107;54392;7162;2703;4459;14302;7400;6902;4443;2232;2211;1482;843;639;2182;1076;1106;2346;1112;1234;3849;2137;1712;961.0;560.0;539.0;509.0;2802.0;2410.0;995
5512;Lelystad;2012;76686;20883;45839;9964;54696;7317;2751;4566;14673;7429;7244;4508;2224;2284;1483;834;649;2270;1104;1166;2424;1122;1302;3988;2145;1843;960.0;570.0;580.0;497.0;2818.0;2423.0;995
5513;Lelystad;2013;77560;21212;45633;10715;55050;7502;2832;4670;15008;7473;7535;4523;2187;2336;1495;833;662;2342;1120;1222;2489;1145;1344;4159;2188;1971;939.0;590.0;545.0;502.0;3007.0;2418.0;995
5514;Lelystad;2014;78550;21492;45662;11396;55448;7675;2891;4784;15427;7537;7890;4574;2162;2412;1504;821;683;2450;1166;1284;2549;1157;1392;4350;2231;2119;960.0;608.0;572.0;493.0;2672.0;2425.0;995
5515;Lelystad;2015;79237;21675;45520;12042;55760;7739;2898;4841;15738;7594;8144;4616;2148;2468;1519;817;702;2501;1182;1319;2619;1190;1429;4483;2257;2226;956.0;639.0;559.0;487.0;2666.0;2385.0;995
5516;Lelystad;2016;79914;21932;45405;12577;55984;7833;2940;4893;16097;7679;8418;4659;2151;2508;1521;801;720;2599;1219;1380;2684;1204;1480;4634;2304;2330;952.0;645.0;565.0;493.0;2922.0;2460.0;995
5517;Lelystad;2017;80761;22171;45449;13141;56312;7973;3006;4967;16476;7758;8718;4729;2160;2569;1566;809;757;2661;1222;1439;2762;1226;1536;4758;2341;2417;961.0;666.0;559.0;492.0;2836.0;2473.0;995
5518;Lelystad;2018;81494;22396;45372;13726;56590;8096;3058;5038;16808;7816;8992;4776;2168;2608;1585;792;793;2733;1239;1494;2833;1250;1583;4881;2367;2514;961.0;679.0;555.0;475.0;2706.0;2489.0;995
5519;Lelystad;2019;82076;22415;45312;14349;56759;8245;3096;5149;17072;7918;9154;4808;2181;2627;1608;787;821;2774;1272;1502;2871;1258;1613;5011;2420;2591;970.0;707.0;536.0;486.0;2790.0;2465.0;995
5520;Lelystad;2020;82720;22540;45299;14881;56986;8392;3139;5253;17342;7930;9412;4826;2148;2678;1636;778;858;2834;1293;1541;2931;1276;1655;5115;2435;2680;963.0;722.0;558.0;483.0;2751.0;2520.0;995
5521;Lelystad;2021;83281;22543;45403;15335;57135;8564;3230;5334;17582;7965;9617;4841;2125;2716;1677;772;905;2896;1307;1589;2957;1302;1655;5211;2459;2752;975.0;745.0;550.0;489.0;2593.0;2539.0;995
5522;Lelystad;2022;83631;22456;45370;15805;57206;8638;3270;5368;17787;8053;9734;4856;2131;2725;1680;762;918;2937;1325;1612;2984;1325;1659;5330;2510;2820;983.0;766.0;567.0;497.0;2611.0;2546.0;995
5523;Lelystad;2023;83992;22384;45383;16225;57296;8753;3317;5436;17943;8104;9839;4877;2134;2743;1682;747;935;2954;1337;1617;3003;1337;1666;5427;2549;2878;1013.0;788.0;559.0;473.0;2761.0;2525.0;995
5524;Lelystad;2024;84544;22477;45481;16586;57462;8906;3361;5545;18176;8117;10059;4895;2124;2771;1682;724;958;3020;1342;1678;3033;1341;1692;5546;2586;2960;1034.0;822.0;563.0;484.0;2535.0;2556.0;995
5525;Lelystad;2025;84821;22407;45482;16932;57464;8990;3378;5612;18367;8153;10214;4907;2098;2809;1694;716;978;3068;1352;1716;3029;1345;1684;5669;2642;3027;;;;;;;995
5526;Lemsterland;2008;13568;3381;8237;1950;12188;808;349;459;572;337;235;72;33;39;26;12;14;104;52;52;57;29;28;313;211;102;171.0;107.0;38.0;61.0;689.0;633.0;82
5527;Lemsterland;2009;13666;3384;8259;2023;12262;807;349;458;597;341;256;76;33;43;27;13;14;113;55;58;50;23;27;331;217;114;167.0;106.0;38.0;60.0;633.0;650.0;82
5528;Lemsterland;2010;13688;3341;8236;2111;12270;790;330;460;628;358;270;81;36;45;30;15;15;115;57;58;58;27;31;344;223;121;168.0;113.0;42.0;60.0;588.0;637.0;82
5529;Lemsterland;2011;13677;3287;8193;2197;12244;794;324;470;639;357;282;85;39;46;32;14;18;128;59;69;52;27;25;342;218;124;160.0;114.0;44.0;61.0;594.0;632.0;82
5530;Lemsterland;2012;13668;3225;8140;2303;12227;794;319;475;647;361;286;90;42;48;32;13;19;132;61;71;53;26;27;340;219;121;156.0;120.0;48.0;59.0;619.0;626.0;82
5531;Lemsterland;2013;13689;3205;8089;2395;12242;788;303;485;659;364;295;92;45;47;31;14;17;138;63;75;56;26;30;342;216;126;152.0;119.0;44.0;59.0;609.0;620.0;82
5532;Lemsterland;2014;13696;3161;8047;2488;12234;799;308;491;663;365;298;84;45;39;33;14;19;140;61;79;59;29;30;347;216;131;155.0;122.0;44.0;56.0;621.0;609.0;82
5533;Lemsterland;2015;13731;3121;8029;2581;12269;793;309;484;669;359;310;92;46;46;38;16;22;138;61;77;66;31;35;335;205;130;143.0;123.0;45.0;58.0;587.0;617.0;82
5534;Lemsterland;2016;13709;3094;7963;2652;12242;794;306;488;673;356;317;94;48;46;40;19;21;132;55;77;73;34;39;334;200;134;144.0;127.0;47.0;56.0;704.0;624.0;82
5535;Lemsterland;2017;13801;3069;8043;2689;12310;788;285;503;703;384;319;98;53;45;45;24;21;139;58;81;69;36;33;352;213;139;138.0;129.0;36.0;56.0;642.0;639.0;82
5536;Lemsterland;2018;13793;3008;8030;2755;12308;788;292;496;697;382;315;104;59;45;43;24;19;138;58;80;77;39;38;335;202;133;138.0;132.0;44.0;52.0;622.0;624.0;82
5537;Lemsterland;2019;13790;2940;8006;2844;12303;781;292;489;706;380;326;106;59;47;45;25;20;147;62;85;88;43;45;320;191;129;139.0;134.0;39.0;52.0;655.0;618.0;82
5538;Lemsterland;2020;13820;2924;8009;2887;12315;775;302;473;730;383;347;104;58;46;51;27;24;154;60;94;96;49;47;325;189;136;134.0;136.0;43.0;49.0;586.0;613.0;82
5539;Lemsterland;2021;13786;2844;7951;2991;12252;780;308;472;754;394;360;106;57;49;52;28;24;159;62;97;104;55;49;333;192;141;138.0;138.0;41.0;53.0;619.0;602.0;82
5540;Lemsterland;2022;13791;2841;7901;3049;12266;767;302;465;758;393;365;108;60;48;53;29;24;160;65;95;106;52;54;331;187;144;138.0;145.0;39.0;50.0;639.0;613.0;82
5541;Lemsterland;2023;13799;2830;7871;3098;12273;755;299;456;771;395;376;106;58;48;59;34;25;169;72;97;105;47;58;332;184;148;135.0;149.0;44.0;54.0;570.0;607.0;82
5542;Lemsterland;2024;13740;2765;7789;3186;12206;740;295;445;794;407;387;107;59;48;66;38;28;173;73;100;110;49;61;338;188;150;130.0;151.0;39.0;47.0;574.0;599.0;82
5543;Lemsterland;2025;13689;2730;7688;3271;12120;748;294;454;821;417;404;103;56;47;72;40;32;199;79;120;109;51;58;338;191;147;;;;;;;82
5544;Leudal;2008;36254;8809;21669;5776;32226;3124;1165;1959;904;544;360;69;29;40;56;24;32;106;55;51;93;45;48;580;391;189;281.0;265.0;163.0;220.0;1528.0;1581.0;1640
5545;Leudal;2009;36166;8624;21567;5975;32034;3125;1154;1971;1007;613;394;87;40;47;62;25;37;126;71;55;112;55;57;620;422;198;271.0;267.0;173.0;221.0;1473.0;1651.0;1640
5546;Leudal;2010;35949;8416;21393;6140;31720;3121;1139;1982;1108;661;447;107;53;54;75;32;43;160;83;77;125;60;65;641;433;208;263.0;273.0;177.0;220.0;1446.0;1668.0;1640
5547;Leudal;2011;35678;8146;21221;6311;31360;3134;1154;1980;1184;694;490;111;58;53;87;41;46;188;90;98;143;64;79;655;441;214;266.0;275.0;191.0;209.0;1564.0;1652.0;1640
5548;Leudal;2012;35569;7924;21067;6578;31131;3113;1159;1954;1325;762;563;139;74;65;86;43;43;225;104;121;153;69;84;722;472;250;266.0;275.0;197.0;210.0;1531.0;1695.0;1640
5549;Leudal;2013;35385;7718;20854;6813;30857;3120;1191;1929;1408;820;588;143;75;68;89;47;42;242;116;126;166;76;90;768;506;262;268.0;289.0;185.0;199.0;1605.0;1653.0;1640
5550;Leudal;2014;35305;7530;20728;7047;30683;3134;1195;1939;1488;862;626;150;83;67;97;50;47;265;127;138;177;78;99;799;524;275;268.0;289.0;182.0;212.0;1616.0;1673.0;1640
5551;Leudal;2015;35201;7422;20493;7286;30502;3131;1185;1946;1568;907;661;167;89;78;93;48;45;289;144;145;187;77;110;832;549;283;271.0;304.0;195.0;201.0;1565.0;1688.0;1640
5552;Leudal;2016;35044;7235;20329;7480;30190;3179;1216;1963;1675;945;730;190;101;89;114;53;61;296;149;147;204;86;118;871;556;315;273.0;302.0;187.0;208.0;1698.0;1662.0;1640
5553;Leudal;2017;35031;7140;20171;7720;30105;3190;1239;1951;1736;957;779;190;100;90;129;68;61;318;153;165;217;94;123;882;542;340;288.0;310.0;184.0;198.0;1647.0;1661.0;1640
5554;Leudal;2018;34985;7056;20008;7921;29985;3208;1257;1951;1792;955;837;210;106;104;133;62;71;312;142;170;238;99;139;899;546;353;289.0;312.0;182.0;197.0;1793.0;1704.0;1640
5555;Leudal;2019;35041;6999;19886;8156;29909;3262;1279;1983;1870;1010;860;231;113;118;140;62;78;325;150;175;243;104;139;931;581;350;300.0;325.0;187.0;197.0;1668.0;1692.0;1640
5556;Leudal;2020;34985;6887;19758;8340;29764;3292;1296;1996;1929;1051;878;239;119;120;142;69;73;330;150;180;247;105;142;971;608;363;309.0;329.0;180.0;197.0;1578.0;1713.0;1640
5557;Leudal;2021;34817;6764;19540;8513;29532;3290;1287;2003;1995;1081;914;250;127;123;134;67;67;347;154;193;267;115;152;997;618;379;304.0;330.0;205.0;191.0;1683.0;1684.0;1640
5558;Leudal;2022;34817;6673;19431;8713;29439;3336;1323;2013;2042;1108;934;267;133;134;147;72;75;368;174;194;264;117;147;996;612;384;321.0;343.0;169.0;191.0;1629.0;1651.0;1640
5559;Leudal;2023;34756;6587;19245;8924;29318;3347;1309;2038;2091;1142;949;278;138;140;151;79;72;381;180;201;258;115;143;1023;630;393;319.0;343.0;182.0;191.0;1719.0;1678.0;1640
5560;Leudal;2024;34765;6575;19108;9082;29185;3396;1327;2069;2184;1195;989;289;145;144;157;82;75;385;186;199;278;123;155;1075;659;416;328.0;352.0;185.0;195.0;1696.0;1651.0;1640
5561;Leudal;2025;34782;6607;18868;9307;29144;3375;1320;2055;2263;1231;1032;290;139;151;163;91;72;412;198;214;284;128;156;1114;675;439;;;;;;;1640
5562;Leusden;2008;28770;7203;17496;4071;24958;2320;837;1483;1492;944;548;188;83;105;129;75;54;90;41;49;108;47;61;977;698;279;256.0;216.0;110.0;147.0;1356.0;1387.0;327
5563;Leusden;2009;28748;7009;17537;4202;24881;2316;841;1475;1551;954;597;205;92;113;141;79;62;108;47;61;121;51;70;976;685;291;253.0;220.0;106.0;141.0;1350.0;1369.0;327
5564;Leusden;2010;28730;6830;17549;4351;24826;2293;827;1466;1611;982;629;221;99;122;147;86;61;124;50;74;132;53;79;987;694;293;249.0;223.0;116.0;140.0;1406.0;1415.0;327
5565;Leusden;2011;28726;6651;17614;4461;24763;2301;826;1475;1662;990;672;222;100;122;150;86;64;150;58;92;143;55;88;997;691;306;249.0;224.0;115.0;140.0;1400.0;1436.0;327
5566;Leusden;2012;28694;6475;17494;4725;24686;2315;832;1483;1693;979;714;228;109;119;158;87;71;164;65;99;158;58;100;985;660;325;251.0;232.0;117.0;132.0;1385.0;1427.0;327
5567;Leusden;2013;28661;6310;17411;4940;24610;2281;817;1464;1770;1018;752;236;115;121;166;86;80;173;70;103;174;59;115;1021;688;333;251.0;237.0;120.0;132.0;1382.0;1423.0;327
5568;Leusden;2014;28625;6164;17352;5109;24534;2281;822;1459;1810;1045;765;236;120;116;170;92;78;180;73;107;186;67;119;1038;693;345;254.0;243.0;123.0;136.0;1366.0;1408.0;327
5569;Leusden;2015;28584;6073;17229;5282;24497;2268;826;1442;1819;1036;783;240;118;122;176;95;81;186;77;109;184;70;114;1033;676;357;257.0;244.0;114.0;129.0;1428.0;1436.0;327
5570;Leusden;2016;28572;5949;17157;5466;24465;2234;810;1424;1873;1078;795;247;126;121;173;89;84;193;82;111;201;78;123;1059;703;356;257.0;244.0;126.0;122.0;1378.0;1394.0;327
5571;Leusden;2017;28580;5875;17066;5639;24396;2245;801;1444;1939;1110;829;259;135;124;178;94;84;203;86;117;222;87;135;1077;708;369;267.0;252.0;120.0;124.0;1406.0;1402.0;327
5572;Leusden;2018;28600;5813;16960;5827;24363;2251;833;1418;1986;1129;857;252;131;121;193;93;100;218;86;132;220;88;132;1103;731;372;276.0;259.0;118.0;122.0;1559.0;1389.0;327
5573;Leusden;2019;28784;5792;16967;6025;24469;2252;825;1427;2063;1155;908;266;137;129;200;99;101;241;94;147;228;91;137;1128;734;394;284.0;263.0;116.0;129.0;1464.0;1402.0;327
5574;Leusden;2020;28857;5758;16932;6167;24485;2265;831;1434;2107;1185;922;275;141;134;202;102;100;254;102;152;235;93;142;1141;747;394;282.0;271.0;112.0;123.0;1484.0;1391.0;327
5575;Leusden;2021;28953;5702;16916;6335;24529;2306;846;1460;2118;1177;941;273;139;134;196;98;98;259;107;152;246;100;146;1144;733;411;290.0;269.0;119.0;123.0;1565.0;1410.0;327
5576;Leusden;2022;29130;5714;16908;6508;24649;2273;836;1437;2208;1231;977;280;147;133;195;99;96;259;104;155;242;101;141;1232;780;452;289.0;284.0;108.0;127.0;1592.0;1469.0;327
5577;Leusden;2023;29244;5694;16853;6697;24720;2257;840;1417;2267;1245;1022;284;150;134;212;110;102;268;105;163;263;104;159;1240;776;464;300.0;290.0;118.0;118.0;1639.0;1474.0;327
5578;Leusden;2024;29420;5693;16865;6862;24779;2275;862;1413;2366;1300;1066;301;161;140;235;122;113;273;103;170;269;107;162;1288;807;481;309.0;294.0;123.0;124.0;1571.0;1455.0;327
5579;Leusden;2025;29554;5738;16781;7035;24877;2287;868;1419;2390;1301;1089;314;160;154;237;127;110;286;112;174;286;119;167;1267;783;484;;;;;;;327
5580;Liesveld;2008;9582;2791;5577;1214;9103;291;95;196;188;109;79;20;9;11;9;4;5;18;6;12;46;22;24;95;68;27;128.0;64.0;17.0;30.0;253.0;302.0;694
5581;Liesveld;2009;9587;2773;5557;1257;9079;292;95;197;216;122;94;26;13;13;12;5;7;24;8;16;46;20;26;108;76;32;129.0;69.0;15.0;26.0;280.0;303.0;694
5582;Liesveld;2010;9616;2761;5544;1311;9064;301;95;206;251;130;121;33;13;20;16;5;11;30;11;19;55;22;33;117;79;38;125.0;67.0;21.0;26.0;262.0;314.0;694
5583;Liesveld;2011;9617;2732;5510;1375;9019;309;101;208;289;148;141;36;15;21;20;7;13;36;12;24;63;27;36;134;87;47;124.0;73.0;16.0;26.0;271.0;309.0;694
5584;Liesveld;2012;9620;2693;5468;1459;8981;333;110;223;306;154;152;36;14;22;21;8;13;41;15;26;65;29;36;143;88;55;122.0;75.0;20.0;27.0;284.0;302.0;694
5585;Liesveld;2013;9643;2675;5435;1533;8964;342;113;229;337;168;169;43;18;25;25;11;14;48;16;32;65;29;36;156;94;62;121.0;73.0;22.0;26.0;150.0;294.0;694
5586;Liesveld;2014;9545;2615;5336;1594;8836;343;113;230;366;181;185;49;20;29;24;11;13;46;16;30;78;33;45;169;101;68;112.0;78.0;22.0;28.0;277.0;285.0;694
5587;Liesveld;2015;9566;2571;5343;1652;8841;342;114;228;383;194;189;54;22;32;23;10;13;48;16;32;82;35;47;176;111;65;116.0;77.0;19.0;26.0;254.0;298.0;694
5588;Liesveld;2016;9553;2533;5325;1695;8810;347;119;228;396;196;200;55;26;29;21;9;12;53;17;36;91;36;55;176;108;68;115.0;82.0;21.0;27.0;265.0;303.0;694
5589;Liesveld;2017;9541;2482;5314;1745;8781;348;125;223;412;197;215;64;30;34;21;8;13;55;18;37;91;36;55;181;105;76;113.0;81.0;20.0;27.0;303.0;289.0;694
5590;Liesveld;2018;9580;2441;5344;1795;8778;359;137;222;443;206;237;68;31;37;25;12;13;55;20;35;100;37;63;195;106;89;115.0;86.0;20.0;25.0;257.0;303.0;694
5591;Liesveld;2019;9559;2403;5310;1846;8739;363;137;226;457;216;241;72;32;40;27;13;14;58;23;35;106;40;66;194;108;86;117.0;85.0;25.0;28.0;275.0;294.0;694
5592;Liesveld;2020;9569;2358;5326;1885;8719;366;138;228;484;232;252;76;35;41;30;15;15;65;24;41;105;38;67;208;120;88;117.0;85.0;19.0;24.0;267.0;295.0;694
5593;Liesveld;2021;9569;2341;5305;1923;8695;376;141;235;498;234;264;84;39;45;32;14;18;69;26;43;105;37;68;208;118;90;116.0;93.0;21.0;24.0;284.0;295.0;694
5594;Liesveld;2022;9579;2300;5317;1962;8670;398;145;253;511;237;274;82;38;44;34;14;20;77;29;48;113;38;75;205;118;87;117.0;90.0;22.0;24.0;316.0;297.0;694
5595;Liesveld;2023;9626;2294;5318;2014;8670;414;153;261;542;242;300;88;41;47;38;17;21;78;27;51;120;40;80;218;117;101;113.0;91.0;24.0;27.0;280.0;300.0;694
5596;Liesveld;2024;9626;2273;5292;2061;8645;423;155;268;558;248;310;91;43;48;42;15;27;77;28;49;122;41;81;226;121;105;113.0;94.0;19.0;24.0;301.0;299.0;694
5597;Liesveld;2025;9643;2254;5277;2112;8624;452;164;288;567;254;313;87;44;43;40;14;26;85;30;55;123;39;84;232;127;105;;;;;;;694
5598;Lingewaal;2008;10649;2766;6450;1433;9839;445;145;300;365;192;173;47;17;30;15;3;12;40;20;20;105;56;49;158;96;62;105.0;84.0;20.0;41.0;293.0;346.0;733
5599;Lingewaal;2009;10597;2724;6381;1492;9777;437;134;303;383;199;184;49;20;29;16;5;11;43;21;22;106;53;53;169;100;69;102.0;84.0;24.0;36.0;350.0;354.0;733
5600;Lingewaal;2010;10600;2658;6379;1563;9767;442;139;303;391;203;188;47;20;27;18;5;13;48;21;27;107;54;53;171;103;68;102.0;89.0;25.0;40.0;338.0;355.0;733
5601;Lingewaal;2011;10583;2602;6393;1588;9726;453;144;309;404;204;200;49;19;30;21;8;13;55;26;29;108;54;54;171;97;74;106.0;92.0;26.0;40.0;372.0;364.0;733
5602;Lingewaal;2012;10592;2535;6354;1703;9692;474;153;321;426;219;207;50;21;29;27;13;14;61;32;29;116;58;58;172;95;77;101.0;92.0;29.0;38.0;299.0;373.0;733
5603;Lingewaal;2013;10520;2473;6252;1795;9595;470;150;320;455;234;221;53;21;32;25;14;11;66;35;31;126;62;64;185;102;83;103.0;93.0;24.0;35.0;321.0;363.0;733
5604;Lingewaal;2014;10479;2405;6214;1860;9548;470;150;320;461;234;227;57;27;30;31;16;15;64;35;29;126;57;69;183;99;84;103.0;93.0;21.0;35.0;298.0;362.0;733
5605;Lingewaal;2015;10412;2368;6117;1927;9456;469;144;325;487;238;249;66;28;38;42;22;20;76;35;41;121;55;66;182;98;84;104.0;96.0;27.0;33.0;350.0;377.0;733
5606;Lingewaal;2016;10387;2341;6060;1986;9400;472;143;329;515;248;267;68;27;41;46;24;22;77;32;45;123;55;68;201;110;91;101.0;98.0;25.0;35.0;342.0;364.0;733
5607;Lingewaal;2017;10360;2298;6019;2043;9353;473;142;331;534;260;274;75;31;44;45;24;21;83;33;50;124;58;66;207;114;93;105.0;96.0;22.0;38.0;388.0;365.0;733
5608;Lingewaal;2018;10376;2269;6005;2102;9359;473;141;332;544;255;289;76;31;45;47;27;20;90;34;56;131;55;76;200;108;92;108.0;101.0;24.0;33.0;376.0;373.0;733
5609;Lingewaal;2019;10379;2247;5958;2174;9344;481;151;330;554;268;286;88;34;54;51;32;19;86;37;49;129;56;73;200;109;91;104.0;104.0;22.0;42.0;373.0;359.0;733
5610;Lingewaal;2020;10375;2216;5959;2200;9320;482;153;329;573;276;297;90;35;55;60;38;22;88;38;50;129;54;75;206;111;95;110.0;104.0;23.0;34.0;366.0;376.0;733
5611;Lingewaal;2021;10362;2195;5904;2263;9287;482;144;338;593;278;315;94;34;60;68;36;32;95;43;52;123;50;73;213;115;98;108.0;108.0;24.0;34.0;428.0;371.0;733
5612;Lingewaal;2022;10409;2186;5898;2325;9297;486;147;339;626;291;335;95;38;57;76;38;38;99;44;55;128;46;82;228;125;103;110.0;111.0;23.0;36.0;410.0;378.0;733
5613;Lingewaal;2023;10428;2189;5868;2371;9295;503;157;346;630;292;338;98;40;58;77;38;39;96;43;53;127;46;81;232;125;107;109.0;113.0;26.0;35.0;441.0;386.0;733
5614;Lingewaal;2024;10471;2172;5869;2430;9324;506;153;353;641;293;348;98;40;58;78;35;43;109;49;60;126;48;78;230;121;109;115.0;115.0;26.0;31.0;395.0;396.0;733
5615;Lingewaal;2025;10468;2171;5807;2490;9298;507;153;354;663;310;353;93;37;56;77;37;40;118;53;65;131;49;82;244;134;110;;;;;;;733
5616;Lingewaard;2008;44887;11465;27506;5916;40491;3041;805;2236;1355;739;616;177;71;106;107;43;64;226;122;104;101;44;57;744;459;285;468.0;306.0;134.0;147.0;1576.0;1532.0;1705
5617;Lingewaard;2009;45087;11417;27482;6188;40509;3092;841;2251;1486;807;679;188;70;118;123;55;68;271;148;123;120;53;67;784;481;303;458.0;309.0;141.0;144.0;1571.0;1568.0;1705
5618;Lingewaard;2010;45240;11362;27431;6447;40527;3087;840;2247;1626;852;774;201;79;122;140;58;82;299;156;143;142;57;85;844;502;342;457.0;320.0;143.0;141.0;1615.0;1550.0;1705
5619;Lingewaard;2011;45450;11267;27477;6706;40575;3121;848;2273;1754;915;839;208;82;126;152;71;81;343;171;172;164;70;94;887;521;366;436.0;332.0;162.0;139.0;1813.0;1495.0;1705
5620;Lingewaard;2012;45902;11265;27498;7139;40768;3191;899;2292;1943;998;945;219;91;128;181;81;100;387;188;199;187;79;108;969;559;410;447.0;346.0;166.0;139.0;1823.0;1533.0;1705
5621;Lingewaard;2013;46328;11286;27459;7583;41001;3232;907;2325;2095;1048;1047;246;102;144;201;98;103;431;192;239;208;83;125;1009;573;436;434.0;349.0;174.0;141.0;1737.0;1569.0;1705
5622;Lingewaard;2014;46617;11258;27374;7985;41081;3270;926;2344;2266;1115;1151;267;113;154;225;108;117;475;211;264;231;94;137;1068;589;479;443.0;364.0;159.0;139.0;1739.0;1563.0;1705
5623;Lingewaard;2015;46894;11197;27258;8439;41209;3301;953;2348;2384;1175;1209;283;128;155;235;116;119;510;232;278;244;100;144;1112;599;513;446.0;388.0;174.0;140.0;1842.0;1612.0;1705
5624;Lingewaard;2016;47222;11102;27342;8778;41359;3346;979;2367;2517;1231;1286;295;139;156;253;123;130;541;237;304;270;111;159;1158;621;537;454.0;395.0;161.0;144.0;1823.0;1614.0;1705
5625;Lingewaard;2017;47510;11063;27364;9083;41476;3352;989;2363;2682;1290;1392;316;150;166;273;123;150;568;250;318;300;124;176;1225;643;582;472.0;411.0;187.0;143.0;1836.0;1669.0;1705
5626;Lingewaard;2018;47785;11045;27331;9409;41553;3403;1033;2370;2829;1337;1492;336;161;175;282;126;156;614;261;353;348;138;210;1249;651;598;477.0;419.0;181.0;148.0;1752.0;1633.0;1705
5627;Lingewaard;2019;47997;10946;27282;9769;41600;3421;1049;2372;2976;1393;1583;356;172;184;303;133;170;643;276;367;374;145;229;1300;667;633;468.0;433.0;182.0;143.0;1878.0;1650.0;1705
5628;Lingewaard;2020;48303;10870;27347;10086;41709;3477;1083;2394;3117;1475;1642;380;189;191;308;130;178;680;298;382;392;157;235;1357;701;656;487.0;444.0;198.0;140.0;1851.0;1712.0;1705
5629;Lingewaard;2021;48548;10810;27364;10374;41764;3507;1093;2414;3277;1544;1733;381;197;184;323;143;180;729;311;418;426;171;255;1418;722;696;487.0;455.0;184.0;143.0;1871.0;1729.0;1705
5630;Lingewaard;2022;48771;10770;27311;10690;41825;3531;1102;2429;3415;1606;1809;396;204;192;341;152;189;753;321;432;448;171;277;1477;758;719;500.0;455.0;174.0;143.0;1835.0;1719.0;1705
5631;Lingewaard;2023;48967;10666;27378;10923;41864;3539;1106;2433;3564;1672;1892;410;206;204;365;163;202;798;347;451;482;181;301;1509;775;734;499.0;479.0;175.0;138.0;1920.0;1728.0;1705
5632;Lingewaard;2024;49218;10572;27463;11183;41962;3560;1131;2429;3696;1707;1989;438;218;220;368;158;210;819;349;470;504;181;323;1567;801;766;526.0;488.0;205.0;143.0;1850.0;1762.0;1705
5633;Lingewaard;2025;49412;10615;27367;11430;41910;3608;1144;2464;3894;1787;2107;465;238;227;414;186;228;862;364;498;533;188;345;1620;811;809;;;;;;;1705
5634;Lisse;2008;21824;5338;13082;3404;19297;1657;762;895;870;510;360;104;46;58;54;29;25;68;31;37;100;58;42;544;346;198;211.0;172.0;136.0;129.0;820.0;888.0;553
5635;Lisse;2009;21804;5313;13005;3486;19203;1686;767;919;915;524;391;105;49;56;65;37;28;86;37;49;112;59;53;547;342;205;198.0;173.0;138.0;131.0;857.0;904.0;553
5636;Lisse;2010;21792;5268;12954;3570;19095;1719;796;923;978;554;424;120;53;67;74;44;30;99;43;56;134;64;70;551;350;201;196.0;184.0;151.0;125.0;935.0;918.0;553
5637;Lisse;2011;21848;5193;13000;3655;19067;1743;832;911;1038;581;457;125;56;69;80;52;28;106;44;62;146;69;77;581;360;221;187.0;184.0;154.0;133.0;955.0;915.0;553
5638;Lisse;2012;21916;5081;12993;3842;19060;1787;862;925;1069;598;471;143;65;78;90;61;29;108;45;63;145;65;80;583;362;221;186.0;187.0;145.0;125.0;922.0;904.0;553
5639;Lisse;2013;21956;4986;12962;4008;19048;1805;868;937;1103;613;490;144;64;80;102;66;36;117;49;68;159;71;88;581;363;218;190.0;188.0;149.0;127.0;759.0;895.0;553
5640;Lisse;2014;21846;4852;12864;4130;18896;1815;869;946;1135;636;499;151;69;82;106;70;36;121;52;69;160;74;86;597;371;226;191.0;192.0;150.0;122.0;791.0;889.0;553
5641;Lisse;2015;21777;4753;12787;4237;18783;1821;875;946;1173;645;528;157;70;87;108;72;36;136;56;80;163;70;93;609;377;232;192.0;196.0;144.0;126.0;785.0;856.0;553
5642;Lisse;2016;21723;4692;12673;4358;18680;1841;886;955;1202;668;534;170;80;90;108;73;35;142;54;88;160;77;83;622;384;238;188.0;200.0;147.0;127.0;863.0;868.0;553
5643;Lisse;2017;21729;4617;12642;4470;18634;1843;913;930;1252;691;561;188;86;102;112;76;36;145;56;89;162;78;84;645;395;250;193.0;211.0;153.0;120.0;837.0;864.0;553
5644;Lisse;2018;21720;4584;12558;4578;18511;1909;952;957;1300;694;606;190;89;101;122;81;41;165;58;107;167;80;87;656;386;270;194.0;206.0;148.0;124.0;842.0;881.0;553
5645;Lisse;2019;21697;4517;12533;4647;18422;1925;958;967;1350;731;619;193;93;100;127;85;42;179;67;112;179;88;91;672;398;274;200.0;205.0;148.0;120.0;857.0;879.0;553
5646;Lisse;2020;21700;4482;12477;4741;18372;1939;977;962;1389;749;640;204;98;106;134;89;45;181;64;117;189;89;100;681;409;272;200.0;208.0;139.0;113.0;936.0;869.0;553
5647;Lisse;2021;21785;4431;12517;4837;18376;1982;998;984;1427;762;665;215;99;116;140;92;48;180;60;120;193;89;104;699;422;277;203.0;212.0;150.0;120.0;876.0;892.0;553
5648;Lisse;2022;21792;4390;12512;4890;18285;2014;1020;994;1493;791;702;223;105;118;145;96;49;196;69;127;197;92;105;732;429;303;205.0;220.0;146.0;118.0;848.0;878.0;553
5649;Lisse;2023;21778;4365;12406;5007;18222;2025;1051;974;1531;824;707;230;111;119;147;94;53;197;80;117;212;104;108;745;435;310;213.0;224.0;140.0;123.0;808.0;878.0;553
5650;Lisse;2024;21713;4332;12285;5096;18080;2066;1084;982;1567;827;740;231;109;122;146;88;58;213;88;125;227;107;120;750;435;315;212.0;225.0;147.0;119.0;938.0;875.0;553
5651;Lisse;2025;21791;4317;12281;5193;18098;2074;1090;984;1619;864;755;230;106;124;156;96;60;219;87;132;225;114;111;789;461;328;;;;;;;553
5652;Lith;2008;6716;1789;4111;816;6344;255;74;181;117;59;58;19;8;11;9;2;7;29;13;16;7;1;6;53;35;18;68.0;45.0;17.0;26.0;251.0;241.0;808
5653;Lith;2009;6740;1781;4126;833;6342;258;75;183;140;73;67;21;8;13;12;4;8;32;15;17;7;2;5;68;44;24;66.0;44.0;19.0;24.0;98.0;260.0;808
5654;Lith;2010;6596;1697;4027;872;6207;249;73;176;140;68;72;20;6;14;12;3;9;35;14;21;7;2;5;66;43;23;60.0;49.0;17.0;25.0;102.0;247.0;808
5655;Lith;2011;6455;1624;3936;895;6064;245;68;177;146;73;73;21;8;13;12;3;9;37;15;22;11;5;6;65;42;23;55.0;49.0;15.0;23.0;214.0;235.0;808
5656;Lith;2012;6432;1566;3896;970;6032;249;68;181;151;75;76;20;8;12;13;3;10;40;17;23;12;4;8;66;43;23;55.0;49.0;16.0;21.0;219.0;237.0;808
5657;Lith;2013;6416;1529;3843;1044;6006;245;68;177;165;81;84;23;10;13;14;3;11;41;18;23;15;4;11;72;46;26;53.0;52.0;17.0;22.0;252.0;244.0;808
5658;Lith;2014;6421;1489;3832;1100;5988;244;65;179;189;93;96;24;11;13;16;3;13;46;20;26;19;5;14;84;54;30;54.0;54.0;16.0;24.0;262.0;245.0;808
5659;Lith;2015;6431;1467;3833;1131;5984;249;64;185;198;98;100;30;13;17;21;6;15;50;21;29;16;5;11;81;53;28;55.0;54.0;18.0;22.0;261.0;242.0;808
5660;Lith;2016;6449;1427;3841;1181;5992;253;67;186;204;105;99;31;15;16;24;8;16;52;22;30;18;5;13;79;55;24;58.0;57.0;16.0;24.0;249.0;241.0;808
5661;Lith;2017;6451;1400;3819;1232;5989;261;71;190;201;101;100;31;16;15;21;6;15;50;21;29;22;6;16;77;52;25;57.0;57.0;22.0;23.0;290.0;241.0;808
5662;Lith;2018;6499;1398;3830;1271;5999;274;85;189;226;119;107;36;17;19;20;8;12;53;24;29;28;10;18;89;60;29;58.0;60.0;15.0;23.0;224.0;264.0;808
5663;Lith;2019;6450;1358;3773;1319;5942;271;80;191;237;121;116;39;17;22;21;8;13;56;24;32;29;11;18;92;61;31;62.0;60.0;23.0;23.0;272.0;246.0;808
5664;Lith;2020;6479;1324;3794;1361;5950;273;84;189;256;139;117;42;21;21;25;11;14;58;26;32;31;14;17;100;67;33;60.0;61.0;22.0;22.0;229.0;252.0;808
5665;Lith;2021;6457;1289;3765;1403;5919;278;89;189;260;139;121;38;19;19;27;12;15;62;26;36;30;14;16;103;68;35;63.0;64.0;15.0;23.0;280.0;247.0;808
5666;Lith;2022;6482;1301;3748;1433;5925;291;94;197;266;140;126;37;20;17;27;13;14;68;29;39;32;14;18;102;64;38;66.0;63.0;19.0;21.0;256.0;245.0;808
5667;Lith;2023;6495;1268;3731;1496;5906;314;104;210;275;143;132;38;20;18;30;15;15;71;30;41;37;17;20;99;61;38;67.0;66.0;15.0;23.0;282.0;259.0;808
5668;Lith;2024;6512;1257;3732;1523;5908;314;100;214;290;149;141;36;18;18;36;18;18;74;32;42;41;19;22;103;62;41;66.0;72.0;21.0;22.0;310.0;253.0;808
5669;Lith;2025;6563;1263;3711;1589;5933;325;106;219;305;148;157;36;18;18;36;16;20;80;33;47;49;20;29;104;61;43;;;;;;;808
5670;Littenseradiel;2008;10913;3003;6519;1391;10379;395;104;291;139;84;55;24;11;13;10;2;8;14;3;11;11;7;4;80;61;19;115.0;85.0;19.0;33.0;467.0;504.0;140
5671;Littenseradiel;2009;10894;2920;6509;1465;10368;382;103;279;144;89;55;24;13;11;10;4;6;18;5;13;17;9;8;75;58;17;113.0;86.0;18.0;33.0;420.0;489.0;140
5672;Littenseradiel;2010;10838;2826;6481;1531;10303;384;97;287;151;97;54;24;14;10;10;4;6;27;11;16;18;10;8;72;58;14;111.0;91.0;21.0;34.0;528.0;466.0;140
5673;Littenseradiel;2011;10909;2777;6539;1593;10346;388;103;285;175;116;59;32;17;15;10;6;4;30;15;15;22;12;10;81;66;15;111.0;92.0;25.0;32.0;509.0;463.0;140
5674;Littenseradiel;2012;10968;2718;6557;1693;10380;395;104;291;193;126;67;36;18;18;10;6;4;30;17;13;30;16;14;87;69;18;107.0;95.0;22.0;29.0;424.0;474.0;140
5675;Littenseradiel;2013;10924;2629;6495;1800;10324;397;111;286;203;127;76;39;21;18;9;6;3;36;19;17;31;16;15;88;65;23;107.0;97.0;27.0;31.0;486.0;470.0;140
5676;Littenseradiel;2014;10946;2555;6531;1860;10320;400;108;292;226;139;87;41;22;19;13;8;5;45;19;26;32;17;15;95;73;22;104.0;98.0;21.0;28.0;450.0;470.0;140
5677;Littenseradiel;2015;10926;2483;6503;1940;10290;394;104;290;242;141;101;43;23;20;16;9;7;45;19;26;32;14;18;106;76;30;105.0;101.0;23.0;32.0;495.0;452.0;140
5678;Littenseradiel;2016;10966;2449;6512;2005;10318;394;108;286;254;146;108;49;28;21;21;12;9;41;18;23;30;16;14;113;72;41;108.0;104.0;25.0;30.0;393.0;489.0;140
5679;Littenseradiel;2017;10871;2360;6464;2047;10206;392;101;291;273;154;119;50;30;20;19;11;8;52;20;32;34;15;19;118;78;40;110.0;104.0;21.0;31.0;464.0;461.0;140
5680;Littenseradiel;2018;10872;2309;6477;2086;10212;372;91;281;288;163;125;56;34;22;18;10;8;52;22;30;36;16;20;126;81;45;104.0;104.0;21.0;31.0;465.0;477.0;140
5681;Littenseradiel;2019;10850;2245;6441;2164;10165;379;94;285;306;178;128;59;35;24;22;14;8;53;22;31;34;16;18;138;91;47;109.0;105.0;20.0;36.0;446.0;488.0;140
5682;Littenseradiel;2020;10795;2180;6392;2223;10098;382;97;285;315;177;138;59;34;25;23;13;10;61;25;36;37;17;20;135;88;47;110.0;112.0;26.0;33.0;500.0;506.0;140
5683;Littenseradiel;2021;10780;2130;6375;2275;10069;393;106;287;318;178;140;60;31;29;24;15;9;66;30;36;39;18;21;129;84;45;110.0;110.0;22.0;30.0;484.0;484.0;140
5684;Littenseradiel;2022;10772;2096;6336;2340;10024;398;112;286;350;184;166;62;30;32;29;15;14;72;30;42;43;19;24;144;90;54;108.0;112.0;26.0;30.0;489.0;493.0;140
5685;Littenseradiel;2023;10761;2044;6306;2411;10001;378;102;276;382;206;176;70;35;35;31;17;14;76;32;44;48;20;28;157;102;55;111.0;113.0;28.0;31.0;485.0;482.0;140
5686;Littenseradiel;2024;10761;1996;6275;2490;9971;384;116;268;406;219;187;70;36;34;40;23;17;75;32;43;47;21;26;174;107;67;106.0;115.0;22.0;32.0;509.0;477.0;140
5687;Littenseradiel;2025;10775;1981;6232;2562;9986;390;119;271;399;212;187;68;34;34;42;25;17;72;31;41;43;20;23;174;102;72;;;;;;;140
5688;Lochem;2008;32351;7274;18180;6897;29355;1789;582;1207;1207;678;529;96;47;49;62;22;40;343;191;152;269;135;134;437;283;154;232.0;329.0;71.0;118.0;1245.0;1195.0;262
5689;Lochem;2009;32262;7091;18149;7022;29221;1798;583;1215;1243;692;551;100;51;49;74;35;39;356;194;162;270;134;136;443;278;165;234.0;330.0;87.0;118.0;1380.0;1202.0;262
5690;Lochem;2010;32316;6950;18234;7132;29205;1818;568;1250;1293;726;567;103;58;45;81;38;43;368;198;170;283;137;146;458;295;163;226.0;333.0;91.0;118.0;1243.0;1207.0;262
5691;Lochem;2011;32221;6768;18236;7217;29065;1828;558;1270;1328;745;583;119;68;51;84;40;44;362;197;165;298;142;156;465;298;167;226.0;334.0;90.0;113.0;1195.0;1207.0;262
5692;Lochem;2012;32081;6602;18046;7433;28878;1839;557;1282;1364;757;607;130;71;59;91;46;45;359;194;165;307;146;161;477;300;177;228.0;345.0;90.0;113.0;1358.0;1179.0;262
5693;Lochem;2013;32120;6490;17953;7677;28858;1854;570;1284;1408;778;630;143;74;69;99;48;51;359;198;161;319;149;170;488;309;179;230.0;344.0;84.0;110.0;1196.0;1225.0;262
5694;Lochem;2014;31955;6337;17835;7783;28676;1879;588;1291;1400;767;633;148;74;74;97;46;51;351;198;153;307;142;165;497;307;190;232.0;350.0;96.0;105.0;1197.0;1204.0;262
5695;Lochem;2015;31824;6228;17747;7849;28488;1881;578;1303;1455;807;648;165;79;86;105;57;48;364;208;156;306;139;167;515;324;191;235.0;353.0;82.0;115.0;1278.0;1251.0;262
5696;Lochem;2016;31703;6091;17637;7975;28314;1904;598;1306;1485;828;657;167;83;84;107;59;48;370;213;157;314;142;172;527;331;196;245.0;360.0;93.0;116.0;1292.0;1267.0;262
5697;Lochem;2017;31594;5994;17554;8046;28179;1901;583;1318;1514;831;683;181;85;96;107;61;46;383;209;174;313;141;172;530;335;195;245.0;351.0;81.0;101.0;1452.0;1263.0;262
5698;Lochem;2018;31659;5947;17517;8195;28200;1921;598;1323;1538;833;705;186;93;93;112;65;47;385;207;178;321;140;181;534;328;206;260.0;361.0;102.0;109.0;1212.0;1255.0;262
5699;Lochem;2019;31509;5846;17399;8264;27999;1942;611;1331;1568;852;716;200;95;105;122;72;50;381;212;169;321;138;183;544;335;209;256.0;361.0;78.0;108.0;1273.0;1238.0;262
5700;Lochem;2020;31413;5740;17286;8387;27892;1903;597;1306;1618;871;747;206;97;109;132;79;53;395;218;177;324;138;186;561;339;222;258.0;366.0;85.0;107.0;1197.0;1234.0;262
5701;Lochem;2021;31249;5644;17109;8496;27687;1921;598;1323;1641;873;768;204;93;111;133;78;55;404;222;182;326;139;187;574;341;233;260.0;365.0;83.0;104.0;1269.0;1232.0;262
5702;Lochem;2022;31164;5565;17051;8548;27546;1917;600;1317;1701;891;810;214;95;119;135;78;57;416;227;189;341;141;200;595;350;245;268.0;363.0;84.0;105.0;1230.0;1235.0;262
5703;Lochem;2023;31044;5427;16967;8650;27398;1943;613;1330;1703;891;812;222;94;128;144;85;59;415;227;188;333;140;193;589;345;244;272.0;363.0;88.0;96.0;1187.0;1206.0;262
5704;Lochem;2024;30929;5391;16815;8723;27276;1950;597;1353;1703;897;806;222;94;128;147;89;58;411;229;182;339;142;197;584;343;241;271.0;367.0;89.0;100.0;1246.0;1196.0;262
5705;Lochem;2025;30872;5375;16655;8842;27193;1947;600;1347;1732;921;811;231;98;133;157;96;61;409;229;180;341;143;198;594;355;239;;;;;;;262
5706;Loenen;2008;8153;1980;4755;1418;7033;752;267;485;368;194;174;59;28;31;37;16;21;65;31;34;30;15;15;177;104;73;62.0;77.0;27.0;39.0;414.0;411.0;329
5707;Loenen;2009;8130;1941;4751;1438;6996;749;266;483;385;205;180;65;28;37;39;18;21;65;34;31;33;15;18;183;110;73;60.0;73.0;29.0;38.0;480.0;408.0;329
5708;Loenen;2010;8181;1898;4811;1472;7035;755;271;484;391;201;190;69;29;40;38;19;19;61;31;30;41;16;25;182;106;76;64.0;78.0;38.0;36.0;397.0;436.0;329
5709;Loenen;2011;8131;1841;4811;1479;6940;763;282;481;428;208;220;74;36;38;39;19;20;64;29;35;54;16;38;197;108;89;63.0;75.0;36.0;39.0;397.0;437.0;329
5710;Loenen;2012;8077;1786;4750;1541;6891;743;267;476;443;220;223;76;38;38;41;19;22;69;33;36;57;16;41;200;114;86;65.0;77.0;29.0;37.0;428.0;444.0;329
5711;Loenen;2013;8042;1752;4714;1576;6837;756;266;490;449;213;236;75;36;39;42;18;24;68;29;39;57;16;41;207;114;93;66.0;74.0;32.0;37.0;431.0;429.0;329
5712;Loenen;2014;8032;1718;4690;1624;6799;770;277;493;463;216;247;77;35;42;41;17;24;73;31;42;59;16;43;213;117;96;65.0;77.0;29.0;35.0;430.0;437.0;329
5713;Loenen;2015;8009;1676;4689;1644;6760;772;278;494;477;217;260;83;38;45;39;16;23;79;32;47;70;18;52;206;113;93;69.0;76.0;33.0;38.0;404.0;419.0;329
5714;Loenen;2016;7983;1603;4708;1672;6718;768;278;490;497;230;267;92;39;53;44;19;25;87;33;54;66;21;45;208;118;90;67.0;79.0;33.0;32.0;398.0;429.0;329
5715;Loenen;2017;7942;1564;4685;1693;6670;786;282;504;486;232;254;90;39;51;40;19;21;83;34;49;76;25;51;197;115;82;69.0;78.0;31.0;33.0;398.0;447.0;329
5716;Loenen;2018;7883;1515;4634;1734;6599;788;287;501;496;240;256;89;42;47;39;19;20;86;31;55;78;25;53;204;123;81;73.0;80.0;27.0;32.0;406.0;418.0;329
5717;Loenen;2019;7860;1476;4606;1778;6560;788;298;490;512;245;267;87;44;43;42;21;21;88;30;58;81;28;53;214;122;92;70.0;79.0;28.0;35.0;435.0;441.0;329
5718;Loenen;2020;7839;1453;4580;1806;6534;784;294;490;521;258;263;86;44;42;42;21;21;89;32;57;78;29;49;226;132;94;73.0;82.0;28.0;37.0;388.0;420.0;329
5719;Loenen;2021;7791;1408;4566;1817;6485;779;296;483;527;270;257;85;45;40;41;22;19;87;33;54;74;26;48;240;144;96;71.0;81.0;28.0;36.0;409.0;414.0;329
5720;Loenen;2022;7769;1392;4534;1843;6466;778;300;478;525;264;261;79;39;40;40;19;21;86;34;52;84;30;54;236;142;94;77.0;85.0;29.0;33.0;394.0;416.0;329
5721;Loenen;2023;7736;1362;4496;1878;6418;774;289;485;544;266;278;80;39;41;44;22;22;95;35;60;86;29;57;239;141;98;82.0;84.0;31.0;30.0;407.0;430.0;329
5722;Loenen;2024;7713;1351;4431;1931;6378;786;290;496;549;270;279;87;42;45;46;25;21;99;37;62;82;27;55;235;139;96;72.0;84.0;26.0;33.0;424.0;414.0;329
5723;Loenen;2025;7705;1348;4413;1944;6368;783;291;492;554;283;271;90;46;44;48;28;20;91;35;56;84;29;55;241;145;96;;;;;;;329
5724;Loon op Zand;2008;22650;5381;13715;3554;20692;1174;420;754;784;440;344;115;70;45;48;18;30;238;113;125;50;16;34;333;223;110;201.0;190.0;82.0;106.0;618.0;834.0;809
5725;Loon op Zand;2009;22423;5225;13576;3622;20456;1165;412;753;802;453;349;116;70;46;49;22;27;238;115;123;51;19;32;348;227;121;193.0;194.0;82.0;103.0;704.0;856.0;809
5726;Loon op Zand;2010;22252;5072;13517;3663;20263;1155;412;743;834;469;365;108;63;45;53;25;28;250;117;133;61;24;37;362;240;122;192.0;197.0;84.0;106.0;761.0;864.0;809
5727;Loon op Zand;2011;22125;4917;13470;3738;20092;1182;422;760;851;476;375;113;62;51;48;24;24;256;117;139;58;24;34;376;249;127;191.0;195.0;106.0;103.0;877.0;882.0;809
5728;Loon op Zand;2012;22121;4851;13353;3917;20010;1209;445;764;902;498;404;117;66;51;61;31;30;265;122;143;68;25;43;391;254;137;187.0;203.0;92.0;100.0;851.0;882.0;809
5729;Loon op Zand;2013;22070;4746;13210;4114;19899;1212;442;770;959;524;435;126;67;59;65;31;34;277;123;154;89;36;53;402;267;135;187.0;204.0;108.0;105.0;760.0;900.0;809
5730;Loon op Zand;2014;21916;4603;13068;4245;19708;1222;441;781;986;534;452;129;69;60;71;34;37;282;124;158;94;40;54;410;267;143;187.0;208.0;92.0;100.0;885.0;883.0;809
5731;Loon op Zand;2015;21891;4537;12945;4409;19603;1247;457;790;1041;554;487;137;76;61;74;36;38;286;120;166;107;43;64;437;279;158;190.0;213.0;97.0;97.0;839.0;872.0;809
5732;Loon op Zand;2016;21837;4398;12899;4540;19483;1285;478;807;1069;578;491;142;77;65;78;41;37;288;126;162;115;48;67;446;286;160;190.0;214.0;92.0;97.0;908.0;868.0;809
5733;Loon op Zand;2017;21849;4319;12874;4656;19437;1299;474;825;1113;606;507;149;82;67;75;40;35;294;127;167;127;54;73;468;303;165;191.0;220.0;97.0;94.0;923.0;869.0;809
5734;Loon op Zand;2018;21879;4259;12835;4785;19431;1295;469;826;1153;625;528;156;80;76;78;42;36;304;131;173;128;54;74;487;318;169;198.0;220.0;96.0;92.0;927.0;882.0;809
5735;Loon op Zand;2019;21908;4208;12804;4896;19407;1291;467;824;1210;640;570;154;75;79;78;42;36;326;135;191;139;55;84;513;333;180;204.0;229.0;92.0;93.0;869.0;878.0;809
5736;Loon op Zand;2020;21877;4146;12722;5009;19331;1308;478;830;1238;649;589;156;75;81;84;48;36;323;136;187;157;57;100;518;333;185;200.0;234.0;90.0;95.0;830.0;900.0;809
5737;Loon op Zand;2021;21774;4108;12561;5105;19182;1325;497;828;1267;660;607;152;75;77;80;44;36;326;136;190;162;60;102;547;345;202;202.0;232.0;104.0;99.0;876.0;885.0;809
5738;Loon op Zand;2022;21741;4020;12526;5195;19103;1314;486;828;1324;697;627;159;77;82;79;44;35;329;143;186;167;61;106;590;372;218;206.0;235.0;95.0;98.0;933.0;871.0;809
5739;Loon op Zand;2023;21777;3983;12507;5287;19082;1317;483;834;1378;725;653;163;77;86;80;46;34;336;146;190;174;62;112;625;394;231;218.0;244.0;93.0;93.0;982.0;869.0;809
5740;Loon op Zand;2024;21865;3990;12441;5434;19119;1334;509;825;1412;743;669;170;82;88;80;47;33;344;140;204;178;64;114;640;410;230;212.0;250.0;102.0;95.0;949.0;896.0;809
5741;Loon op Zand;2025;21888;3983;12392;5513;19061;1358;518;840;1469;778;691;187;92;95;82;45;37;343;136;207;187;69;118;670;436;234;;;;;;;809
5742;Lopik;2008;13925;4016;8283;1626;12967;460;166;294;498;286;212;40;23;17;15;9;6;26;14;12;195;108;87;222;132;90;158.0;87.0;32.0;51.0;385.0;501.0;331
5743;Lopik;2009;13861;3938;8238;1685;12886;470;166;304;505;294;211;43;25;18;16;12;4;39;22;17;191;105;86;216;130;86;153.0;89.0;38.0;52.0;422.0;525.0;331
5744;Lopik;2010;13808;3868;8186;1754;12783;481;172;309;544;318;226;54;30;24;21;14;7;42;23;19;193;104;89;234;147;87;153.0;94.0;37.0;50.0;346.0;508.0;331
5745;Lopik;2011;13693;3776;8119;1798;12639;486;170;316;568;335;233;61;36;25;20;13;7;50;27;23;198;110;88;239;149;90;142.0;92.0;40.0;50.0;383.0;486.0;331
5746;Lopik;2012;13630;3657;8097;1876;12548;499;175;324;583;341;242;68;39;29;22;15;7;58;29;29;205;112;93;230;146;84;142.0;95.0;45.0;50.0;413.0;495.0;331
5747;Lopik;2013;13592;3578;8039;1975;12458;509;176;333;625;360;265;74;42;32;26;16;10;67;32;35;206;113;93;252;157;95;147.0;98.0;39.0;48.0;420.0;481.0;331
5748;Lopik;2014;13573;3516;7991;2066;12395;525;182;343;653;365;288;79;42;37;29;17;12;76;33;43;213;116;97;256;157;99;141.0;98.0;46.0;46.0;332.0;484.0;331
5749;Lopik;2015;13465;3432;7909;2124;12269;514;185;329;682;372;310;83;44;39;30;18;12;83;35;48;222;117;105;264;158;106;138.0;102.0;52.0;45.0;349.0;489.0;331
5750;Lopik;2016;13366;3319;7862;2185;12120;522;190;332;724;396;328;87;52;35;35;18;17;99;41;58;233;120;113;270;165;105;137.0;107.0;36.0;45.0;358.0;471.0;331
5751;Lopik;2017;13276;3222;7794;2260;12016;519;190;329;741;397;344;93;51;42;36;20;16;100;41;59;244;122;122;268;163;105;134.0;107.0;41.0;42.0;332.0;463.0;331
5752;Lopik;2018;13173;3121;7680;2372;11899;536;206;330;738;398;340;95;52;43;36;20;16;97;39;58;241;119;122;269;168;101;136.0;110.0;42.0;44.0;453.0;465.0;331
5753;Lopik;2019;13187;3025;7729;2433;11876;548;215;333;763;412;351;103;56;47;36;20;16;97;39;58;247;124;123;280;173;107;138.0;111.0;40.0;42.0;361.0;485.0;331
5754;Lopik;2020;13089;2959;7633;2497;11749;555;222;333;785;424;361;104;58;46;47;23;24;102;41;61;248;126;122;284;176;108;136.0;117.0;34.0;40.0;265.0;480.0;331
5755;Lopik;2021;12887;2859;7479;2549;11557;548;214;334;782;424;358;109;63;46;49;25;24;93;35;58;248;124;124;283;177;106;134.0;115.0;39.0;41.0;367.0;468.0;331
5756;Lopik;2022;12803;2779;7420;2604;11439;571;222;349;793;418;375;110;61;49;50;26;24;105;38;67;243;122;121;285;171;114;133.0;116.0;38.0;39.0;376.0;476.0;331
5757;Lopik;2023;12721;2695;7369;2657;11346;565;217;348;810;425;385;118;64;54;51;27;24;104;37;67;249;125;124;288;172;116;129.0;118.0;37.0;40.0;496.0;458.0;331
5758;Lopik;2024;12767;2661;7370;2736;11338;578;214;364;851;447;404;118;66;52;53;28;25;114;38;76;259;134;125;307;181;126;136.0;124.0;42.0;42.0;448.0;479.0;331
5759;Lopik;2025;12749;2626;7327;2796;11279;582;219;363;888;470;418;123;67;56;52;31;21;126;45;81;268;141;127;319;186;133;;;;;;;331
5760;Loppersum;2008;10565;2594;6436;1535;9894;445;157;288;226;132;94;35;22;13;47;25;22;20;7;13;10;4;6;114;74;40;93.0;95.0;23.0;31.0;474.0;600.0;24
5761;Loppersum;2009;10432;2517;6363;1552;9730;446;159;287;256;149;107;41;24;17;52;29;23;22;8;14;12;5;7;129;83;46;97.0;97.0;26.0;29.0;507.0;608.0;24
5762;Loppersum;2010;10331;2444;6318;1569;9612;437;153;284;282;164;118;37;22;15;59;34;25;31;10;21;15;5;10;140;93;47;93.0;93.0;27.0;31.0;461.0;612.0;24
5763;Loppersum;2011;10178;2351;6215;1612;9439;444;159;285;295;173;122;46;23;23;63;36;27;33;13;20;16;7;9;137;94;43;96.0;93.0;23.0;25.0;490.0;602.0;24
5764;Loppersum;2012;10069;2277;6135;1657;9291;443;163;280;335;204;131;46;24;22;69;40;29;37;15;22;27;11;16;156;114;42;95.0;91.0;28.0;27.0;476.0;594.0;24
5765;Loppersum;2013;9958;2208;6014;1736;9157;456;172;284;345;211;134;43;24;19;68;38;30;45;17;28;32;14;18;157;118;39;93.0;93.0;27.0;30.0;496.0;597.0;24
5766;Loppersum;2014;9858;2146;5925;1787;9042;452;167;285;364;225;139;48;28;20;75;43;32;53;19;34;32;14;18;156;121;35;92.0;94.0;22.0;29.0;462.0;596.0;24
5767;Loppersum;2015;9717;2060;5833;1824;8886;469;172;297;362;218;144;50;30;20;72;42;30;52;21;31;33;14;19;155;111;44;91.0;94.0;27.0;28.0;482.0;572.0;24
5768;Loppersum;2016;9627;2002;5760;1865;8780;464;175;289;383;230;153;55;33;22;73;45;28;59;24;35;32;15;17;164;113;51;94.0;93.0;22.0;25.0;440.0;585.0;24
5769;Loppersum;2017;9482;1964;5629;1889;8621;457;169;288;404;237;167;56;36;20;75;43;32;66;24;42;35;18;17;172;116;56;90.0;95.0;24.0;23.0;437.0;554.0;24
5770;Loppersum;2018;9362;1907;5511;1944;8492;445;172;273;425;251;174;59;39;20;75;43;32;73;29;44;36;18;18;182;122;60;84.0;94.0;24.0;27.0;436.0;563.0;24
5771;Loppersum;2019;9224;1832;5408;1984;8378;426;166;260;420;251;169;52;36;16;74;44;30;73;30;43;49;21;28;172;120;52;89.0;94.0;26.0;23.0;437.0;534.0;24
5772;Loppersum;2020;9127;1794;5320;2013;8259;426;168;258;442;261;181;57;37;20;73;42;31;78;32;46;50;24;26;184;126;58;86.0;96.0;23.0;24.0;436.0;522.0;24
5773;Loppersum;2021;9031;1765;5216;2050;8163;421;162;259;447;259;188;57;38;19;72;44;28;79;35;44;60;25;35;179;117;62;88.0;97.0;20.0;23.0;446.0;526.0;24
5774;Loppersum;2022;8940;1701;5170;2069;8067;415;166;249;458;253;205;55;35;20;73;44;29;82;35;47;69;26;43;179;113;66;86.0;94.0;18.0;24.0;415.0;514.0;24
5775;Loppersum;2023;8828;1664;5051;2113;7945;419;170;249;464;249;215;59;38;21;69;40;29;85;36;49;73;24;49;178;111;67;88.0;98.0;20.0;24.0;431.0;501.0;24
5776;Loppersum;2024;8744;1638;4969;2137;7859;411;159;252;474;246;228;60;38;22;63;37;26;86;33;53;78;24;54;187;114;73;86.0;97.0;19.0;21.0;409.0;501.0;24
5777;Loppersum;2025;8639;1624;4853;2162;7761;399;157;242;479;246;233;59;37;22;67;36;31;90;31;59;78;26;52;185;116;69;;;;;;;24
5778;Losser;2008;21789;5125;13052;3612;18621;2618;743;1875;550;334;216;57;35;22;24;10;14;205;107;98;19;9;10;245;173;72;192.0;191.0;59.0;85.0;558.0;658.0;168
5779;Losser;2009;21668;4974;13006;3688;18504;2546;731;1815;618;378;240;69;44;25;29;14;15;212;111;101;29;17;12;279;192;87;188.0;194.0;59.0;79.0;483.0;654.0;168
5780;Losser;2010;21475;4787;12935;3753;18339;2470;700;1770;666;408;258;76;47;29;30;14;16;207;111;96;45;26;19;308;210;98;180.0;197.0;62.0;86.0;613.0;591.0;168
5781;Losser;2011;21457;4675;12909;3873;18319;2401;683;1718;737;449;288;84;52;32;35;17;18;228;119;109;52;28;24;338;233;105;182.0;193.0;67.0;77.0;561.0;574.0;168
5782;Losser;2012;21424;4553;12847;4024;18286;2343;666;1677;795;470;325;95;55;40;36;17;19;237;120;117;62;33;29;365;245;120;181.0;199.0;75.0;87.0;695.0;601.0;168
5783;Losser;2013;21488;4453;12874;4161;18332;2292;653;1639;864;495;369;106;59;47;39;18;21;247;124;123;77;41;36;395;253;142;188.0;210.0;71.0;78.0;600.0;607.0;168
5784;Losser;2014;21455;4374;12788;4293;18299;2238;653;1585;918;525;393;111;64;47;52;26;26;246;120;126;90;47;43;419;268;151;190.0;207.0;73.0;78.0;609.0;585.0;168
5785;Losser;2015;21458;4266;12769;4423;18296;2208;638;1570;954;548;406;120;71;49;54;26;28;255;121;134;97;49;48;428;281;147;189.0;218.0;79.0;80.0;651.0;643.0;168
5786;Losser;2016;21439;4195;12715;4529;18261;2166;634;1532;1012;572;440;118;68;50;60;30;30;268;128;140;108;55;53;458;291;167;185.0;220.0;71.0;70.0;514.0;678.0;168
5787;Losser;2017;21245;4097;12521;4627;18101;2107;621;1486;1037;586;451;122;73;49;63;34;29;271;129;142;108;52;56;473;298;175;188.0;219.0;61.0;74.0;674.0;645.0;168
5788;Losser;2018;21231;4020;12460;4751;18094;2075;613;1462;1062;590;472;127;75;52;64;34;30;276;132;144;112;50;62;483;299;184;195.0;219.0;71.0;76.0;595.0;632.0;168
5789;Losser;2019;21167;3965;12324;4878;18026;2028;602;1426;1113;610;503;134;80;54;69;36;33;281;132;149;121;53;68;508;309;199;187.0;222.0;70.0;69.0;663.0;618.0;168
5790;Losser;2020;21180;3898;12303;4979;18049;1984;594;1390;1147;620;527;137;76;61;72;39;33;291;132;159;125;58;67;522;315;207;194.0;236.0;62.0;71.0;654.0;650.0;168
5791;Losser;2021;21136;3784;12246;5106;18030;1925;580;1345;1181;626;555;144;76;68;69;36;33;297;133;164;138;62;76;533;319;214;201.0;236.0;70.0;67.0;709.0;644.0;168
5792;Losser;2022;21170;3743;12226;5201;18018;1927;601;1326;1225;638;587;160;84;76;69;36;33;305;134;171;146;65;81;545;319;226;202.0;238.0;76.0;69.0;607.0;646.0;168
5793;Losser;2023;21105;3710;12101;5294;17948;1889;596;1293;1268;669;599;180;95;85;73;37;36;306;141;165;149;66;83;560;330;230;199.0;241.0;62.0;64.0;720.0;632.0;168
5794;Losser;2024;21152;3688;12098;5366;17967;1890;607;1283;1295;675;620;181;98;83;78;42;36;306;138;168;159;66;93;571;331;240;202.0;248.0;66.0;65.0;684.0;630.0;168
5795;Losser;2025;21163;3677;12020;5466;17951;1864;605;1259;1348;696;652;189;105;84;79;46;33;310;139;171;163;67;96;607;339;268;;;;;;;168
5796;Maarssen;2008;38889;9299;24890;4700;32115;3268;1184;2084;3506;2010;1496;1030;578;452;247;135;112;318;152;166;745;369;376;1166;776;390;412.0;267.0;148.0;199.0;1788.0;2117.0;333
5797;Maarssen;2009;38658;9036;24746;4876;31834;3269;1206;2063;3555;2022;1533;1013;569;444;249;133;116;353;161;192;764;368;396;1176;791;385;401.0;278.0;154.0;197.0;1865.0;2150.0;333
5798;Maarssen;2010;38457;8832;24574;5051;31586;3265;1223;2042;3606;2061;1545;1006;567;439;256;139;117;387;180;207;773;376;397;1184;799;385;406.0;281.0;157.0;191.0;1857.0;2133.0;333
5799;Maarssen;2011;38277;8670;24359;5248;31390;3261;1247;2014;3626;2045;1581;1002;555;447;260;142;118;410;187;223;778;381;397;1176;780;396;396.0;283.0;164.0;191.0;1910.0;2131.0;333
5800;Maarssen;2012;38145;8426;24081;5638;31188;3255;1247;2008;3702;2062;1640;1007;551;456;249;140;109;439;192;247;801;385;416;1206;794;412;398.0;295.0;173.0;183.0;1883.0;2115.0;333
5801;Maarssen;2013;38009;8246;23748;6015;31000;3278;1254;2024;3731;2059;1672;980;547;433;254;151;103;472;205;267;818;381;437;1207;775;432;394.0;302.0;168.0;182.0;1903.0;2129.0;333
5802;Maarssen;2014;37863;8083;23469;6311;30781;3281;1276;2005;3801;2067;1734;971;544;427;253;152;101;510;207;303;861;382;479;1206;782;424;389.0;305.0;168.0;178.0;1902.0;2066.0;333
5803;Maarssen;2015;37777;7963;23217;6597;30588;3318;1295;2023;3871;2066;1805;954;535;419;272;155;117;528;207;321;886;382;504;1231;787;444;393.0;313.0;153.0;186.0;1929.0;2029.0;333
5804;Maarssen;2016;37730;7911;23033;6786;30421;3356;1324;2032;3953;2077;1876;935;521;414;278;161;117;570;212;358;915;396;519;1255;787;468;400.0;321.0;174.0;177.0;1889.0;2020.0;333
5805;Maarssen;2017;37680;7872;22826;6982;30277;3365;1349;2016;4038;2095;1943;956;529;427;289;168;121;595;213;382;941;401;540;1257;784;473;401.0;322.0;181.0;175.0;1933.0;2038.0;333
5806;Maarssen;2018;37667;7842;22568;7257;30161;3408;1377;2031;4098;2110;1988;950;523;427;283;168;115;622;219;403;965;404;561;1278;796;482;398.0;331.0;176.0;177.0;2044.0;2045.0;333
5807;Maarssen;2019;37736;7834;22423;7479;30093;3435;1404;2031;4208;2154;2054;953;516;437;292;175;117;659;239;420;978;406;572;1326;818;508;398.0;346.0;164.0;173.0;1985.0;2022.0;333
5808;Maarssen;2020;37745;7855;22244;7646;30024;3444;1412;2032;4277;2189;2088;948;510;438;301;179;122;673;244;429;992;408;584;1363;848;515;396.0;350.0;155.0;172.0;2092.0;2053.0;333
5809;Maarssen;2021;37817;7837;22179;7801;29965;3508;1456;2052;4344;2197;2147;942;504;438;321;184;137;688;241;447;1001;402;599;1392;866;526;404.0;351.0;168.0;180.0;2170.0;2064.0;333
5810;Maarssen;2022;37966;7856;22111;7999;29971;3565;1469;2096;4430;2230;2200;940;506;434;318;185;133;720;260;460;1021;404;617;1431;875;556;407.0;356.0;157.0;171.0;2179.0;2051.0;333
5811;Maarssen;2023;38135;7916;22038;8181;30017;3596;1478;2118;4522;2227;2295;952;507;445;325;181;144;737;261;476;1044;402;642;1464;876;588;397.0;363.0;172.0;169.0;2246.0;2053.0;333
5812;Maarssen;2024;38368;7940;22040;8388;30054;3702;1537;2165;4612;2252;2360;965;508;457;315;185;130;769;270;499;1045;399;646;1518;890;628;396.0;373.0;153.0;167.0;2299.0;2121.0;333
5813;Maarssen;2025;38557;7986;22032;8539;30117;3771;1582;2189;4669;2255;2414;968;504;464;317;183;134;788;279;509;1045;393;652;1551;896;655;;;;;;;333
5814;Maasbree;2008;12933;3238;8005;1690;11821;857;250;607;255;136;119;22;11;11;19;7;12;24;10;14;38;15;23;152;93;59;123.0;93.0;38.0;47.0;389.0;465.0;934
5815;Maasbree;2009;12881;3162;7958;1761;11735;870;264;606;276;150;126;26;13;13;20;8;12;35;13;22;43;20;23;152;96;56;119.0;92.0;46.0;48.0;426.0;464.0;934
5816;Maasbree;2010;12869;3081;7948;1840;11701;867;264;603;301;166;135;34;13;21;19;8;11;40;16;24;43;21;22;165;108;57;115.0;96.0;41.0;45.0;456.0;516.0;934
5817;Maasbree;2011;12825;2994;7913;1918;11609;883;276;607;333;181;152;32;13;19;23;12;11;48;17;31;58;27;31;172;112;60;113.0;102.0;41.0;46.0;481.0;512.0;934
5818;Maasbree;2012;12801;2929;7854;2018;11544;892;281;611;365;192;173;37;15;22;28;14;14;58;22;36;65;31;34;177;110;67;117.0;109.0;44.0;46.0;516.0;500.0;934
5819;Maasbree;2013;12823;2886;7802;2135;11512;925;302;623;386;204;182;39;16;23;27;13;14;61;23;38;72;33;39;187;119;68;115.0;108.0;51.0;47.0;523.0;522.0;934
5820;Maasbree;2014;12836;2820;7785;2231;11467;955;296;659;414;217;197;40;16;24;28;13;15;67;24;43;83;38;45;196;126;70;114.0;107.0;53.0;46.0;479.0;515.0;934
5821;Maasbree;2015;12816;2757;7705;2354;11416;961;304;657;439;232;207;43;18;25;28;13;15;79;28;51;85;37;48;204;136;68;118.0;111.0;45.0;46.0;519.0;536.0;934
5822;Maasbree;2016;12805;2706;7660;2439;11384;962;318;644;459;236;223;44;18;26;26;10;16;86;27;59;85;35;50;218;146;72;117.0;113.0;42.0;44.0;533.0;525.0;934
5823;Maasbree;2017;12816;2662;7620;2534;11374;969;316;653;473;236;237;47;16;31;33;13;20;84;29;55;89;33;56;220;145;75;120.0;120.0;44.0;44.0;498.0;510.0;934
5824;Maasbree;2018;12805;2640;7556;2609;11329;975;325;650;501;242;259;54;21;33;37;15;22;92;29;63;96;34;62;222;143;79;125.0;125.0;46.0;44.0;490.0;490.0;934
5825;Maasbree;2019;12808;2610;7541;2657;11292;985;332;653;531;265;266;56;21;35;33;14;19;99;35;64;99;37;62;244;158;86;129.0;126.0;42.0;45.0;550.0;528.0;934
5826;Maasbree;2020;12831;2611;7493;2727;11290;973;334;639;568;289;279;58;26;32;32;12;20;111;42;69;107;42;65;260;167;93;129.0;129.0;46.0;42.0;553.0;530.0;934
5827;Maasbree;2021;12858;2583;7476;2799;11256;984;333;651;618;323;295;65;32;33;41;18;23;120;46;74;107;41;66;285;186;99;128.0;130.0;44.0;48.0;555.0;521.0;934
5828;Maasbree;2022;12887;2580;7455;2852;11241;1000;348;652;646;337;309;73;39;34;47;20;27;127;49;78;109;41;68;290;188;102;133.0;134.0;50.0;46.0;548.0;525.0;934
5829;Maasbree;2023;12913;2596;7393;2924;11236;997;342;655;680;362;318;80;44;36;50;20;30;126;51;75;112;40;72;312;207;105;135.0;137.0;45.0;49.0;537.0;515.0;934
5830;Maasbree;2024;12930;2597;7371;2962;11216;1003;342;661;711;368;343;96;46;50;50;21;29;126;52;74;117;42;75;322;207;115;137.0;140.0;44.0;45.0;585.0;529.0;934
5831;Maasbree;2025;12982;2600;7342;3040;11209;1032;348;684;741;379;362;93;46;47;59;27;32;131;49;82;116;42;74;342;215;127;;;;;;;934
5832;Maasdonk;2008;11153;3031;6567;1555;10598;344;112;232;211;111;100;32;16;16;22;12;10;44;20;24;16;5;11;97;58;39;97.0;84.0;22.0;40.0;326.0;397.0;1671
5833;Maasdonk;2009;11078;2971;6521;1586;10466;355;113;242;257;134;123;42;17;25;22;11;11;47;22;25;20;7;13;126;77;49;94.0;86.0;27.0;43.0;349.0;413.0;1671
5834;Maasdonk;2010;11008;2923;6461;1624;10374;363;113;250;271;127;144;45;16;29;27;13;14;46;22;24;28;9;19;125;67;58;92.0;88.0;25.0;43.0;376.0;432.0;1671
5835;Maasdonk;2011;10940;2828;6454;1658;10285;376;113;263;279;132;147;48;20;28;26;13;13;44;23;21;31;8;23;130;68;62;96.0;89.0;26.0;39.0;399.0;430.0;1671
5836;Maasdonk;2012;10905;2767;6415;1723;10221;378;118;260;306;134;172;52;20;32;29;12;17;50;22;28;37;9;28;138;71;67;95.0;89.0;30.0;38.0;380.0;427.0;1671
5837;Maasdonk;2013;10858;2666;6424;1768;10133;380;126;254;345;154;191;52;23;29;31;14;17;62;27;35;38;8;30;162;82;80;97.0;92.0;28.0;37.0;392.0;438.0;1671
5838;Maasdonk;2014;10810;2598;6390;1822;10042;385;123;262;383;175;208;60;27;33;34;16;18;60;25;35;44;11;33;185;96;89;97.0;92.0;31.0;39.0;407.0;431.0;1671
5839;Maasdonk;2015;10785;2552;6355;1878;9975;405;137;268;405;178;227;67;31;36;40;20;20;67;26;41;50;16;34;181;85;96;95.0;96.0;28.0;38.0;485.0;435.0;1671
5840;Maasdonk;2016;10826;2492;6404;1930;9972;410;143;267;444;191;253;64;32;32;43;21;22;71;26;45;47;15;32;219;97;122;103.0;95.0;35.0;40.0;460.0;453.0;1671
5841;Maasdonk;2017;10836;2436;6427;1973;9935;431;156;275;470;195;275;70;35;35;50;25;25;74;26;48;53;15;38;223;94;129;106.0;99.0;30.0;39.0;515.0;457.0;1671
5842;Maasdonk;2018;10894;2420;6433;2041;9954;438;157;281;502;209;293;81;41;40;48;24;24;77;29;48;57;18;39;239;97;142;108.0;101.0;36.0;40.0;451.0;463.0;1671
5843;Maasdonk;2019;10886;2385;6417;2084;9907;444;160;284;535;220;315;82;43;39;54;23;31;83;31;52;56;16;40;260;107;153;113.0;104.0;31.0;44.0;501.0;454.0;1671
5844;Maasdonk;2020;10931;2341;6419;2171;9916;454;166;288;561;222;339;88;43;45;58;23;35;94;36;58;59;16;43;262;104;158;112.0;106.0;36.0;46.0;497.0;457.0;1671
5845;Maasdonk;2021;10969;2314;6418;2237;9932;461;167;294;576;232;344;82;42;40;57;21;36;96;37;59;65;18;47;276;114;162;118.0;107.0;31.0;40.0;470.0;480.0;1671
5846;Maasdonk;2022;10962;2314;6353;2295;9877;492;171;321;593;232;361;89;47;42;62;23;39;96;35;61;78;21;57;268;106;162;114.0;111.0;31.0;43.0;527.0;473.0;1671
5847;Maasdonk;2023;11010;2306;6334;2370;9886;504;180;324;620;240;380;95;50;45;66;24;42;96;36;60;87;22;65;276;108;168;122.0;113.0;31.0;41.0;524.0;474.0;1671
5848;Maasdonk;2024;11061;2319;6305;2437;9903;517;193;324;641;249;392;95;53;42;63;19;44;99;37;62;94;26;68;290;114;176;120.0;115.0;46.0;46.0;511.0;470.0;1671
5849;Maasdonk;2025;11108;2334;6267;2507;9909;515;196;319;684;270;414;99;57;42;67;20;47;107;36;71;99;28;71;312;129;183;;;;;;;1671
5850;Maasdriel;2008;23376;5856;14376;3144;21716;1094;413;681;566;331;235;72;36;36;29;9;20;58;37;21;143;73;70;264;176;88;231.0;181.0;48.0;85.0;657.0;743.0;263
5851;Maasdriel;2009;23305;5790;14269;3246;21577;1112;416;696;616;349;267;86;44;42;38;11;27;68;44;24;156;77;79;268;173;95;225.0;188.0;47.0;88.0;742.0;787.0;263
5852;Maasdriel;2010;23259;5699;14234;3326;21468;1128;425;703;663;377;286;92;47;45;45;16;29;85;59;26;167;78;89;274;177;97;211.0;189.0;64.0;79.0;730.0;807.0;263
5853;Maasdriel;2011;23192;5578;14216;3398;21319;1165;432;733;708;398;310;98;53;45;48;19;29;113;71;42;176;81;95;273;174;99;211.0;189.0;54.0;80.0;674.0;814.0;263
5854;Maasdriel;2012;23051;5455;14044;3552;21118;1179;435;744;754;420;334;106;54;52;56;26;30;119;79;40;184;81;103;289;180;109;204.0;197.0;60.0;78.0;858.0;798.0;263
5855;Maasdriel;2013;23103;5379;13999;3725;21102;1210;456;754;791;448;343;118;62;56;60;26;34;127;89;38;189;83;106;297;188;109;204.0;198.0;54.0;77.0;697.0;838.0;263
5856;Maasdriel;2014;22948;5252;13849;3847;20904;1225;467;758;819;462;357;118;65;53;66;30;36;141;96;45;187;80;107;307;191;116;200.0;199.0;51.0;80.0;822.0;800.0;263
5857;Maasdriel;2015;22945;5187;13766;3992;20844;1227;460;767;874;480;394;126;64;62;68;30;38;159;99;60;186;86;100;335;201;134;203.0;198.0;61.0;76.0;706.0;819.0;263
5858;Maasdriel;2016;22826;5076;13608;4142;20688;1222;468;754;916;504;412;127;68;59;73;31;42;166;102;64;197;89;108;353;214;139;203.0;204.0;58.0;84.0;860.0;800.0;263
5859;Maasdriel;2017;22862;5033;13544;4285;20655;1246;477;769;961;512;449;137;71;66;80;34;46;173;98;75;214;94;120;357;215;142;202.0;206.0;60.0;78.0;800.0;814.0;263
5860;Maasdriel;2018;22829;4930;13510;4389;20555;1256;478;778;1018;541;477;144;71;73;82;40;42;198;110;88;215;94;121;379;226;153;210.0;211.0;57.0;81.0;869.0;819.0;263
5861;Maasdriel;2019;22855;4867;13493;4495;20521;1267;489;778;1067;572;495;136;68;68;100;47;53;195;113;82;224;96;128;412;248;164;218.0;216.0;60.0;76.0;767.0;845.0;263
5862;Maasdriel;2020;22765;4782;13365;4618;20380;1280;487;793;1105;590;515;140;69;71;104;53;51;212;115;97;218;101;117;431;252;179;214.0;223.0;57.0;79.0;868.0;807.0;263
5863;Maasdriel;2021;22796;4703;13348;4745;20360;1290;496;794;1146;609;537;142;69;73;105;54;51;231;121;110;220;104;116;448;261;187;220.0;223.0;58.0;74.0;891.0;854.0;263
5864;Maasdriel;2022;22817;4643;13292;4882;20283;1344;525;819;1190;628;562;146;71;75;113;56;57;238;124;114;226;108;118;467;269;198;216.0;229.0;55.0;78.0;826.0;827.0;263
5865;Maasdriel;2023;22784;4560;13189;5035;20202;1339;513;826;1243;655;588;153;74;79;121;60;61;255;134;121;231;111;120;483;276;207;218.0;237.0;57.0;81.0;905.0;835.0;263
5866;Maasdriel;2024;22812;4519;13125;5168;20178;1351;508;843;1283;664;619;162;74;88;132;62;70;276;146;130;236;111;125;477;271;206;237.0;240.0;54.0;80.0;840.0;825.0;263
5867;Maasdriel;2025;22798;4491;13025;5282;20083;1382;517;865;1333;680;653;167;78;89;139;64;75;283;152;131;244;110;134;500;276;224;;;;;;;263
5868;Maasgouw;2008;23829;5036;14424;4369;20637;2675;753;1922;517;344;173;36;21;15;31;19;12;53;30;23;46;22;24;351;252;99;164.0;186.0;106.0;140.0;814.0;978.0;1641
5869;Maasgouw;2009;23610;4889;14230;4491;20395;2643;750;1893;572;360;212;44;26;18;34;21;13;78;38;40;57;21;36;359;254;105;163.0;193.0;106.0;142.0;839.0;982.0;1641
5870;Maasgouw;2010;23361;4801;13968;4592;20138;2595;741;1854;628;379;249;57;27;30;39;24;15;85;44;41;71;28;43;376;256;120;162.0;196.0;122.0;136.0;842.0;984.0;1641
5871;Maasgouw;2011;23159;4671;13823;4665;19896;2565;756;1809;698;413;285;66;30;36;43;25;18;92;46;46;89;33;56;408;279;129;158.0;194.0;140.0;133.0;916.0;1000.0;1641
5872;Maasgouw;2012;23028;4569;13637;4822;19724;2541;768;1773;763;445;318;82;40;42;51;31;20;113;52;61;101;41;60;416;281;135;150.0;203.0;126.0;137.0;876.0;1017.0;1641
5873;Maasgouw;2013;22825;4444;13385;4996;19498;2533;778;1755;794;464;330;92;45;47;53;31;22;116;53;63;114;50;64;419;285;134;152.0;198.0;123.0;125.0;951.0;996.0;1641
5874;Maasgouw;2014;22735;4348;13250;5137;19372;2522;783;1739;841;469;372;98;51;47;58;33;25;130;52;78;131;55;76;424;278;146;157.0;208.0;128.0;123.0;957.0;996.0;1641
5875;Maasgouw;2015;22640;4285;13035;5320;19218;2547;816;1731;875;474;401;108;57;51;64;36;28;148;55;93;134;59;75;421;267;154;159.0;212.0;115.0;122.0;906.0;997.0;1641
5876;Maasgouw;2016;22491;4188;12848;5455;19051;2516;806;1710;924;493;431;114;62;52;76;42;34;159;59;100;152;63;89;423;267;156;150.0;210.0;118.0;123.0;933.0;988.0;1641
5877;Maasgouw;2017;22373;4132;12653;5588;18886;2509;822;1687;978;515;463;118;61;57;78;44;34;174;65;109;167;66;101;441;279;162;160.0;214.0;109.0;120.0;885.0;1004.0;1641
5878;Maasgouw;2018;22191;4050;12430;5711;18694;2491;806;1685;1006;538;468;120;62;58;86;46;40;183;71;112;164;67;97;453;292;161;157.0;219.0;108.0;115.0;956.0;985.0;1641
5879;Maasgouw;2019;22058;3965;12300;5793;18570;2465;813;1652;1023;554;469;130;68;62;91;49;42;184;71;113;161;72;89;457;294;163;159.0;220.0;110.0;120.0;935.0;1013.0;1641
5880;Maasgouw;2020;21909;3844;12169;5896;18408;2425;794;1631;1076;572;504;141;73;68;102;53;49;185;70;115;160;70;90;488;306;182;167.0;219.0;109.0;118.0;894.0;1005.0;1641
5881;Maasgouw;2021;21739;3789;11930;6020;18234;2374;799;1575;1131;596;535;144;78;66;111;57;54;203;72;131;183;84;99;490;305;185;167.0;226.0;114.0;108.0;882.0;972.0;1641
5882;Maasgouw;2022;21597;3722;11725;6150;18044;2368;803;1565;1185;621;564;151;82;69;116;56;60;217;82;135;185;87;98;516;314;202;170.0;240.0;114.0;108.0;921.0;1001.0;1641
5883;Maasgouw;2023;21454;3661;11545;6248;17893;2357;810;1547;1204;615;589;154;86;68;111;57;54;217;80;137;195;85;110;527;307;220;172.0;236.0;105.0;109.0;887.0;953.0;1641
5884;Maasgouw;2024;21326;3649;11343;6334;17762;2345;811;1534;1219;642;577;154;87;67;120;62;58;224;83;141;182;85;97;539;325;214;165.0;235.0;100.0;109.0;879.0;927.0;1641
5885;Maasgouw;2025;21200;3642;11108;6450;17622;2312;809;1503;1266;667;599;163;94;69;125;64;61;226;85;141;194;89;105;558;335;223;;;;;;;1641
5886;Maassluis;2008;31535;7282;19294;4959;24427;2177;854;1323;4931;2724;2207;528;289;239;360;238;122;1759;923;836;1199;566;633;1085;708;377;340.0;268.0;125.0;173.0;1236.0;1418.0;556
5887;Maassluis;2009;31382;7194;19059;5129;24322;2152;832;1320;4908;2697;2211;540;291;249;369;244;125;1720;901;819;1186;559;627;1093;702;391;337.0;275.0;134.0;160.0;1359.0;1424.0;556
5888;Maassluis;2010;31357;7153;18900;5304;24326;2157;835;1322;4874;2658;2216;564;297;267;367;238;129;1683;873;810;1165;554;611;1095;696;399;329.0;277.0;139.0;164.0;1394.0;1401.0;556
5889;Maassluis;2011;31381;7105;18874;5402;24328;2135;831;1304;4918;2650;2268;585;305;280;393;257;136;1637;827;810;1169;550;619;1134;711;423;318.0;280.0;122.0;165.0;1452.0;1395.0;556
5890;Maassluis;2012;31439;7056;18655;5728;24374;2130;813;1317;4935;2615;2320;595;305;290;403;253;150;1626;809;817;1170;549;621;1141;699;442;325.0;284.0;126.0;157.0;1590.0;1406.0;556
5891;Maassluis;2013;31638;7050;18585;6003;24522;2146;812;1334;4970;2622;2348;612;314;298;411;254;157;1596;796;800;1160;543;617;1191;715;476;318.0;295.0;127.0;153.0;1576.0;1427.0;556
5892;Maassluis;2014;31788;7047;18489;6252;24633;2183;831;1352;4972;2614;2358;623;312;311;424;266;158;1567;795;772;1154;543;611;1204;698;506;330.0;297.0;125.0;146.0;1565.0;1413.0;556
5893;Maassluis;2015;31957;7062;18418;6477;24788;2204;844;1360;4965;2599;2366;640;325;315;432;265;167;1533;767;766;1162;555;607;1198;687;511;328.0;302.0;127.0;145.0;1633.0;1421.0;556
5894;Maassluis;2016;32176;7100;18427;6649;24940;2240;871;1369;4996;2595;2401;649;326;323;438;264;174;1509;746;763;1155;549;606;1245;710;535;336.0;310.0;138.0;147.0;1595.0;1440.0;556
5895;Maassluis;2017;32353;7071;18445;6837;25112;2252;872;1380;4989;2616;2373;660;326;334;459;273;186;1458;725;733;1147;561;586;1265;731;534;336.0;314.0;128.0;138.0;1505.0;1457.0;556
5896;Maassluis;2018;32417;7079;18356;6982;25103;2295;890;1405;5019;2586;2433;661;323;338;474;273;201;1450;711;739;1151;554;597;1283;725;558;336.0;315.0;126.0;146.0;1702.0;1456.0;556
5897;Maassluis;2019;32665;7132;18423;7110;25310;2331;911;1420;5024;2580;2444;669;327;342;476;278;198;1427;696;731;1148;549;599;1304;730;574;339.0;333.0;134.0;139.0;1567.0;1478.0;556
5898;Maassluis;2020;32755;7089;18476;7190;25393;2345;911;1434;5017;2588;2429;682;331;351;479;281;198;1406;690;716;1136;548;588;1314;738;576;350.0;319.0;118.0;139.0;1661.0;1443.0;556
5899;Maassluis;2021;32984;7123;18538;7323;25532;2408;944;1464;5044;2608;2436;671;327;344;491;286;205;1367;674;693;1141;552;589;1374;769;605;350.0;338.0;131.0;140.0;1571.0;1485.0;556
5900;Maassluis;2022;33073;7139;18543;7391;25609;2426;957;1469;5038;2611;2427;675;332;343;503;290;213;1323;650;673;1145;558;587;1392;781;611;350.0;342.0;138.0;140.0;1655.0;1468.0;556
5901;Maassluis;2023;33270;7169;18631;7470;25709;2465;950;1515;5096;2642;2454;694;340;354;527;305;222;1306;640;666;1146;556;590;1423;801;622;350.0;346.0;139.0;131.0;1468.0;1478.0;556
5902;Maassluis;2024;33274;7137;18597;7540;25706;2508;980;1528;5060;2626;2434;679;337;342;541;311;230;1274;625;649;1133;546;587;1433;807;626;339.0;349.0;131.0;141.0;1599.0;1483.0;556
5903;Maassluis;2025;33373;7174;18535;7664;25720;2561;1000;1561;5092;2643;2449;696;339;357;564;324;240;1243;613;630;1130;540;590;1459;827;632;;;;;;;556
5904;Maastricht;2008;118445;22172;75792;20481;92678;17034;7123;9911;8733;5417;3316;483;230;253;587;389;198;1622;836;786;1838;925;913;4203;3037;1166;916.0;1293.0;1886.0;2112.0;4341.0;4538.0;935
5905;Maastricht;2009;117665;21882;75292;20491;92089;16886;7170;9716;8690;5302;3388;533;258;275;604;401;203;1617;827;790;1862;908;954;4074;2908;1166;923.0;1307.0;1920.0;2057.0;4347.0;4519.0;935
5906;Maastricht;2010;116997;21645;74803;20549;91562;16705;7193;9512;8730;5226;3504;597;288;309;623;419;204;1659;837;822;1887;910;977;3964;2772;1192;935.0;1300.0;1937.0;1975.0;4277.0;4493.0;935
5907;Maastricht;2011;116401;21292;74257;20852;91014;16626;7303;9323;8761;5171;3590;642;303;339;653;435;218;1670;838;832;1907;897;1010;3889;2698;1191;972.0;1310.0;1970.0;1967.0;4276.0;4494.0;935
5908;Maastricht;2012;115869;21052;73607;21210;90517;16548;7335;9213;8804;5124;3680;705;344;361;676;443;233;1687;835;852;1901;876;1025;3835;2626;1209;1000.0;1305.0;1985.0;1894.0;4161.0;4457.0;935
5909;Maastricht;2013;115383;20975;72854;21554;89995;16479;7433;9046;8909;5079;3830;754;372;382;725;456;269;1734;851;883;1924;853;1071;3772;2547;1225;1020.0;1301.0;1953.0;1857.0;4159.0;4458.0;935
5910;Maastricht;2014;114914;20855;72210;21849;89532;16395;7477;8918;8987;5069;3918;804;391;413;748;477;271;1755;852;903;1937;859;1078;3743;2490;1253;1046.0;1318.0;1929.0;1811.0;4152.0;4436.0;935
5911;Maastricht;2015;114499;20720;71774;22005;89136;16252;7488;8764;9111;5100;4011;849;417;432;803;508;295;1777;872;905;1943;844;1099;3739;2459;1280;1062.0;1309.0;1881.0;1783.0;4150.0;4437.0;935
5912;Maastricht;2016;114081;20729;71153;22199;88776;16179;7503;8676;9126;5063;4063;897;438;459;819;523;296;1797;881;916;1922;831;1091;3691;2390;1301;1077.0;1311.0;1828.0;1748.0;4087.0;4370.0;935
5913;Maastricht;2017;113666;20733;70583;22350;88340;16110;7565;8545;9216;5057;4159;940;464;476;839;539;300;1821;876;945;1941;833;1108;3675;2345;1330;1079.0;1308.0;1837.0;1721.0;4089.0;4407.0;935
5914;Maastricht;2018;113254;20810;69909;22535;87921;16010;7571;8439;9323;5099;4224;977;498;479;854;541;313;1844;884;960;1980;838;1142;3668;2338;1330;1087.0;1295.0;1809.0;1686.0;4114.0;4385.0;935
5915;Maastricht;2019;112916;20768;69382;22766;87573;15943;7583;8360;9400;5106;4294;1033;527;506;876;556;320;1867;877;990;1980;838;1142;3644;2308;1336;1083.0;1312.0;1751.0;1663.0;4047.0;4410.0;935
5916;Maastricht;2020;112429;20715;68798;22916;87171;15802;7594;8208;9456;5106;4350;1043;536;507;893;563;330;1897;883;1014;2009;834;1175;3614;2290;1324;1082.0;1310.0;1721.0;1622.0;4102.0;4342.0;935
5917;Maastricht;2021;112082;20619;68382;23081;86785;15806;7662;8144;9491;5100;4391;1073;550;523;900;563;337;1916;899;1017;2013;821;1192;3589;2267;1322;1074.0;1293.0;1698.0;1601.0;4066.0;4348.0;935
5918;Maastricht;2022;111700;20649;67807;23244;86385;15722;7669;8053;9593;5143;4450;1099;564;535;911;569;342;1924;897;1027;2060;834;1226;3599;2279;1320;1049.0;1312.0;1650.0;1582.0;4118.0;4323.0;935
5919;Maastricht;2023;111315;20580;67313;23422;85979;15643;7676;7967;9693;5141;4552;1146;579;567;914;567;347;1941;905;1036;2073;832;1241;3619;2258;1361;1057.0;1318.0;1651.0;1557.0;4049.0;4281.0;935
5920;Maastricht;2024;110933;20676;66714;23543;85607;15544;7688;7856;9782;5164;4618;1183;602;581;940;571;369;1944;911;1033;2086;833;1253;3629;2247;1382;1075.0;1301.0;1609.0;1511.0;3963.0;4260.0;935
5921;Maastricht;2025;110521;20705;66074;23742;85164;15490;7710;7780;9867;5202;4665;1235;627;608;967;587;380;1952;909;1043;2094;834;1260;3619;2245;1374;;;;;;;935
5922;Margraten;2008;13140;3090;7716;2334;11642;1236;419;817;262;152;110;27;12;15;25;13;12;20;7;13;32;11;21;158;109;49;72.0;114.0;59.0;85.0;563.0;619.0;936
5923;Margraten;2009;13018;2952;7651;2415;11490;1230;421;809;298;162;136;35;16;19;26;13;13;30;10;20;48;16;32;159;107;52;70.0;119.0;60.0;86.0;535.0;623.0;936
5924;Margraten;2010;12857;2841;7529;2487;11323;1206;411;795;328;178;150;40;22;18;24;13;11;39;12;27;59;18;41;166;113;53;70.0;117.0;66.0;83.0;527.0;627.0;936
5925;Margraten;2011;12694;2687;7457;2550;11148;1183;414;769;363;194;169;45;22;23;23;12;11;50;14;36;70;24;46;175;122;53;73.0;126.0;67.0;79.0;558.0;614.0;936
5926;Margraten;2012;12576;2575;7351;2650;11016;1178;414;764;382;197;185;51;28;23;22;9;13;48;15;33;76;21;55;185;124;61;73.0;128.0;64.0;82.0;560.0;616.0;936
5927;Margraten;2013;12448;2499;7226;2723;10889;1154;414;740;405;192;213;64;30;34;22;8;14;47;12;35;85;22;63;187;120;67;78.0;128.0;63.0;79.0;590.0;596.0;936
5928;Margraten;2014;12378;2405;7190;2783;10795;1161;424;737;422;208;214;64;34;30;25;10;15;52;15;37;91;27;64;190;122;68;74.0;132.0;67.0;75.0;610.0;637.0;936
5929;Margraten;2015;12287;2359;7081;2847;10681;1178;438;740;428;218;210;56;31;25;25;11;14;54;18;36;88;27;61;205;131;74;78.0;132.0;63.0;80.0;592.0;601.0;936
5930;Margraten;2016;12208;2276;7041;2891;10590;1156;421;735;462;241;221;60;29;31;31;16;15;57;18;39;102;34;68;212;144;68;78.0;134.0;65.0;71.0;541.0;602.0;936
5931;Margraten;2017;12087;2204;6948;2935;10466;1136;421;715;485;244;241;74;33;41;35;14;21;60;23;37;107;32;75;209;142;67;84.0;134.0;64.0;67.0;565.0;625.0;936
5932;Margraten;2018;11976;2148;6871;2957;10361;1136;431;705;479;245;234;78;36;42;36;15;21;65;24;41;104;35;69;196;135;61;89.0;137.0;57.0;71.0;558.0;614.0;936
5933;Margraten;2019;11860;2079;6770;3011;10239;1114;436;678;507;258;249;82;40;42;39;17;22;66;26;40;112;38;74;208;137;71;87.0;139.0;59.0;71.0;548.0;602.0;936
5934;Margraten;2020;11743;2034;6656;3053;10104;1113;428;685;526;262;264;86;40;46;37;15;22;65;28;37;118;36;82;220;143;77;92.0;142.0;63.0;67.0;568.0;594.0;936
5935;Margraten;2021;11665;2002;6587;3076;9990;1123;452;671;552;266;286;84;38;46;43;17;26;73;27;46;118;35;83;234;149;85;91.0;145.0;52.0;69.0;559.0;595.0;936
5936;Margraten;2022;11560;1970;6509;3081;9898;1112;449;663;550;269;281;79;37;42;39;15;24;65;24;41;130;41;89;237;152;85;92.0;141.0;57.0;68.0;524.0;596.0;936
5937;Margraten;2023;11427;1963;6382;3082;9772;1083;444;639;572;273;299;82;37;45;47;23;24;74;29;45;135;38;97;234;146;88;95.0;146.0;57.0;67.0;534.0;581.0;936
5938;Margraten;2024;11319;1931;6278;3110;9650;1078;443;635;591;290;301;83;40;43;44;20;24;84;34;50;131;41;90;249;155;94;93.0;144.0;52.0;63.0;509.0;569.0;936
5939;Margraten;2025;11198;1892;6190;3116;9526;1064;443;621;608;292;316;83;38;45;46;22;24;88;34;54;141;43;98;250;155;95;;;;;;;936
5940;De Marne;2008;10986;2684;6475;1827;10060;563;215;348;363;253;110;40;16;24;18;14;4;22;11;11;14;7;7;269;205;64;122.0;107.0;33.0;74.0;559.0;611.0;1663
5941;De Marne;2009;10910;2682;6334;1894;9977;576;210;366;357;229;128;43;19;24;20;18;2;29;12;17;18;6;12;247;174;73;122.0;108.0;33.0;72.0;616.0;621.0;1663
5942;De Marne;2010;10882;2675;6281;1926;9919;592;207;385;371;233;138;42;21;21;22;18;4;35;13;22;20;9;11;252;172;80;118.0;109.0;35.0;73.0;624.0;645.0;1663
5943;De Marne;2011;10833;2657;6224;1952;9833;611;208;403;389;234;155;43;22;21;30;22;8;45;16;29;22;7;15;249;167;82;122.0;112.0;36.0;69.0;691.0;640.0;1663
5944;De Marne;2012;10863;2654;6178;2031;9819;631;213;418;413;256;157;43;22;21;31;21;10;47;20;27;25;7;18;267;186;81;122.0;109.0;38.0;73.0;695.0;645.0;1663
5945;De Marne;2013;10892;2649;6128;2115;9835;659;228;431;398;235;163;47;24;23;32;22;10;50;21;29;33;10;23;236;158;78;119.0;110.0;31.0;63.0;678.0;667.0;1663
5946;De Marne;2014;10882;2670;6014;2198;9786;682;221;461;414;247;167;54;28;26;34;23;11;52;23;29;39;14;25;235;159;76;119.0;115.0;36.0;68.0;664.0;645.0;1663
5947;De Marne;2015;10876;2630;5996;2250;9757;694;219;475;425;248;177;57;27;30;35;23;12;55;23;32;41;15;26;237;160;77;123.0;110.0;32.0;66.0;689.0;638.0;1663
5948;De Marne;2016;10909;2646;5969;2294;9769;702;213;489;438;253;185;55;26;29;41;26;15;55;22;33;51;15;36;236;164;72;125.0;112.0;38.0;64.0;622.0;668.0;1663
5949;De Marne;2017;10850;2641;5892;2317;9694;721;208;513;435;244;191;62;29;33;44;29;15;53;23;30;53;16;37;223;147;76;121.0;114.0;32.0;58.0;574.0;633.0;1663
5950;De Marne;2018;10773;2611;5796;2366;9599;727;204;523;447;247;200;64;34;30;48;31;17;59;23;36;51;14;37;225;145;80;120.0;116.0;40.0;62.0;605.0;630.0;1663
5951;De Marne;2019;10731;2593;5750;2388;9558;726;214;512;447;253;194;71;41;30;47;32;15;62;25;37;50;14;36;217;141;76;117.0;117.0;31.0;58.0;598.0;603.0;1663
5952;De Marne;2020;10701;2592;5699;2410;9485;750;218;532;466;257;209;74;42;32;51;30;21;62;25;37;54;16;38;225;144;81;119.0;115.0;30.0;59.0;636.0;634.0;1663
5953;De Marne;2021;10678;2587;5653;2438;9458;757;224;533;463;259;204;72;41;31;51;34;17;61;23;38;53;16;37;226;145;81;120.0;117.0;32.0;57.0;601.0;641.0;1663
5954;De Marne;2022;10617;2549;5579;2489;9374;779;237;542;464;258;206;76;42;34;49;33;16;64;24;40;52;15;37;223;144;79;109.0;118.0;30.0;59.0;597.0;629.0;1663
5955;De Marne;2023;10548;2530;5504;2514;9296;780;229;551;472;256;216;75;41;34;52;30;22;69;23;46;54;17;37;222;145;77;114.0;120.0;36.0;53.0;574.0;635.0;1663
5956;De Marne;2024;10465;2509;5415;2541;9204;781;233;548;480;261;219;77;41;36;55;35;20;76;27;49;50;15;35;222;143;79;112.0;120.0;37.0;55.0;575.0;620.0;1663
5957;De Marne;2025;10393;2478;5348;2567;9117;779;236;543;497;267;230;79;44;35;54;28;26;78;32;46;57;17;40;229;146;83;;;;;;;1663
5958;Marum;2008;9955;2581;6004;1370;9329;434;161;273;192;100;92;42;17;25;16;7;9;14;4;10;7;4;3;113;68;45;98.0;70.0;19.0;35.0;537.0;542.0;25
5959;Marum;2009;9963;2541;5990;1432;9322;425;162;263;216;109;107;37;15;22;19;7;12;23;8;15;13;5;8;124;74;50;91.0;72.0;30.0;35.0;508.0;557.0;25
5960;Marum;2010;9933;2466;5985;1482;9256;436;170;266;241;128;113;39;17;22;26;12;14;27;13;14;16;6;10;133;80;53;91.0;71.0;40.0;38.0;524.0;572.0;25
5961;Marum;2011;9908;2387;5978;1543;9227;437;172;265;244;131;113;47;20;27;26;12;14;30;16;14;17;6;11;124;77;47;89.0;75.0;27.0;34.0;514.0;547.0;25
5962;Marum;2012;9883;2338;5936;1609;9197;435;168;267;251;136;115;47;24;23;27;12;15;32;15;17;21;10;11;124;75;49;88.0;75.0;31.0;34.0;499.0;576.0;25
5963;Marum;2013;9818;2258;5881;1679;9122;427;165;262;269;145;124;52;23;29;31;16;15;37;19;18;23;12;11;126;75;51;88.0;73.0;30.0;41.0;490.0;573.0;25
5964;Marum;2014;9740;2201;5834;1705;9021;416;160;256;303;162;141;52;24;28;35;21;14;44;19;25;30;14;16;142;84;58;83.0;73.0;26.0;34.0;505.0;547.0;25
5965;Marum;2015;9701;2137;5808;1756;8977;426;166;260;298;159;139;47;21;26;35;20;15;46;20;26;31;14;17;139;84;55;86.0;78.0;22.0;34.0;521.0;548.0;25
5966;Marum;2016;9671;2056;5809;1806;8927;430;169;261;314;164;150;50;22;28;36;19;17;49;20;29;38;14;24;141;89;52;87.0;78.0;26.0;31.0;505.0;553.0;25
5967;Marum;2017;9628;2016;5756;1856;8865;426;164;262;337;179;158;58;28;30;39;21;18;55;24;31;43;15;28;142;91;51;87.0;76.0;23.0;30.0;497.0;543.0;25
5968;Marum;2018;9586;1966;5681;1939;8801;436;177;259;349;188;161;63;29;34;37;22;15;54;23;31;53;18;35;142;96;46;86.0;83.0;24.0;29.0;483.0;543.0;25
5969;Marum;2019;9525;1884;5634;2007;8737;433;171;262;355;184;171;65;30;35;39;23;16;59;23;36;57;16;41;135;92;43;90.0;84.0;25.0;32.0;508.0;527.0;25
5970;Marum;2020;9506;1869;5581;2056;8695;449;171;278;362;201;161;67;33;34;36;23;13;59;25;34;56;17;39;144;103;41;91.0;82.0;25.0;31.0;544.0;529.0;25
5971;Marum;2021;9525;1844;5579;2102;8700;458;177;281;367;205;162;63;34;29;39;19;20;62;28;34;56;17;39;147;107;40;94.0;85.0;22.0;28.0;504.0;547.0;25
5972;Marum;2022;9488;1803;5537;2148;8660;458;178;280;370;209;161;62;34;28;38;20;18;66;28;38;57;19;38;147;108;39;90.0;84.0;25.0;30.0;504.0;559.0;25
5973;Marum;2023;9435;1781;5467;2187;8593;468;182;286;374;206;168;66;35;31;37;20;17;71;31;40;63;22;41;137;98;39;93.0;87.0;27.0;31.0;472.0;529.0;25
5974;Marum;2024;9380;1746;5395;2239;8539;454;176;278;387;212;175;68;36;32;38;23;15;76;31;45;64;20;44;141;102;39;92.0;90.0;23.0;31.0;473.0;525.0;25
5975;Marum;2025;9323;1719;5282;2322;8468;457;177;280;398;216;182;66;34;32;37;23;14;82;33;49;61;18;43;152;108;44;;;;;;;25
5976;Medemblik;2008;26855;6853;16434;3568;24175;1478;546;932;1202;714;488;112;50;62;99;56;43;351;183;168;59;28;31;581;397;184;283.0;192.0;90.0;136.0;1396.0;1319.0;420
5977;Medemblik;2009;26978;6805;16421;3752;24205;1512;567;945;1261;729;532;129;57;72;106;58;48;340;177;163;65;26;39;621;411;210;288.0;197.0;102.0;136.0;1243.0;1364.0;420
5978;Medemblik;2010;26917;6642;16335;3940;24101;1533;564;969;1283;746;537;144;67;77;105;58;47;319;169;150;70;32;38;645;420;225;280.0;207.0;86.0;124.0;1395.0;1369.0;420
5979;Medemblik;2011;26980;6485;16370;4125;24113;1558;563;995;1309;761;548;156;68;88;106;60;46;326;177;149;85;39;46;636;417;219;278.0;214.0;100.0;125.0;1381.0;1411.0;420
5980;Medemblik;2012;26992;6344;16212;4436;24034;1589;570;1019;1369;779;590;163;69;94;117;66;51;334;180;154;91;39;52;664;425;239;267.0;214.0;94.0;130.0;1397.0;1380.0;420
5981;Medemblik;2013;27027;6218;16064;4745;24031;1611;573;1038;1385;778;607;169;72;97;115;64;51;336;178;158;95;42;53;670;422;248;268.0;228.0;95.0;124.0;1265.0;1387.0;420
5982;Medemblik;2014;26919;6043;15910;4966;23876;1633;586;1047;1410;783;627;183;78;105;121;71;50;332;180;152;97;42;55;677;412;265;268.0;229.0;98.0;125.0;1413.0;1371.0;420
5983;Medemblik;2015;26976;5969;15831;5176;23890;1645;593;1052;1441;775;666;194;82;112;117;69;48;335;177;158;109;46;63;686;401;285;262.0;241.0;96.0;121.0;1461.0;1346.0;420
5984;Medemblik;2016;27090;5880;15807;5403;23934;1665;613;1052;1491;802;689;201;87;114;114;64;50;335;177;158;124;53;71;717;421;296;264.0;246.0;92.0;120.0;1392.0;1372.0;420
5985;Medemblik;2017;27103;5822;15739;5542;23919;1645;617;1028;1539;809;730;218;89;129;118;68;50;337;173;164;136;56;80;730;423;307;259.0;251.0;94.0;121.0;1404.0;1383.0;420
5986;Medemblik;2018;27108;5717;15665;5726;23866;1678;630;1048;1564;821;743;221;92;129;121;69;52;341;172;169;139;58;81;742;430;312;269.0;259.0;101.0;115.0;1479.0;1362.0;420
5987;Medemblik;2019;27223;5666;15707;5850;23891;1711;643;1068;1621;841;780;221;92;129;126;73;53;360;185;175;151;61;90;763;430;333;264.0;269.0;92.0;120.0;1480.0;1365.0;420
5988;Medemblik;2020;27307;5563;15775;5969;23944;1734;657;1077;1629;843;786;230;93;137;123;72;51;359;179;180;166;66;100;751;433;318;273.0;264.0;94.0;120.0;1553.0;1378.0;420
5989;Medemblik;2021;27469;5500;15851;6118;24066;1752;671;1081;1651;855;796;228;95;133;121;68;53;355;178;177;169;65;104;778;449;329;278.0;274.0;117.0;119.0;1435.0;1391.0;420
5990;Medemblik;2022;27518;5439;15823;6256;24054;1781;690;1091;1683;872;811;221;94;127;118;66;52;358;178;180;184;70;114;802;464;338;280.0;283.0;95.0;115.0;1458.0;1379.0;420
5991;Medemblik;2023;27577;5359;15824;6394;24059;1802;713;1089;1716;897;819;220;99;121;124;68;56;368;187;181;195;75;120;809;468;341;286.0;288.0;96.0;120.0;1479.0;1387.0;420
5992;Medemblik;2024;27648;5323;15825;6500;24080;1827;706;1121;1741;924;817;216;102;114;133;71;62;360;193;167;196;76;120;836;482;354;287.0;293.0;90.0;117.0;1316.0;1365.0;420
5993;Medemblik;2025;27572;5312;15650;6610;23989;1852;718;1134;1731;921;810;212;105;107;124;69;55;360;197;163;203;79;124;832;471;361;;;;;;;420
5994;Meerlo-Wanssum;2008;7604;1957;4601;1046;6995;474;139;335;135;94;41;9;4;5;6;4;2;20;11;9;12;7;5;88;68;20;71.0;53.0;22.0;26.0;306.0;332.0;993
5995;Meerlo-Wanssum;2009;7593;1927;4579;1087;6943;487;148;339;163;109;54;11;4;7;10;7;3;28;13;15;15;8;7;99;77;22;69.0;54.0;27.0;29.0;250.0;341.0;993
5996;Meerlo-Wanssum;2010;7516;1877;4501;1138;6849;487;147;340;180;118;62;11;5;6;13;7;6;30;14;16;19;9;10;107;83;24;67.0;57.0;24.0;29.0;336.0;325.0;993
5997;Meerlo-Wanssum;2011;7533;1854;4491;1188;6815;513;154;359;205;130;75;15;8;7;10;5;5;32;16;16;19;11;8;129;90;39;71.0;58.0;27.0;28.0;305.0;337.0;993
5998;Meerlo-Wanssum;2012;7514;1817;4446;1251;6753;533;159;374;228;137;91;15;7;8;11;5;6;34;16;18;17;9;8;151;100;51;65.0;63.0;26.0;28.0;342.0;333.0;993
5999;Meerlo-Wanssum;2013;7524;1797;4435;1292;6734;540;161;379;250;148;102;24;9;15;14;6;8;36;18;18;21;9;12;155;106;49;68.0;68.0;26.0;32.0;359.0;347.0;993
6000;Meerlo-Wanssum;2014;7533;1772;4431;1330;6707;554;176;378;272;157;115;27;11;16;17;9;8;43;22;21;21;10;11;164;105;59;68.0;66.0;28.0;31.0;329.0;347.0;993
6001;Meerlo-Wanssum;2015;7515;1719;4412;1384;6673;547;172;375;295;171;124;26;11;15;18;11;7;56;26;30;29;12;17;166;111;55;69.0;68.0;27.0;31.0;299.0;342.0;993
6002;Meerlo-Wanssum;2016;7471;1674;4355;1442;6616;542;172;370;313;193;120;28;14;14;21;14;7;56;29;27;34;14;20;174;122;52;71.0;70.0;29.0;27.0;321.0;333.0;993
6003;Meerlo-Wanssum;2017;7463;1660;4310;1493;6594;553;182;371;316;191;125;28;14;14;25;15;10;54;26;28;34;14;20;175;122;53;72.0;71.0;29.0;25.0;343.0;355.0;993
6004;Meerlo-Wanssum;2018;7457;1645;4285;1527;6550;560;186;374;347;206;141;35;18;17;30;19;11;57;27;30;35;15;20;190;127;63;76.0;77.0;25.0;28.0;322.0;352.0;993
6005;Meerlo-Wanssum;2019;7424;1628;4227;1569;6478;578;194;384;368;215;153;38;21;17;31;19;12;57;27;30;41;17;24;201;131;70;76.0;81.0;26.0;29.0;325.0;352.0;993
6006;Meerlo-Wanssum;2020;7389;1608;4204;1577;6428;585;197;388;376;205;171;40;21;19;31;18;13;61;26;35;43;17;26;201;123;78;78.0;77.0;26.0;28.0;371.0;355.0;993
6007;Meerlo-Wanssum;2021;7405;1599;4173;1633;6421;584;194;390;400;214;186;41;21;20;31;17;14;65;27;38;47;15;32;216;134;82;78.0;77.0;24.0;31.0;344.0;366.0;993
6008;Meerlo-Wanssum;2022;7377;1596;4122;1659;6396;581;195;386;400;213;187;44;24;20;32;17;15;64;25;39;50;18;32;210;129;81;83.0;80.0;26.0;27.0;360.0;351.0;993
6009;Meerlo-Wanssum;2023;7390;1586;4130;1674;6401;571;190;381;418;236;182;47;27;20;33;19;14;65;29;36;49;19;30;224;142;82;81.0;79.0;26.0;26.0;324.0;350.0;993
6010;Meerlo-Wanssum;2024;7368;1559;4104;1705;6358;593;198;395;417;225;192;47;25;22;32;16;16;64;30;34;55;22;33;219;132;87;83.0;85.0;26.0;28.0;352.0;351.0;993
6011;Meerlo-Wanssum;2025;7366;1549;4087;1730;6333;597;201;396;436;235;201;47;25;22;35;23;12;66;29;37;55;20;35;233;138;95;;;;;;;993
6012;Meerssen;2008;19526;4282;11667;3577;17244;1759;531;1228;523;298;225;28;14;14;27;12;15;51;30;21;58;25;33;359;217;142;139.0;187.0;82.0;130.0;791.0;860.0;938
6013;Meerssen;2009;19364;4154;11545;3665;17051;1741;532;1209;572;327;245;37;19;18;30;15;15;67;39;28;57;23;34;381;231;150;136.0;190.0;106.0;128.0;801.0;859.0;938
6014;Meerssen;2010;19233;4039;11436;3758;16842;1745;560;1185;646;364;282;48;26;22;39;19;20;74;39;35;73;26;47;412;254;158;136.0;193.0;92.0;125.0;860.0;868.0;938
6015;Meerssen;2011;19139;3938;11330;3871;16678;1773;593;1180;688;378;310;55;33;22;37;15;22;90;44;46;76;30;46;430;256;174;138.0;201.0;108.0;130.0;846.0;866.0;938
6016;Meerssen;2012;19037;3816;11257;3964;16507;1809;611;1198;721;387;334;63;38;25;44;19;25;92;47;45;86;31;55;436;252;184;145.0;194.0;109.0;129.0;857.0;857.0;938
6017;Meerssen;2013;18968;3710;11180;4078;16390;1805;618;1187;773;404;369;72;40;32;46;23;23;95;44;51;91;29;62;469;268;201;144.0;199.0;103.0;125.0;904.0;889.0;938
6018;Meerssen;2014;18909;3622;11102;4185;16310;1800;624;1176;799;403;396;77;38;39;55;31;24;106;45;61;98;32;66;463;257;206;149.0;204.0;105.0;125.0;843.0;910.0;938
6019;Meerssen;2015;18768;3549;10990;4229;16170;1792;628;1164;806;404;402;87;38;49;59;30;29;102;50;52;103;39;64;455;247;208;153.0;201.0;105.0;126.0;913.0;898.0;938
6020;Meerssen;2016;18716;3475;10954;4287;16082;1785;639;1146;849;424;425;94;46;48;58;27;31;104;52;52;113;42;71;480;257;223;149.0;209.0;100.0;123.0;892.0;902.0;938
6021;Meerssen;2017;18624;3432;10850;4342;15966;1772;639;1133;886;434;452;98;48;50;56;28;28;116;58;58;115;43;72;501;257;244;154.0;214.0;93.0;118.0;863.0;884.0;938
6022;Meerssen;2018;18518;3375;10727;4416;15816;1785;663;1122;917;449;468;112;58;54;60;32;28;116;59;57;121;45;76;508;255;253;153.0;214.0;96.0;115.0;906.0;895.0;938
6023;Meerssen;2019;18450;3304;10664;4482;15726;1779;659;1120;945;457;488;120;61;59;62;29;33;121;61;60;135;52;83;507;254;253;160.0;217.0;90.0;111.0;913.0;877.0;938
6024;Meerssen;2020;18410;3267;10612;4531;15637;1801;658;1143;972;486;486;129;67;62;69;34;35;123;62;61;142;54;88;509;269;240;164.0;214.0;92.0;117.0;885.0;858.0;938
6025;Meerssen;2021;18364;3235;10548;4581;15538;1796;658;1138;1030;500;530;134;68;66;75;34;41;146;74;72;145;56;89;530;268;262;158.0;220.0;94.0;110.0;871.0;860.0;938
6026;Meerssen;2022;18299;3175;10490;4634;15462;1785;643;1142;1052;515;537;139;74;65;75;37;38;149;71;78;148;56;92;541;277;264;160.0;220.0;95.0;115.0;847.0;897.0;938
6027;Meerssen;2023;18170;3158;10335;4677;15295;1782;651;1131;1093;534;559;145;77;68;86;43;43;155;70;85;151;58;93;556;286;270;160.0;225.0;96.0;107.0;911.0;872.0;938
6028;Meerssen;2024;18134;3126;10242;4766;15224;1784;655;1129;1126;556;570;157;85;72;85;44;41;160;77;83;157;56;101;567;294;273;158.0;228.0;90.0;106.0;907.0;865.0;938
6029;Meerssen;2025;18090;3107;10153;4830;15166;1763;659;1104;1161;560;601;167;88;79;89;45;44;167;77;90;161;60;101;577;290;287;;;;;;;938
6030;Meijel;2008;5771;1369;3537;865;5441;230;62;168;100;60;40;12;4;8;2;0;2;8;4;4;5;3;2;73;49;24;40.0;47.0;18.0;18.0;70.0;139.0;941
6031;Meijel;2009;5696;1329;3488;879;5341;238;66;172;117;71;46;16;6;10;3;1;2;10;5;5;8;4;4;80;55;25;38.0;47.0;18.0;16.0;150.0;147.0;941
6032;Meijel;2010;5693;1309;3479;905;5319;247;72;175;127;78;49;16;7;9;4;2;2;14;7;7;8;4;4;85;58;27;40.0;47.0;14.0;21.0;155.0;155.0;941
6033;Meijel;2011;5680;1278;3470;932;5290;252;77;175;138;87;51;16;8;8;5;4;1;13;6;7;11;6;5;93;63;30;39.0;47.0;16.0;16.0;153.0;155.0;941
6034;Meijel;2012;5672;1256;3439;977;5267;253;78;175;152;94;58;18;9;9;6;4;2;15;7;8;12;5;7;101;69;32;38.0;47.0;15.0;19.0;192.0;162.0;941
6035;Meijel;2013;5689;1239;3424;1026;5261;251;81;170;177;103;74;24;12;12;5;3;2;18;7;11;17;6;11;113;75;38;37.0;51.0;15.0;17.0;143.0;163.0;941
6036;Meijel;2014;5653;1183;3418;1052;5219;250;79;171;184;109;75;24;13;11;5;3;2;21;7;14;17;7;10;117;79;38;41.0;52.0;15.0;18.0;216.0;160.0;941
6037;Meijel;2015;5696;1178;3426;1092;5231;254;85;169;211;121;90;30;17;13;5;3;2;26;7;19;22;10;12;128;84;44;43.0;53.0;16.0;17.0;162.0;171.0;941
6038;Meijel;2016;5676;1149;3397;1130;5176;270;94;176;230;129;101;30;17;13;6;4;2;28;7;21;26;13;13;140;88;52;45.0;60.0;18.0;14.0;200.0;164.0;941
6039;Meijel;2017;5703;1116;3425;1162;5180;278;96;182;245;140;105;33;22;11;8;5;3;32;8;24;25;13;12;147;92;55;47.0;59.0;19.0;20.0;196.0;166.0;941
6040;Meijel;2018;5721;1089;3438;1194;5178;289;103;186;254;139;115;34;21;13;13;7;6;34;9;25;25;14;11;148;88;60;49.0;57.0;16.0;18.0;199.0;165.0;941
6041;Meijel;2019;5746;1087;3418;1241;5194;289;101;188;263;146;117;32;18;14;16;10;6;31;7;24;31;16;15;153;95;58;51.0;61.0;18.0;17.0;156.0;176.0;941
6042;Meijel;2020;5718;1061;3385;1272;5168;278;94;184;272;150;122;29;16;13;19;13;6;35;9;26;34;18;16;155;94;61;52.0;62.0;17.0;19.0;207.0;167.0;941
6043;Meijel;2021;5747;1055;3389;1303;5176;283;96;187;288;158;130;32;19;13;19;14;5;39;11;28;34;17;17;164;97;67;57.0;63.0;19.0;18.0;212.0;175.0;941
6044;Meijel;2022;5780;1055;3389;1336;5191;285;105;180;304;170;134;35;21;14;18;13;5;45;16;29;36;20;16;170;100;70;58.0;65.0;22.0;17.0;165.0;171.0;941
6045;Meijel;2023;5773;1053;3356;1364;5154;298;112;186;321;184;137;34;19;15;19;13;6;50;21;29;41;23;18;177;108;69;60.0;66.0;17.0;16.0;174.0;165.0;941
6046;Meijel;2024;5778;1054;3329;1395;5151;296;112;184;331;186;145;36;20;16;19;14;5;51;21;30;41;21;20;184;110;74;59.0;69.0;19.0;20.0;198.0;166.0;941
6047;Meijel;2025;5800;1076;3315;1409;5138;308;116;192;354;201;153;43;26;17;24;16;8;46;20;26;49;24;25;192;115;77;;;;;;;941
6048;Menaldumadeel;2008;13854;3623;8343;1888;13167;459;127;332;228;143;85;32;17;15;15;12;3;18;6;12;23;8;15;140;100;40;129.0;112.0;25.0;47.0;518.0;603.0;83
6049;Menaldumadeel;2009;13767;3532;8271;1964;13043;462;136;326;262;157;105;39;19;20;18;12;6;20;7;13;29;6;23;156;113;43;129.0;111.0;34.0;44.0;540.0;583.0;83
6050;Menaldumadeel;2010;13734;3464;8242;2028;12983;462;137;325;289;171;118;45;22;23;20;12;8;21;9;12;28;7;21;175;121;54;129.0;117.0;30.0;46.0;521.0;562.0;83
6051;Menaldumadeel;2011;13690;3374;8229;2087;12901;466;137;329;323;183;140;46;23;23;21;11;10;30;13;17;33;10;23;193;126;67;125.0;117.0;33.0;48.0;553.0;507.0;83
6052;Menaldumadeel;2012;13731;3319;8193;2219;12906;459;135;324;366;205;161;51;24;27;26;13;13;37;16;21;39;13;26;213;139;74;130.0;113.0;34.0;46.0;553.0;546.0;83
6053;Menaldumadeel;2013;13744;3224;8212;2308;12891;468;140;328;385;216;169;61;29;32;26;15;11;45;21;24;39;13;26;214;138;76;136.0;117.0;31.0;44.0;452.0;560.0;83
6054;Menaldumadeel;2014;13647;3137;8104;2406;12772;477;144;333;398;216;182;67;34;33;28;15;13;51;22;29;40;17;23;212;128;84;129.0;120.0;34.0;49.0;526.0;551.0;83
6055;Menaldumadeel;2015;13617;3071;8072;2474;12708;480;152;328;429;246;183;70;39;31;34;19;15;57;26;31;43;19;24;225;143;82;138.0;123.0;37.0;49.0;528.0;565.0;83
6056;Menaldumadeel;2016;13584;3007;8035;2542;12646;480;162;318;458;256;202;75;40;35;34;18;16;56;24;32;46;21;25;247;153;94;138.0;127.0;33.0;47.0;524.0;580.0;83
6057;Menaldumadeel;2017;13525;2944;7975;2606;12557;479;160;319;489;273;216;81;45;36;34;19;15;60;27;33;53;23;30;261;159;102;138.0;127.0;58.0;45.0;540.0;547.0;83
6058;Menaldumadeel;2018;13545;2912;7960;2673;12545;496;166;330;504;281;223;86;48;38;42;25;17;61;26;35;59;22;37;256;160;96;146.0;124.0;38.0;50.0;542.0;633.0;83
6059;Menaldumadeel;2019;13465;2866;7867;2732;12424;503;165;338;538;302;236;86;47;39;46;28;18;59;27;32;66;25;41;281;175;106;144.0;126.0;35.0;48.0;515.0;571.0;83
6060;Menaldumadeel;2020;13415;2815;7831;2769;12335;508;167;341;572;304;268;87;47;40;47;26;21;71;28;43;69;26;43;298;177;121;148.0;130.0;43.0;41.0;527.0;595.0;83
6061;Menaldumadeel;2021;13366;2775;7748;2843;12270;512;164;348;584;306;278;88;49;39;46;24;22;78;33;45;80;29;51;292;171;121;151.0;134.0;33.0;47.0;537.0;583.0;83
6062;Menaldumadeel;2022;13324;2752;7670;2902;12195;521;172;349;608;310;298;101;54;47;37;20;17;86;34;52;79;32;47;305;170;135;151.0;132.0;33.0;46.0;563.0;600.0;83
6063;Menaldumadeel;2023;13295;2700;7646;2949;12151;528;168;360;616;311;305;97;50;47;39;21;18;90;38;52;81;30;51;309;172;137;151.0;133.0;44.0;44.0;503.0;594.0;83
6064;Menaldumadeel;2024;13223;2687;7545;2991;12046;538;175;363;639;321;318;97;46;51;44;21;23;95;39;56;89;35;54;314;180;134;154.0;137.0;35.0;47.0;491.0;571.0;83
6065;Menaldumadeel;2025;13152;2668;7463;3021;11945;549;179;370;658;327;331;96;47;49;48;24;24;98;38;60;93;37;56;323;181;142;;;;;;;83
6066;Menterwolde;2008;11951;2828;7507;1616;11167;490;171;319;294;170;124;51;24;27;11;7;4;56;24;32;24;10;14;152;105;47;117.0;103.0;32.0;59.0;537.0;876.0;1987
6067;Menterwolde;2009;11542;2690;7211;1641;10747;482;170;312;313;178;135;53;23;30;14;6;8;57;29;28;27;13;14;162;107;55;108.0;96.0;34.0;59.0;525.0;856.0;1987
6068;Menterwolde;2010;11148;2568;6907;1673;10351;459;160;299;338;200;138;49;23;26;14;6;8;66;35;31;34;13;21;175;123;52;98.0;97.0;31.0;55.0;568.0;809.0;1987
6069;Menterwolde;2011;10800;2429;6674;1697;10012;446;152;294;342;209;133;47;26;21;21;10;11;66;36;30;39;16;23;169;121;48;88.0;94.0;33.0;54.0;539.0;771.0;1987
6070;Menterwolde;2012;10441;2299;6377;1765;9683;415;142;273;343;207;136;49;24;25;18;7;11;72;37;35;44;22;22;160;117;43;83.0;93.0;29.0;48.0;517.0;766.0;1987
6071;Menterwolde;2013;10155;2202;6117;1836;9354;414;145;269;387;234;153;55;28;27;23;13;10;90;45;45;48;21;27;171;127;44;79.0;94.0;31.0;48.0;533.0;739.0;1987
6072;Menterwolde;2014;9885;2083;5916;1886;9061;404;148;256;420;253;167;61;31;30;28;16;12;95;47;48;58;28;30;178;131;47;79.0;93.0;32.0;48.0;518.0;726.0;1987
6073;Menterwolde;2015;9568;1974;5690;1904;8748;390;144;246;430;261;169;62;31;31;29;17;12;96;43;53;59;31;28;184;139;45;72.0;93.0;28.0;45.0;456.0;705.0;1987
6074;Menterwolde;2016;9283;1867;5464;1952;8442;387;144;243;454;274;180;65;37;28;33;16;17;101;50;51;62;30;32;193;141;52;71.0;93.0;31.0;44.0;453.0;690.0;1987
6075;Menterwolde;2017;8988;1754;5280;1954;8138;382;145;237;468;278;190;73;38;35;33;17;16;105;51;54;69;34;35;188;138;50;71.0;90.0;31.0;47.0;464.0;648.0;1987
6076;Menterwolde;2018;8744;1673;5086;1985;7891;369;141;228;484;290;194;70;38;32;37;22;15;106;51;55;77;38;39;194;141;53;66.0;93.0;30.0;39.0;420.0;630.0;1987
6077;Menterwolde;2019;8447;1580;4858;2009;7604;365;140;225;478;276;202;72;38;34;39;20;19;107;50;57;74;32;42;186;136;50;66.0;95.0;27.0;41.0;440.0;592.0;1987
6078;Menterwolde;2020;8208;1500;4679;2029;7367;355;138;217;486;277;209;76;38;38;38;20;18;116;50;66;69;30;39;187;139;48;62.0;93.0;26.0;40.0;359.0;599.0;1987
6079;Menterwolde;2021;7915;1400;4489;2026;7075;339;125;214;501;285;216;77;39;38;37;18;19;120;53;67;71;35;36;196;140;56;54.0;94.0;25.0;37.0;496.0;557.0;1987
6080;Menterwolde;2022;7734;1349;4357;2028;6911;340;121;219;483;291;192;65;36;29;38;20;18;120;54;66;69;33;36;191;148;43;59.0;92.0;24.0;37.0;392.0;561.0;1987
6081;Menterwolde;2023;7513;1292;4182;2039;6679;325;117;208;509;312;197;65;38;27;42;21;21;120;54;66;70;36;34;212;163;49;56.0;93.0;25.0;36.0;397.0;531.0;1987
6082;Menterwolde;2024;7309;1242;4022;2045;6493;314;114;200;502;306;196;69;38;31;46;21;25;113;52;61;72;36;36;202;159;43;50.0;95.0;23.0;33.0;343.0;530.0;1987
6083;Menterwolde;2025;7041;1177;3829;2035;6238;307;115;192;496;310;186;71;43;28;44;21;23;109;51;58;73;36;37;199;159;40;;;;;;;1987
6084;Meppel;2008;31351;7615;19047;4689;28194;1577;553;1024;1580;906;674;226;121;105;67;43;24;79;38;41;569;278;291;639;426;213;365.0;270.0;85.0;143.0;1821.0;1505.0;119
6085;Meppel;2009;31709;7656;19264;4789;28548;1585;541;1044;1576;911;665;226;126;100;74;48;26;92;43;49;563;273;290;621;421;200;364.0;274.0;80.0;145.0;1815.0;1513.0;119
6086;Meppel;2010;32041;7686;19443;4912;28871;1579;537;1042;1591;912;679;225;129;96;89;53;36;122;51;71;550;270;280;605;409;196;362.0;273.0;94.0;148.0;1723.0;1548.0;119
6087;Meppel;2011;32255;7697;19569;4989;29065;1572;533;1039;1618;927;691;235;137;98;91;56;35;137;59;78;539;262;277;616;413;203;351.0;274.0;92.0;137.0;1754.0;1489.0;119
6088;Meppel;2012;32556;7710;19561;5285;29327;1572;528;1044;1657;948;709;245;144;101;100;61;39;149;65;84;537;263;274;626;415;211;348.0;294.0;90.0;138.0;1794.0;1508.0;119
6089;Meppel;2013;32850;7776;19548;5526;29568;1577;531;1046;1705;970;735;255;149;106;107;62;45;167;76;91;547;272;275;629;411;218;350.0;292.0;105.0;132.0;1777.0;1525.0;119
6090;Meppel;2014;33138;7745;19652;5741;29776;1587;535;1052;1775;1015;760;265;158;107;109;62;47;185;86;99;551;277;274;665;432;233;350.0;294.0;98.0;144.0;1767.0;1535.0;119
6091;Meppel;2015;33381;7791;19687;5903;29977;1604;540;1064;1800;1023;777;273;163;110;101;57;44;216;95;121;538;271;267;672;437;235;346.0;296.0;92.0;134.0;1775.0;1537.0;119
6092;Meppel;2016;33632;7775;19793;6064;30187;1611;530;1081;1834;1054;780;285;174;111;101;64;37;225;102;123;526;266;260;697;448;249;348.0;303.0;91.0;140.0;1843.0;1567.0;119
6093;Meppel;2017;33907;7776;19902;6229;30412;1623;536;1087;1872;1079;793;297;178;119;108;69;39;250;114;136;513;262;251;704;456;248;351.0;307.0;98.0;130.0;1764.0;1592.0;119
6094;Meppel;2018;34094;7768;19868;6458;30583;1630;541;1089;1881;1086;795;308;186;122;107;69;38;254;116;138;502;257;245;710;458;252;349.0;309.0;97.0;139.0;1822.0;1604.0;119
6095;Meppel;2019;34313;7745;19867;6701;30804;1627;549;1078;1882;1089;793;305;183;122;103;70;33;266;116;150;491;258;233;717;462;255;344.0;326.0;88.0;133.0;1842.0;1615.0;119
6096;Meppel;2020;34519;7673;19907;6939;31002;1625;539;1086;1892;1072;820;321;186;135;113;72;41;272;119;153;474;253;221;712;442;270;347.0;327.0;91.0;126.0;1841.0;1602.0;119
6097;Meppel;2021;34748;7660;19919;7169;31155;1648;547;1101;1945;1088;857;335;192;143;121;71;50;289;130;159;483;258;225;717;437;280;351.0;336.0;89.0;128.0;1877.0;1615.0;119
6098;Meppel;2022;34990;7579;20062;7349;31370;1656;555;1101;1964;1089;875;341;187;154;128;75;53;301;134;167;467;253;214;727;440;287;351.0;345.0;94.0;128.0;1798.0;1634.0;119
6099;Meppel;2023;35130;7570;20012;7548;31474;1668;564;1104;1988;1098;890;347;188;159;130;82;48;317;144;173;466;248;218;728;436;292;353.0;353.0;90.0;135.0;1803.0;1658.0;119
6100;Meppel;2024;35235;7536;19949;7750;31585;1658;563;1095;1992;1099;893;352;188;164;131;85;46;318;144;174;460;252;208;731;430;301;357.0;356.0;93.0;131.0;1855.0;1640.0;119
6101;Meppel;2025;35416;7515;19935;7966;31739;1672;567;1105;2005;1123;882;340;186;154;139;90;49;333;150;183;449;256;193;744;441;303;;;;;;;119
6102;Middelburg (Z.);2008;47748;11477;28385;7886;39761;4353;1873;2480;3634;2101;1533;531;272;259;253;132;121;826;421;405;321;151;170;1703;1125;578;537.0;439.0;226.0;231.0;2203.0;1902.0;687
6103;Middelburg (Z.);2009;48148;11470;28640;8038;39959;4409;1891;2518;3780;2144;1636;564;281;283;281;148;133;845;424;421;337;156;181;1753;1135;618;534.0;442.0;243.0;237.0;2241.0;1917.0;687
6104;Middelburg (Z.);2010;48574;11509;28820;8245;40196;4469;1938;2531;3909;2205;1704;583;299;284;308;170;138;858;432;426;359;154;205;1801;1150;651;549.0;449.0;262.0;243.0;2304.0;1964.0;687
6105;Middelburg (Z.);2011;49036;11507;29128;8401;40489;4523;1964;2559;4024;2225;1799;594;307;287;328;173;155;884;437;447;364;155;209;1854;1153;701;546.0;460.0;260.0;244.0;2267.0;1995.0;687
6106;Middelburg (Z.);2012;49418;11474;29205;8739;40702;4603;2004;2599;4113;2254;1859;612;313;299;335;179;156;898;438;460;377;165;212;1891;1159;732;555.0;464.0;287.0;237.0;2356.0;2016.0;687
6107;Middelburg (Z.);2013;49901;11521;29284;9096;40962;4712;2058;2654;4227;2286;1941;619;328;291;343;176;167;924;446;478;406;175;231;1935;1161;774;575.0;464.0;265.0;230.0;2330.0;2031.0;687
6108;Middelburg (Z.);2014;50350;11551;29391;9408;41198;4793;2092;2701;4359;2319;2040;629;322;307;374;193;181;935;447;488;415;177;238;2006;1180;826;567.0;473.0;267.0;229.0;2258.0;2035.0;687
6109;Middelburg (Z.);2015;50706;11505;29555;9646;41397;4872;2138;2734;4437;2346;2091;631;325;306;390;196;194;923;441;482;442;189;253;2051;1195;856;580.0;490.0;294.0;232.0;2226.0;2036.0;687
6110;Middelburg (Z.);2016;51059;11567;29583;9909;41568;4940;2177;2763;4551;2394;2157;634;331;303;406;208;198;946;442;504;440;188;252;2125;1225;900;585.0;484.0;268.0;230.0;2223.0;2046.0;687
6111;Middelburg (Z.);2017;51381;11590;29685;10106;41704;5014;2192;2822;4663;2481;2182;638;339;299;413;221;192;947;443;504;482;203;279;2183;1275;908;596.0;487.0;275.0;232.0;2267.0;2071.0;687
6112;Middelburg (Z.);2018;51731;11609;29786;10336;41881;5098;2243;2855;4752;2525;2227;635;334;301;437;234;203;952;454;498;496;210;286;2232;1293;939;603.0;492.0;276.0;229.0;2255.0;2067.0;687
6113;Middelburg (Z.);2019;52083;11630;29869;10584;42070;5170;2281;2889;4843;2542;2301;640;332;308;442;235;207;973;470;503;523;215;308;2265;1290;975;599.0;505.0;277.0;238.0;2401.0;2066.0;687
6114;Middelburg (Z.);2020;52565;11751;29968;10846;42330;5249;2327;2922;4986;2604;2382;663;347;316;464;240;224;988;471;517;554;224;330;2317;1322;995;620.0;517.0;283.0;225.0;2291.0;2108.0;687
6115;Middelburg (Z.);2021;52915;11790;30052;11073;42553;5261;2337;2924;5101;2663;2438;659;349;310;484;246;238;999;473;526;585;232;353;2374;1363;1011;611.0;521.0;266.0;218.0;2327.0;2131.0;687
6116;Middelburg (Z.);2022;53251;11859;30090;11302;42744;5319;2362;2957;5188;2690;2498;685;359;326;485;244;241;1011;486;525;591;231;360;2416;1370;1046;626.0;523.0;290.0;222.0;2299.0;2102.0;687
6117;Middelburg (Z.);2023;53624;11922;30186;11516;42988;5357;2385;2972;5279;2745;2534;709;377;332;502;258;244;1006;483;523;601;240;361;2461;1387;1074;633.0;530.0;285.0;228.0;2286.0;2114.0;687
6118;Middelburg (Z.);2024;53962;12031;30215;11716;43117;5433;2410;3023;5412;2812;2600;723;386;337;507;255;252;1020;492;528;626;244;382;2536;1435;1101;627.0;546.0;267.0;220.0;2304.0;2118.0;687
6119;Middelburg (Z.);2025;54282;12097;30281;11904;43286;5486;2451;3035;5510;2846;2664;722;392;330;536;275;261;1040;500;540;652;246;406;2560;1433;1127;;;;;;;687
6120;Middelharnis;2008;17488;4384;10269;2835;16429;674;242;432;385;232;153;86;46;40;30;14;16;32;15;17;24;12;12;213;145;68;193.0;186.0;37.0;58.0;589.0;592.0;559
6121;Middelharnis;2009;17475;4336;10299;2840;16341;697;253;444;437;251;186;95;54;41;38;17;21;40;16;24;38;15;23;226;149;77;191.0;189.0;43.0;57.0;648.0;611.0;559
6122;Middelharnis;2010;17502;4295;10329;2878;16297;719;263;456;486;279;207;105;58;47;42;18;24;53;24;29;44;18;26;242;161;81;190.0;182.0;41.0;57.0;539.0;609.0;559
6123;Middelharnis;2011;17424;4215;10334;2875;16171;738;269;469;515;295;220;109;58;51;45;21;24;63;31;32;51;18;33;247;167;80;194.0;182.0;39.0;52.0;500.0;611.0;559
6124;Middelharnis;2012;17312;4153;10157;3002;16027;751;269;482;534;306;228;115;59;56;46;22;24;72;37;35;56;19;37;245;169;76;188.0;175.0;39.0;52.0;532.0;606.0;559
6125;Middelharnis;2013;17241;4113;10023;3105;15911;759;259;500;571;321;250;119;62;57;52;25;27;83;40;43;64;20;44;253;174;79;186.0;179.0;45.0;51.0;590.0;592.0;559
6126;Middelharnis;2014;17242;4074;9951;3217;15851;768;258;510;623;339;284;136;70;66;53;26;27;92;42;50;71;18;53;271;183;88;191.0;182.0;35.0;48.0;591.0;614.0;559
6127;Middelharnis;2015;17214;4017;9944;3253;15764;784;255;529;666;346;320;139;71;68;64;34;30;105;50;55;84;21;63;274;170;104;187.0;183.0;35.0;51.0;594.0;594.0;559
6128;Middelharnis;2016;17203;3957;9951;3295;15697;795;254;541;711;364;347;148;76;72;67;33;34;113;54;59;85;22;63;298;179;119;186.0;184.0;43.0;50.0;492.0;600.0;559
6129;Middelharnis;2017;17091;3886;9873;3332;15542;816;268;548;733;381;352;148;79;69;70;37;33;111;52;59;93;25;68;311;188;123;181.0;178.0;47.0;49.0;537.0;588.0;559
6130;Middelharnis;2018;17042;3867;9779;3396;15451;840;276;564;751;380;371;154;82;72;70;33;37;112;50;62;99;26;73;316;189;127;184.0;183.0;44.0;52.0;608.0;595.0;559
6131;Middelharnis;2019;17050;3842;9757;3451;15417;854;283;571;779;395;384;157;82;75;65;30;35;120;54;66;106;28;78;331;201;130;183.0;190.0;39.0;48.0;691.0;583.0;559
6132;Middelharnis;2020;17144;3839;9729;3576;15457;887;302;585;800;400;400;154;83;71;67;30;37;121;50;71;112;31;81;346;206;140;187.0;185.0;38.0;50.0;504.0;601.0;559
6133;Middelharnis;2021;17038;3768;9634;3636;15349;880;302;578;809;415;394;152;83;69;68;33;35;119;50;69;118;33;85;352;216;136;189.0;189.0;40.0;46.0;652.0;579.0;559
6134;Middelharnis;2022;17108;3760;9666;3682;15381;893;304;589;834;421;413;156;83;73;68;34;34;127;52;75;118;36;82;365;216;149;188.0;195.0;41.0;53.0;578.0;598.0;559
6135;Middelharnis;2023;17072;3740;9602;3730;15318;907;309;598;847;419;428;159;83;76;68;34;34;137;53;84;121;37;84;362;212;150;184.0;198.0;41.0;49.0;676.0;574.0;559
6136;Middelharnis;2024;17153;3758;9584;3811;15327;925;319;606;901;446;455;167;87;80;71;37;34;136;52;84;129;42;87;398;228;170;186.0;197.0;45.0;49.0;625.0;587.0;559
6137;Middelharnis;2025;17179;3759;9531;3889;15293;948;328;620;938;454;484;176;91;85;73;39;34;139;52;87;136;49;87;414;223;191;;;;;;;559
6138;Midden-Delfland;2008;17716;4901;10476;2339;16205;883;282;601;628;339;289;107;51;56;37;21;16;76;33;43;106;55;51;302;179;123;150.0;117.0;48.0;67.0;806.0;742.0;1842
6139;Midden-Delfland;2009;17798;4754;10631;2413;16207;902;292;610;689;374;315;116;55;61;44;24;20;92;40;52;109;56;53;328;199;129;149.0;122.0;55.0;72.0;775.0;746.0;1842
6140;Midden-Delfland;2010;17839;4668;10650;2521;16144;933;304;629;762;407;355;122;56;66;50;23;27;100;47;53;124;56;68;366;225;141;149.0;125.0;56.0;70.0;717.0;754.0;1842
6141;Midden-Delfland;2011;17813;4550;10695;2568;16052;930;300;630;831;437;394;125;57;68;57;24;33;111;53;58;133;58;75;405;245;160;145.0;130.0;51.0;66.0;715.0;746.0;1842
6142;Midden-Delfland;2012;17784;4436;10635;2713;15985;912;294;618;887;450;437;135;58;77;65;28;37;124;53;71;130;56;74;433;255;178;149.0;133.0;55.0;66.0;688.0;743.0;1842
6143;Midden-Delfland;2013;17737;4324;10591;2822;15890;898;301;597;949;475;474;151;61;90;69;28;41;130;53;77;135;57;78;464;276;188;145.0;136.0;55.0;66.0;778.0;718.0;1842
6144;Midden-Delfland;2014;17799;4196;10632;2971;15914;899;301;598;986;486;500;164;65;99;72;30;42;135;55;80;131;56;75;484;280;204;142.0;141.0;51.0;65.0;719.0;733.0;1842
6145;Midden-Delfland;2015;17775;4076;10610;3089;15846;900;299;601;1029;494;535;166;61;105;78;37;41;138;59;79;143;54;89;504;283;221;150.0;147.0;56.0;64.0;622.0;723.0;1842
6146;Midden-Delfland;2016;17671;3954;10549;3168;15667;910;302;608;1094;516;578;175;64;111;79;34;45;147;63;84;151;57;94;542;298;244;143.0;149.0;58.0;63.0;704.0;736.0;1842
6147;Midden-Delfland;2017;17630;3904;10458;3268;15569;930;312;618;1131;520;611;177;65;112;85;34;51;164;70;94;148;59;89;557;292;265;143.0;150.0;55.0;62.0;689.0;728.0;1842
6148;Midden-Delfland;2018;17581;3784;10441;3356;15468;950;316;634;1163;541;622;193;70;123;86;37;49;164;69;95;150;62;88;570;303;267;146.0;160.0;58.0;63.0;711.0;712.0;1842
6149;Midden-Delfland;2019;17564;3703;10396;3465;15388;968;330;638;1208;567;641;196;73;123;88;34;54;174;72;102;152;64;88;598;324;274;146.0;160.0;55.0;63.0;753.0;714.0;1842
6150;Midden-Delfland;2020;17582;3624;10399;3559;15350;979;332;647;1253;596;657;200;75;125;89;34;55;179;77;102;160;67;93;625;343;282;142.0;162.0;63.0;65.0;720.0;679.0;1842
6151;Midden-Delfland;2021;17602;3546;10389;3667;15331;986;336;650;1285;621;664;199;78;121;91;35;56;181;78;103;165;71;94;649;359;290;147.0;166.0;58.0;58.0;696.0;699.0;1842
6152;Midden-Delfland;2022;17582;3462;10311;3809;15243;1022;354;668;1317;642;675;209;86;123;92;37;55;185;80;105;170;72;98;661;367;294;142.0;171.0;63.0;61.0;677.0;714.0;1842
6153;Midden-Delfland;2023;17520;3391;10200;3929;15122;1042;367;675;1356;659;697;218;92;126;93;38;55;194;82;112;184;74;110;667;373;294;148.0;175.0;57.0;64.0;691.0;696.0;1842
6154;Midden-Delfland;2024;17484;3322;10127;4035;15036;1057;369;688;1391;668;723;225;92;133;97;40;57;197;89;108;184;69;115;688;378;310;144.0;173.0;59.0;65.0;773.0;694.0;1842
6155;Midden-Delfland;2025;17531;3295;10052;4184;15035;1082;378;704;1414;686;728;229;96;133;104;40;64;204;93;111;182;70;112;695;387;308;;;;;;;1842
6156;Midden-Drenthe;2008;33830;8306;19877;5647;31647;1482;517;965;701;410;291;97;46;51;56;22;34;61;32;29;63;27;36;424;283;141;329.0;306.0;83.0;103.0;1082.0;1187.0;1731
6157;Midden-Drenthe;2009;33737;8226;19690;5821;31498;1486;504;982;753;454;299;117;54;63;65;26;39;65;35;30;57;28;29;449;311;138;325.0;308.0;84.0;106.0;1238.0;1177.0;1731
6158;Midden-Drenthe;2010;33798;8204;19538;6056;31440;1496;510;986;862;511;351;136;58;78;71;29;42;87;48;39;72;32;40;496;344;152;309.0;315.0;87.0;106.0;1018.0;1176.0;1731
6159;Midden-Drenthe;2011;33618;8034;19327;6257;31165;1503;504;999;950;553;397;148;68;80;70;28;42;103;55;48;94;35;59;535;367;168;302.0;320.0;98.0;107.0;1098.0;1151.0;1731
6160;Midden-Drenthe;2012;33539;7914;19043;6582;30968;1534;513;1021;1037;585;452;156;73;83;80;31;49;121;61;60;108;36;72;572;384;188;302.0;327.0;108.0;106.0;1139.0;1162.0;1731
6161;Midden-Drenthe;2013;33495;7846;18771;6878;30823;1531;511;1020;1141;640;501;170;80;90;92;36;56;136;65;71;131;45;86;612;414;198;297.0;330.0;104.0;115.0;1087.0;1165.0;1731
6162;Midden-Drenthe;2014;33375;7703;18498;7174;30617;1545;516;1029;1213;675;538;180;89;91;95;39;56;147;69;78;146;52;94;645;426;219;297.0;337.0;108.0;114.0;1040.0;1189.0;1731
6163;Midden-Drenthe;2015;33182;7528;18220;7434;30366;1548;516;1032;1268;702;566;188;90;98;106;45;61;153;72;81;148;54;94;673;441;232;292.0;343.0;100.0;108.0;1038.0;1154.0;1731
6164;Midden-Drenthe;2016;33013;7393;17993;7627;30139;1533;493;1040;1341;735;606;193;92;101;113;44;69;180;82;98;153;57;96;702;460;242;288.0;352.0;120.0;110.0;1087.0;1133.0;1731
6165;Midden-Drenthe;2017;32914;7252;17854;7808;29952;1544;490;1054;1418;772;646;202;97;105;121;51;70;207;96;111;172;67;105;716;461;255;283.0;356.0;103.0;113.0;1073.0;1138.0;1731
6166;Midden-Drenthe;2018;32771;7123;17676;7972;29759;1520;477;1043;1492;820;672;209;96;113;128;59;69;211;89;122;179;74;105;765;502;263;283.0;367.0;101.0;119.0;1148.0;1139.0;1731
6167;Midden-Drenthe;2019;32679;6996;17569;8114;29584;1546;492;1054;1549;853;696;213;99;114;132;62;70;235;99;136;188;79;109;781;514;267;288.0;372.0;108.0;112.0;1207.0;1164.0;1731
6168;Midden-Drenthe;2020;32636;6876;17428;8332;29478;1537;497;1040;1621;875;746;221;95;126;147;72;75;250;103;147;191;79;112;812;526;286;290.0;372.0;108.0;112.0;1282.0;1154.0;1731
6169;Midden-Drenthe;2021;32682;6808;17324;8550;29430;1544;500;1044;1708;909;799;233;102;131;163;71;92;259;108;151;199;81;118;854;547;307;301.0;383.0;103.0;110.0;1083.0;1154.0;1731
6170;Midden-Drenthe;2022;32525;6668;17144;8713;29196;1545;499;1046;1784;934;850;245;112;133;173;72;101;267;104;163;224;98;126;875;548;327;295.0;391.0;98.0;111.0;1092.0;1133.0;1731
6171;Midden-Drenthe;2023;32381;6524;16980;8877;28976;1542;487;1055;1863;974;889;253;120;133;189;74;115;285;110;175;246;101;145;890;569;321;304.0;395.0;97.0;114.0;1145.0;1105.0;1731
6172;Midden-Drenthe;2024;32315;6466;16741;9108;28834;1547;486;1061;1934;990;944;259;128;131;203;76;127;296;110;186;273;104;169;903;572;331;288.0;400.0;96.0;117.0;1274.0;1108.0;1731
6173;Midden-Drenthe;2025;32352;6431;16627;9294;28809;1549;493;1056;1994;1011;983;267;132;135;204;75;129;309;116;193;286;106;180;928;582;346;;;;;;;1731
6174;Mill en Sint Hubert;2008;10761;2680;6478;1603;10207;383;101;282;171;94;77;23;12;11;10;4;6;24;13;11;21;8;13;93;57;36;99.0;88.0;23.0;34.0;304.0;301.0;815
6175;Mill en Sint Hubert;2009;10766;2659;6457;1650;10172;387;105;282;207;112;95;28;13;15;11;4;7;24;11;13;29;12;17;115;72;43;97.0;90.0;24.0;43.0;267.0;329.0;815
6176;Mill en Sint Hubert;2010;10694;2582;6409;1703;10075;395;108;287;224;116;108;31;13;18;13;4;9;25;11;14;31;11;20;124;77;47;94.0;92.0;24.0;38.0;284.0;347.0;815
6177;Mill en Sint Hubert;2011;10621;2544;6347;1730;9955;404;107;297;262;135;127;40;19;21;12;3;9;33;15;18;35;14;21;142;84;58;90.0;86.0;29.0;39.0;247.0;351.0;815
6178;Mill en Sint Hubert;2012;10512;2451;6295;1766;9837;406;107;299;269;136;133;44;22;22;11;3;8;37;17;20;36;15;21;141;79;62;91.0;88.0;30.0;34.0;365.0;343.0;815
6179;Mill en Sint Hubert;2013;10538;2429;6283;1826;9813;415;119;296;310;152;158;52;26;26;13;3;10;37;16;21;48;19;29;160;88;72;89.0;92.0;29.0;37.0;368.0;359.0;815
6180;Mill en Sint Hubert;2014;10537;2401;6234;1902;9792;430;131;299;315;159;156;51;28;23;18;4;14;39;15;24;47;23;24;160;89;71;88.0;100.0;30.0;35.0;389.0;374.0;815
6181;Mill en Sint Hubert;2015;10536;2327;6247;1962;9746;447;144;303;343;171;172;53;29;24;21;6;15;42;17;25;53;28;25;174;91;83;92.0;96.0;26.0;35.0;357.0;358.0;815
6182;Mill en Sint Hubert;2016;10524;2304;6207;2013;9708;455;142;313;361;180;181;55;28;27;21;8;13;51;22;29;53;30;23;181;92;89;91.0;100.0;31.0;35.0;397.0;361.0;815
6183;Mill en Sint Hubert;2017;10549;2269;6204;2076;9690;470;145;325;389;197;192;59;28;31;22;8;14;52;23;29;57;30;27;199;108;91;95.0;100.0;25.0;38.0;403.0;367.0;815
6184;Mill en Sint Hubert;2018;10569;2245;6195;2129;9684;463;144;319;422;205;217;65;31;34;26;9;17;61;26;35;66;33;33;204;106;98;101.0;103.0;26.0;38.0;394.0;370.0;815
6185;Mill en Sint Hubert;2019;10579;2234;6172;2173;9654;469;145;324;456;224;232;73;35;38;29;11;18;68;27;41;70;38;32;216;113;103;106.0;105.0;34.0;37.0;406.0;374.0;815
6186;Mill en Sint Hubert;2020;10608;2197;6192;2219;9634;487;152;335;487;241;246;80;39;41;27;11;16;68;27;41;86;41;45;226;123;103;108.0;106.0;30.0;34.0;420.0;380.0;815
6187;Mill en Sint Hubert;2021;10646;2165;6207;2274;9621;500;159;341;525;260;265;82;41;41;26;12;14;79;31;48;82;41;41;256;135;121;112.0;108.0;29.0;39.0;396.0;379.0;815
6188;Mill en Sint Hubert;2022;10658;2135;6186;2337;9601;516;158;358;541;262;279;82;41;41;31;14;17;86;34;52;83;39;44;259;134;125;114.0;112.0;27.0;40.0;394.0;373.0;815
6189;Mill en Sint Hubert;2023;10668;2135;6143;2390;9602;519;166;353;547;263;284;85;42;43;30;15;15;85;35;50;88;39;49;259;132;127;118.0;116.0;32.0;37.0;429.0;368.0;815
6190;Mill en Sint Hubert;2024;10727;2164;6128;2435;9607;543;180;363;577;270;307;83;39;44;34;17;17;91;38;53;89;36;53;280;140;140;126.0;116.0;33.0;36.0;421.0;373.0;815
6191;Mill en Sint Hubert;2025;10783;2178;6113;2492;9614;548;192;356;621;293;328;87;41;46;41;22;19;95;41;54;96;40;56;302;149;153;;;;;;;815
6192;Millingen aan de Rijn;2008;5698;1397;3484;817;4870;710;227;483;118;78;40;32;13;19;9;5;4;2;0;2;6;5;1;69;55;14;39.0;48.0;21.0;29.0;134.0;176.0;265
6193;Millingen aan de Rijn;2009;5639;1348;3455;836;4823;687;222;465;129;87;42;32;14;18;11;8;3;5;2;3;7;4;3;74;59;15;39.0;48.0;18.0;26.0;103.0;171.0;265
6194;Millingen aan de Rijn;2010;5555;1285;3418;852;4755;661;208;453;139;90;49;36;14;22;14;11;3;7;2;5;7;5;2;75;58;17;35.0;47.0;18.0;25.0;140.0;176.0;265
6195;Millingen aan de Rijn;2011;5500;1216;3423;861;4701;651;208;443;148;93;55;36;14;22;16;13;3;10;4;6;10;6;4;76;56;20;40.0;48.0;20.0;21.0;111.0;167.0;265
6196;Millingen aan de Rijn;2012;5435;1164;3362;909;4635;636;199;437;164;107;57;37;16;21;18;15;3;14;4;10;13;9;4;82;63;19;38.0;50.0;21.0;25.0;144.0;167.0;265
6197;Millingen aan de Rijn;2013;5396;1122;3319;955;4591;635;202;433;170;106;64;39;18;21;17;13;4;13;7;6;18;9;9;83;59;24;35.0;46.0;22.0;25.0;65.0;181.0;265
6198;Millingen aan de Rijn;2014;5267;1065;3213;989;4474;619;196;423;174;103;71;44;20;24;17;12;5;14;7;7;19;8;11;80;56;24;37.0;48.0;20.0;22.0;178.0;162.0;265
6199;Millingen aan de Rijn;2015;5270;1040;3204;1026;4479;614;194;420;177;105;72;45;22;23;20;15;5;14;5;9;18;9;9;80;54;26;40.0;48.0;17.0;20.0;154.0;181.0;265
6200;Millingen aan de Rijn;2016;5232;999;3180;1053;4437;607;195;412;188;111;77;45;20;25;19;15;4;18;5;13;18;9;9;88;62;26;37.0;50.0;15.0;22.0;187.0;170.0;265
6201;Millingen aan de Rijn;2017;5229;972;3185;1072;4443;592;190;402;194;113;81;45;20;25;20;15;5;23;8;15;18;8;10;88;62;26;42.0;55.0;21.0;22.0;180.0;175.0;265
6202;Millingen aan de Rijn;2018;5220;956;3157;1107;4435;583;185;398;202;121;81;44;20;24;22;17;5;23;6;17;20;11;9;93;67;26;44.0;53.0;18.0;22.0;188.0;185.0;265
6203;Millingen aan de Rijn;2019;5211;940;3134;1137;4427;570;184;386;214;130;84;48;25;23;22;17;5;24;7;17;23;14;9;97;67;30;44.0;56.0;14.0;20.0;168.0;184.0;265
6204;Millingen aan de Rijn;2020;5176;913;3116;1147;4371;576;191;385;229;135;94;47;24;23;22;15;7;26;8;18;27;15;12;107;73;34;46.0;52.0;16.0;20.0;198.0;175.0;265
6205;Millingen aan de Rijn;2021;5188;890;3125;1173;4378;569;192;377;241;138;103;45;23;22;26;15;11;26;9;17;33;17;16;111;74;37;49.0;55.0;18.0;18.0;159.0;186.0;265
6206;Millingen aan de Rijn;2022;5153;866;3077;1210;4339;567;196;371;247;142;105;47;24;23;25;15;10;33;13;20;34;19;15;108;71;37;49.0;57.0;13.0;21.0;196.0;167.0;265
6207;Millingen aan de Rijn;2023;5167;845;3097;1225;4343;562;189;373;262;149;113;48;24;24;27;16;11;43;18;25;33;18;15;111;73;38;48.0;53.0;15.0;19.0;189.0;181.0;265
6208;Millingen aan de Rijn;2024;5167;836;3054;1277;4344;543;182;361;280;152;128;50;24;26;24;15;9;43;18;25;37;19;18;126;76;50;53.0;59.0;41.0;20.0;225.0;178.0;265
6209;Millingen aan de Rijn;2025;5239;888;3041;1310;4381;546;190;356;312;163;149;50;23;27;30;19;11;44;21;23;43;19;24;145;81;64;;;;;;;265
6210;Moerdijk;2008;36223;8506;22321;5396;32953;1987;700;1287;1283;726;557;178;91;87;84;46;38;369;194;175;161;84;77;491;311;180;313.0;332.0;128.0;181.0;1040.0;1095.0;1709
6211;Moerdijk;2009;36102;8451;22073;5578;32730;2018;707;1311;1354;753;601;187;91;96;101;55;46;382;198;184;175;86;89;509;323;186;303.0;338.0;137.0;186.0;981.0;1129.0;1709
6212;Moerdijk;2010;35876;8384;21728;5764;32408;2042;715;1327;1426;789;637;204;97;107;106;60;46;397;201;196;183;90;93;536;341;195;298.0;336.0;154.0;183.0;1078.0;1109.0;1709
6213;Moerdijk;2011;35783;8291;21593;5899;32200;2081;739;1342;1502;827;675;225;107;118;111;67;44;400;198;202;210;100;110;556;355;201;289.0;341.0;151.0;173.0;1195.0;1140.0;1709
6214;Moerdijk;2012;35767;8204;21360;6203;32078;2117;741;1376;1572;856;716;239;109;130;117;66;51;418;206;212;210;101;109;588;374;214;289.0;353.0;159.0;174.0;1077.0;1132.0;1709
6215;Moerdijk;2013;35639;8093;21042;6504;31858;2165;743;1422;1616;882;734;249;116;133;126;73;53;429;209;220;216;105;111;596;379;217;281.0;348.0;153.0;171.0;1030.0;1129.0;1709
6216;Moerdijk;2014;35458;7911;20786;6761;31584;2203;766;1437;1671;905;766;259;123;136;134;72;62;436;213;223;231;111;120;611;386;225;281.0;361.0;162.0;171.0;1200.0;1116.0;1709
6217;Moerdijk;2015;35459;7875;20635;6949;31371;2269;803;1466;1819;951;868;281;128;153;155;80;75;462;226;236;262;117;145;659;400;259;274.0;363.0;169.0;172.0;1163.0;1124.0;1709
6218;Moerdijk;2016;35409;7794;20459;7156;31184;2350;839;1511;1875;981;894;282;131;151;153;80;73;476;223;253;278;126;152;686;421;265;282.0;378.0;168.0;170.0;1227.0;1139.0;1709
6219;Moerdijk;2017;35406;7682;20377;7347;31030;2400;873;1527;1976;1015;961;297;135;162;169;83;86;489;224;265;292;127;165;729;446;283;285.0;380.0;165.0;167.0;1171.0;1130.0;1709
6220;Moerdijk;2018;35353;7593;20231;7529;30861;2435;880;1555;2057;1044;1013;317;144;173;181;96;85;515;234;281;302;131;171;742;439;303;287.0;377.0;158.0;168.0;1263.0;1112.0;1709
6221;Moerdijk;2019;35407;7458;20280;7669;30805;2484;892;1592;2118;1056;1062;327;143;184;193;99;94;523;235;288;318;135;183;757;444;313;296.0;389.0;157.0;163.0;1174.0;1108.0;1709
6222;Moerdijk;2020;35377;7339;20195;7843;30622;2539;920;1619;2216;1119;1097;347;154;193;215;110;105;537;238;299;322;141;181;795;476;319;298.0;397.0;159.0;172.0;1251.0;1154.0;1709
6223;Moerdijk;2021;35367;7228;20195;7944;30446;2589;950;1639;2332;1150;1182;363;162;201;219;110;109;565;234;331;343;147;196;842;497;345;316.0;409.0;161.0;174.0;1135.0;1180.0;1709
6224;Moerdijk;2022;35221;7139;19984;8098;30202;2642;969;1673;2377;1148;1229;380;165;215;222;111;111;575;227;348;349;154;195;851;491;360;308.0;418.0;166.0;168.0;1124.0;1161.0;1709
6225;Moerdijk;2023;35076;6986;19853;8237;29983;2661;978;1683;2432;1172;1260;389;173;216;233;112;121;577;233;344;351;157;194;882;497;385;306.0;421.0;161.0;169.0;1170.0;1110.0;1709
6226;Moerdijk;2024;35015;6926;19724;8365;29799;2696;989;1707;2520;1219;1301;401;182;219;247;115;132;592;239;353;372;164;208;908;519;389;315.0;427.0;171.0;170.0;1250.0;1126.0;1709
6227;Moerdijk;2025;35033;6966;19635;8432;29698;2722;987;1735;2613;1247;1366;416;187;229;275;131;144;607;233;374;379;169;210;936;527;409;;;;;;;1709
6228;Montferland;2008;34127;8198;20276;5653;30326;2805;833;1972;996;620;376;112;61;51;35;12;23;302;149;153;48;26;22;499;372;127;254.0;300.0;89.0;152.0;799.0;1071.0;1955
6229;Montferland;2009;33750;7958;19985;5807;29965;2712;794;1918;1073;653;420;125;64;61;41;17;24;307;151;156;71;36;35;529;385;144;249.0;306.0;114.0;141.0;961.0;1072.0;1955
6230;Montferland;2010;33561;7786;19766;6009;29735;2657;753;1904;1169;702;467;140;72;68;56;26;30;332;157;175;92;50;42;549;397;152;248.0;307.0;95.0;129.0;954.0;1095.0;1955
6231;Montferland;2011;33331;7601;19588;6142;29460;2623;753;1870;1248;750;498;151;79;72;64;32;32;340;161;179;114;57;57;579;421;158;242.0;312.0;94.0;133.0;879.0;1093.0;1955
6232;Montferland;2012;33011;7376;19231;6404;29142;2573;749;1824;1296;773;523;166;91;75;63;36;27;363;166;197;127;65;62;577;415;162;242.0;326.0;108.0;134.0;1056.0;1116.0;1955
6233;Montferland;2013;32846;7176;19092;6578;28950;2554;760;1794;1342;802;540;178;98;80;63;36;27;360;164;196;145;73;72;596;431;165;240.0;331.0;99.0;127.0;1163.0;1121.0;1955
6234;Montferland;2014;32771;7055;18924;6792;28808;2524;747;1777;1439;847;592;195;110;85;72;39;33;368;166;202;160;78;82;644;454;190;239.0;333.0;103.0;136.0;1142.0;1119.0;1955
6235;Montferland;2015;32670;6896;18816;6958;28613;2511;740;1771;1546;904;642;211;117;94;83;46;37;388;178;210;178;84;94;686;479;207;247.0;343.0;99.0;130.0;1091.0;1130.0;1955
6236;Montferland;2016;32506;6730;18695;7081;28461;2485;757;1728;1560;885;675;214;119;95;85;47;38;399;173;226;191;92;99;671;454;217;249.0;354.0;92.0;127.0;1188.0;1142.0;1955
6237;Montferland;2017;32414;6578;18647;7189;28325;2472;778;1694;1617;909;708;234;124;110;103;55;48;427;185;242;202;102;100;651;443;208;254.0;360.0;99.0;120.0;1095.0;1161.0;1955
6238;Montferland;2018;32223;6444;18480;7299;28103;2432;771;1661;1688;938;750;248;130;118;114;61;53;435;189;246;214;104;110;677;454;223;269.0;362.0;97.0;125.0;1284.0;1151.0;1955
6239;Montferland;2019;32236;6316;18566;7354;28026;2420;783;1637;1790;982;808;258;136;122;122;63;59;461;199;262;229;106;123;720;478;242;276.0;363.0;89.0;119.0;1185.0;1133.0;1955
6240;Montferland;2020;32175;6199;18499;7477;27909;2425;791;1634;1841;1002;839;274;144;130;122;59;63;474;207;267;245;116;129;726;476;250;278.0;370.0;104.0;120.0;1287.0;1165.0;1955
6241;Montferland;2021;32193;6130;18483;7580;27830;2426;793;1633;1937;1048;889;276;143;133;130;68;62;499;213;286;262;117;145;770;507;263;294.0;373.0;97.0;118.0;1124.0;1174.0;1955
6242;Montferland;2022;32048;6011;18251;7786;27665;2384;779;1605;1999;1075;924;286;149;137;138;72;66;527;221;306;273;126;147;775;507;268;294.0;388.0;90.0;109.0;1240.0;1167.0;1955
6243;Montferland;2023;32009;5936;18174;7899;27576;2360;786;1574;2073;1103;970;306;154;152;145;76;69;541;217;324;294;136;158;787;520;267;300.0;391.0;105.0;118.0;1209.0;1129.0;1955
6244;Montferland;2024;31987;5863;18079;8045;27486;2343;784;1559;2158;1132;1026;312;158;154;162;80;82;548;212;336;318;148;170;818;534;284;301.0;397.0;89.0;118.0;1268.0;1135.0;1955
6245;Montferland;2025;31997;5833;17987;8177;27414;2361;805;1556;2222;1174;1048;324;171;153;163;86;77;549;209;340;331;153;178;855;555;300;;;;;;;1955
6246;Montfoort;2008;13376;3710;8116;1550;12233;648;219;429;495;284;211;58;29;29;35;20;15;78;41;37;106;46;60;218;148;70;158.0;82.0;36.0;53.0;417.0;536.0;335
6247;Montfoort;2009;13318;3628;8064;1626;12155;635;215;420;528;296;232;63;33;30;44;23;21;79;43;36;111;48;63;231;149;82;148.0;88.0;43.0;52.0;492.0;541.0;335
6248;Montfoort;2010;13323;3601;7985;1737;12118;638;217;421;567;306;261;71;32;39;46;25;21;82;44;38;118;52;66;250;153;97;142.0;87.0;40.0;50.0;457.0;551.0;335
6249;Montfoort;2011;13275;3524;7924;1827;12074;637;222;415;564;302;262;73;36;37;47;24;23;79;43;36;117;48;69;248;151;97;143.0;91.0;44.0;50.0;461.0;517.0;335
6250;Montfoort;2012;13264;3455;7839;1970;12016;647;220;427;601;320;281;75;37;38;45;22;23;89;43;46;123;51;72;269;167;102;140.0;95.0;40.0;49.0;462.0;528.0;335
6251;Montfoort;2013;13236;3397;7749;2090;11969;634;220;414;633;338;295;84;39;45;44;22;22;96;48;48;129;52;77;280;177;103;139.0;96.0;41.0;51.0;421.0;519.0;335
6252;Montfoort;2014;13171;3308;7690;2173;11894;628;219;409;649;348;301;85;43;42;50;24;26;101;50;51;127;54;73;286;177;109;138.0;98.0;41.0;48.0;396.0;526.0;335
6253;Montfoort;2015;13076;3220;7601;2255;11757;637;230;407;682;357;325;89;43;46;51;26;25;110;52;58;135;57;78;297;179;118;131.0;100.0;40.0;46.0;492.0;510.0;335
6254;Montfoort;2016;13084;3191;7558;2335;11728;647;230;417;709;368;341;95;46;49;56;27;29;116;56;60;129;52;77;313;187;126;131.0;106.0;38.0;47.0;448.0;512.0;335
6255;Montfoort;2017;13037;3109;7537;2391;11650;643;231;412;744;386;358;103;47;56;60;27;33;122;62;60;132;58;74;327;192;135;129.0;105.0;43.0;42.0;434.0;524.0;335
6256;Montfoort;2018;12973;3042;7477;2454;11562;658;237;421;753;384;369;104;47;57;60;24;36;118;61;57;134;56;78;337;196;141;129.0;107.0;42.0;48.0;472.0;526.0;335
6257;Montfoort;2019;12937;2963;7434;2540;11491;682;248;434;764;384;380;103;42;61;58;23;35;118;58;60;140;58;82;345;203;142;128.0;113.0;42.0;46.0;507.0;529.0;335
6258;Montfoort;2020;12927;2892;7448;2587;11461;676;244;432;790;394;396;108;43;65;62;25;37;121;56;65;144;60;84;355;210;145;125.0;113.0;38.0;45.0;461.0;511.0;335
6259;Montfoort;2021;12880;2827;7447;2606;11395;682;247;435;803;394;409;117;47;70;60;25;35;117;58;59;153;57;96;356;207;149;129.0;115.0;41.0;44.0;489.0;530.0;335
6260;Montfoort;2022;12850;2779;7409;2662;11327;700;252;448;823;402;421;125;46;79;59;22;37;119;57;62;155;59;96;365;218;147;129.0;118.0;48.0;43.0;465.0;528.0;335
6261;Montfoort;2023;12805;2711;7412;2682;11273;704;257;447;828;414;414;123;51;72;62;24;38;133;64;69;154;60;94;356;215;141;126.0;119.0;39.0;42.0;440.0;522.0;335
6262;Montfoort;2024;12728;2656;7352;2720;11167;708;254;454;853;432;421;127;53;74;60;24;36;135;68;67;161;65;96;370;222;148;130.0;125.0;41.0;41.0;463.0;496.0;335
6263;Montfoort;2025;12701;2614;7295;2792;11104;718;254;464;879;445;434;132;56;76;61;24;37;152;73;79;156;66;90;378;226;152;;;;;;;335
6264;Mook en Middelaar;2008;8101;1980;4756;1365;7064;773;242;531;264;145;119;24;10;14;20;8;12;26;14;12;14;9;5;180;104;76;61.0;69.0;28.0;41.0;428.0;440.0;944
6265;Mook en Middelaar;2009;8068;1930;4733;1405;7021;763;233;530;284;157;127;29;13;16;22;11;11;28;16;12;20;10;10;185;107;78;60.0;72.0;35.0;38.0;400.0;426.0;944
6266;Mook en Middelaar;2010;8028;1878;4705;1445;6955;757;222;535;316;187;129;33;16;17;29;16;13;37;24;13;22;12;10;195;119;76;56.0;75.0;32.0;37.0;429.0;440.0;944
6267;Mook en Middelaar;2011;7995;1853;4687;1455;6909;752;221;531;334;195;139;35;16;19;29;19;10;47;29;18;30;13;17;193;118;75;56.0;74.0;31.0;33.0;472.0;452.0;944
6268;Mook en Middelaar;2012;7997;1794;4692;1511;6926;749;221;528;322;183;139;31;15;16;31;19;12;45;29;16;32;12;20;183;108;75;57.0;75.0;35.0;32.0;461.0;469.0;944
6269;Mook en Middelaar;2013;7975;1741;4672;1562;6866;750;228;522;359;201;158;38;17;21;34;20;14;56;35;21;33;13;20;198;116;82;62.0;76.0;31.0;36.0;437.0;462.0;944
6270;Mook en Middelaar;2014;7932;1704;4627;1601;6771;757;236;521;404;227;177;42;19;23;36;22;14;62;35;27;37;16;21;227;135;92;66.0;78.0;37.0;32.0;451.0;481.0;944
6271;Mook en Middelaar;2015;7895;1654;4595;1646;6708;770;240;530;417;235;182;44;18;26;33;20;13;67;36;31;41;21;20;232;140;92;66.0;78.0;38.0;35.0;439.0;469.0;944
6272;Mook en Middelaar;2016;7857;1617;4549;1691;6657;762;233;529;438;245;193;49;23;26;40;25;15;69;38;31;41;18;23;239;141;98;65.0;78.0;32.0;35.0;447.0;486.0;944
6273;Mook en Middelaar;2017;7803;1591;4501;1711;6630;746;225;521;427;248;179;55;27;28;39;26;13;63;35;28;39;20;19;231;140;91;65.0;81.0;34.0;33.0;424.0;466.0;944
6274;Mook en Middelaar;2018;7747;1545;4464;1738;6570;748;235;513;429;254;175;58;31;27;40;24;16;65;39;26;46;26;20;220;134;86;69.0;80.0;33.0;35.0;439.0;462.0;944
6275;Mook en Middelaar;2019;7712;1513;4451;1748;6526;754;233;521;432;244;188;57;26;31;40;23;17;61;37;24;53;26;27;221;132;89;67.0;82.0;30.0;32.0;467.0;453.0;944
6276;Mook en Middelaar;2020;7710;1509;4439;1762;6507;744;236;508;459;259;200;61;26;35;46;27;19;59;34;25;57;26;31;236;146;90;68.0;79.0;31.0;32.0;441.0;482.0;944
6277;Mook en Middelaar;2021;7658;1478;4397;1783;6445;739;237;502;474;265;209;59;27;32;49;28;21;71;38;33;55;25;30;240;147;93;69.0;82.0;40.0;30.0;457.0;463.0;944
6278;Mook en Middelaar;2022;7650;1482;4376;1792;6419;727;245;482;504;280;224;62;28;34;58;34;24;74;38;36;67;30;37;243;150;93;70.0;82.0;32.0;30.0;440.0;452.0;944
6279;Mook en Middelaar;2023;7629;1430;4365;1834;6370;724;248;476;535;299;236;67;28;39;62;38;24;80;40;40;72;31;41;254;162;92;69.0;84.0;37.0;31.0;461.0;468.0;944
6280;Mook en Middelaar;2024;7615;1413;4341;1861;6329;724;245;479;562;311;251;70;28;42;64;40;24;90;43;47;76;34;42;262;166;96;70.0;86.0;32.0;34.0;465.0;452.0;944
6281;Mook en Middelaar;2025;7610;1400;4324;1886;6310;723;248;475;577;328;249;70;30;40;68;44;24;96;45;51;72;32;40;271;177;94;;;;;;;944
6282;Moordrecht;2008;7984;2231;4734;1019;6438;1001;335;666;545;293;252;43;18;25;26;12;14;21;10;11;328;162;166;127;91;36;92.0;49.0;26.0;37.0;350.0;333.0;563
6283;Moordrecht;2009;8034;2208;4766;1060;6474;978;332;646;582;315;267;48;19;29;30;14;16;27;13;14;347;176;171;130;93;37;88.0;57.0;27.0;37.0;338.0;368.0;563
6284;Moordrecht;2010;8028;2166;4766;1096;6482;956;319;637;590;318;272;48;18;30;32;17;15;30;14;16;342;174;168;138;95;43;88.0;58.0;41.0;35.0;461.0;367.0;563
6285;Moordrecht;2011;8161;2168;4873;1120;6547;954;325;629;660;342;318;59;18;41;38;17;21;35;16;19;376;187;189;152;104;48;85.0;60.0;29.0;34.0;551.0;384.0;563
6286;Moordrecht;2012;8349;2161;4994;1194;6704;971;343;628;674;352;322;60;22;38;41;19;22;36;17;19;384;198;186;153;96;57;91.0;60.0;39.0;38.0;520.0;396.0;563
6287;Moordrecht;2013;8506;2196;5032;1278;6833;961;335;626;712;371;341;63;24;39;47;23;24;46;19;27;390;207;183;166;98;68;96.0;59.0;31.0;34.0;524.0;393.0;563
6288;Moordrecht;2014;8672;2190;5131;1351;6951;979;339;640;742;377;365;68;25;43;56;25;31;46;19;27;406;213;193;166;95;71;103.0;67.0;34.0;37.0;476.0;394.0;563
6289;Moordrecht;2015;8788;2163;5223;1402;7010;989;353;636;789;398;391;71;29;42;62;29;33;47;19;28;428;219;209;181;102;79;109.0;65.0;30.0;35.0;374.0;399.0;563
6290;Moordrecht;2016;8803;2144;5202;1457;7014;984;357;627;805;396;409;70;29;41;66;30;36;51;17;34;429;219;210;189;101;88;107.0;68.0;33.0;33.0;386.0;408.0;563
6291;Moordrecht;2017;8821;2143;5173;1505;7015;982;355;627;824;414;410;72;29;43;69;32;37;55;24;31;434;223;211;194;106;88;101.0;71.0;33.0;36.0;383.0;401.0;563
6292;Moordrecht;2018;8831;2119;5152;1560;6989;997;345;652;845;423;422;75;30;45;66;28;38;55;25;30;439;226;213;210;114;96;108.0;69.0;40.0;38.0;360.0;390.0;563
6293;Moordrecht;2019;8844;2082;5130;1632;6989;989;341;648;866;427;439;81;32;49;70;30;40;56;23;33;443;226;217;216;116;100;104.0;73.0;35.0;38.0;385.0;392.0;563
6294;Moordrecht;2020;8866;2052;5144;1670;6977;992;341;651;897;452;445;83;34;49;67;30;37;67;28;39;456;234;222;224;126;98;109.0;73.0;32.0;37.0;438.0;402.0;563
6295;Moordrecht;2021;8934;2065;5156;1713;7027;994;343;651;913;459;454;94;37;57;65;29;36;78;33;45;455;235;220;221;125;96;109.0;75.0;31.0;31.0;427.0;413.0;563
6296;Moordrecht;2022;8984;2069;5135;1780;7050;1013;354;659;921;461;460;96;38;58;59;26;33;92;38;54;461;236;225;213;123;90;109.0;76.0;40.0;34.0;481.0;406.0;563
6297;Moordrecht;2023;9099;2087;5161;1851;7121;1013;358;655;965;479;486;106;43;63;69;33;36;93;42;51;473;238;235;224;123;101;112.0;78.0;32.0;37.0;398.0;411.0;563
6298;Moordrecht;2024;9117;2087;5126;1904;7134;1012;359;653;971;480;491;112;45;67;72;31;41;87;38;49;477;243;234;223;123;100;104.0;79.0;30.0;35.0;376.0;399.0;563
6299;Moordrecht;2025;9115;2040;5155;1920;7134;1002;348;654;979;491;488;109;45;64;78;39;39;91;38;53;473;245;228;228;124;104;;;;;;;563
6300;Muiden;2008;6584;1610;3920;1054;5520;722;250;472;342;168;174;61;24;37;28;13;15;42;16;26;46;27;19;165;88;77;43.0;52.0;42.0;44.0;310.0;340.0;424
6301;Muiden;2009;6543;1559;3895;1089;5462;719;249;470;362;167;195;66;24;42;27;12;15;49;15;34;54;29;25;166;87;79;42.0;55.0;41.0;43.0;291.0;338.0;424
6302;Muiden;2010;6481;1514;3845;1122;5423;690;233;457;368;167;201;68;24;44;28;13;15;55;18;37;57;27;30;160;85;75;40.0;52.0;40.0;44.0;352.0;341.0;424
6303;Muiden;2011;6476;1488;3850;1138;5372;713;251;462;391;180;211;79;29;50;30;12;18;62;22;40;65;32;33;155;85;70;41.0;54.0;43.0;43.0;367.0;339.0;424
6304;Muiden;2012;6491;1462;3821;1208;5376;706;249;457;409;191;218;79;33;46;32;14;18;68;23;45;69;34;35;161;87;74;44.0;54.0;42.0;39.0;318.0;353.0;424
6305;Muiden;2013;6449;1417;3811;1221;5316;712;254;458;421;193;228;87;38;49;31;13;18;75;24;51;71;33;38;157;85;72;48.0;55.0;43.0;42.0;355.0;346.0;424
6306;Muiden;2014;6452;1369;3805;1278;5294;713;257;456;445;201;244;93;40;53;32;13;19;80;24;56;75;34;41;165;90;75;48.0;58.0;41.0;40.0;363.0;351.0;424
6307;Muiden;2015;6457;1381;3742;1334;5276;723;261;462;458;208;250;95;42;53;34;15;19;80;25;55;74;33;41;175;93;82;51.0;61.0;42.0;40.0;368.0;347.0;424
6308;Muiden;2016;6471;1341;3777;1353;5276;714;259;455;481;207;274;97;40;57;35;17;18;84;23;61;78;32;46;187;95;92;53.0;61.0;41.0;39.0;320.0;359.0;424
6309;Muiden;2017;6425;1299;3735;1391;5219;703;256;447;503;214;289;103;43;60;34;16;18;92;25;67;81;37;44;193;93;100;55.0;60.0;42.0;39.0;367.0;352.0;424
6310;Muiden;2018;6439;1280;3732;1427;5213;702;249;453;524;219;305;107;42;65;33;15;18;97;29;68;85;41;44;202;92;110;53.0;66.0;41.0;39.0;338.0;370.0;424
6311;Muiden;2019;6396;1241;3715;1440;5153;703;251;452;540;236;304;113;50;63;32;12;20;102;30;72;91;43;48;202;101;101;59.0;65.0;41.0;38.0;340.0;349.0;424
6312;Muiden;2020;6385;1221;3712;1452;5122;704;257;447;559;244;315;118;54;64;28;11;17;112;32;80;93;43;50;208;104;104;58.0;62.0;44.0;40.0;376.0;366.0;424
6313;Muiden;2021;6396;1215;3712;1469;5099;709;259;450;588;261;327;120;57;63;36;13;23;115;32;83;106;54;52;211;105;106;60.0;64.0;43.0;38.0;336.0;348.0;424
6314;Muiden;2022;6385;1196;3709;1480;5068;717;257;460;600;270;330;120;59;61;32;11;21;117;32;85;120;58;62;211;110;101;64.0;68.0;39.0;39.0;384.0;350.0;424
6315;Muiden;2023;6416;1199;3692;1525;5061;733;267;466;622;272;350;117;59;58;37;13;24;120;32;88;119;54;65;229;114;115;63.0;67.0;40.0;38.0;425.0;371.0;424
6316;Muiden;2024;6469;1195;3735;1539;5088;748;272;476;633;272;361;121;59;62;39;13;26;130;32;98;120;52;68;223;116;107;65.0;66.0;37.0;39.0;391.0;361.0;424
6317;Muiden;2025;6496;1216;3716;1564;5099;742;272;470;655;287;368;122;62;60;44;17;27;132;35;97;131;54;77;226;119;107;;;;;;;424
6318;Naarden;2008;17452;4602;9628;3222;14253;2088;751;1337;1111;554;557;136;59;77;85;29;56;67;28;39;313;159;154;510;279;231;142.0;161.0;125.0;128.0;1316.0;1073.0;425
6319;Naarden;2009;17675;4616;9792;3267;14453;2077;759;1318;1145;561;584;152;62;90;92;34;58;77;31;46;310;161;149;514;273;241;144.0;156.0;118.0;129.0;1183.0;1118.0;425
6320;Naarden;2010;17718;4595;9809;3314;14470;2079;781;1298;1169;564;605;164;67;97;96;37;59;90;37;53;296;153;143;523;270;253;142.0;150.0;125.0;125.0;1167.0;1142.0;425
6321;Naarden;2011;17739;4515;9897;3327;14435;2083;786;1297;1221;590;631;170;72;98;103;40;63;98;40;58;304;161;143;546;277;269;149.0;154.0;135.0;127.0;1154.0;1109.0;425
6322;Naarden;2012;17788;4481;9852;3455;14463;2066;784;1282;1259;613;646;187;81;106;108;47;61;113;47;66;308;160;148;543;278;265;157.0;150.0;124.0;125.0;1169.0;1115.0;425
6323;Naarden;2013;17850;4435;9854;3561;14473;2068;793;1275;1309;609;700;199;83;116;117;43;74;119;44;75;312;157;155;562;282;280;149.0;156.0;129.0;120.0;1242.0;1133.0;425
6324;Naarden;2014;17960;4409;9869;3682;14478;2119;822;1297;1363;631;732;208;90;118;128;46;82;125;49;76;321;161;160;581;285;296;157.0;159.0;129.0;123.0;1142.0;1127.0;425
6325;Naarden;2015;17980;4343;9873;3764;14512;2102;816;1286;1366;624;742;215;95;120;121;43;78;127;52;75;325;155;170;578;279;299;153.0;156.0;130.0;118.0;1162.0;1116.0;425
6326;Naarden;2016;18036;4297;9922;3817;14525;2100;830;1270;1411;629;782;226;94;132;122;45;77;145;56;89;334;155;179;584;279;305;157.0;157.0;113.0;115.0;1142.0;1153.0;425
6327;Naarden;2017;18024;4197;9961;3866;14497;2107;841;1266;1420;647;773;231;101;130;129;52;77;147;59;88;322;145;177;591;290;301;149.0;158.0;123.0;112.0;1114.0;1138.0;425
6328;Naarden;2018;18003;4108;9944;3951;14424;2118;846;1272;1461;658;803;249;109;140;134;53;81;158;58;100;314;138;176;606;300;306;157.0;160.0;135.0;115.0;1153.0;1128.0;425
6329;Naarden;2019;18046;4068;9986;3992;14414;2147;862;1285;1485;670;815;253;113;140;135;55;80;156;59;97;323;145;178;618;298;320;157.0;157.0;129.0;116.0;1160.0;1122.0;425
6330;Naarden;2020;18098;4007;10053;4038;14442;2176;881;1295;1480;654;826;258;117;141;135;53;82;166;62;104;307;138;169;614;284;330;148.0;160.0;119.0;116.0;1044.0;1145.0;425
6331;Naarden;2021;17988;3927;9993;4068;14358;2141;874;1267;1489;666;823;269;123;146;129;53;76;171;62;109;303;144;159;617;284;333;152.0;159.0;122.0;113.0;1105.0;1105.0;425
6332;Naarden;2022;17991;3872;9993;4126;14308;2155;883;1272;1528;675;853;269;115;154;136;58;78;177;63;114;315;149;166;631;290;341;151.0;165.0;113.0;109.0;1099.0;1143.0;425
6333;Naarden;2023;17938;3827;9926;4185;14201;2207;904;1303;1530;679;851;267;120;147;132;59;73;183;69;114;298;144;154;650;287;363;148.0;167.0;114.0;110.0;1114.0;1131.0;425
6334;Naarden;2024;17907;3754;9878;4275;14134;2228;923;1305;1545;687;858;270;125;145;141;61;80;191;76;115;300;139;161;643;286;357;149.0;173.0;113.0;106.0;1138.0;1085.0;425
6335;Naarden;2025;17944;3720;9848;4376;14133;2220;919;1301;1591;709;882;278;124;154;151;68;83;197;75;122;297;137;160;668;305;363;;;;;;;425
6336;Neder-Betuwe;2008;21995;6871;12493;2631;20622;907;302;605;466;251;215;49;25;24;25;9;16;44;27;17;167;79;88;181;111;70;327.0;157.0;41.0;80.0;408.0;761.0;1740
6337;Neder-Betuwe;2009;21777;6765;12281;2731;20369;901;303;598;507;253;254;59;28;31;29;10;19;52;29;23;174;71;103;193;115;78;318.0;156.0;46.0;80.0;330.0;792.0;1740
6338;Neder-Betuwe;2010;21448;6620;12016;2812;19993;910;302;608;545;275;270;63;30;33;35;13;22;60;35;25;183;72;111;204;125;79;306.0;162.0;47.0;75.0;500.0;794.0;1740
6339;Neder-Betuwe;2011;21270;6482;11902;2886;19769;914;305;609;587;291;296;71;33;38;42;18;24;74;41;33;187;71;116;213;128;85;299.0;163.0;48.0;71.0;533.0;773.0;1740
6340;Neder-Betuwe;2012;21145;6386;11708;3051;19610;908;313;595;627;307;320;85;42;43;42;15;27;85;42;43;189;71;118;226;137;89;289.0;168.0;43.0;71.0;540.0;770.0;1740
6341;Neder-Betuwe;2013;21007;6256;11532;3219;19420;901;316;585;686;335;351;93;43;50;45;17;28;90;41;49;203;79;124;255;155;100;280.0;166.0;55.0;76.0;499.0;791.0;1740
6342;Neder-Betuwe;2014;20809;6107;11406;3296;19150;918;321;597;741;372;369;98;48;50;52;23;29;98;46;52;208;79;129;285;176;109;277.0;169.0;50.0;71.0;498.0;770.0;1740
6343;Neder-Betuwe;2015;20626;5969;11259;3398;18932;916;323;593;778;387;391;103;53;50;59;28;31;105;49;56;203;73;130;308;184;124;264.0;172.0;51.0;72.0;506.0;762.0;1740
6344;Neder-Betuwe;2016;20441;5832;11137;3472;18713;911;323;588;817;412;405;105;53;52;64;30;34;116;51;65;206;76;130;326;202;124;264.0;179.0;45.0;69.0;521.0;787.0;1740
6345;Neder-Betuwe;2017;20238;5711;10985;3542;18493;916;322;594;829;412;417;108;57;51;64;30;34;115;52;63;214;78;136;328;195;133;265.0;176.0;53.0;74.0;483.0;765.0;1740
6346;Neder-Betuwe;2018;20027;5577;10825;3625;18252;907;324;583;868;416;452;113;59;54;69;31;38;136;60;76;216;72;144;334;194;140;253.0;179.0;45.0;68.0;517.0;748.0;1740
6347;Neder-Betuwe;2019;19851;5441;10667;3743;18047;906;320;586;898;424;474;117;57;60;75;33;42;139;63;76;218;69;149;349;202;147;250.0;182.0;48.0;66.0;612.0;736.0;1740
6348;Neder-Betuwe;2020;19780;5353;10612;3815;17926;894;316;578;960;439;521;123;60;63;76;32;44;156;70;86;236;74;162;369;203;166;259.0;182.0;58.0;65.0;561.0;758.0;1740
6349;Neder-Betuwe;2021;19656;5234;10528;3894;17767;887;309;578;1002;446;556;132;65;67;76;33;43;167;71;96;241;73;168;386;204;182;248.0;188.0;47.0;64.0;587.0;746.0;1740
6350;Neder-Betuwe;2022;19542;5108;10469;3965;17633;879;304;575;1030;455;575;141;69;72;72;32;40;178;78;100;248;71;177;391;205;186;244.0;186.0;51.0;64.0;543.0;742.0;1740
6351;Neder-Betuwe;2023;19392;5025;10327;4040;17452;872;301;571;1068;470;598;143;67;76;75;32;43;183;77;106;254;73;181;413;221;192;247.0;190.0;55.0;60.0;627.0;748.0;1740
6352;Neder-Betuwe;2024;19324;4975;10261;4088;17349;887;300;587;1088;476;612;142;65;77;78;33;45;195;80;115;255;72;183;418;226;192;230.0;199.0;57.0;66.0;577.0;737.0;1740
6353;Neder-Betuwe;2025;19188;4880;10129;4179;17168;905;307;598;1115;479;636;155;71;84;85;37;48;198;80;118;258;75;183;419;216;203;;;;;;;1740
6354;Nederlek;2008;14536;3591;8631;2314;13340;772;289;483;424;239;185;66;34;32;35;9;26;33;12;21;72;33;39;218;151;67;134.0;126.0;29.0;50.0;481.0;508.0;643
6355;Nederlek;2009;14498;3515;8612;2371;13259;775;292;483;464;261;203;75;39;36;38;12;26;45;19;26;81;37;44;225;154;71;131.0;125.0;35.0;51.0;442.0;514.0;643
6356;Nederlek;2010;14419;3456;8533;2430;13139;785;300;485;495;275;220;82;44;38;42;14;28;53;24;29;80;35;45;238;158;80;131.0;130.0;34.0;51.0;580.0;499.0;643
6357;Nederlek;2011;14486;3416;8579;2491;13132;799;297;502;555;286;269;97;44;53;46;15;31;61;24;37;89;37;52;262;166;96;134.0;129.0;40.0;48.0;555.0;504.0;643
6358;Nederlek;2012;14536;3381;8517;2638;13131;809;299;510;596;297;299;94;46;48;47;13;34;76;30;46;102;40;62;277;168;109;136.0;130.0;40.0;49.0;577.0;514.0;643
6359;Nederlek;2013;14596;3324;8519;2753;13150;808;297;511;638;327;311;104;49;55;50;14;36;76;35;41;109;45;64;299;184;115;139.0;135.0;37.0;48.0;631.0;501.0;643
6360;Nederlek;2014;14721;3329;8548;2844;13203;831;308;523;687;330;357;115;52;63;58;17;41;89;37;52;120;47;73;305;177;128;136.0;135.0;38.0;47.0;604.0;531.0;643
6361;Nederlek;2015;14787;3315;8547;2925;13225;850;316;534;712;338;374;122;57;65;58;18;40;94;38;56;120;47;73;318;178;140;142.0;142.0;46.0;44.0;508.0;497.0;643
6362;Nederlek;2016;14802;3275;8535;2992;13198;866;323;543;738;342;396;128;59;69;63;18;45;100;38;62;124;48;76;323;179;144;142.0;140.0;34.0;46.0;435.0;509.0;643
6363;Nederlek;2017;14719;3216;8443;3060;13110;865;321;544;744;349;395;121;57;64;61;20;41;108;42;66;125;46;79;329;184;145;145.0;144.0;34.0;49.0;473.0;507.0;643
6364;Nederlek;2018;14672;3188;8369;3115;13049;878;315;563;745;352;393;121;58;63;63;21;42;112;46;66;120;46;74;329;181;148;142.0;146.0;39.0;43.0;488.0;496.0;643
6365;Nederlek;2019;14656;3140;8345;3171;12994;874;321;553;788;372;416;137;65;72;66;21;45;119;48;71;125;48;77;341;190;151;145.0;147.0;47.0;50.0;468.0;491.0;643
6366;Nederlek;2020;14631;3092;8315;3224;12948;882;330;552;801;385;416;146;68;78;65;22;43;116;47;69;125;47;78;349;201;148;144.0;150.0;35.0;42.0;531.0;504.0;643
6367;Nederlek;2021;14647;3060;8304;3283;12883;918;351;567;846;405;441;147;66;81;60;22;38;128;52;76;143;51;92;368;214;154;148.0;154.0;34.0;45.0;506.0;503.0;643
6368;Nederlek;2022;14635;3020;8249;3366;12847;924;349;575;864;410;454;144;63;81;62;20;42;130;52;78;145;54;91;383;221;162;149.0;156.0;34.0;43.0;523.0;516.0;643
6369;Nederlek;2023;14628;2998;8198;3432;12797;939;359;580;892;425;467;153;69;84;66;20;46;135;56;79;141;55;86;397;225;172;151.0;160.0;44.0;46.0;486.0;500.0;643
6370;Nederlek;2024;14606;2995;8142;3469;12758;934;352;582;914;432;482;154;68;86;72;23;49;142;54;88;142;59;83;404;228;176;151.0;161.0;39.0;44.0;600.0;508.0;643
6371;Nederlek;2025;14682;3036;8122;3524;12789;949;357;592;944;455;489;160;65;95;80;30;50;146;58;88;142;61;81;416;241;175;;;;;;;643
6372;Nederweert;2008;16223;3957;9734;2532;15143;836;227;609;244;151;93;21;10;11;34;16;18;21;10;11;31;14;17;137;101;36;135.0;108.0;56.0;83.0;280.0;432.0;946
6373;Nederweert;2009;16073;3891;9576;2606;14974;830;228;602;269;159;110;25;14;11;35;17;18;32;15;17;41;19;22;136;94;42;122.0;112.0;62.0;80.0;374.0;435.0;946
6374;Nederweert;2010;16007;3789;9520;2698;14863;839;245;594;305;181;124;27;16;11;38;19;19;38;18;20;51;25;26;151;103;48;121.0;116.0;71.0;84.0;270.0;451.0;946
6375;Nederweert;2011;15819;3672;9388;2759;14634;862;257;605;323;196;127;30;20;10;40;19;21;45;22;23;53;27;26;155;108;47;118.0;116.0;68.0;75.0;404.0;430.0;946
6376;Nederweert;2012;15791;3605;9329;2857;14548;896;274;622;347;202;145;44;27;17;40;19;21;47;21;26;57;28;29;159;107;52;117.0;115.0;72.0;71.0;312.0;451.0;946
6377;Nederweert;2013;15654;3495;9185;2974;14386;890;270;620;378;220;158;50;32;18;43;19;24;55;25;30;61;28;33;169;116;53;116.0;126.0;71.0;75.0;397.0;430.0;946
6378;Nederweert;2014;15608;3401;9121;3086;14281;911;285;626;416;235;181;58;36;22;46;22;24;63;27;36;64;30;34;185;120;65;118.0;124.0;74.0;75.0;395.0;443.0;946
6379;Nederweert;2015;15553;3315;9026;3212;14191;913;277;636;449;257;192;62;39;23;48;25;23;71;32;39;66;29;37;202;132;70;115.0;130.0;69.0;74.0;361.0;436.0;946
6380;Nederweert;2016;15460;3225;8936;3299;14054;929;280;649;477;279;198;61;40;21;50;26;24;75;32;43;70;31;39;221;150;71;117.0;134.0;72.0;75.0;435.0;437.0;946
6381;Nederweert;2017;15440;3150;8885;3405;13987;937;284;653;516;306;210;67;42;25;59;33;26;87;38;49;79;34;45;224;159;65;121.0;141.0;72.0;74.0;449.0;447.0;946
6382;Nederweert;2018;15420;3097;8837;3486;13912;950;291;659;558;329;229;75;48;27;59;34;25;99;42;57;85;41;44;240;164;76;125.0;143.0;71.0;73.0;450.0;448.0;946
6383;Nederweert;2019;15402;3030;8813;3559;13823;975;310;665;604;352;252;81;50;31;64;40;24;122;55;67;89;44;45;248;163;85;127.0;141.0;65.0;74.0;478.0;444.0;946
6384;Nederweert;2020;15415;3003;8769;3643;13767;996;317;679;652;369;283;86;53;33;74;46;28;140;58;82;99;46;53;253;166;87;130.0;151.0;72.0;72.0;432.0;454.0;946
6385;Nederweert;2021;15372;2910;8721;3741;13672;1020;325;695;680;374;306;85;51;34;77;48;29;152;59;93;106;50;56;260;166;94;131.0;151.0;61.0;74.0;487.0;458.0;946
6386;Nederweert;2022;15370;2875;8671;3824;13651;1002;322;680;717;387;330;100;55;45;76;48;28;154;59;95;117;52;65;270;173;97;135.0;155.0;69.0;74.0;510.0;457.0;946
6387;Nederweert;2023;15400;2859;8619;3922;13634;1027;341;686;739;397;342;99;54;45;82;53;29;154;58;96;127;57;70;277;175;102;136.0;159.0;60.0;76.0;501.0;469.0;946
6388;Nederweert;2024;15395;2827;8571;3997;13601;1029;342;687;765;412;353;107;62;45;82;52;30;158;59;99;128;56;72;290;183;107;140.0;161.0;73.0;71.0;455.0;458.0;946
6389;Nederweert;2025;15375;2820;8460;4095;13550;1040;341;699;785;418;367;112;65;47;90;57;33;160;59;101;132;55;77;291;182;109;;;;;;;946
6390;Neerijnen;2008;11508;3126;6871;1511;10771;451;148;303;286;152;134;16;10;6;16;9;7;23;8;15;110;53;57;121;72;49;145.0;92.0;21.0;42.0;381.0;423.0;304
6391;Neerijnen;2009;11500;3096;6840;1564;10724;460;153;307;316;164;152;21;11;10;21;13;8;30;10;20;110;52;58;134;78;56;146.0;89.0;24.0;39.0;428.0;448.0;304
6392;Neerijnen;2010;11524;3096;6806;1622;10708;478;162;316;338;172;166;28;12;16;19;12;7;31;11;20;111;53;58;149;84;65;141.0;92.0;24.0;42.0;369.0;441.0;304
6393;Neerijnen;2011;11486;3036;6779;1671;10635;483;173;310;368;189;179;32;14;18;20;12;8;40;17;23;113;51;62;163;95;68;137.0;92.0;31.0;40.0;457.0;442.0;304
6394;Neerijnen;2012;11538;3009;6743;1786;10659;490;179;311;389;203;186;34;17;17;24;15;9;47;17;30;111;50;61;173;104;69;136.0;96.0;32.0;39.0;414.0;454.0;304
6395;Neerijnen;2013;11533;2972;6689;1872;10619;492;171;321;422;214;208;39;20;19;23;12;11;50;16;34;121;52;69;189;114;75;138.0;93.0;30.0;39.0;396.0;449.0;304
6396;Neerijnen;2014;11517;2925;6662;1930;10568;506;177;329;443;223;220;44;23;21;22;11;11;52;18;34;121;51;70;204;120;84;129.0;96.0;27.0;40.0;450.0;450.0;304
6397;Neerijnen;2015;11537;2902;6642;1993;10570;493;169;324;474;225;249;51;24;27;22;11;11;62;22;40;125;51;74;214;117;97;132.0;97.0;27.0;40.0;439.0;456.0;304
6398;Neerijnen;2016;11543;2877;6626;2040;10528;512;183;329;503;244;259;53;30;23;25;12;13;75;28;47;125;52;73;225;122;103;130.0;100.0;29.0;37.0;351.0;448.0;304
6399;Neerijnen;2017;11469;2836;6547;2086;10458;509;177;332;502;242;260;56;32;24;24;12;12;80;32;48;119;49;70;223;117;106;129.0;103.0;28.0;37.0;405.0;469.0;304
6400;Neerijnen;2018;11424;2789;6534;2101;10394;511;177;334;519;256;263;58;34;24;25;12;13;87;34;53;122;54;68;227;122;105;129.0;99.0;34.0;38.0;383.0;454.0;304
6401;Neerijnen;2019;11381;2731;6503;2147;10317;532;184;348;532;263;269;63;36;27;28;14;14;89;37;52;121;54;67;231;122;109;131.0;102.0;29.0;43.0;398.0;450.0;304
6402;Neerijnen;2020;11346;2672;6476;2198;10254;545;186;359;547;274;273;64;36;28;32;18;14;96;38;58;120;54;66;235;128;107;125.0;104.0;31.0;37.0;401.0;437.0;304
6403;Neerijnen;2021;11326;2624;6452;2250;10200;554;186;368;572;289;283;67;37;30;31;19;12;102;36;66;124;56;68;248;141;107;130.0;108.0;34.0;42.0;419.0;449.0;304
6404;Neerijnen;2022;11311;2565;6435;2311;10168;573;195;378;570;288;282;65;37;28;34;20;14;102;35;67;118;51;67;251;145;106;129.0;106.0;24.0;37.0;422.0;455.0;304
6405;Neerijnen;2023;11289;2540;6415;2334;10124;588;206;382;577;294;283;66;40;26;42;23;19;111;42;69;115;49;66;243;140;103;127.0;110.0;26.0;41.0;415.0;454.0;304
6406;Neerijnen;2024;11253;2478;6409;2366;10074;589;205;384;590;298;292;66;39;27;41;20;21;117;42;75;113;51;62;253;146;107;128.0;116.0;21.0;34.0;442.0;451.0;304
6407;Neerijnen;2025;11244;2460;6373;2411;10065;571;194;377;608;308;300;67;40;27;40;21;19;117;43;74;110;51;59;274;153;121;;;;;;;304
6408;Niedorp;2008;12077;3213;7361;1503;11193;553;200;353;331;183;148;37;15;22;26;10;16;26;11;15;24;10;14;218;137;81;132.0;84.0;32.0;54.0;535.0;479.0;412
6409;Niedorp;2009;12161;3206;7375;1580;11250;563;202;361;348;183;165;38;17;21;30;14;16;36;12;24;28;10;18;216;130;86;128.0;88.0;39.0;53.0;567.0;488.0;412
6410;Niedorp;2010;12267;3202;7383;1682;11312;577;204;373;378;196;182;41;19;22;34;10;24;41;15;26;33;14;19;229;138;91;128.0;87.0;38.0;56.0;639.0;493.0;412
6411;Niedorp;2011;12436;3169;7505;1762;11424;589;210;379;423;228;195;50;22;28;44;14;30;45;16;29;32;17;15;252;159;93;130.0;93.0;38.0;49.0;676.0;520.0;412
6412;Niedorp;2012;12617;3155;7564;1898;11527;617;223;394;473;250;223;59;27;32;51;17;34;56;23;33;41;19;22;266;164;102;136.0;96.0;40.0;54.0;648.0;532.0;412
6413;Niedorp;2013;12759;3117;7600;2042;11629;625;227;398;505;260;245;66;28;38;49;16;33;68;29;39;52;21;31;270;166;104;139.0;102.0;30.0;51.0;732.0;541.0;412
6414;Niedorp;2014;12967;3122;7691;2154;11764;638;232;406;565;272;293;80;32;48;51;16;35;69;24;45;68;23;45;297;177;120;143.0;106.0;47.0;52.0;672.0;553.0;412
6415;Niedorp;2015;13119;3127;7733;2259;11845;668;239;429;606;282;324;85;32;53;58;20;38;78;26;52;74;26;48;311;178;133;152.0;105.0;41.0;51.0;665.0;562.0;412
6416;Niedorp;2016;13259;3128;7780;2351;11928;706;251;455;625;282;343;85;33;52;63;22;41;82;27;55;81;26;55;314;174;140;152.0;109.0;41.0;50.0;631.0;556.0;412
6417;Niedorp;2017;13369;3102;7828;2439;11998;725;257;468;646;294;352;85;32;53;64;24;40;95;34;61;84;24;60;318;180;138;152.0;112.0;63.0;56.0;622.0;563.0;412
6418;Niedorp;2018;13480;3121;7860;2499;12068;726;249;477;686;309;377;98;41;57;62;25;37;94;34;60;106;31;75;326;178;148;156.0;119.0;51.0;60.0;561.0;555.0;412
6419;Niedorp;2019;13514;3119;7825;2570;12043;746;253;493;725;326;399;97;40;57;68;27;41;111;46;65;117;32;85;332;181;151;160.0;121.0;42.0;53.0;653.0;560.0;412
6420;Niedorp;2020;13637;3127;7873;2637;12105;748;247;501;784;354;430;104;41;63;80;33;47;114;47;67;137;41;96;349;192;157;156.0;123.0;43.0;54.0;597.0;582.0;412
6421;Niedorp;2021;13679;3090;7876;2713;12088;764;247;517;827;373;454;112;47;65;84;35;49;124;51;73;148;46;102;359;194;165;153.0;125.0;52.0;53.0;606.0;561.0;412
6422;Niedorp;2022;13752;3074;7887;2791;12133;760;242;518;859;398;461;112;46;66;88;37;51;132;56;76;152;49;103;375;210;165;156.0;126.0;43.0;54.0;668.0;571.0;412
6423;Niedorp;2023;13868;3095;7916;2857;12183;773;248;525;912;420;492;119;46;73;89;39;50;137;54;83;165;52;113;402;229;173;155.0;135.0;50.0;54.0;653.0;568.0;412
6424;Niedorp;2024;13970;3090;7922;2958;12213;780;243;537;977;460;517;125;50;75;97;44;53;149;58;91;173;54;119;433;254;179;154.0;141.0;52.0;50.0;639.0;570.0;412
6425;Niedorp;2025;14056;3082;7943;3031;12245;807;254;553;1004;468;536;133;54;79;98;47;51;155;60;95;171;55;116;447;252;195;;;;;;;412
6426;Nieuwegein;2008;60905;13799;39815;7291;47775;5781;2203;3578;7349;4211;3138;2243;1226;1017;572;337;235;640;326;314;1531;783;748;2363;1539;824;614.0;369.0;266.0;334.0;2915.0;3273.0;356
6427;Nieuwegein;2009;60733;13635;39412;7686;47485;5762;2235;3527;7486;4291;3195;2214;1222;992;577;348;229;715;358;357;1605;809;796;2375;1554;821;614.0;391.0;270.0;321.0;2971.0;3275.0;356
6428;Nieuwegein;2010;60612;13448;39120;8044;47313;5697;2226;3471;7602;4400;3202;2183;1218;965;567;350;217;787;396;391;1654;849;805;2411;1587;824;613.0;403.0;278.0;325.0;3006.0;3236.0;356
6429;Nieuwegein;2011;60550;13275;38924;8351;47118;5714;2271;3443;7718;4460;3258;2139;1189;950;576;359;217;866;439;427;1699;864;835;2438;1609;829;608.0;413.0;269.0;306.0;3044.0;3262.0;356
6430;Nieuwegein;2012;60495;13137;38298;9060;46961;5697;2292;3405;7837;4507;3330;2091;1156;935;589;363;226;904;448;456;1751;903;848;2502;1637;865;599.0;415.0;268.0;311.0;3137.0;3249.0;356
6431;Nieuwegein;2013;60527;13058;37842;9627;46866;5667;2287;3380;7994;4569;3425;2053;1120;933;592;364;228;950;476;474;1828;932;896;2571;1677;894;605.0;430.0;271.0;309.0;3257.0;3235.0;356
6432;Nieuwegein;2014;60688;13050;37517;10121;46841;5684;2340;3344;8163;4652;3511;2030;1102;928;592;367;225;1017;506;511;1905;969;936;2619;1708;911;589.0;446.0;287.0;305.0;3338.0;3210.0;356
6433;Nieuwegein;2015;60941;13036;37290;10615;46906;5675;2362;3313;8360;4756;3604;2016;1089;927;609;384;225;1070;523;547;1941;990;951;2724;1770;954;601.0;451.0;282.0;307.0;3115.0;3204.0;356
6434;Nieuwegein;2016;60983;13032;36895;11056;46826;5673;2371;3302;8484;4800;3684;1988;1083;905;603;378;225;1120;542;578;2002;1008;994;2771;1789;982;608.0;462.0;296.0;307.0;3161.0;3211.0;356
6435;Nieuwegein;2017;61073;13035;36575;11463;46701;5743;2402;3341;8629;4866;3763;1983;1083;900;615;385;230;1165;571;594;2028;1013;1015;2838;1814;1024;606.0;474.0;286.0;302.0;3198.0;3224.0;356
6436;Nieuwegein;2018;61166;12977;36336;11853;46661;5746;2402;3344;8759;4908;3851;1961;1059;902;628;389;239;1230;594;636;2059;1040;1019;2881;1826;1055;602.0;487.0;278.0;308.0;3253.0;3233.0;356
6437;Nieuwegein;2019;61281;12936;36120;12225;46675;5752;2430;3322;8854;4941;3913;1951;1050;901;641;401;240;1254;604;650;2075;1057;1018;2933;1829;1104;599.0;495.0;270.0;296.0;3205.0;3224.0;356
6438;Nieuwegein;2020;61345;12898;35917;12530;46566;5824;2441;3383;8955;4963;3992;1942;1037;905;654;404;250;1311;626;685;2088;1082;1006;2960;1814;1146;590.0;495.0;269.0;285.0;3126.0;3253.0;356
6439;Nieuwegein;2021;61302;12784;35696;12822;46378;5844;2461;3383;9080;5008;4072;1940;1032;908;666;416;250;1345;641;704;2136;1094;1042;2993;1825;1168;597.0;511.0;278.0;286.0;3193.0;3258.0;356
6440;Nieuwegein;2022;61322;12655;35557;13110;46271;5820;2467;3353;9231;5058;4173;1940;1025;915;664;412;252;1382;654;728;2186;1114;1072;3059;1853;1206;628.0;522.0;282.0;287.0;3153.0;3251.0;356
6441;Nieuwegein;2023;61331;12566;35337;13428;46110;5845;2471;3374;9376;5153;4223;1907;1011;896;704;442;262;1417;677;740;2202;1121;1081;3146;1902;1244;623.0;539.0;270.0;285.0;3375.0;3271.0;356
6442;Nieuwegein;2024;61511;12511;35316;13684;46158;5908;2520;3388;9445;5207;4238;1904;1005;899;696;439;257;1454;682;772;2213;1151;1062;3178;1930;1248;627.0;558.0;255.0;276.0;3422.0;3290.0;356
6443;Nieuwegein;2025;61698;12533;35289;13876;46186;5954;2576;3378;9558;5251;4307;1913;1001;912;714;448;266;1482;682;800;2226;1167;1059;3223;1953;1270;;;;;;;356
6444;Nieuwerkerk aan den IJssel;2008;21815;5830;13398;2587;19014;1430;506;924;1371;699;672;337;154;183;142;43;99;57;32;25;316;158;158;519;312;207;207.0;129.0;64.0;84.0;670.0;918.0;567
6445;Nieuwerkerk aan den IJssel;2009;21626;5664;13256;2706;18782;1428;507;921;1416;727;689;336;157;179;142;44;98;72;37;35;321;159;162;545;330;215;204.0;136.0;67.0;88.0;649.0;928.0;567
6446;Nieuwerkerk aan den IJssel;2010;21396;5448;13157;2791;18542;1422;502;920;1432;728;704;325;148;177;141;47;94;85;39;46;320;159;161;561;335;226;189.0;139.0;70.0;83.0;1005.0;890.0;567
6447;Nieuwerkerk aan den IJssel;2011;21552;5346;13314;2892;18582;1453;514;939;1517;742;775;335;148;187;158;48;110;107;49;58;340;165;175;577;332;245;198.0;142.0;66.0;85.0;1014.0;936.0;567
6448;Nieuwerkerk aan den IJssel;2012;21669;5225;13327;3117;18598;1488;517;971;1583;778;805;342;153;189;149;48;101;124;57;67;342;169;173;626;351;275;200.0;152.0;65.0;85.0;1031.0;945.0;567
6449;Nieuwerkerk aan den IJssel;2013;21785;5133;13328;3324;18620;1533;533;1000;1632;799;833;348;155;193;165;51;114;136;58;78;345;173;172;638;362;276;203.0;153.0;67.0;93.0;1115.0;969.0;567
6450;Nieuwerkerk aan den IJssel;2014;21959;5075;13318;3566;18687;1594;565;1029;1678;816;862;350;155;195;172;51;121;154;60;94;337;163;174;665;387;278;213.0;159.0;75.0;90.0;992.0;980.0;567
6451;Nieuwerkerk aan den IJssel;2015;22015;4972;13330;3713;18693;1609;570;1039;1713;839;874;358;161;197;181;53;128;159;62;97;344;167;177;671;396;275;214.0;165.0;73.0;86.0;1121.0;950.0;567
6452;Nieuwerkerk aan den IJssel;2016;22224;4960;13399;3865;18805;1643;567;1076;1776;862;914;370;165;205;178;55;123;172;71;101;355;167;188;701;404;297;222.0;171.0;84.0;84.0;1259.0;1004.0;567
6453;Nieuwerkerk aan den IJssel;2017;22532;4994;13488;4050;18997;1713;609;1104;1822;872;950;370;161;209;176;56;120;188;75;113;366;169;197;722;411;311;230.0;176.0;76.0;91.0;1036.0;1013.0;567
6454;Nieuwerkerk aan den IJssel;2018;22595;4936;13425;4234;18976;1740;621;1119;1879;889;990;372;167;205;188;62;126;196;74;122;371;172;199;752;414;338;230.0;179.0;76.0;85.0;1148.0;991.0;567
6455;Nieuwerkerk aan den IJssel;2019;22797;4934;13458;4405;19063;1781;642;1139;1953;908;1045;369;162;207;202;69;133;216;83;133;376;167;209;790;427;363;237.0;189.0;67.0;86.0;1110.0;1006.0;567
6456;Nieuwerkerk aan den IJssel;2020;22930;4896;13429;4605;19059;1856;683;1173;2015;915;1100;377;163;214;214;68;146;229;88;141;377;168;209;818;428;390;238.0;191.0;74.0;87.0;1167.0;996.0;567
6457;Nieuwerkerk aan den IJssel;2021;23139;4949;13418;4772;19171;1880;698;1182;2088;925;1163;391;167;224;221;68;153;259;98;161;385;166;219;832;426;406;250.0;197.0;75.0;83.0;1195.0;1042.0;567
6458;Nieuwerkerk aan den IJssel;2022;23339;4941;13459;4939;19251;1939;724;1215;2149;953;1196;406;166;240;229;71;158;268;109;159;394;165;229;852;442;410;253.0;200.0;68.0;90.0;1161.0;1065.0;567
6459;Nieuwerkerk aan den IJssel;2023;23466;4915;13481;5070;19281;1974;748;1226;2211;968;1243;413;167;246;238;72;166;274;111;163;401;166;235;885;452;433;259.0;202.0;76.0;86.0;1102.0;1054.0;567
6460;Nieuwerkerk aan den IJssel;2024;23560;4894;13426;5240;19334;1995;752;1243;2231;986;1245;419;174;245;237;77;160;285;112;173;392;169;223;898;454;444;253.0;212.0;79.0;85.0;1150.0;1038.0;567
6461;Nieuwerkerk aan den IJssel;2025;23710;4923;13365;5422;19377;2021;773;1248;2312;1017;1295;432;180;252;248;78;170;294;113;181;403;172;231;935;474;461;;;;;;;567
6462;Nieuwkoop;2008;26060;6686;15955;3419;23970;1262;483;779;828;430;398;121;59;62;57;24;33;38;15;23;239;115;124;373;217;156;231.0;165.0;59.0;87.0;438.0;922.0;569
6463;Nieuwkoop;2009;25618;6413;15622;3583;23500;1265;486;779;853;443;410;129;60;69;57;24;33;50;24;26;231;112;119;386;223;163;213.0;171.0;69.0;89.0;549.0;937.0;569
6464;Nieuwkoop;2010;25255;6202;15299;3754;23099;1250;484;766;906;475;431;137;65;72;63;29;34;72;35;37;233;117;116;401;229;172;208.0;179.0;63.0;82.0;758.0;912.0;569
6465;Nieuwkoop;2011;25115;6001;15209;3905;22863;1282;499;783;970;507;463;146;68;78;68;29;39;83;38;45;243;122;121;430;250;180;207.0;184.0;63.0;81.0;776.0;919.0;569
6466;Nieuwkoop;2012;24981;5826;15017;4138;22625;1319;511;808;1037;525;512;168;73;95;70;30;40;92;43;49;251;121;130;456;258;198;205.0;188.0;67.0;85.0;879.0;910.0;569
6467;Nieuwkoop;2013;24951;5693;14843;4415;22518;1363;529;834;1070;535;535;172;76;96;72;30;42;102;45;57;256;119;137;468;265;203;200.0;193.0;67.0;78.0;849.0;915.0;569
6468;Nieuwkoop;2014;24884;5540;14735;4609;22364;1389;535;854;1131;548;583;176;77;99;83;32;51;112;48;64;266;118;148;494;273;221;201.0;202.0;70.0;76.0;884.0;899.0;569
6469;Nieuwkoop;2015;24865;5391;14654;4820;22266;1393;533;860;1206;581;625;193;82;111;92;41;51;124;53;71;277;120;157;520;285;235;201.0;207.0;78.0;74.0;634.0;902.0;569
6470;Nieuwkoop;2016;24598;5276;14369;4953;21961;1402;537;865;1235;595;640;197;86;111;99;47;52;147;63;84;277;122;155;515;277;238;198.0;208.0;73.0;79.0;735.0;874.0;569
6471;Nieuwkoop;2017;24446;5167;14207;5072;21737;1422;543;879;1287;620;667;207;91;116;106;50;56;164;66;98;282;129;153;528;284;244;196.0;219.0;67.0;76.0;808.0;878.0;569
6472;Nieuwkoop;2018;24346;5054;14108;5184;21557;1452;558;894;1337;635;702;222;94;128;109;48;61;169;65;104;288;134;154;549;294;255;203.0;221.0;66.0;71.0;890.0;896.0;569
6473;Nieuwkoop;2019;24321;4950;14026;5345;21426;1487;584;903;1408;671;737;233;101;132;121;55;66;189;68;121;301;142;159;564;305;259;204.0;228.0;66.0;75.0;873.0;881.0;569
6474;Nieuwkoop;2020;24283;4835;13986;5462;21302;1487;589;898;1494;714;780;241;101;140;131;57;74;209;78;131;315;153;162;598;325;273;212.0;228.0;66.0;75.0;925.0;865.0;569
6475;Nieuwkoop;2021;24319;4740;13977;5602;21234;1522;605;917;1563;749;814;261;110;151;144;62;82;231;84;147;312;156;156;615;337;278;214.0;234.0;67.0;74.0;976.0;897.0;569
6476;Nieuwkoop;2022;24374;4675;13941;5758;21193;1574;624;950;1607;771;836;261;115;146;151;65;86;244;88;156;315;154;161;636;349;287;216.0;243.0;67.0;78.0;926.0;926.0;569
6477;Nieuwkoop;2023;24337;4603;13853;5881;21104;1586;629;957;1647;770;877;269;113;156;152;62;90;264;93;171;315;152;163;647;350;297;221.0;250.0;70.0;80.0;851.0;898.0;569
6478;Nieuwkoop;2024;24253;4579;13619;6055;20995;1591;631;960;1667;783;884;272;120;152;153;62;91;258;94;164;326;156;170;658;351;307;220.0;251.0;69.0;78.0;969.0;900.0;569
6479;Nieuwkoop;2025;24285;4555;13553;6177;20955;1625;648;977;1705;811;894;282;126;156;155;69;86;262;100;162;333;157;176;673;359;314;;;;;;;569
6480;Nieuw-Lekkerland;2008;9428;3062;5280;1086;8781;406;143;263;241;131;110;28;13;15;22;5;17;18;7;11;35;22;13;138;84;54;156.0;59.0;22.0;31.0;166.0;332.0;571
6481;Nieuw-Lekkerland;2009;9352;3003;5224;1125;8688;406;141;265;258;136;122;33;14;19;22;6;16;25;10;15;40;26;14;138;80;58;150.0;62.0;22.0;28.0;197.0;334.0;571
6482;Nieuw-Lekkerland;2010;9299;2941;5182;1176;8623;399;140;259;277;149;128;38;17;21;23;8;15;27;9;18;44;28;16;145;87;58;141.0;61.0;18.0;27.0;210.0;314.0;571
6483;Nieuw-Lekkerland;2011;9267;2899;5156;1212;8566;410;139;271;291;150;141;41;17;24;19;6;13;33;12;21;47;27;20;151;88;63;136.0;65.0;25.0;26.0;227.0;311.0;571
6484;Nieuw-Lekkerland;2012;9253;2870;5093;1290;8500;421;143;278;332;168;164;51;21;30;20;6;14;38;16;22;52;28;24;171;97;74;139.0;67.0;21.0;28.0;199.0;308.0;571
6485;Nieuw-Lekkerland;2013;9210;2829;5013;1368;8426;436;145;291;348;173;175;62;25;37;19;7;12;41;19;22;56;27;29;170;95;75;132.0;71.0;21.0;29.0;202.0;297.0;571
6486;Nieuw-Lekkerland;2014;9170;2781;4970;1419;8366;441;152;289;363;176;187;64;26;38;23;8;15;53;23;30;63;30;33;160;89;71;133.0;71.0;21.0;27.0;283.0;311.0;571
6487;Nieuw-Lekkerland;2015;9199;2747;4985;1467;8371;442;152;290;386;188;198;64;27;37;24;9;15;59;25;34;66;32;34;173;95;78;131.0;71.0;20.0;26.0;216.0;296.0;571
6488;Nieuw-Lekkerland;2016;9175;2703;4959;1513;8345;432;148;284;398;196;202;64;28;36;24;8;16;64;27;37;62;33;29;184;100;84;128.0;72.0;20.0;27.0;207.0;298.0;571
6489;Nieuw-Lekkerland;2017;9134;2642;4922;1570;8278;442;150;292;414;201;213;71;32;39;28;9;19;62;24;38;61;31;30;192;105;87;133.0;75.0;21.0;25.0;191.0;296.0;571
6490;Nieuw-Lekkerland;2018;9084;2601;4892;1591;8208;451;155;296;425;208;217;75;35;40;33;12;21;68;28;40;60;30;30;189;103;86;128.0;78.0;26.0;24.0;286.0;293.0;571
6491;Nieuw-Lekkerland;2019;9128;2571;4933;1624;8223;459;165;294;446;214;232;76;33;43;38;14;24;72;27;45;69;33;36;191;107;84;133.0;76.0;21.0;28.0;203.0;303.0;571
6492;Nieuw-Lekkerland;2020;9078;2515;4918;1645;8151;475;182;293;452;221;231;76;36;40;38;13;25;76;28;48;73;37;36;189;107;82;124.0;76.0;24.0;23.0;195.0;303.0;571
6493;Nieuw-Lekkerland;2021;9021;2457;4900;1664;8087;480;183;297;454;227;227;82;39;43;42;17;25;74;29;45;77;37;40;179;105;74;129.0;78.0;21.0;22.0;220.0;303.0;571
6494;Nieuw-Lekkerland;2022;8988;2428;4868;1692;8036;480;183;297;472;238;234;83;41;42;46;18;28;77;29;48;84;41;43;182;109;73;120.0;78.0;18.0;24.0;313.0;292.0;571
6495;Nieuw-Lekkerland;2023;9045;2405;4903;1737;8041;494;189;305;510;258;252;85;43;42;46;15;31;86;31;55;89;42;47;204;127;77;123.0;81.0;24.0;26.0;209.0;308.0;571
6496;Nieuw-Lekkerland;2024;8988;2375;4844;1769;7976;496;190;306;516;260;256;81;40;41;49;17;32;85;34;51;89;41;48;212;128;84;120.0;84.0;21.0;24.0;266.0;309.0;571
6497;Nieuw-Lekkerland;2025;8977;2363;4798;1816;7932;497;194;303;548;263;285;90;44;46;48;18;30;90;32;58;97;43;54;223;126;97;;;;;;;571
6498;Nijefurd;2008;10728;2543;6189;1996;10068;481;165;316;179;105;74;18;11;7;13;4;9;19;6;13;13;6;7;116;78;38;118.0;114.0;22.0;38.0;415.0;407.0;104
6499;Nijefurd;2009;10725;2510;6150;2065;10052;479;160;319;194;116;78;21;13;8;13;4;9;25;8;17;15;8;7;120;83;37;115.0;116.0;22.0;39.0;385.0;408.0;104
6500;Nijefurd;2010;10685;2467;6078;2140;10000;467;154;313;218;133;85;22;16;6;16;6;10;29;10;19;23;12;11;128;89;39;110.0;118.0;37.0;36.0;326.0;411.0;104
6501;Nijefurd;2011;10594;2391;6015;2188;9892;462;156;306;240;139;101;30;19;11;21;9;12;34;14;20;31;14;17;124;83;41;105.0;119.0;25.0;35.0;400.0;412.0;104
6502;Nijefurd;2012;10560;2325;5940;2295;9859;458;157;301;243;136;107;38;21;17;21;10;11;45;21;24;31;14;17;108;70;38;107.0;120.0;23.0;33.0;397.0;395.0;104
6503;Nijefurd;2013;10540;2282;5891;2367;9803;462;157;305;275;160;115;43;25;18;26;13;13;48;23;25;32;14;18;126;85;41;106.0;125.0;32.0;32.0;397.0;409.0;104
6504;Nijefurd;2014;10510;2234;5855;2421;9758;472;158;314;280;165;115;49;27;22;25;12;13;49;27;22;31;16;15;126;83;43;103.0;123.0;31.0;30.0;365.0;397.0;104
6505;Nijefurd;2015;10461;2179;5820;2462;9680;477;155;322;304;173;131;51;28;23;29;15;14;57;31;26;36;17;19;131;82;49;102.0;124.0;25.0;34.0;427.0;384.0;104
6506;Nijefurd;2016;10473;2142;5816;2515;9655;485;155;330;333;188;145;54;32;22;34;18;16;64;31;33;41;17;24;140;90;50;100.0;124.0;34.0;36.0;375.0;408.0;104
6507;Nijefurd;2017;10415;2110;5745;2560;9578;480;160;320;357;197;160;55;33;22;34;18;16;75;36;39;49;20;29;144;90;54;100.0;123.0;26.0;32.0;337.0;404.0;104
6508;Nijefurd;2018;10319;2046;5659;2614;9475;473;154;319;371;201;170;57;32;25;36;19;17;85;41;44;48;22;26;145;87;58;100.0;127.0;26.0;31.0;394.0;404.0;104
6509;Nijefurd;2019;10277;1991;5631;2655;9425;460;149;311;392;215;177;59;34;25;41;21;20;91;45;46;51;24;27;150;91;59;99.0;124.0;24.0;34.0;404.0;403.0;104
6510;Nijefurd;2020;10243;1966;5570;2707;9385;462;152;310;396;218;178;65;37;28;44;25;19;90;47;43;57;25;32;140;84;56;99.0;128.0;23.0;30.0;423.0;405.0;104
6511;Nijefurd;2021;10226;1925;5541;2760;9344;482;163;319;400;224;176;68;38;30;46;24;22;90;49;41;56;28;28;140;85;55;99.0;133.0;22.0;30.0;436.0;393.0;104
6512;Nijefurd;2022;10230;1926;5511;2793;9310;504;171;333;416;227;189;69;37;32;47;26;21;93;47;46;62;30;32;145;87;58;98.0;137.0;40.0;29.0;399.0;400.0;104
6513;Nijefurd;2023;10201;1894;5495;2812;9262;499;173;326;440;245;195;69;38;31;50;28;22;96;48;48;66;32;34;159;99;60;98.0;141.0;26.0;32.0;402.0;380.0;104
6514;Nijefurd;2024;10175;1879;5456;2840;9218;509;180;329;448;246;202;72;43;29;51;26;25;92;46;46;70;32;38;163;99;64;96.0;138.0;27.0;32.0;391.0;392.0;104
6515;Nijefurd;2025;10129;1822;5427;2880;9150;505;180;325;474;261;213;81;47;34;56;30;26;95;48;47;75;33;42;167;103;64;;;;;;;104
6516;Nijkerk;2008;38393;10154;23037;5202;34737;1731;602;1129;1925;1108;817;201;107;94;65;25;40;298;172;126;752;412;340;609;392;217;453.0;258.0;129.0;161.0;1140.0;1230.0;267
6517;Nijkerk;2009;38473;10088;22916;5469;34691;1757;611;1146;2025;1150;875;221;119;102;72;32;40;323;181;142;748;400;348;661;418;243;452.0;261.0;168.0;160.0;1077.0;1250.0;267
6518;Nijkerk;2010;38502;9981;22844;5677;34676;1757;609;1148;2069;1186;883;232;128;104;79;37;42;322;184;138;748;393;355;688;444;244;429.0;271.0;164.0;163.0;1076.0;1252.0;267
6519;Nijkerk;2011;38491;9883;22726;5882;34569;1783;616;1167;2139;1222;917;226;120;106;81;39;42;355;200;155;753;393;360;724;470;254;418.0;285.0;169.0;164.0;1217.0;1253.0;267
6520;Nijkerk;2012;38599;9749;22631;6219;34585;1803;634;1169;2211;1245;966;234;130;104;86;40;46;369;208;161;759;387;372;763;480;283;418.0;284.0;170.0;155.0;1156.0;1267.0;267
6521;Nijkerk;2013;38639;9634;22437;6568;34551;1852;676;1176;2236;1244;992;246;135;111;92;44;48;373;213;160;751;384;367;774;468;306;401.0;293.0;182.0;150.0;1117.0;1269.0;267
6522;Nijkerk;2014;38637;9533;22334;6770;34425;1888;704;1184;2324;1296;1028;255;138;117;103;49;54;403;225;178;755;388;367;808;496;312;402.0;304.0;171.0;155.0;1168.0;1221.0;267
6523;Nijkerk;2015;38704;9460;22228;7016;34412;1918;716;1202;2374;1330;1044;266;147;119;116;57;59;392;222;170;763;384;379;837;520;317;388.0;314.0;171.0;149.0;1106.0;1252.0;267
6524;Nijkerk;2016;38662;9351;22127;7184;34285;1931;719;1212;2446;1363;1083;286;159;127;114;53;61;407;223;184;763;382;381;876;546;330;390.0;319.0;170.0;152.0;1100.0;1239.0;267
6525;Nijkerk;2017;38616;9226;22034;7356;34144;1981;749;1232;2491;1380;1111;291;161;130;123;62;61;405;217;188;754;377;377;918;563;355;384.0;321.0;169.0;160.0;1282.0;1229.0;267
6526;Nijkerk;2018;38745;9139;22055;7551;34174;2024;779;1245;2547;1409;1138;295;166;129;135;70;65;408;218;190;753;376;377;956;579;377;392.0;344.0;190.0;154.0;1138.0;1264.0;267
6527;Nijkerk;2019;38709;8979;22002;7728;34049;2045;781;1264;2615;1456;1159;305;172;133;138;71;67;417;221;196;747;379;368;1008;613;395;387.0;346.0;177.0;163.0;1116.0;1224.0;267
6528;Nijkerk;2020;38660;8839;21934;7887;33918;2068;799;1269;2674;1496;1178;318;176;142;150;84;66;428;220;208;733;374;359;1045;642;403;383.0;352.0;163.0;155.0;1199.0;1237.0;267
6529;Nijkerk;2021;38666;8713;21888;8065;33861;2088;808;1280;2717;1507;1210;323;180;143;159;89;70;446;219;227;733;370;363;1056;649;407;376.0;357.0;162.0;158.0;1213.0;1269.0;267
6530;Nijkerk;2022;38636;8548;21843;8245;33782;2102;807;1295;2752;1530;1222;329;184;145;166;91;75;459;223;236;722;365;357;1076;667;409;382.0;361.0;161.0;156.0;1274.0;1240.0;267
6531;Nijkerk;2023;38698;8427;21827;8444;33745;2131;822;1309;2822;1577;1245;339;193;146;174;90;84;468;227;241;718;370;348;1123;697;426;389.0;372.0;171.0;154.0;1134.0;1235.0;267
6532;Nijkerk;2024;38637;8267;21777;8593;33596;2145;837;1308;2896;1595;1301;339;190;149;198;105;93;488;230;258;718;363;355;1153;707;446;382.0;381.0;165.0;155.0;1189.0;1212.0;267
6533;Nijkerk;2025;38629;8160;21674;8795;33517;2171;855;1316;2941;1622;1319;357;199;158;197;104;93;504;236;268;700;362;338;1183;721;462;;;;;;;267
6534;Nijmegen;2008;162474;32365;108456;21653;124000;19224;7684;11540;19250;11399;7851;1615;817;798;1945;1205;740;5045;2660;2385;3304;1653;1651;7341;5064;2277;1780.0;1382.0;1545.0;1655.0;7940.0;6982.0;268
6535;Nijmegen;2009;163753;32511;109194;22048;125085;19307;7739;11568;19361;11288;8073;1669;842;827;1948;1185;763;5040;2611;2429;3337;1626;1711;7367;5024;2343;1848.0;1413.0;1601.0;1635.0;8084.0;6993.0;268
6536;Nijmegen;2010;165280;32767;109985;22528;126385;19428;7881;11547;19467;11165;8302;1760;881;879;1961;1192;769;5028;2572;2456;3341;1577;1764;7377;4943;2434;1915.0;1439.0;1681.0;1615.0;7766.0;7060.0;268
6537;Nijmegen;2011;166563;32991;110531;23041;127434;19550;7956;11594;19579;11128;8451;1831;910;921;1992;1225;767;5016;2553;2463;3382;1577;1805;7358;4863;2495;1954.0;1449.0;1678.0;1609.0;7494.0;7029.0;268
6538;Nijmegen;2012;167624;33227;110371;24026;128333;19623;8063;11560;19668;11072;8596;1917;957;960;2034;1260;774;4979;2509;2470;3397;1552;1845;7341;4794;2547;1999.0;1488.0;1692.0;1577.0;7522.0;6967.0;268
6539;Nijmegen;2013;168834;33498;110385;24951;129343;19727;8170;11557;19764;10997;8767;1982;990;992;2018;1234;784;4987;2486;2501;3406;1527;1879;7371;4760;2611;2069.0;1507.0;1688.0;1547.0;7294.0;7079.0;268
6540;Nijmegen;2014;169780;33794;110346;25640;130109;19762;8232;11530;19909;10978;8931;2039;1014;1025;2055;1253;802;4977;2465;2512;3429;1520;1909;7409;4726;2683;2105.0;1531.0;1681.0;1537.0;7319.0;7033.0;268
6541;Nijmegen;2015;170813;34041;110373;26399;130916;19872;8348;11524;20025;10992;9033;2076;1051;1025;2067;1273;794;4980;2450;2530;3471;1502;1969;7431;4716;2715;2127.0;1544.0;1672.0;1502.0;7748.0;6977.0;268
6542;Nijmegen;2016;172365;34537;110713;27115;132004;20071;8487;11584;20290;11017;9273;2131;1061;1070;2068;1293;775;5053;2461;2592;3540;1492;2048;7498;4710;2788;2172.0;1571.0;1671.0;1493.0;7756.0;7010.0;268
6543;Nijmegen;2017;173915;35003;110925;27987;133219;20210;8618;11592;20486;11047;9439;2157;1084;1073;2087;1306;781;5084;2454;2630;3566;1473;2093;7592;4730;2862;2176.0;1597.0;1655.0;1486.0;7781.0;7067.0;268
6544;Nijmegen;2018;175401;35419;111084;28898;134347;20303;8723;11580;20751;11103;9648;2240;1115;1125;2142;1346;796;5091;2425;2666;3597;1472;2125;7681;4745;2936;2191.0;1616.0;1626.0;1490.0;7633.0;7103.0;268
6545;Nijmegen;2019;176671;35771;111188;29712;135347;20375;8802;11573;20949;11092;9857;2289;1142;1147;2167;1347;820;5122;2422;2700;3600;1447;2153;7771;4734;3037;2217.0;1659.0;1618.0;1467.0;7541.0;7158.0;268
6546;Nijmegen;2020;177792;36053;111222;30517;136244;20470;8892;11578;21078;11089;9989;2332;1156;1176;2175;1364;811;5103;2395;2708;3646;1448;2198;7822;4726;3096;2195.0;1674.0;1630.0;1466.0;7708.0;7110.0;268
6547;Nijmegen;2021;179094;36345;111477;31272;137057;20627;9011;11616;21410;11187;10223;2388;1180;1208;2238;1400;838;5148;2395;2753;3698;1463;2235;7938;4749;3189;2185.0;1708.0;1631.0;1431.0;7486.0;7199.0;268
6548;Nijmegen;2022;180080;36588;111500;31992;137670;20737;9119;11618;21673;11255;10418;2443;1192;1251;2261;1404;857;5169;2385;2784;3727;1474;2253;8073;4800;3273;2189.0;1738.0;1631.0;1453.0;7315.0;7141.0;268
6549;Nijmegen;2023;180903;36865;111345;32693;138157;20809;9280;11529;21937;11305;10632;2526;1213;1313;2292;1415;877;5199;2377;2822;3753;1472;2281;8167;4828;3339;2182.0;1766.0;1577.0;1428.0;7507.0;7132.0;268
6550;Nijmegen;2024;181863;37070;111339;33454;138733;20911;9401;11510;22219;11388;10831;2565;1224;1341;2337;1454;883;5252;2369;2883;3772;1460;2312;8293;4881;3412;2173.0;1789.0;1597.0;1424.0;7371.0;7198.0;268
6551;Nijmegen;2025;182614;37183;111176;34255;139123;20954;9497;11457;22537;11508;11029;2634;1253;1381;2390;1482;908;5248;2357;2891;3846;1465;2381;8419;4951;3468;;;;;;;268
6552;Noord-Beveland;2008;7289;1563;4236;1490;6557;552;254;298;180;94;86;26;10;16;11;6;5;19;7;12;17;9;8;107;62;45;64.0;73.0;25.0;28.0;408.0;396.0;1695
6553;Noord-Beveland;2009;7289;1580;4160;1549;6555;546;238;308;188;103;85;25;13;12;16;9;7;21;8;13;21;10;11;105;63;42;60.0;75.0;25.0;32.0;468.0;399.0;1695
6554;Noord-Beveland;2010;7337;1599;4130;1608;6577;556;239;317;204;113;91;27;16;11;19;10;9;28;11;17;23;10;13;107;66;41;61.0;77.0;25.0;28.0;477.0;410.0;1695
6555;Noord-Beveland;2011;7386;1611;4113;1662;6591;574;227;347;221;116;105;29;16;13;19;10;9;33;12;21;27;13;14;113;65;48;59.0;79.0;29.0;30.0;456.0;421.0;1695
6556;Noord-Beveland;2012;7400;1622;4029;1749;6552;593;227;366;255;125;130;35;17;18;22;11;11;39;14;25;33;13;20;126;70;56;60.0;76.0;27.0;30.0;400.0;402.0;1695
6557;Noord-Beveland;2013;7378;1595;3962;1821;6504;614;224;390;260;127;133;35;15;20;23;12;11;38;13;25;37;15;22;127;72;55;58.0;79.0;33.0;29.0;475.0;403.0;1695
6558;Noord-Beveland;2014;7433;1605;3945;1883;6526;634;225;409;273;135;138;38;17;21;24;12;12;45;17;28;36;15;21;130;74;56;59.0;81.0;28.0;29.0;474.0;404.0;1695
6559;Noord-Beveland;2015;7481;1615;3918;1948;6532;661;234;427;288;142;146;46;23;23;22;13;9;49;18;31;41;16;25;130;72;58;60.0;83.0;29.0;29.0;443.0;413.0;1695
6560;Noord-Beveland;2016;7490;1636;3852;2002;6524;670;222;448;296;145;151;47;25;22;22;10;12;54;20;34;38;16;22;135;74;61;56.0;83.0;29.0;29.0;419.0;395.0;1695
6561;Noord-Beveland;2017;7488;1631;3831;2026;6484;691;212;479;313;140;173;53;24;29;24;9;15;57;22;35;40;15;25;139;70;69;59.0;86.0;29.0;25.0;477.0;409.0;1695
6562;Noord-Beveland;2018;7534;1651;3823;2060;6491;701;218;483;342;153;189;60;27;33;27;12;15;66;25;41;46;15;31;143;74;69;61.0;85.0;32.0;28.0;398.0;405.0;1695
6563;Noord-Beveland;2019;7509;1632;3786;2091;6424;713;221;492;372;167;205;64;29;35;36;17;19;77;27;50;44;15;29;151;79;72;64.0;85.0;28.0;28.0;389.0;407.0;1695
6564;Noord-Beveland;2020;7471;1590;3750;2131;6392;703;219;484;376;168;208;64;28;36;35;16;19;78;29;49;47;15;32;152;80;72;57.0;87.0;32.0;28.0;447.0;406.0;1695
6565;Noord-Beveland;2021;7487;1586;3741;2160;6385;700;223;477;402;173;229;65;27;38;38;17;21;85;29;56;50;14;36;164;86;78;56.0;88.0;33.0;29.0;424.0;427.0;1695
6566;Noord-Beveland;2022;7457;1552;3734;2171;6339;701;224;477;417;181;236;72;29;43;41;20;21;83;29;54;49;16;33;172;87;85;61.0;92.0;32.0;25.0;408.0;431.0;1695
6567;Noord-Beveland;2023;7410;1541;3714;2155;6266;708;226;482;436;189;247;73;31;42;45;20;25;88;32;56;52;16;36;178;90;88;61.0;91.0;30.0;27.0;462.0;413.0;1695
6568;Noord-Beveland;2024;7435;1524;3741;2170;6281;703;226;477;451;199;252;79;34;45;43;21;22;90;35;55;48;14;34;191;95;96;63.0;95.0;30.0;30.0;428.0;425.0;1695
6569;Noord-Beveland;2025;7406;1535;3682;2189;6231;715;216;499;460;198;262;83;37;46;48;23;25;84;34;50;50;13;37;195;91;104;;;;;;;1695
6570;Noordenveld;2008;31254;7396;17806;6052;29043;1318;483;835;893;536;357;163;83;80;82;54;28;73;44;29;65;31;34;510;324;186;250.0;255.0;80.0;110.0;1602.0;1617.0;1699
6571;Noordenveld;2009;31209;7296;17679;6234;28894;1288;469;819;1027;607;420;179;90;89;91;60;31;81;47;34;87;37;50;589;373;216;238.0;260.0;107.0;117.0;1757.0;1681.0;1699
6572;Noordenveld;2010;31257;7194;17652;6411;28814;1304;492;812;1139;655;484;203;105;98;93;63;30;91;50;41;121;49;72;631;388;243;241.0;270.0;103.0;121.0;1660.0;1723.0;1699
6573;Noordenveld;2011;31151;7075;17513;6563;28642;1284;482;802;1225;685;540;211;117;94;104;63;41;103;57;46;145;51;94;662;397;265;247.0;270.0;99.0;115.0;1715.0;1737.0;1699
6574;Noordenveld;2012;31092;6961;17357;6774;28523;1287;475;812;1282;705;577;217;120;97;106;66;40;115;59;56;151;56;95;693;404;289;250.0;276.0;101.0;119.0;1669.0;1733.0;1699
6575;Noordenveld;2013;30986;6830;17162;6994;28357;1294;476;818;1335;718;617;234;128;106;114;68;46;132;66;66;162;55;107;693;401;292;248.0;281.0;106.0;115.0;1714.0;1721.0;1699
6576;Noordenveld;2014;30940;6727;17044;7169;28228;1295;485;810;1417;755;662;249;141;108;130;73;57;145;73;72;183;57;126;710;411;299;256.0;291.0;104.0;120.0;1678.0;1732.0;1699
6577;Noordenveld;2015;30839;6596;16965;7278;28060;1315;498;817;1464;765;699;252;142;110;141;80;61;149;71;78;206;62;144;716;410;306;262.0;289.0;100.0;112.0;1703.0;1751.0;1699
6578;Noordenveld;2016;30755;6500;16889;7366;27913;1306;499;807;1536;785;751;257;150;107;157;84;73;160;78;82;214;60;154;748;413;335;270.0;292.0;98.0;117.0;1706.0;1727.0;1699
6579;Noordenveld;2017;30698;6398;16815;7485;27794;1293;491;802;1611;801;810;263;153;110;160;89;71;175;81;94;226;65;161;787;413;374;273.0;289.0;111.0;114.0;1750.0;1745.0;1699
6580;Noordenveld;2018;30689;6383;16685;7621;27685;1299;478;821;1705;853;852;274;157;117;159;92;67;184;81;103;245;69;176;843;454;389;281.0;296.0;102.0;123.0;1658.0;1738.0;1699
6581;Noordenveld;2019;30574;6319;16555;7700;27507;1294;487;807;1773;850;923;290;159;131;163;89;74;202;84;118;277;82;195;841;436;405;289.0;307.0;109.0;118.0;1702.0;1728.0;1699
6582;Noordenveld;2020;30524;6259;16490;7775;27364;1321;502;819;1839;853;986;297;161;136;169;86;83;203;88;115;294;86;208;876;432;444;288.0;304.0;106.0;120.0;1626.0;1742.0;1699
6583;Noordenveld;2021;30379;6193;16343;7843;27163;1288;490;798;1928;887;1041;314;168;146;182;89;93;222;95;127;314;91;223;896;444;452;295.0;304.0;112.0;110.0;1752.0;1760.0;1699
6584;Noordenveld;2022;30367;6175;16247;7945;27095;1290;486;804;1982;918;1064;313;174;139;185;94;91;226;99;127;319;85;234;939;466;473;282.0;305.0;98.0;115.0;1749.0;1734.0;1699
6585;Noordenveld;2023;30344;6120;16136;8088;26982;1312;497;815;2050;949;1101;324;179;145;179;91;88;240;104;136;334;94;240;973;481;492;284.0;310.0;94.0;117.0;1702.0;1743.0;1699
6586;Noordenveld;2024;30255;6065;15972;8218;26820;1335;503;832;2100;981;1119;321;182;139;193;97;96;259;116;143;336;100;236;991;486;505;285.0;311.0;101.0;108.0;1669.0;1721.0;1699
6587;Noordenveld;2025;30172;6020;15858;8294;26677;1330;514;816;2165;1022;1143;330;189;141;201;103;98;266;121;145;357;111;246;1011;498;513;;;;;;;1699
6588;Noordoostpolder;2008;46015;13068;26791;6156;40775;2387;1049;1338;2853;1766;1087;276;138;138;286;191;95;332;180;152;496;218;278;1463;1039;424;624.0;359.0;158.0;242.0;1766.0;1804.0;171
6589;Noordoostpolder;2009;46166;12989;26865;6312;40819;2433;1066;1367;2914;1764;1150;288;147;141;288;185;103;340;186;154;501;214;287;1497;1032;465;630.0;369.0;170.0;247.0;1990.0;1781.0;171
6590;Noordoostpolder;2010;46563;12972;27117;6474;40996;2534;1107;1427;3033;1826;1207;297;153;144;297;179;118;354;191;163;529;224;305;1556;1079;477;634.0;381.0;176.0;241.0;1987.0;1860.0;171
6591;Noordoostpolder;2011;46884;12917;27348;6619;41126;2600;1128;1472;3158;1867;1291;310;152;158;314;183;131;375;209;166;552;228;324;1607;1095;512;632.0;380.0;191.0;245.0;2030.0;1874.0;171
6592;Noordoostpolder;2012;47244;12882;27484;6878;41310;2673;1153;1520;3261;1909;1352;332;162;170;316;187;129;380;204;176;555;223;332;1678;1133;545;631.0;380.0;228.0;246.0;2068.0;1910.0;171
6593;Noordoostpolder;2013;47643;12890;27585;7168;41494;2745;1190;1555;3404;1959;1445;352;177;175;317;181;136;406;213;193;571;229;342;1758;1159;599;633.0;382.0;197.0;248.0;2070.0;1912.0;171
6594;Noordoostpolder;2014;48008;12904;27680;7424;41683;2820;1213;1607;3505;1969;1536;364;177;187;316;175;141;431;220;211;578;236;342;1816;1161;655;643.0;388.0;221.0;249.0;2092.0;1913.0;171
6595;Noordoostpolder;2015;48420;12928;27869;7623;41891;2890;1245;1645;3639;2014;1625;377;183;194;327;175;152;442;226;216;598;238;360;1895;1192;703;650.0;405.0;195.0;248.0;1927.0;1902.0;171
6596;Noordoostpolder;2016;48640;12934;27812;7894;41920;2976;1276;1700;3744;2064;1680;385;180;205;336;185;151;463;235;228;614;246;368;1946;1218;728;649.0;401.0;193.0;250.0;1966.0;1909.0;171
6597;Noordoostpolder;2017;48893;12987;27770;8136;42024;2994;1274;1720;3875;2145;1730;401;191;210;350;191;159;468;244;224;631;262;369;2025;1257;768;646.0;415.0;194.0;251.0;1962.0;1928.0;171
6598;Noordoostpolder;2018;49102;12924;27742;8436;42086;3068;1306;1762;3948;2181;1767;420;203;217;372;201;171;482;248;234;616;255;361;2058;1274;784;644.0;411.0;194.0;242.0;1916.0;1906.0;171
6599;Noordoostpolder;2019;49304;12888;27751;8665;42097;3130;1331;1799;4077;2249;1828;426;211;215;384;207;177;495;253;242;632;265;367;2140;1313;827;652.0;425.0;195.0;244.0;1993.0;1897.0;171
6600;Noordoostpolder;2020;49585;12840;27792;8953;42238;3161;1353;1808;4186;2304;1882;436;216;220;385;204;181;515;260;255;636;272;364;2214;1352;862;650.0;431.0;209.0;252.0;2073.0;1969.0;171
6601;Noordoostpolder;2021;49867;12854;27804;9209;42333;3202;1363;1839;4332;2392;1940;455;230;225;397;211;186;540;276;264;646;289;357;2294;1386;908;646.0;426.0;220.0;250.0;2020.0;1947.0;171
6602;Noordoostpolder;2022;50145;12833;27849;9463;42466;3242;1386;1856;4437;2451;1986;461;238;223;402;203;199;560;284;276;659;287;372;2355;1439;916;662.0;437.0;208.0;249.0;2049.0;1955.0;171
6603;Noordoostpolder;2023;50428;12864;27807;9757;42552;3283;1432;1851;4593;2516;2077;464;236;228;418;201;217;598;298;300;651;289;362;2462;1492;970;675.0;445.0;195.0;250.0;1987.0;1938.0;171
6604;Noordoostpolder;2024;50657;12912;27742;10003;42619;3344;1471;1873;4694;2582;2112;487;250;237;426;203;223;612;309;303;649;283;366;2520;1537;983;652.0;460.0;194.0;255.0;1955.0;1950.0;171
6605;Noordoostpolder;2025;50799;12923;27646;10230;42640;3369;1487;1882;4790;2617;2173;489;250;239;420;200;220;630;316;314;652;286;366;2599;1565;1034;;;;;;;171
6606;Noordwijk;2008;24370;5294;15269;3807;20876;2431;1247;1184;1063;619;444;88;43;45;63;23;40;59;30;29;287;142;145;566;381;185;202.0;214.0;280.0;156.0;803.0;1084.0;575
6607;Noordwijk;2009;24205;5196;15079;3930;20596;2472;1293;1179;1137;668;469;107;53;54;66;26;40;74;38;36;293;151;142;597;400;197;198.0;205.0;293.0;168.0;896.0;1072.0;575
6608;Noordwijk;2010;24148;5101;14987;4060;20426;2531;1357;1174;1191;702;489;114;57;57;75;34;41;92;47;45;296;150;146;614;414;200;193.0;213.0;316.0;167.0;920.0;1061.0;575
6609;Noordwijk;2011;24140;5045;14926;4169;20303;2555;1394;1161;1282;754;528;131;62;69;86;40;46;115;62;53;302;151;151;648;439;209;196.0;215.0;324.0;156.0;950.0;1073.0;575
6610;Noordwijk;2012;24170;4970;14792;4408;20242;2596;1441;1155;1332;794;538;141;71;70;98;51;47;124;66;58;302;149;153;667;457;210;197.0;219.0;337.0;150.0;759.0;1023.0;575
6611;Noordwijk;2013;24074;4894;14623;4557;20048;2640;1476;1164;1386;832;554;153;76;77;104;55;49;134;71;63;301;151;150;694;479;215;194.0;226.0;341.0;158.0;871.0;1028.0;575
6612;Noordwijk;2014;24071;4852;14469;4750;19938;2685;1521;1164;1448;859;589;168;82;86;109;59;50;142;67;75;307;149;158;722;502;220;196.0;222.0;330.0;157.0;930.0;1010.0;575
6613;Noordwijk;2015;24143;4839;14440;4864;19878;2749;1584;1165;1516;885;631;184;86;98;116;66;50;156;70;86;324;157;167;736;506;230;200.0;234.0;337.0;161.0;1031.0;1028.0;575
6614;Noordwijk;2016;24290;4846;14463;4981;19891;2815;1621;1194;1584;921;663;180;82;98;121;69;52;172;72;100;334;169;165;777;529;248;207.0;235.0;337.0;161.0;793.0;1020.0;575
6615;Noordwijk;2017;24214;4774;14345;5095;19722;2836;1645;1191;1656;975;681;190;89;101;134;77;57;190;85;105;348;178;170;794;546;248;205.0;239.0;335.0;166.0;873.0;1017.0;575
6616;Noordwijk;2018;24209;4747;14253;5209;19644;2858;1675;1183;1707;986;721;201;90;111;143;80;63;209;88;121;356;184;172;798;544;254;210.0;241.0;338.0;165.0;914.0;1029.0;575
6617;Noordwijk;2019;24238;4744;14176;5318;19592;2882;1720;1162;1764;1004;760;211;91;120;159;90;69;217;92;125;357;181;176;820;550;270;213.0;247.0;337.0;157.0;883.0;1020.0;575
6618;Noordwijk;2020;24248;4704;14164;5380;19518;2898;1739;1159;1832;1057;775;228;107;121;167;91;76;221;98;123;365;183;182;851;578;273;214.0;254.0;328.0;161.0;997.0;1045.0;575
6619;Noordwijk;2021;24329;4726;14117;5486;19507;2938;1769;1169;1884;1084;800;248;116;132;178;96;82;223;101;122;371;181;190;864;590;274;222.0;260.0;350.0;151.0;909.0;1040.0;575
6620;Noordwijk;2022;24372;4706;14080;5586;19466;2962;1789;1173;1944;1119;825;254;118;136;192;101;91;240;110;130;370;176;194;888;614;274;228.0;256.0;339.0;157.0;987.0;1025.0;575
6621;Noordwijk;2023;24489;4721;14099;5669;19460;3011;1839;1172;2018;1161;857;255;125;130;204;109;95;254;108;146;372;185;187;933;634;299;232.0;266.0;350.0;155.0;1027.0;1061.0;575
6622;Noordwijk;2024;24619;4748;14122;5749;19451;3092;1903;1189;2076;1191;885;257;129;128;208;116;92;271;117;154;382;187;195;958;642;316;240.0;266.0;341.0;162.0;982.0;1051.0;575
6623;Noordwijk;2025;24705;4735;14113;5857;19424;3136;1941;1195;2145;1222;923;268;130;138;209;114;95;289;124;165;386;189;197;993;665;328;;;;;;;575
6624;Noordwijkerhout;2008;15011;3677;8941;2393;13198;1280;627;653;533;303;230;78;40;38;40;13;27;36;23;13;64;35;29;315;192;123;120.0;120.0;88.0;85.0;465.0;614.0;576
6625;Noordwijkerhout;2009;14869;3567;8861;2441;13026;1273;633;640;570;331;239;81;44;37;42;14;28;49;29;20;71;38;33;327;206;121;114.0;117.0;91.0;88.0;613.0;606.0;576
6626;Noordwijkerhout;2010;14878;3500;8846;2532;12969;1284;647;637;625;363;262;84;46;38;54;21;33;60;37;23;72;36;36;355;223;132;118.0;123.0;96.0;86.0;528.0;612.0;576
6627;Noordwijkerhout;2011;14800;3401;8836;2563;12841;1296;665;631;663;374;289;99;51;48;63;24;39;59;32;27;81;37;44;361;230;131;125.0;129.0;102.0;87.0;506.0;607.0;576
6628;Noordwijkerhout;2012;14711;3320;8687;2704;12705;1301;683;618;705;384;321;105;51;54;63;26;37;68;37;31;85;36;49;384;234;150;121.0;134.0;98.0;91.0;534.0;582.0;576
6629;Noordwijkerhout;2013;14659;3263;8602;2794;12622;1298;689;609;739;400;339;112;51;61;66;27;39;78;38;40;83;33;50;400;251;149;123.0;129.0;107.0;83.0;574.0;596.0;576
6630;Noordwijkerhout;2014;14658;3243;8510;2905;12555;1311;684;627;792;423;369;118;55;63;67;32;35;90;43;47;87;35;52;430;258;172;124.0;140.0;112.0;83.0;571.0;589.0;576
6631;Noordwijkerhout;2015;14654;3189;8486;2979;12499;1335;701;634;820;431;389;129;52;77;70;38;32;87;41;46;90;33;57;444;267;177;127.0;138.0;100.0;84.0;629.0;608.0;576
6632;Noordwijkerhout;2016;14681;3141;8489;3051;12470;1350;716;634;861;442;419;135;54;81;83;42;41;91;46;45;95;32;63;457;268;189;138.0;145.0;104.0;89.0;586.0;609.0;576
6633;Noordwijkerhout;2017;14665;3107;8472;3086;12399;1390;737;653;876;448;428;137;58;79;84;43;41;94;42;52;95;31;64;466;274;192;136.0;140.0;99.0;86.0;628.0;593.0;576
6634;Noordwijkerhout;2018;14708;3064;8505;3139;12392;1428;779;649;888;447;441;128;51;77;88;46;42;107;48;59;103;33;70;462;269;193;143.0;142.0;105.0;81.0;639.0;643.0;576
6635;Noordwijkerhout;2019;14730;3028;8462;3240;12375;1433;771;662;922;462;460;133;52;81;87;49;38;115;52;63;116;37;79;471;272;199;146.0;147.0;103.0;82.0;609.0;625.0;576
6636;Noordwijkerhout;2020;14733;2977;8467;3289;12325;1433;768;665;975;484;491;142;53;89;95;56;39;126;54;72;124;39;85;488;282;206;147.0;150.0;99.0;83.0;689.0;631.0;576
6637;Noordwijkerhout;2021;14805;2962;8513;3330;12340;1462;784;678;1003;515;488;147;58;89;97;57;40;131;58;73;128;44;84;500;298;202;149.0;153.0;100.0;80.0;684.0;613.0;576
6638;Noordwijkerhout;2022;14895;2977;8556;3362;12384;1480;799;681;1031;517;514;161;63;98;95;52;43;134;64;70;122;43;79;519;295;224;155.0;151.0;103.0;78.0;498.0;632.0;576
6639;Noordwijkerhout;2023;14791;2923;8444;3424;12227;1485;802;683;1079;541;538;167;67;100;98;51;47;144;67;77;137;51;86;533;305;228;152.0;156.0;114.0;86.0;678.0;629.0;576
6640;Noordwijkerhout;2024;14871;2939;8442;3490;12245;1521;836;685;1105;546;559;161;63;98;104;58;46;151;69;82;148;52;96;541;304;237;156.0;154.0;107.0;76.0;534.0;616.0;576
6641;Noordwijkerhout;2025;14824;2933;8363;3528;12163;1542;856;686;1119;554;565;163;71;92;109;59;50;164;78;86;149;51;98;534;295;239;;;;;;;576
6642;Nuenen, Gerwen en Nederwetten;2008;22866;5532;13785;3549;20348;1883;593;1290;635;370;265;83;38;45;43;19;24;56;27;29;42;18;24;411;268;143;167.0;149.0;107.0;139.0;838.0;925.0;820
6643;Nuenen, Gerwen en Nederwetten;2009;22767;5327;13674;3766;20229;1863;591;1272;675;398;277;91;45;46;45;22;23;63;32;31;50;19;31;426;280;146;161.0;157.0;106.0;132.0;1000.0;938.0;820
6644;Nuenen, Gerwen en Nederwetten;2010;22810;5190;13673;3947;20209;1857;595;1262;744;418;326;99;49;50;49;23;26;71;31;40;60;27;33;465;288;177;164.0;168.0;113.0;129.0;948.0;952.0;820
6645;Nuenen, Gerwen en Nederwetten;2011;22787;5032;13615;4140;20158;1836;586;1250;793;427;366;103;51;52;53;21;32;85;32;53;77;34;43;475;289;186;164.0;174.0;109.0;129.0;1021.0;954.0;820
6646;Nuenen, Gerwen en Nederwetten;2012;22829;4896;13547;4386;20151;1817;591;1226;861;466;395;114;59;55;53;18;35;90;36;54;91;40;51;513;313;200;164.0;178.0;115.0;132.0;1056.0;988.0;820
6647;Nuenen, Gerwen en Nederwetten;2013;22868;4770;13460;4638;20173;1816;594;1222;879;486;393;118;62;56;57;21;36;96;44;52;100;46;54;508;313;195;168.0;186.0;112.0;128.0;1061.0;991.0;820
6648;Nuenen, Gerwen en Nederwetten;2014;22904;4619;13444;4841;20197;1796;582;1214;911;489;422;131;61;70;61;24;37;112;48;64;107;50;57;500;306;194;174.0;192.0;112.0;128.0;1024.0;1002.0;820
6649;Nuenen, Gerwen en Nederwetten;2015;22893;4484;13413;4996;20115;1823;607;1216;955;515;440;139;67;72;63;30;33;126;58;68;120;51;69;507;309;198;182.0;197.0;121.0;125.0;1052.0;1035.0;820
6650;Nuenen, Gerwen en Nederwetten;2016;22896;4406;13325;5165;20065;1803;592;1211;1028;555;473;144;72;72;76;36;40;145;64;81;131;55;76;532;328;204;185.0;201.0;115.0;123.0;1042.0;1005.0;820
6651;Nuenen, Gerwen en Nederwetten;2017;22911;4324;13314;5273;20054;1790;584;1206;1067;578;489;143;73;70;76;36;40;151;73;78;141;55;86;556;341;215;197.0;209.0;114.0;117.0;1050.0;1029.0;820
6652;Nuenen, Gerwen en Nederwetten;2018;22920;4260;13248;5412;20040;1773;579;1194;1107;577;530;148;76;72;85;36;49;164;72;92;148;54;94;562;339;223;201.0;213.0;106.0;115.0;991.0;1040.0;820
6653;Nuenen, Gerwen en Nederwetten;2019;22851;4185;13149;5517;19942;1757;577;1180;1152;617;535;152;77;75;92;38;54;171;82;89;154;60;94;583;360;223;200.0;221.0;112.0;113.0;1014.0;1002.0;820
6654;Nuenen, Gerwen en Nederwetten;2020;22841;4107;13099;5635;19896;1760;588;1172;1185;637;548;159;81;78;94;39;55;175;83;92;161;62;99;596;372;224;206.0;225.0;120.0;121.0;1077.0;1008.0;820
6655;Nuenen, Gerwen en Nederwetten;2021;22890;4085;13066;5739;19866;1784;607;1177;1240;665;575;162;84;78;99;42;57;192;90;102;169;63;106;618;386;232;214.0;234.0;116.0;108.0;1053.0;1021.0;820
6656;Nuenen, Gerwen en Nederwetten;2022;22912;4062;13005;5845;19858;1795;618;1177;1259;670;589;162;86;76;106;44;62;201;96;105;174;64;110;616;380;236;216.0;241.0;109.0;115.0;1069.0;1041.0;820
6657;Nuenen, Gerwen en Nederwetten;2023;22913;4065;12907;5941;19834;1788;617;1171;1291;685;606;167;86;81;112;43;69;201;93;108;187;67;120;624;396;228;217.0;251.0;123.0;111.0;1098.0;1008.0;820
6658;Nuenen, Gerwen en Nederwetten;2024;22982;4106;12815;6061;19822;1809;624;1185;1351;715;636;177;91;86;118;50;68;201;88;113;196;74;122;659;412;247;220.0;251.0;114.0;110.0;1061.0;1040.0;820
6659;Nuenen, Gerwen en Nederwetten;2025;22986;4125;12688;6173;19771;1818;630;1188;1397;744;653;189;96;93;127;55;72;211;97;114;200;74;126;670;422;248;;;;;;;820
6660;Nunspeet;2008;26265;7238;14907;4120;24613;875;342;533;777;478;299;67;31;36;27;14;13;90;44;46;111;51;60;482;338;144;324.0;212.0;90.0;98.0;837.0;900.0;302
6661;Nunspeet;2009;26310;7121;14994;4195;24591;880;347;533;839;503;336;82;37;45;28;13;15;108;53;55;120;55;65;501;345;156;321.0;213.0;94.0;108.0;788.0;903.0;302
6662;Nunspeet;2010;26294;7026;14996;4272;24506;885;346;539;903;534;369;91;40;51;38;18;20;125;59;66;130;62;68;519;355;164;315.0;213.0;97.0;102.0;799.0;946.0;302
6663;Nunspeet;2011;26246;6872;15026;4348;24392;893;346;547;961;558;403;107;51;56;39;19;20;131;62;69;140;63;77;544;363;181;319.0;222.0;102.0;100.0;835.0;948.0;302
6664;Nunspeet;2012;26234;6759;14965;4510;24319;910;346;564;1005;573;432;112;56;56;44;20;24;143;72;71;148;61;87;558;364;194;318.0;225.0;107.0;101.0;843.0;946.0;302
6665;Nunspeet;2013;26232;6670;14943;4619;24249;940;358;582;1043;581;462;115;54;61;59;27;32;161;78;83;154;65;89;554;357;197;317.0;222.0;102.0;100.0;753.0;936.0;302
6666;Nunspeet;2014;26148;6558;14874;4716;24098;954;373;581;1096;612;484;124;60;64;63;33;30;174;83;91;155;67;88;580;369;211;314.0;223.0;104.0;100.0;792.0;936.0;302
6667;Nunspeet;2015;26105;6480;14816;4809;23979;991;392;599;1135;616;519;134;65;69;63;36;27;182;82;100;156;65;91;600;368;232;313.0;232.0;101.0;98.0;721.0;955.0;302
6668;Nunspeet;2016;25957;6323;14733;4901;23789;1008;396;612;1160;633;527;137;68;69;67;36;31;182;84;98;159;67;92;615;378;237;313.0;228.0;107.0;101.0;791.0;940.0;302
6669;Nunspeet;2017;25902;6290;14629;4983;23680;1010;389;621;1212;659;553;145;68;77;75;41;34;196;90;106;169;73;96;627;387;240;314.0;226.0;105.0;99.0;879.0;936.0;302
6670;Nunspeet;2018;25941;6227;14609;5105;23632;1041;401;640;1268;679;589;145;69;76;80;40;40;214;98;116;173;74;99;656;398;258;309.0;236.0;102.0;102.0;857.0;937.0;302
6671;Nunspeet;2019;25937;6130;14558;5249;23591;1058;406;652;1288;684;604;148;72;76;86;41;45;224;100;124;173;74;99;657;397;260;308.0;233.0;101.0;100.0;841.0;949.0;302
6672;Nunspeet;2020;25906;6060;14451;5395;23532;1054;404;650;1320;691;629;150;71;79;89;42;47;235;107;128;178;76;102;668;395;273;309.0;239.0;108.0;96.0;849.0;942.0;302
6673;Nunspeet;2021;25896;6023;14354;5519;23456;1065;395;670;1375;732;643;161;80;81;95;42;53;242;113;129;187;79;108;690;418;272;312.0;243.0;107.0;94.0;820.0;941.0;302
6674;Nunspeet;2022;25861;5948;14286;5627;23354;1097;403;694;1410;745;665;163;77;86;106;49;57;256;122;134;201;82;119;684;415;269;305.0;244.0;107.0;92.0;780.0;925.0;302
6675;Nunspeet;2023;25795;5872;14188;5735;23237;1113;417;696;1445;763;682;171;86;85;115;51;64;263;120;143;199;80;119;697;426;271;308.0;249.0;99.0;92.0;777.0;921.0;302
6676;Nunspeet;2024;25719;5806;14103;5810;23123;1125;418;707;1471;784;687;175;88;87;111;49;62;262;119;143;209;83;126;714;445;269;310.0;252.0;96.0;91.0;703.0;893.0;302
6677;Nunspeet;2025;25593;5775;13883;5935;22971;1127;427;700;1495;786;709;180;94;86;115;51;64;266;116;150;215;86;129;719;439;280;;;;;;;302
6678;Nuth;2008;15695;3260;9396;3039;13613;1658;409;1249;424;252;172;50;28;22;26;18;8;70;39;31;47;20;27;231;147;84;109.0;157.0;81.0;111.0;568.0;696.0;951
6679;Nuth;2009;15490;3157;9257;3076;13429;1614;404;1210;447;262;185;51;28;23;30;22;8;75;47;28;54;25;29;237;140;97;104.0;159.0;80.0;110.0;648.0;686.0;951
6680;Nuth;2010;15369;3065;9169;3135;13293;1602;409;1193;474;273;201;55;34;21;37;27;10;82;46;36;64;27;37;236;139;97;106.0;158.0;82.0;105.0;725.0;703.0;951
6681;Nuth;2011;15321;2980;9110;3231;13239;1571;420;1151;511;285;226;52;33;19;45;30;15;89;50;39;74;27;47;251;145;106;107.0;162.0;83.0;107.0;689.0;717.0;951
6682;Nuth;2012;15215;2911;8998;3306;13149;1542;411;1131;524;286;238;57;35;22;36;22;14;87;49;38;81;33;48;263;147;116;107.0;156.0;107.0;101.0;703.0;715.0;951
6683;Nuth;2013;15162;2857;8884;3421;13066;1536;425;1111;560;292;268;58;36;22;42;25;17;97;55;42;93;37;56;270;139;131;109.0;163.0;82.0;100.0;779.0;719.0;951
6684;Nuth;2014;15152;2789;8830;3533;13018;1525;426;1099;609;328;281;62;39;23;45;28;17;108;62;46;89;41;48;305;158;147;114.0;163.0;87.0;101.0;821.0;724.0;951
6685;Nuth;2015;15188;2784;8773;3631;12994;1526;447;1079;668;358;310;70;41;29;49;31;18;124;65;59;101;50;51;324;171;153;117.0;172.0;113.0;100.0;831.0;753.0;951
6686;Nuth;2016;15231;2793;8749;3689;13029;1494;440;1054;708;368;340;76;44;32;52;30;22;133;71;62;118;54;64;329;169;160;122.0;175.0;88.0;97.0;815.0;750.0;951
6687;Nuth;2017;15235;2775;8735;3725;13004;1494;465;1029;737;391;346;74;44;30;61;37;24;144;81;63;124;56;68;334;173;161;125.0;171.0;88.0;99.0;789.0;752.0;951
6688;Nuth;2018;15216;2731;8675;3810;12943;1493;463;1030;780;402;378;76;45;31;63;33;30;160;88;72;128;58;70;353;178;175;130.0;177.0;95.0;103.0;824.0;749.0;951
6689;Nuth;2019;15236;2760;8621;3855;12923;1493;455;1038;820;425;395;86;52;34;62;32;30;169;93;76;135;62;73;368;186;182;144.0;185.0;90.0;94.0;768.0;761.0;951
6690;Nuth;2020;15199;2758;8575;3866;12824;1497;463;1034;878;443;435;98;60;38;62;31;31;181;97;84;139;63;76;398;192;206;142.0;181.0;82.0;95.0;824.0;753.0;951
6691;Nuth;2021;15217;2748;8554;3915;12797;1492;465;1027;928;461;467;102;65;37;65;34;31;190;97;93;149;67;82;422;198;224;146.0;187.0;82.0;91.0;836.0;754.0;951
6692;Nuth;2022;15251;2760;8535;3956;12788;1507;496;1011;956;470;486;110;69;41;72;36;36;194;104;90;153;61;92;427;200;227;150.0;190.0;89.0;98.0;795.0;754.0;951
6693;Nuth;2023;15245;2770;8477;3998;12754;1494;492;1002;997;482;515;111;73;38;69;36;33;203;105;98;162;66;96;452;202;250;150.0;188.0;83.0;87.0;811.0;744.0;951
6694;Nuth;2024;15271;2795;8403;4073;12745;1485;517;968;1041;493;548;113;72;41;65;33;32;214;110;104;181;74;107;468;204;264;147.0;194.0;79.0;90.0;862.0;727.0;951
6695;Nuth;2025;15349;2867;8369;4113;12776;1490;530;960;1083;507;576;120;79;41;65;30;35;222;118;104;194;77;117;482;203;279;;;;;;;951
6696;Oegstgeest;2008;21739;5481;12741;3517;17226;3038;1448;1590;1475;843;632;240;124;116;146;69;77;94;45;49;98;46;52;897;559;338;172.0;197.0;281.0;180.0;1343.0;1437.0;579
6697;Oegstgeest;2009;21724;5337;12859;3528;17115;3068;1498;1570;1541;886;655;258;135;123;134;65;69;125;65;60;120;52;68;904;569;335;174.0;193.0;287.0;176.0;1322.0;1461.0;579
6698;Oegstgeest;2010;21678;5168;12905;3605;17032;3091;1510;1581;1555;883;672;272;139;133;129;60;69;139;71;68;134;53;81;881;560;321;175.0;197.0;286.0;176.0;1350.0;1492.0;579
6699;Oegstgeest;2011;21625;4989;13015;3621;16957;3104;1540;1564;1564;886;678;270;140;130;132;66;66;138;67;71;137;54;83;887;559;328;184.0;196.0;312.0;175.0;1276.0;1492.0;579
6700;Oegstgeest;2012;21535;4837;12936;3762;16798;3137;1584;1553;1600;926;674;274;144;130;143;78;65;146;80;66;154;57;97;883;567;316;194.0;193.0;320.0;177.0;1315.0;1461.0;579
6701;Oegstgeest;2013;21536;4735;12946;3855;16747;3148;1610;1538;1641;930;711;278;137;141;173;95;78;159;86;73;173;63;110;858;549;309;195.0;197.0;313.0;169.0;1319.0;1453.0;579
6702;Oegstgeest;2014;21548;4631;12931;3986;16620;3241;1664;1577;1687;955;732;277;133;144;167;99;68;182;96;86;190;69;121;871;558;313;197.0;198.0;316.0;173.0;1280.0;1440.0;579
6703;Oegstgeest;2015;21532;4539;12955;4038;16504;3315;1722;1593;1713;966;747;266;130;136;169;102;67;201;106;95;206;72;134;871;556;315;204.0;200.0;325.0;166.0;1347.0;1477.0;579
6704;Oegstgeest;2016;21568;4499;12962;4107;16451;3354;1758;1596;1763;986;777;263;127;136;164;106;58;215;114;101;224;74;150;897;565;332;206.0;200.0;309.0;173.0;1319.0;1475.0;579
6705;Oegstgeest;2017;21554;4449;12924;4181;16387;3366;1795;1571;1801;991;810;268;128;140;177;112;65;226;114;112;228;73;155;902;564;338;211.0;197.0;314.0;174.0;1278.0;1444.0;579
6706;Oegstgeest;2018;21544;4398;12872;4274;16322;3378;1806;1572;1844;1005;839;274;129;145;180;113;67;230;110;120;255;79;176;905;574;331;210.0;204.0;316.0;173.0;1294.0;1424.0;579
6707;Oegstgeest;2019;21564;4353;12856;4355;16227;3451;1854;1597;1886;1025;861;279;131;148;190;112;78;250;126;124;261;85;176;906;571;335;214.0;203.0;335.0;174.0;1357.0;1472.0;579
6708;Oegstgeest;2020;21630;4383;12834;4413;16209;3468;1860;1608;1953;1049;904;288;137;151;203;119;84;254;127;127;270;82;188;938;584;354;211.0;203.0;305.0;168.0;1296.0;1455.0;579
6709;Oegstgeest;2021;21619;4324;12765;4530;16161;3488;1882;1606;1970;1063;907;288;134;154;211;125;86;261;127;134;269;86;183;941;591;350;208.0;208.0;307.0;159.0;1329.0;1448.0;579
6710;Oegstgeest;2022;21650;4292;12703;4655;16136;3516;1919;1597;1998;1108;890;285;139;146;210;133;77;264;132;132;279;98;181;960;606;354;206.0;209.0;307.0;160.0;1403.0;1449.0;579
6711;Oegstgeest;2023;21751;4283;12693;4775;16140;3570;1953;1617;2041;1134;907;292;145;147;211;132;79;282;141;141;286;100;186;970;616;354;206.0;209.0;306.0;164.0;1374.0;1483.0;579
6712;Oegstgeest;2024;21785;4247;12713;4825;16099;3605;1974;1631;2081;1156;925;294;148;146;213;130;83;288;146;142;289;105;184;997;627;370;209.0;216.0;302.0;164.0;1305.0;1449.0;579
6713;Oegstgeest;2025;21776;4249;12602;4925;15996;3640;2011;1629;2140;1203;937;296;155;141;214;136;78;301;157;144;284;105;179;1045;650;395;;;;;;;579
6714;Oirschot;2008;17663;4484;10591;2588;16679;653;217;436;331;186;145;37;16;21;35;19;16;37;14;23;32;17;15;190;120;70;156.0;129.0;63.0;86.0;323.0;495.0;823
6715;Oirschot;2009;17496;4358;10492;2646;16474;650;220;430;372;209;163;44;20;24;44;27;17;52;19;33;34;15;19;198;128;70;150.0;132.0;63.0;79.0;436.0;517.0;823
6716;Oirschot;2010;17419;4252;10472;2695;16352;654;223;431;413;226;187;43;21;22;44;29;15;67;23;44;39;13;26;220;140;80;149.0;135.0;72.0;81.0;530.0;506.0;823
6717;Oirschot;2011;17449;4167;10508;2774;16311;683;241;442;455;252;203;44;23;21;52;33;19;78;27;51;44;20;24;237;149;88;149.0;140.0;78.0;81.0;425.0;538.0;823
6718;Oirschot;2012;17344;4030;10440;2874;16155;690;245;445;499;274;225;50;25;25;53;33;20;91;31;60;60;27;33;245;158;87;148.0;142.0;75.0;81.0;494.0;534.0;823
6719;Oirschot;2013;17306;3936;10359;3011;16036;714;261;453;556;304;252;58;28;30;54;38;16;106;35;71;70;31;39;268;172;96;151.0;141.0;71.0;79.0;518.0;527.0;823
6720;Oirschot;2014;17301;3872;10281;3148;15961;722;249;473;618;336;282;69;33;36;59;40;19;120;41;79;78;35;43;292;187;105;148.0;148.0;77.0;79.0;603.0;536.0;823
6721;Oirschot;2015;17368;3815;10294;3259;15941;755;256;499;672;354;318;70;34;36;62;40;22;140;43;97;83;34;49;317;203;114;158.0;150.0;76.0;80.0;603.0;557.0;823
6722;Oirschot;2016;17421;3758;10304;3359;15912;777;270;507;732;386;346;74;36;38;62;40;22;157;49;108;92;37;55;347;224;123;160.0;151.0;82.0;80.0;556.0;567.0;823
6723;Oirschot;2017;17423;3702;10262;3459;15826;820;284;536;777;401;376;76;38;38;61;39;22;177;57;120;94;39;55;369;228;141;164.0;151.0;82.0;78.0;489.0;585.0;823
6724;Oirschot;2018;17345;3611;10184;3550;15698;838;303;535;809;409;400;84;38;46;66;43;23;189;55;134;90;40;50;380;233;147;165.0;157.0;75.0;79.0;595.0;541.0;823
6725;Oirschot;2019;17404;3565;10213;3626;15693;846;295;551;865;437;428;84;37;47;74;48;26;212;60;152;93;43;50;402;249;153;169.0;160.0;85.0;78.0;602.0;558.0;823
6726;Oirschot;2020;17464;3519;10222;3723;15682;862;314;548;920;443;477;99;44;55;76;46;30;243;65;178;97;43;54;405;245;160;169.0;167.0;76.0;80.0;598.0;564.0;823
6727;Oirschot;2021;17499;3468;10186;3845;15642;863;303;560;994;477;517;114;53;61;81;47;34;265;71;194;105;44;61;429;262;167;179.0;165.0;79.0;76.0;569.0;569.0;823
6728;Oirschot;2022;17518;3469;10087;3962;15604;879;307;572;1035;498;537;116;55;61;83;50;33;275;77;198;117;49;68;444;267;177;175.0;168.0;77.0;79.0;627.0;565.0;823
6729;Oirschot;2023;17586;3434;10051;4101;15610;909;324;585;1067;506;561;124;59;65;85;48;37;295;78;217;119;49;70;444;272;172;185.0;172.0;75.0;78.0;574.0;540.0;823
6730;Oirschot;2024;17632;3437;9992;4203;15604;916;322;594;1112;541;571;123;62;61;88;52;36;292;76;216;127;48;79;482;303;179;178.0;181.0;77.0;83.0;618.0;556.0;823
6731;Oirschot;2025;17687;3437;9915;4335;15595;948;339;609;1144;551;593;131;63;68;91;56;35;298;76;222;136;50;86;488;306;182;;;;;;;823
6732;Oisterwijk;2008;25740;6274;15095;4371;22862;1734;663;1071;1144;691;453;107;56;51;68;25;43;150;75;75;170;87;83;649;448;201;221.0;220.0;124.0;144.0;917.0;1003.0;824
6733;Oisterwijk;2009;25638;6118;15034;4486;22716;1748;657;1091;1174;712;462;120;67;53;68;27;41;150;78;72;181;89;92;655;451;204;215.0;224.0;130.0;145.0;910.0;1029.0;824
6734;Oisterwijk;2010;25498;5949;14981;4568;22500;1747;657;1090;1251;749;502;129;65;64;73;29;44;160;85;75;189;97;92;700;473;227;209.0;223.0;130.0;146.0;971.0;1029.0;824
6735;Oisterwijk;2011;25413;5772;14995;4646;22343;1766;661;1105;1304;777;527;134;71;63;75;33;42;166;88;78;197;90;107;732;495;237;206.0;235.0;134.0;141.0;928.0;1054.0;824
6736;Oisterwijk;2012;25252;5573;14919;4760;22139;1772;652;1120;1341;801;540;145;75;70;71;35;36;179;91;88;199;97;102;747;503;244;208.0;238.0;134.0;143.0;1013.0;1018.0;824
6737;Oisterwijk;2013;25210;5416;14852;4942;22000;1804;675;1129;1406;837;569;156;81;75;78;37;41;205;93;112;201;100;101;766;526;240;216.0;242.0;164.0;141.0;982.0;1070.0;824
6738;Oisterwijk;2014;25122;5322;14732;5068;21835;1804;690;1114;1483;879;604;176;89;87;88;45;43;212;102;110;200;100;100;807;543;264;216.0;237.0;131.0;137.0;955.0;1080.0;824
6739;Oisterwijk;2015;24971;5163;14619;5189;21650;1822;692;1130;1499;891;608;177;90;87;84;43;41;216;98;118;209;105;104;813;555;258;215.0;243.0;142.0;139.0;1059.0;1055.0;824
6740;Oisterwijk;2016;24951;5141;14512;5298;21535;1856;716;1140;1560;912;648;182;88;94;91;53;38;212;102;110;225;105;120;850;564;286;220.0;241.0;128.0;141.0;1070.0;1073.0;824
6741;Oisterwijk;2017;24916;5047;14468;5401;21407;1905;730;1175;1604;942;662;189;95;94;97;56;41;207;102;105;230;107;123;881;582;299;223.0;247.0;162.0;141.0;1018.0;1075.0;824
6742;Oisterwijk;2018;24863;4979;14385;5499;21273;1930;746;1184;1660;963;697;196;97;99;98;55;43;225;107;118;238;109;129;903;595;308;223.0;254.0;148.0;135.0;1065.0;1071.0;824
6743;Oisterwijk;2019;24840;4960;14315;5565;21178;1954;755;1199;1708;990;718;202;101;101;99;54;45;226;109;117;240;110;130;941;616;325;229.0;250.0;146.0;134.0;992.0;1108.0;824
6744;Oisterwijk;2020;24716;4854;14201;5661;20988;1977;760;1217;1751;1002;749;211;107;104;100;55;45;239;116;123;254;110;144;947;614;333;228.0;257.0;143.0;130.0;1063.0;1063.0;824
6745;Oisterwijk;2021;24702;4777;14201;5724;20881;2020;782;1238;1801;1036;765;222;114;108;100;57;43;242;120;122;262;116;146;975;629;346;235.0;258.0;140.0;135.0;1153.0;1078.0;824
6746;Oisterwijk;2022;24760;4723;14228;5809;20825;2063;818;1245;1872;1058;814;237;119;118;103;61;42;270;127;143;270;119;151;992;632;360;244.0;266.0;141.0;136.0;1087.0;1078.0;824
6747;Oisterwijk;2023;24756;4673;14178;5905;20734;2075;816;1259;1947;1096;851;232;120;112;110;63;47;286;132;154;278;124;154;1041;657;384;240.0;271.0;145.0;134.0;1099.0;1092.0;824
6748;Oisterwijk;2024;24743;4654;14100;5989;20642;2087;812;1275;2014;1114;900;236;118;118;119;66;53;304;135;169;280;123;157;1075;672;403;254.0;267.0;136.0;135.0;1006.0;1091.0;824
6749;Oisterwijk;2025;24649;4643;13946;6060;20501;2097;802;1295;2051;1133;918;234;116;118;124;68;56;313;136;177;277;120;157;1103;693;410;;;;;;;824
6750;Oldebroek;2008;22255;6000;13217;3038;21166;597;209;388;492;278;214;45;25;20;36;18;18;50;14;36;40;13;27;321;208;113;268.0;171.0;64.0;80.0;465.0;856.0;269
6751;Oldebroek;2009;21947;5763;13108;3076;20835;608;202;406;504;291;213;51;28;23;40;20;20;52;16;36;41;16;25;320;211;109;263.0;170.0;70.0;82.0;635.0;825.0;269
6752;Oldebroek;2010;21840;5623;13069;3148;20672;620;207;413;548;314;234;57;29;28;41;20;21;61;24;37;54;20;34;335;221;114;254.0;176.0;74.0;75.0;650.0;822.0;269
6753;Oldebroek;2011;21750;5489;13048;3213;20504;648;216;432;598;334;264;68;32;36;47;21;26;65;32;33;58;20;38;360;229;131;251.0;173.0;81.0;82.0;710.0;832.0;269
6754;Oldebroek;2012;21707;5409;12968;3330;20373;676;225;451;658;374;284;70;37;33;47;22;25;85;39;46;66;27;39;390;249;141;249.0;179.0;80.0;79.0;684.0;847.0;269
6755;Oldebroek;2013;21616;5321;12863;3432;20216;689;228;461;711;396;315;85;42;43;57;25;32;93;39;54;75;29;46;401;261;140;245.0;183.0;109.0;80.0;635.0;866.0;269
6756;Oldebroek;2014;21478;5230;12762;3486;20005;705;230;475;768;436;332;89;51;38;68;34;34;109;49;60;81;29;52;421;273;148;239.0;188.0;75.0;76.0;726.0;825.0;269
6757;Oldebroek;2015;21430;5144;12694;3592;19904;729;240;489;797;441;356;95;52;43;68;32;36;122;50;72;79;27;52;433;280;153;236.0;188.0;81.0;76.0;750.0;825.0;269
6758;Oldebroek;2016;21411;5086;12663;3662;19803;748;252;496;860;453;407;97;52;45;84;43;41;142;55;87;92;24;68;445;279;166;240.0;189.0;80.0;78.0;893.0;838.0;269
6759;Oldebroek;2017;21519;5065;12705;3749;19830;781;266;515;908;474;434;112;58;54;90;46;44;155;57;98;94;28;66;457;285;172;247.0;187.0;79.0;84.0;842.0;843.0;269
6760;Oldebroek;2018;21574;5019;12674;3881;19839;796;261;535;939;480;459;115;55;60;94;47;47;155;58;97;105;33;72;470;287;183;253.0;196.0;87.0;83.0;804.0;856.0;269
6761;Oldebroek;2019;21585;4973;12648;3964;19778;826;278;548;981;486;495;124;59;65;96;48;48;165;57;108;116;34;82;480;288;192;246.0;202.0;77.0;78.0;898.0;848.0;269
6762;Oldebroek;2020;21682;4925;12708;4049;19807;857;299;558;1018;505;513;127;60;67;105;56;49;169;54;115;121;37;84;496;298;198;256.0;204.0;81.0;76.0;772.0;873.0;269
6763;Oldebroek;2021;21642;4876;12597;4169;19745;870;303;567;1027;502;525;133;61;72;108;57;51;174;58;116;120;38;82;492;288;204;252.0;211.0;88.0;78.0;779.0;856.0;269
6764;Oldebroek;2022;21619;4840;12515;4264;19667;889;311;578;1063;524;539;138;63;75;112;62;50;187;63;124;132;40;92;494;296;198;257.0;208.0;93.0;74.0;849.0;828.0;269
6765;Oldebroek;2023;21710;4825;12549;4336;19670;909;303;606;1131;553;578;143;65;78;125;65;60;192;71;121;148;42;106;523;310;213;247.0;217.0;95.0;74.0;825.0;850.0;269
6766;Oldebroek;2024;21737;4822;12443;4472;19627;924;319;605;1186;595;591;159;75;84;134;70;64;191;70;121;152;46;106;550;334;216;251.0;219.0;83.0;78.0;770.0;863.0;269
6767;Oldebroek;2025;21684;4776;12337;4571;19546;927;317;610;1211;597;614;153;70;83;126;67;59;204;70;134;163;48;115;565;342;223;;;;;;;269
6768;Oldenzaal;2008;31838;7723;19087;5028;27158;2573;763;1810;2107;1175;932;86;41;45;64;25;39;1281;682;599;58;24;34;618;403;215;343.0;276.0;124.0;136.0;1003.0;994.0;173
6769;Oldenzaal;2009;31905;7691;19039;5175;27189;2558;759;1799;2158;1217;941;105;53;52;69;30;39;1254;674;580;64;26;38;666;434;232;338.0;279.0;102.0;131.0;1038.0;974.0;173
6770;Oldenzaal;2010;32005;7622;19056;5327;27286;2514;728;1786;2205;1249;956;118;64;54;75;35;40;1241;662;579;74;28;46;697;460;237;331.0;292.0;106.0;136.0;1010.0;996.0;173
6771;Oldenzaal;2011;32032;7559;19054;5419;27336;2493;721;1772;2203;1261;942;136;78;58;84;40;44;1200;644;556;76;35;41;707;464;243;325.0;290.0;108.0;118.0;966.0;950.0;173
6772;Oldenzaal;2012;32077;7442;18982;5653;27338;2507;739;1768;2232;1263;969;158;92;66;87;37;50;1177;637;540;95;38;57;715;459;256;319.0;290.0;130.0;121.0;1018.0;1015.0;173
6773;Oldenzaal;2013;32124;7390;18868;5866;27337;2526;758;1768;2261;1285;976;173;103;70;97;43;54;1150;627;523;118;47;71;723;465;258;323.0;303.0;107.0;119.0;988.0;988.0;173
6774;Oldenzaal;2014;32135;7327;18751;6057;27318;2522;766;1756;2295;1298;997;186;110;76;106;47;59;1130;620;510;132;47;85;741;474;267;308.0;298.0;117.0;111.0;1023.0;991.0;173
6775;Oldenzaal;2015;32187;7267;18707;6213;27295;2518;784;1734;2374;1332;1042;211;124;87;113;54;59;1131;619;512;149;47;102;770;488;282;318.0;310.0;111.0;118.0;980.0;1037.0;173
6776;Oldenzaal;2016;32135;7189;18626;6320;27206;2508;795;1713;2421;1358;1063;224;133;91;120;57;63;1105;603;502;162;54;108;810;511;299;323.0;314.0;107.0;108.0;980.0;1035.0;173
6777;Oldenzaal;2017;32093;7111;18561;6421;27130;2507;794;1713;2456;1367;1089;239;136;103;127;60;67;1082;585;497;167;58;109;841;528;313;326.0;310.0;101.0;116.0;977.0;991.0;173
6778;Oldenzaal;2018;32082;7053;18481;6548;27105;2496;805;1691;2481;1376;1105;245;139;106;128;62;66;1075;581;494;180;65;115;853;529;324;318.0;322.0;102.0;106.0;958.0;1032.0;173
6779;Oldenzaal;2019;32003;6961;18402;6640;26995;2474;804;1670;2534;1411;1123;264;152;112;136;66;70;1064;580;484;188;68;120;882;545;337;316.0;324.0;105.0;120.0;857.0;982.0;173
6780;Oldenzaal;2020;31858;6847;18240;6771;26848;2439;794;1645;2571;1432;1139;273;160;113;151;69;82;1044;572;472;195;69;126;908;562;346;322.0;321.0;107.0;102.0;938.0;1006.0;173
6781;Oldenzaal;2021;31799;6792;18112;6895;26771;2420;784;1636;2608;1444;1164;291;167;124;157;70;87;1025;567;458;221;77;144;914;563;351;326.0;342.0;101.0;105.0;950.0;1008.0;173
6782;Oldenzaal;2022;31723;6729;17988;7006;26655;2409;782;1627;2659;1483;1176;295;170;125;173;80;93;1006;559;447;243;89;154;942;585;357;321.0;333.0;115.0;117.0;989.0;999.0;173
6783;Oldenzaal;2023;31705;6633;17977;7095;26610;2392;794;1598;2703;1489;1214;305;176;129;179;83;96;986;545;441;261;94;167;972;591;381;324.0;339.0;112.0;103.0;954.0;1007.0;173
6784;Oldenzaal;2024;31648;6572;17887;7189;26550;2371;795;1576;2727;1513;1214;328;191;137;187;85;102;966;537;429;264;92;172;982;608;374;333.0;339.0;112.0;102.0;941.0;1009.0;173
6785;Oldenzaal;2025;31586;6581;17672;7333;26477;2357;788;1569;2752;1528;1224;339;197;142;196;88;108;960;535;425;274;92;182;983;616;367;;;;;;;173
6786;Olst-Wijhe;2008;17034;4408;9995;2631;15867;666;207;459;501;284;217;33;20;13;23;8;15;201;99;102;21;10;11;223;147;76;159.0;130.0;36.0;75.0;428.0;603.0;1773
6787;Olst-Wijhe;2009;16850;4303;9866;2681;15668;668;200;468;514;292;222;42;25;17;25;10;15;197;98;99;32;15;17;218;144;74;153.0;129.0;40.0;80.0;539.0;578.0;1773
6788;Olst-Wijhe;2010;16795;4214;9829;2752;15591;671;198;473;533;290;243;55;28;27;30;11;19;195;94;101;35;15;20;218;142;76;151.0;129.0;32.0;71.0;446.0;599.0;1773
6789;Olst-Wijhe;2011;16626;4094;9702;2830;15400;672;203;469;554;291;263;62;35;27;32;9;23;200;97;103;47;17;30;213;133;80;149.0;133.0;32.0;68.0;558.0;581.0;1773
6790;Olst-Wijhe;2012;16584;4020;9575;2989;15320;681;208;473;583;302;281;75;38;37;35;13;22;198;97;101;56;23;33;219;131;88;149.0;138.0;38.0;72.0;463.0;597.0;1773
6791;Olst-Wijhe;2013;16427;3933;9380;3114;15137;692;213;479;598;311;287;85;44;41;42;16;26;189;95;94;66;25;41;216;131;85;144.0;141.0;37.0;66.0;537.0;590.0;1773
6792;Olst-Wijhe;2014;16350;3820;9307;3223;15042;694;212;482;614;320;294;86;46;40;44;16;28;187;93;94;75;31;44;222;134;88;139.0;142.0;35.0;62.0;562.0;597.0;1773
6793;Olst-Wijhe;2015;16287;3717;9257;3313;14948;706;219;487;633;332;301;90;45;45;51;21;30;191;95;96;73;34;39;228;137;91;141.0;140.0;41.0;67.0;456.0;593.0;1773
6794;Olst-Wijhe;2016;16126;3578;9144;3404;14793;694;218;476;639;344;295;93;48;45;54;25;29;194;98;96;76;32;44;222;141;81;138.0;145.0;34.0;62.0;554.0;595.0;1773
6795;Olst-Wijhe;2017;16050;3494;9059;3497;14685;691;208;483;674;359;315;97;50;47;58;26;32;199;97;102;85;41;44;235;145;90;142.0;147.0;32.0;58.0;502.0;609.0;1773
6796;Olst-Wijhe;2018;15913;3387;8945;3581;14570;669;201;468;674;359;315;102;50;52;55;25;30;194;99;95;88;42;46;235;143;92;140.0;148.0;30.0;62.0;574.0;592.0;1773
6797;Olst-Wijhe;2019;15856;3282;8889;3685;14484;660;200;460;712;380;332;110;54;56;63;29;34;193;99;94;108;49;59;238;149;89;142.0;155.0;40.0;60.0;499.0;617.0;1773
6798;Olst-Wijhe;2020;15706;3183;8771;3752;14325;661;206;455;720;372;348;120;56;64;67;30;37;196;103;93;119;51;68;218;132;86;144.0;153.0;30.0;62.0;481.0;596.0;1773
6799;Olst-Wijhe;2021;15550;3087;8620;3843;14142;665;206;459;743;379;364;123;58;65;78;34;44;198;102;96;129;56;73;215;129;86;139.0;155.0;29.0;54.0;465.0;598.0;1773
6800;Olst-Wijhe;2022;15377;2976;8492;3909;13962;658;203;455;757;387;370;131;62;69;80;34;46;203;103;100;129;53;76;214;135;79;141.0;160.0;37.0;58.0;561.0;593.0;1773
6801;Olst-Wijhe;2023;15306;2934;8368;4004;13890;644;209;435;772;385;387;135;64;71;82;34;48;201;102;99;131;52;79;223;133;90;144.0;159.0;35.0;55.0;650.0;581.0;1773
6802;Olst-Wijhe;2024;15342;2910;8335;4097;13873;656;216;440;813;399;414;130;59;71;83;33;50;215;105;110;139;55;84;246;147;99;144.0;167.0;37.0;55.0;471.0;595.0;1773
6803;Olst-Wijhe;2025;15182;2832;8177;4173;13713;654;212;442;815;414;401;130;65;65;79;31;48;212;109;103;145;56;89;249;153;96;;;;;;;1773
6804;Ommen;2008;17154;4122;10242;2790;16224;560;207;353;370;221;149;17;10;7;16;6;10;43;21;22;15;11;4;279;173;106;176.0;159.0;42.0;56.0;534.0;671.0;175
6805;Ommen;2009;17020;4021;10154;2845;16048;563;207;356;409;253;156;27;17;10;20;9;11;55;31;24;21;16;5;286;180;106;172.0;161.0;39.0;54.0;576.0;638.0;175
6806;Ommen;2010;16956;3945;10105;2906;15962;552;200;352;442;279;163;29;20;9;23;10;13;64;34;30;30;20;10;296;195;101;174.0;163.0;42.0;53.0;532.0;664.0;175
6807;Ommen;2011;16827;3826;10048;2953;15795;547;192;355;485;296;189;36;22;14;23;9;14;72;38;34;38;21;17;316;206;110;172.0;162.0;41.0;53.0;476.0;628.0;175
6808;Ommen;2012;16673;3689;9911;3073;15591;566;195;371;516;318;198;40;27;13;24;10;14;87;44;43;39;25;14;326;212;114;166.0;163.0;47.0;49.0;633.0;669.0;175
6809;Ommen;2013;16640;3653;9803;3184;15513;574;199;375;553;330;223;47;30;17;25;9;16;89;42;47;51;28;23;341;221;120;167.0;163.0;44.0;50.0;547.0;671.0;175
6810;Ommen;2014;16517;3593;9646;3278;15353;579;200;379;585;351;234;52;35;17;31;11;20;104;51;53;56;28;28;342;226;116;167.0;163.0;44.0;51.0;599.0;642.0;175
6811;Ommen;2015;16473;3515;9588;3370;15268;582;201;381;623;362;261;62;40;22;32;10;22;112;54;58;60;29;31;357;229;128;170.0;169.0;43.0;51.0;566.0;643.0;175
6812;Ommen;2016;16391;3483;9463;3445;15172;571;197;374;648;368;280;64;40;24;35;9;26;122;64;58;65;30;35;362;225;137;167.0;171.0;47.0;54.0;601.0;664.0;175
6813;Ommen;2017;16318;3443;9374;3501;15080;568;188;380;670;376;294;72;41;31;33;8;25;133;69;64;69;31;38;363;227;136;164.0;168.0;46.0;50.0;628.0;647.0;175
6814;Ommen;2018;16292;3390;9333;3569;15011;570;184;386;711;400;311;80;47;33;40;9;31;144;76;68;72;31;41;375;237;138;160.0;171.0;48.0;50.0;633.0;656.0;175
6815;Ommen;2019;16259;3350;9256;3653;14927;600;194;406;732;404;328;82;48;34;41;10;31;146;76;70;76;32;44;387;238;149;164.0;171.0;48.0;50.0;598.0;645.0;175
6816;Ommen;2020;16204;3320;9149;3735;14826;615;196;419;763;415;348;85;51;34;42;12;30;163;80;83;77;34;43;396;238;158;162.0;172.0;38.0;44.0;624.0;624.0;175
6817;Ommen;2021;16191;3268;9115;3808;14775;615;199;416;801;440;361;97;60;37;39;10;29;181;90;91;81;37;44;403;243;160;166.0;185.0;44.0;54.0;667.0;635.0;175
6818;Ommen;2022;16196;3242;9044;3910;14735;633;219;414;828;446;382;101;61;40;42;13;29;190;89;101;85;36;49;410;247;163;163.0;179.0;43.0;50.0;617.0;671.0;175
6819;Ommen;2023;16122;3164;8983;3975;14624;636;211;425;862;470;392;107;69;38;45;13;32;193;92;101;91;36;55;426;260;166;168.0;182.0;40.0;48.0;659.0;645.0;175
6820;Ommen;2024;16117;3163;8870;4084;14567;649;210;439;901;489;412;110;69;41;46;11;35;207;99;108;102;40;62;436;270;166;167.0;190.0;43.0;48.0;644.0;644.0;175
6821;Ommen;2025;16091;3133;8816;4142;14512;651;210;441;928;498;430;114;66;48;50;12;38;223;103;120;104;42;62;437;275;162;;;;;;;175
6822;Onderbanken;2008;8263;1860;4983;1420;6489;1536;390;1146;238;139;99;25;14;11;8;4;4;19;8;11;76;37;39;110;76;34;55.0;74.0;51.0;71.0;357.0;398.0;881
6823;Onderbanken;2009;8184;1775;4953;1456;6457;1481;379;1102;246;140;106;23;13;10;11;6;5;22;9;13;78;36;42;112;76;36;51.0;78.0;53.0;67.0;347.0;380.0;881
6824;Onderbanken;2010;8111;1706;4906;1499;6399;1430;368;1062;282;156;126;25;14;11;16;9;7;25;12;13;84;36;48;132;85;47;53.0;81.0;51.0;67.0;442.0;405.0;881
6825;Onderbanken;2011;8105;1651;4917;1537;6449;1377;353;1024;279;148;131;27;14;13;12;6;6;30;15;15;84;36;48;126;77;49;53.0;81.0;48.0;69.0;343.0;401.0;881
6826;Onderbanken;2012;7998;1579;4844;1575;6396;1324;350;974;278;146;132;24;14;10;17;7;10;29;15;14;84;35;49;124;75;49;54.0;87.0;52.0;60.0;458.0;403.0;881
6827;Onderbanken;2013;8013;1561;4833;1619;6428;1293;345;948;292;149;143;23;15;8;19;8;11;37;16;21;87;34;53;126;76;50;54.0;86.0;54.0;59.0;446.0;406.0;881
6828;Onderbanken;2014;8015;1553;4797;1665;6438;1265;339;926;312;158;154;25;16;9;22;10;12;38;15;23;89;33;56;138;84;54;58.0;84.0;63.0;57.0;412.0;414.0;881
6829;Onderbanken;2015;7994;1509;4772;1713;6433;1241;342;899;320;163;157;27;18;9;21;10;11;45;18;27;92;36;56;135;81;54;57.0;84.0;50.0;58.0;478.0;419.0;881
6830;Onderbanken;2016;8020;1485;4768;1767;6454;1223;338;885;343;179;164;28;19;9;26;13;13;47;21;26;90;33;57;152;93;59;59.0;90.0;49.0;61.0;499.0;422.0;881
6831;Onderbanken;2017;8055;1467;4781;1807;6518;1186;329;857;351;180;171;30;20;10;24;11;13;49;19;30;92;33;59;156;97;59;64.0;93.0;42.0;52.0;463.0;436.0;881
6832;Onderbanken;2018;8044;1457;4745;1842;6530;1139;318;821;375;179;196;31;20;11;29;14;15;54;20;34;96;31;65;165;94;71;59.0;92.0;42.0;53.0;404.0;420.0;881
6833;Onderbanken;2019;7985;1415;4682;1888;6489;1114;317;797;382;186;196;38;23;15;34;16;18;48;17;31;88;31;57;174;99;75;60.0;93.0;50.0;51.0;464.0;419.0;881
6834;Onderbanken;2020;7997;1400;4688;1909;6513;1099;317;782;385;187;198;33;21;12;31;13;18;53;19;34;89;32;57;179;102;77;65.0;92.0;43.0;53.0;439.0;411.0;881
6835;Onderbanken;2021;7989;1362;4662;1965;6520;1077;306;771;392;187;205;37;24;13;32;14;18;60;21;39;87;31;56;176;97;79;66.0;95.0;60.0;52.0;442.0;425.0;881
6836;Onderbanken;2022;7992;1379;4602;2011;6532;1063;302;761;397;197;200;39;26;13;34;14;20;56;19;37;85;31;54;183;107;76;67.0;101.0;46.0;52.0;489.0;416.0;881
6837;Onderbanken;2023;8026;1364;4596;2066;6556;1046;308;738;424;204;220;42;28;14;37;13;24;60;21;39;92;31;61;193;111;82;69.0;102.0;42.0;51.0;495.0;401.0;881
6838;Onderbanken;2024;8079;1387;4555;2137;6605;1037;318;719;437;212;225;40;27;13;33;13;20;71;26;45;96;31;65;197;115;82;73.0;104.0;44.0;49.0;506.0;427.0;881
6839;Onderbanken;2025;8123;1403;4552;2168;6653;1022;305;717;448;213;235;44;28;16;37;15;22;73;26;47;106;37;69;188;107;81;;;;;;;881
6840;Oosterhout;2008;53703;12685;32603;8415;44897;4317;1557;2760;4489;2422;2067;367;201;166;252;134;118;1462;757;705;1173;515;658;1235;815;420;528.0;450.0;238.0;287.0;1823.0;1450.0;826
6841;Oosterhout;2009;54112;12632;32781;8699;45252;4355;1573;2782;4505;2405;2100;368;202;166;257;138;119;1461;753;708;1179;510;669;1240;802;438;521.0;466.0;237.0;283.0;1826.0;1564.0;826
6842;Oosterhout;2010;54391;12538;32836;9017;45518;4340;1556;2784;4533;2434;2099;376;213;163;269;145;124;1421;737;684;1169;501;668;1298;838;460;526.0;487.0;252.0;281.0;1827.0;1569.0;826
6843;Oosterhout;2011;54663;12395;32953;9315;45707;4353;1576;2777;4603;2474;2129;394;220;174;281;149;132;1417;750;667;1176;503;673;1335;852;483;531.0;495.0;254.0;277.0;1781.0;1693.0;826
6844;Oosterhout;2012;54769;12237;32768;9764;45834;4322;1564;2758;4613;2476;2137;414;226;188;285;155;130;1398;747;651;1163;504;659;1353;844;509;525.0;501.0;251.0;275.0;1768.0;1642.0;826
6845;Oosterhout;2013;54897;12073;32603;10221;45927;4362;1581;2781;4608;2484;2124;425;235;190;295;158;137;1370;741;629;1145;498;647;1373;852;521;529.0;513.0;259.0;258.0;1828.0;1661.0;826
6846;Oosterhout;2014;55090;12001;32470;10619;46076;4363;1590;2773;4651;2516;2135;445;245;200;295;160;135;1371;742;629;1138;500;638;1402;869;533;530.0;534.0;245.0;264.0;1774.0;1652.0;826
6847;Oosterhout;2015;55198;11864;32464;10870;46149;4382;1604;2778;4667;2517;2150;456;252;204;303;164;139;1357;738;619;1133;494;639;1418;869;549;540.0;541.0;241.0;250.0;1727.0;1657.0;826
6848;Oosterhout;2016;55262;11794;32285;11183;46219;4352;1595;2757;4691;2528;2163;473;262;211;310;161;149;1365;736;629;1127;494;633;1416;875;541;532.0;551.0;245.0;250.0;1779.0;1690.0;826
6849;Oosterhout;2017;55331;11785;32092;11454;46237;4366;1622;2744;4728;2554;2174;494;272;222;312;165;147;1361;734;627;1108;490;618;1453;893;560;537.0;549.0;244.0;254.0;1792.0;1661.0;826
6850;Oosterhout;2018;55446;11707;32035;11704;46260;4389;1615;2774;4797;2603;2194;513;281;232;322;177;145;1354;727;627;1110;492;618;1498;926;572;539.0;566.0;236.0;245.0;1819.0;1680.0;826
6851;Oosterhout;2019;55555;11661;31968;11926;46318;4363;1590;2773;4874;2638;2236;533;291;242;329;177;152;1366;724;642;1089;491;598;1557;955;602;543.0;578.0;231.0;245.0;1850.0;1678.0;826
6852;Oosterhout;2020;55684;11610;31961;12113;46363;4406;1608;2798;4915;2657;2258;548;297;251;339;181;158;1383;731;652;1072;485;587;1573;963;610;539.0;582.0;230.0;239.0;1878.0;1683.0;826
6853;Oosterhout;2021;55831;11550;32005;12276;46444;4448;1637;2811;4939;2668;2271;567;302;265;337;179;158;1382;736;646;1065;484;581;1588;967;621;547.0;591.0;228.0;245.0;1814.0;1722.0;826
6854;Oosterhout;2022;55864;11459;31914;12491;46462;4427;1630;2797;4975;2706;2269;603;321;282;354;188;166;1358;733;625;1055;485;570;1605;979;626;548.0;600.0;240.0;233.0;1858.0;1741.0;826
6855;Oosterhout;2023;55937;11449;31851;12637;46478;4409;1627;2782;5050;2744;2306;615;323;292;357;191;166;1378;737;641;1037;482;555;1663;1011;652;542.0;615.0;222.0;240.0;1860.0;1684.0;826
6856;Oosterhout;2024;56023;11434;31743;12846;46481;4420;1629;2791;5122;2783;2339;622;329;293;369;196;173;1391;740;651;1050;487;563;1690;1031;659;555.0;631.0;222.0;231.0;1848.0;1721.0;826
6857;Oosterhout;2025;56070;11419;31599;13052;46464;4455;1633;2822;5151;2782;2369;635;332;303;372;196;176;1409;749;660;1028;474;554;1707;1031;676;;;;;;;826
6858;Oostflakkee;2008;9968;2319;6125;1524;9401;366;117;249;201;117;84;27;11;16;16;7;9;17;8;9;16;9;7;125;82;43;91.0;90.0;20.0;31.0;443.0;386.0;580
6859;Oostflakkee;2009;10017;2297;6163;1557;9398;381;121;260;238;140;98;26;13;13;17;7;10;31;13;18;25;15;10;139;92;47;90.0;84.0;19.0;33.0;383.0;407.0;580
6860;Oostflakkee;2010;9987;2263;6152;1572;9344;389;124;265;254;145;109;26;13;13;20;8;12;31;12;19;31;18;13;146;94;52;88.0;89.0;18.0;32.0;384.0;389.0;580
6861;Oostflakkee;2011;9969;2222;6151;1596;9289;399;129;270;281;150;131;33;14;19;26;10;16;36;14;22;36;20;16;150;92;58;83.0;91.0;24.0;28.0;349.0;416.0;580
6862;Oostflakkee;2012;9890;2163;6072;1655;9171;409;137;272;310;170;140;35;15;20;31;15;16;40;15;25;42;27;15;162;98;64;81.0;93.0;28.0;32.0;351.0;392.0;580
6863;Oostflakkee;2013;9834;2140;5979;1715;9074;432;148;284;328;180;148;43;18;25;34;15;19;43;19;24;45;29;16;163;99;64;81.0;93.0;29.0;34.0;389.0;383.0;580
6864;Oostflakkee;2014;9824;2113;5911;1800;9007;461;164;297;356;193;163;48;20;28;31;14;17;46;20;26;57;34;23;174;105;69;81.0;95.0;18.0;32.0;337.0;386.0;580
6865;Oostflakkee;2015;9748;2057;5838;1853;8906;472;169;303;370;197;173;45;20;25;40;19;21;47;22;25;69;37;32;169;99;70;79.0;91.0;29.0;31.0;370.0;388.0;580
6866;Oostflakkee;2016;9718;2031;5770;1917;8837;484;168;316;397;214;183;49;23;26;41;19;22;61;29;32;69;37;32;177;106;71;74.0;96.0;26.0;30.0;346.0;373.0;580
6867;Oostflakkee;2017;9667;1989;5708;1970;8750;499;175;324;418;225;193;56;27;29;39;20;19;65;29;36;79;41;38;179;108;71;71.0;97.0;22.0;35.0;377.0;382.0;580
6868;Oostflakkee;2018;9623;1947;5655;2021;8674;498;174;324;451;239;212;62;26;36;42;20;22;69;34;35;87;46;41;191;113;78;73.0;97.0;22.0;30.0;352.0;371.0;580
6869;Oostflakkee;2019;9573;1902;5608;2063;8597;502;173;329;474;244;230;67;30;37;46;22;24;73;32;41;95;44;51;193;116;77;72.0;98.0;21.0;28.0;426.0;379.0;580
6870;Oostflakkee;2020;9589;1873;5614;2102;8553;520;179;341;516;262;254;74;31;43;47;21;26;84;38;46;100;48;52;211;124;87;74.0;101.0;22.0;29.0;451.0;376.0;580
6871;Oostflakkee;2021;9632;1854;5623;2155;8532;547;183;364;553;291;262;80;35;45;48;24;24;91;41;50;109;55;54;225;136;89;77.0;102.0;28.0;29.0;375.0;380.0;580
6872;Oostflakkee;2022;9603;1831;5563;2209;8467;550;185;365;586;315;271;88;41;47;55;28;27;92;41;51;124;65;59;227;140;87;80.0;106.0;25.0;30.0;382.0;368.0;580
6873;Oostflakkee;2023;9586;1815;5518;2253;8439;553;193;360;594;309;285;89;42;47;55;25;30;98;41;57;129;67;62;223;134;89;80.0;110.0;19.0;24.0;419.0;369.0;580
6874;Oostflakkee;2024;9601;1803;5507;2291;8416;564;204;360;621;321;300;90;40;50;58;25;33;103;47;56;138;72;66;232;137;95;83.0;112.0;24.0;29.0;353.0;375.0;580
6875;Oostflakkee;2025;9547;1770;5460;2317;8348;573;211;362;626;322;304;91;39;52;56;24;32;109;50;59;139;74;65;231;135;96;;;;;;;580
6876;Oost Gelre;2008;29560;7646;17394;4520;27087;1595;472;1123;878;505;373;75;35;40;40;23;17;169;89;80;231;119;112;363;239;124;296.0;250.0;64.0;105.0;976.0;1087.0;1586
6877;Oost Gelre;2009;29459;7488;17391;4580;26931;1594;481;1113;934;541;393;89;41;48;47;27;20;183;94;89;247;126;121;368;253;115;296.0;251.0;77.0;102.0;1069.0;1106.0;1586
6878;Oost Gelre;2010;29447;7400;17405;4642;26864;1576;479;1097;1007;593;414;98;45;53;56;34;22;197;105;92;254;131;123;402;278;124;290.0;257.0;75.0;106.0;1193.0;1127.0;1586
6879;Oost Gelre;2011;29520;7300;17458;4762;26884;1559;478;1081;1077;639;438;105;50;55;60;35;25;206;110;96;268;137;131;438;307;131;287.0;261.0;77.0;103.0;1059.0;1165.0;1586
6880;Oost Gelre;2012;29417;7125;17374;4918;26755;1531;455;1076;1131;672;459;127;63;64;62;34;28;207;105;102;266;142;124;469;328;141;287.0;267.0;95.0;100.0;1009.0;1160.0;1586
6881;Oost Gelre;2013;29285;6979;17208;5098;26619;1513;459;1054;1153;691;462;133;67;66;74;44;30;202;111;91;261;140;121;483;329;154;282.0;272.0;86.0;102.0;1127.0;1155.0;1586
6882;Oost Gelre;2014;29254;6828;17163;5263;26525;1494;467;1027;1235;724;511;138;68;70;78;47;31;219;117;102;287;155;132;513;337;176;282.0;275.0;77.0;104.0;1185.0;1158.0;1586
6883;Oost Gelre;2015;29262;6725;17137;5400;26509;1462;449;1013;1291;756;535;144;73;71;80;49;31;225;119;106;302;159;143;540;356;184;286.0;284.0;79.0;94.0;1160.0;1193.0;1586
6884;Oost Gelre;2016;29221;6591;17091;5539;26386;1453;447;1006;1382;801;581;166;86;80;87;56;31;245;124;121;314;163;151;570;372;198;285.0;288.0;80.0;99.0;1079.0;1185.0;1586
6885;Oost Gelre;2017;29098;6453;16997;5648;26216;1448;439;1009;1434;841;593;175;90;85;99;63;36;248;128;120;317;167;150;595;393;202;291.0;291.0;81.0;100.0;1169.0;1167.0;1586
6886;Oost Gelre;2018;29085;6429;16888;5768;26151;1447;448;999;1487;861;626;173;91;82;115;71;44;253;127;126;326;165;161;620;407;213;290.0;292.0;76.0;96.0;1149.0;1210.0;1586
6887;Oost Gelre;2019;29008;6279;16854;5875;26046;1406;441;965;1556;902;654;186;103;83;126;72;54;256;126;130;341;178;163;647;423;224;297.0;299.0;85.0;99.0;1170.0;1191.0;1586
6888;Oost Gelre;2020;28974;6209;16778;5987;25959;1408;446;962;1607;903;704;192;104;88;128;70;58;270;130;140;350;180;170;667;419;248;305.0;310.0;96.0;100.0;1104.0;1171.0;1586
6889;Oost Gelre;2021;28901;6130;16696;6075;25838;1408;455;953;1655;940;715;195;106;89;136;81;55;276;136;140;358;184;174;690;433;257;296.0;313.0;75.0;96.0;1085.0;1174.0;1586
6890;Oost Gelre;2022;28778;6030;16542;6206;25710;1392;454;938;1676;942;734;196;106;90;139;83;56;287;135;152;354;180;174;700;438;262;298.0;315.0;77.0;93.0;1185.0;1152.0;1586
6891;Oost Gelre;2023;28782;5976;16488;6318;25647;1408;465;943;1727;971;756;197;104;93;148;89;59;296;140;156;353;182;171;733;456;277;297.0;319.0;78.0;95.0;1134.0;1148.0;1586
6892;Oost Gelre;2024;28731;5936;16339;6456;25552;1391;474;917;1788;1004;784;204;105;99;156;98;58;301;142;159;356;184;172;771;475;296;297.0;325.0;79.0;91.0;1131.0;1143.0;1586
6893;Oost Gelre;2025;28683;5873;16241;6569;25482;1365;477;888;1836;1030;806;209;109;100;163;101;62;303;147;156;375;193;182;786;480;306;;;;;;;1586
6894;Ooststellingwerf;2008;25851;6150;15274;4427;24082;1210;413;797;559;342;217;58;39;19;46;18;28;56;31;25;45;21;24;354;233;121;259.0;254.0;63.0;117.0;1034.0;1119.0;85
6895;Ooststellingwerf;2009;25719;6063;15160;4496;23891;1201;412;789;627;390;237;72;49;23;45;17;28;65;37;28;58;25;33;387;262;125;255.0;255.0;66.0;110.0;1019.0;1140.0;85
6896;Ooststellingwerf;2010;25555;5927;15067;4561;23656;1243;427;816;656;407;249;85;58;27;45;20;25;81;45;36;69;29;40;376;255;121;256.0;258.0;72.0;113.0;1032.0;1121.0;85
6897;Ooststellingwerf;2011;25422;5799;14974;4649;23482;1235;422;813;705;440;265;95;62;33;56;28;28;89;43;46;76;34;42;389;273;116;255.0;265.0;70.0;112.0;1018.0;1125.0;85
6898;Ooststellingwerf;2012;25264;5666;14795;4803;23301;1208;428;780;755;467;288;111;70;41;60;30;30;92;46;46;94;44;50;398;277;121;247.0;258.0;72.0;109.0;1066.0;1140.0;85
6899;Ooststellingwerf;2013;25144;5595;14592;4957;23130;1223;425;798;791;482;309;115;75;40;63;32;31;107;49;58;110;54;56;396;272;124;251.0;262.0;81.0;114.0;986.0;1095.0;85
6900;Ooststellingwerf;2014;24995;5479;14427;5089;22904;1260;432;828;831;502;329;124;79;45;71;40;31;116;52;64;124;61;63;396;270;126;237.0;266.0;81.0;109.0;1091.0;1133.0;85
6901;Ooststellingwerf;2015;24897;5395;14294;5208;22757;1267;434;833;873;516;357;120;77;43;73;40;33;128;58;70;139;71;68;413;270;143;241.0;262.0;97.0;102.0;1017.0;1106.0;85
6902;Ooststellingwerf;2016;24784;5311;14172;5301;22594;1285;470;815;905;515;390;131;81;50;72;39;33;131;57;74;156;74;82;415;264;151;239.0;266.0;67.0;108.0;1028.0;1120.0;85
6903;Ooststellingwerf;2017;24628;5234;13972;5422;22407;1278;468;810;943;522;421;136;79;57;69;34;35;141;63;78;167;78;89;430;268;162;240.0;267.0;71.0;99.0;1131.0;1097.0;85
6904;Ooststellingwerf;2018;24608;5168;13891;5549;22343;1272;470;802;993;545;448;142;84;58;68;37;31;153;66;87;184;92;92;446;266;180;248.0;281.0;78.0;101.0;1135.0;1094.0;85
6905;Ooststellingwerf;2019;24595;5054;13901;5640;22295;1273;471;802;1027;567;460;143;83;60;67;36;31;164;70;94;197;103;94;456;275;181;255.0;277.0;81.0;104.0;1077.0;1141.0;85
6906;Ooststellingwerf;2020;24488;4972;13763;5753;22130;1272;469;803;1086;592;494;150;85;65;76;41;35;172;76;96;212;112;100;476;278;198;248.0;283.0;79.0;96.0;1131.0;1114.0;85
6907;Ooststellingwerf;2021;24455;4909;13681;5865;22026;1277;480;797;1152;634;518;151;85;66;86;50;36;180;79;101;225;119;106;510;301;209;254.0;287.0;71.0;101.0;1166.0;1100.0;85
6908;Ooststellingwerf;2022;24458;4879;13621;5958;21943;1318;489;829;1197;674;523;156;87;69;90;50;40;186;84;102;243;129;114;522;324;198;251.0;289.0;98.0;105.0;1136.0;1107.0;85
6909;Ooststellingwerf;2023;24454;4901;13497;6056;21876;1330;499;831;1248;696;552;162;93;69;96;50;46;183;80;103;266;137;129;541;336;205;257.0;296.0;73.0;105.0;1153.0;1105.0;85
6910;Ooststellingwerf;2024;24435;4879;13416;6140;21757;1379;528;851;1299;711;588;170;96;74;104;55;49;200;83;117;269;145;124;556;332;224;259.0;295.0;81.0;110.0;1150.0;1087.0;85
6911;Ooststellingwerf;2025;24435;4894;13299;6242;21710;1378;526;852;1347;716;631;175;97;78;104;53;51;216;89;127;283;146;137;569;331;238;;;;;;;85
6912;Oostzaan;2008;9246;2293;5535;1418;8235;564;191;373;447;224;223;100;49;51;18;7;11;93;40;53;41;16;25;195;112;83;81.0;79.0;31.0;49.0;306.0;329.0;431
6913;Oostzaan;2009;9209;2248;5509;1452;8174;568;184;384;467;231;236;110;52;58;22;10;12;98;46;52;53;22;31;184;101;83;77.0;79.0;38.0;45.0;263.0;340.0;431
6914;Oostzaan;2010;9124;2197;5458;1469;8058;569;190;379;497;249;248;110;51;59;25;11;14;99;50;49;56;22;34;207;115;92;73.0;80.0;39.0;46.0;365.0;339.0;431
6915;Oostzaan;2011;9138;2158;5496;1484;8036;568;193;375;534;266;268;116;52;64;25;11;14;114;52;62;58;21;37;221;130;91;73.0;80.0;40.0;46.0;295.0;353.0;431
6916;Oostzaan;2012;9070;2112;5403;1555;7948;571;198;373;551;276;275;120;54;66;27;13;14;121;56;65;63;25;38;220;128;92;71.0;82.0;43.0;46.0;340.0;343.0;431
6917;Oostzaan;2013;9054;2075;5355;1624;7889;590;216;374;575;279;296;122;52;70;28;14;14;125;54;71;66;29;37;234;130;104;70.0;83.0;47.0;48.0;334.0;347.0;431
6918;Oostzaan;2014;9028;2020;5339;1669;7822;605;217;388;601;296;305;117;52;65;33;16;17;130;61;69;72;29;43;249;138;111;73.0;83.0;44.0;42.0;267.0;349.0;431
6919;Oostzaan;2015;8941;1968;5258;1715;7724;603;224;379;614;305;309;122;53;69;33;16;17;136;63;73;73;32;41;250;141;109;76.0;83.0;46.0;45.0;401.0;345.0;431
6920;Oostzaan;2016;8992;1968;5264;1760;7730;625;232;393;637;308;329;125;54;71;36;18;18;141;63;78;76;31;45;259;142;117;76.0;88.0;44.0;44.0;333.0;350.0;431
6921;Oostzaan;2017;8965;1914;5267;1784;7677;623;229;394;665;318;347;128;55;73;36;15;21;143;66;77;84;33;51;274;149;125;76.0;84.0;45.0;44.0;310.0;351.0;431
6922;Oostzaan;2018;8917;1854;5254;1809;7607;637;233;404;673;323;350;130;56;74;35;15;20;138;66;72;91;33;58;279;153;126;77.0;88.0;42.0;45.0;363.0;368.0;431
6923;Oostzaan;2019;8900;1814;5270;1816;7568;642;242;400;690;333;357;136;54;82;38;17;21;144;74;70;87;34;53;285;154;131;79.0;89.0;38.0;46.0;423.0;341.0;431
6924;Oostzaan;2020;8965;1798;5307;1860;7590;659;248;411;716;345;371;140;57;83;48;25;23;153;78;75;98;39;59;277;146;131;83.0;89.0;48.0;43.0;346.0;354.0;431
6925;Oostzaan;2021;8957;1777;5285;1895;7553;671;263;408;733;348;385;144;56;88;48;25;23;157;80;77;102;44;58;282;143;139;85.0;93.0;42.0;43.0;310.0;352.0;431
6926;Oostzaan;2022;8908;1739;5239;1930;7477;678;272;406;753;362;391;141;58;83;53;28;25;159;78;81;105;43;62;295;155;140;86.0;93.0;47.0;44.0;331.0;355.0;431
6927;Oostzaan;2023;8881;1700;5214;1967;7417;690;277;413;774;382;392;144;62;82;53;27;26;157;80;77;106;45;61;314;168;146;85.0;95.0;47.0;47.0;393.0;350.0;431
6928;Oostzaan;2024;8915;1695;5218;2002;7411;714;295;419;790;375;415;150;68;82;46;22;24;157;77;80;113;45;68;324;163;161;90.0;96.0;49.0;44.0;367.0;337.0;431
6929;Oostzaan;2025;8946;1703;5197;2046;7408;725;303;422;813;376;437;149;67;82;47;22;25;164;78;86;115;45;70;338;164;174;;;;;;;431
6930;Opmeer;2008;11316;3066;6704;1546;10628;418;129;289;270;152;118;38;17;21;28;15;13;23;13;10;30;12;18;151;95;56;122.0;81.0;29.0;45.0;229.0;396.0;432
6931;Opmeer;2009;11177;2971;6605;1601;10493;423;129;294;261;147;114;36;17;19;28;14;14;19;11;8;30;12;18;148;93;55;115.0;80.0;29.0;41.0;301.0;387.0;432
6932;Opmeer;2010;11116;2896;6546;1674;10416;430;131;299;270;145;125;35;16;19;33;17;16;24;11;13;32;12;20;146;89;57;111.0;88.0;32.0;42.0;431.0;396.0;432
6933;Opmeer;2011;11165;2856;6580;1729;10448;427;128;299;290;154;136;35;14;21;35;19;16;39;19;20;33;11;22;148;91;57;111.0;86.0;30.0;41.0;534.0;400.0;432
6934;Opmeer;2012;11314;2872;6613;1829;10564;437;135;302;313;161;152;42;18;24;39;22;17;48;23;25;32;11;21;152;87;65;110.0;90.0;34.0;40.0;470.0;415.0;432
6935;Opmeer;2013;11385;2817;6645;1923;10586;453;142;311;346;168;178;49;19;30;42;23;19;56;20;36;36;13;23;163;93;70;114.0;93.0;35.0;40.0;512.0;407.0;432
6936;Opmeer;2014;11506;2765;6733;2008;10655;471;150;321;380;179;201;53;18;35;38;21;17;66;24;42;41;14;27;182;102;80;114.0;96.0;36.0;42.0;414.0;429.0;432
6937;Opmeer;2015;11505;2711;6710;2084;10626;467;148;319;412;191;221;62;21;41;39;23;16;73;27;46;41;16;25;197;104;93;115.0;100.0;35.0;43.0;405.0;418.0;432
6938;Opmeer;2016;11504;2640;6727;2137;10604;464;142;322;436;207;229;68;25;43;39;25;14;80;31;49;41;17;24;208;109;99;116.0;103.0;33.0;41.0;464.0;422.0;432
6939;Opmeer;2017;11555;2602;6745;2208;10620;468;148;320;467;225;242;69;27;42;45;26;19;84;34;50;52;23;29;217;115;102;119.0;99.0;35.0;41.0;423.0;425.0;432
6940;Opmeer;2018;11568;2570;6735;2263;10601;469;151;318;498;241;257;69;28;41;50;31;19;92;36;56;56;23;33;231;123;108;119.0;104.0;33.0;42.0;480.0;428.0;432
6941;Opmeer;2019;11627;2533;6771;2323;10629;476;149;327;522;260;262;67;25;42;50;29;21;98;44;54;61;29;32;246;133;113;123.0;107.0;30.0;44.0;488.0;419.0;432
6942;Opmeer;2020;11698;2537;6786;2375;10679;476;154;322;543;265;278;71;26;45;50;29;21;102;44;58;66;31;35;254;135;119;126.0;109.0;37.0;43.0;452.0;433.0;432
6943;Opmeer;2021;11729;2500;6810;2419;10668;496;176;320;565;269;296;72;27;45;52;27;25;113;46;67;69;33;36;259;136;123;128.0;112.0;37.0;43.0;408.0;437.0;432
6944;Opmeer;2022;11711;2467;6741;2503;10639;516;180;336;556;267;289;69;24;45;47;24;23;117;49;68;67;31;36;256;139;117;124.0;113.0;38.0;44.0;508.0;441.0;432
6945;Opmeer;2023;11784;2456;6767;2561;10671;530;187;343;583;277;306;75;27;48;52;31;21;117;48;69;74;32;42;265;139;126;125.0;120.0;34.0;42.0;484.0;432.0;432
6946;Opmeer;2024;11834;2457;6782;2595;10669;546;192;354;619;288;331;78;27;51;52;31;21;121;48;73;86;35;51;282;147;135;131.0;124.0;30.0;40.0;437.0;435.0;432
6947;Opmeer;2025;11834;2441;6748;2645;10633;571;199;372;630;297;333;77;31;46;56;33;23;123;49;74;95;39;56;279;145;134;;;;;;;432
6948;Opsterland;2008;29535;7509;17524;4502;27959;1051;327;724;525;280;245;76;32;44;52;27;25;40;20;20;47;20;27;310;181;129;298.0;250.0;69.0;116.0;1266.0;1281.0;86
6949;Opsterland;2009;29530;7393;17497;4640;27891;1067;330;737;572;306;266;89;41;48;63;31;32;51;30;21;58;21;37;311;183;128;292.0;247.0;79.0;113.0;1221.0;1314.0;86
6950;Opsterland;2010;29451;7256;17442;4753;27749;1074;321;753;628;337;291;101;46;55;58;32;26;74;37;37;67;25;42;328;197;131;284.0;254.0;75.0;110.0;1194.0;1302.0;86
6951;Opsterland;2011;29343;7112;17368;4863;27566;1100;330;770;677;373;304;105;50;55;62;37;25;87;40;47;77;30;47;346;216;130;273.0;258.0;77.0;119.0;1150.0;1309.0;86
6952;Opsterland;2012;29161;6959;17138;5064;27350;1106;316;790;705;386;319;101;51;50;63;39;24;103;44;59;93;35;58;345;217;128;262.0;258.0;79.0;109.0;1227.0;1299.0;86
6953;Opsterland;2013;29068;6775;17035;5258;27199;1119;313;806;750;408;342;107;56;51;70;41;29;113;52;61;104;38;66;356;221;135;267.0;262.0;76.0;110.0;1270.0;1282.0;86
6954;Opsterland;2014;29029;6677;16944;5408;27116;1120;315;805;793;426;367;111;56;55;75;42;33;117;56;61;108;38;70;382;234;148;268.0;266.0;73.0;109.0;1180.0;1285.0;86
6955;Opsterland;2015;28892;6503;16869;5520;26904;1145;323;822;843;442;401;120;63;57;86;49;37;134;58;76;119;42;77;384;230;154;272.0;267.0;72.0;107.0;1190.0;1288.0;86
6956;Opsterland;2016;28764;6368;16771;5625;26720;1169;336;833;875;467;408;123;64;59;101;63;38;140;63;77;124;48;76;387;229;158;271.0;260.0;74.0;106.0;1293.0;1295.0;86
6957;Opsterland;2017;28745;6256;16717;5772;26628;1191;343;848;926;491;435;138;73;65;102;64;38;146;67;79;144;49;95;396;238;158;274.0;268.0;82.0;109.0;1249.0;1310.0;86
6958;Opsterland;2018;28665;6160;16594;5911;26497;1186;334;852;982;509;473;144;75;69;110;64;46;150;73;77;155;53;102;423;244;179;280.0;277.0;82.0;106.0;1266.0;1277.0;86
6959;Opsterland;2019;28635;6073;16527;6035;26427;1208;349;859;1000;515;485;143;75;68;113;65;48;160;73;87;162;57;105;422;245;177;285.0;279.0;69.0;108.0;1325.0;1291.0;86
6960;Opsterland;2020;28641;5937;16503;6201;26402;1213;356;857;1026;533;493;150;81;69;111;66;45;162;70;92;160;58;102;443;258;185;286.0;288.0;77.0;103.0;1274.0;1297.0;86
6961;Opsterland;2021;28593;5860;16436;6297;26312;1218;363;855;1063;543;520;169;90;79;115;65;50;174;73;101;157;55;102;448;260;188;286.0;288.0;76.0;105.0;1318.0;1281.0;86
6962;Opsterland;2022;28604;5812;16343;6449;26270;1216;362;854;1118;553;565;186;96;90;114;66;48;183;75;108;167;59;108;468;257;211;292.0;292.0;69.0;100.0;1189.0;1275.0;86
6963;Opsterland;2023;28490;5726;16196;6568;26114;1232;367;865;1144;565;579;190;101;89;116;68;48;195;81;114;171;64;107;472;251;221;288.0;299.0;77.0;99.0;1382.0;1292.0;86
6964;Opsterland;2024;28551;5718;16116;6717;26110;1253;384;869;1188;585;603;201;107;94;123;75;48;206;86;120;177;62;115;481;255;226;294.0;303.0;75.0;110.0;1273.0;1287.0;86
6965;Opsterland;2025;28500;5677;15993;6830;26015;1270;388;882;1215;598;617;197;108;89;131;75;56;209;90;119;181;65;116;497;260;237;;;;;;;86
6966;Oss;2008;76155;18676;46104;11375;63612;5708;2029;3679;6835;3883;2952;637;341;296;233;128;105;3880;2048;1832;406;209;197;1679;1157;522;782.0;596.0;260.0;370.0;1938.0;2177.0;828
6967;Oss;2009;76002;18526;45833;11643;63442;5683;2024;3659;6877;3899;2978;640;343;297;253;143;110;3824;2015;1809;452;225;227;1708;1173;535;762.0;608.0;287.0;368.0;2053.0;2198.0;828
6968;Oss;2010;75936;18407;45612;11917;63339;5672;2066;3606;6925;3918;3007;656;358;298;270;153;117;3753;1983;1770;509;250;259;1737;1174;563;756.0;617.0;299.0;348.0;2098.0;2256.0;828
6969;Oss;2011;75878;18235;45377;12266;63208;5686;2105;3581;6984;3939;3045;685;367;318;293;172;121;3698;1960;1738;533;247;286;1775;1193;582;738.0;644.0;295.0;340.0;2124.0;2211.0;828
6970;Oss;2012;75849;18091;45002;12756;63075;5699;2137;3562;7075;4002;3073;707;383;324;306;182;124;3653;1947;1706;578;262;316;1831;1228;603;740.0;660.0;311.0;341.0;2359.0;2248.0;828
6971;Oss;2013;76023;17958;44817;13248;63144;5740;2195;3545;7139;4021;3118;732;390;342;324;192;132;3623;1938;1685;601;266;335;1859;1235;624;718.0;678.0;292.0;338.0;2563.0;2294.0;828
6972;Oss;2014;76292;17917;44692;13683;63279;5772;2248;3524;7241;4096;3145;742;401;341;339;204;135;3604;1935;1669;636;287;349;1920;1269;651;724.0;687.0;309.0;321.0;2340.0;2322.0;828
6973;Oss;2015;76344;17739;44570;14035;63189;5828;2284;3544;7327;4161;3166;770;413;357;359;213;146;3567;1929;1638;672;303;369;1959;1303;656;725.0;695.0;305.0;327.0;2508.0;2360.0;828
6974;Oss;2016;76513;17600;44549;14364;63278;5855;2290;3565;7380;4183;3197;811;429;382;362;211;151;3485;1897;1588;723;321;402;1999;1325;674;738.0;713.0;291.0;323.0;2385.0;2375.0;828
6975;Oss;2017;76527;17463;44376;14688;63227;5867;2312;3555;7433;4225;3208;821;445;376;379;228;151;3425;1878;1547;779;344;435;2029;1330;699;745.0;724.0;290.0;311.0;2357.0;2379.0;828
6976;Oss;2018;76511;17233;44213;15065;63125;5855;2349;3506;7531;4269;3262;840;455;385;393;241;152;3377;1862;1515;832;354;478;2089;1357;732;739.0;738.0;306.0;308.0;2578.0;2425.0;828
6977;Oss;2019;76673;17105;44241;15327;63128;5927;2396;3531;7618;4298;3320;860;467;393;414;253;161;3339;1847;1492;892;376;516;2113;1355;758;758.0;737.0;292.0;313.0;2478.0;2423.0;828
6978;Oss;2020;76733;16872;44222;15639;63104;5938;2427;3511;7691;4333;3358;874;478;396;439;263;176;3293;1819;1474;934;400;534;2151;1373;778;770.0;749.0;305.0;306.0;2531.0;2452.0;828
6979;Oss;2021;76844;16722;44178;15944;63081;5956;2451;3505;7807;4386;3421;893;490;403;453;271;182;3243;1802;1441;991;419;572;2227;1404;823;773.0;757.0;295.0;313.0;2552.0;2428.0;828
6980;Oss;2022;76976;16613;44134;16229;63119;5949;2477;3472;7908;4430;3478;910;493;417;476;288;188;3207;1778;1429;1009;429;580;2306;1442;864;795.0;772.0;305.0;313.0;2492.0;2450.0;828
6981;Oss;2023;77039;16468;44029;16542;63071;5969;2495;3474;7999;4509;3490;953;520;433;508;302;206;3140;1760;1380;1039;446;593;2359;1481;878;793.0;783.0;279.0;303.0;2459.0;2436.0;828
6982;Oss;2024;77056;16307;43900;16849;62953;5991;2516;3475;8112;4555;3557;977;533;444;525;311;214;3117;1754;1363;1095;462;633;2398;1495;903;793.0;797.0;299.0;295.0;2579.0;2422.0;828
6983;Oss;2025;77222;16352;43682;17188;63006;6011;2563;3448;8205;4595;3610;986;546;440;526;314;212;3091;1747;1344;1141;474;667;2461;1514;947;;;;;;;828
6984;Oud-Beijerland;2008;23736;6137;14409;3190;21488;1362;444;918;886;476;410;187;93;94;82;29;53;52;25;27;118;60;58;447;269;178;242.0;199.0;58.0;90.0;661.0;833.0;584
6985;Oud-Beijerland;2009;23576;6005;14297;3274;21289;1359;450;909;928;488;440;196;94;102;80;30;50;73;35;38;125;62;63;454;267;187;231.0;192.0;63.0;86.0;665.0;841.0;584
6986;Oud-Beijerland;2010;23417;5867;14203;3347;21073;1374;466;908;970;506;464;203;96;107;81;28;53;88;41;47;133;62;71;465;279;186;224.0;195.0;63.0;87.0;670.0;820.0;584
6987;Oud-Beijerland;2011;23275;5736;14141;3398;20896;1370;450;920;1009;537;472;208;101;107;88;34;54;95;43;52;136;67;69;482;292;190;218.0;194.0;73.0;86.0;762.0;824.0;584
6988;Oud-Beijerland;2012;23226;5624;13976;3626;20797;1375;458;917;1054;543;511;209;100;109;93;34;59;105;44;61;147;71;76;500;294;206;223.0;199.0;69.0;79.0;749.0;800.0;584
6989;Oud-Beijerland;2013;23191;5528;13857;3806;20663;1419;484;935;1109;571;538;213;104;109;101;37;64;122;52;70;154;73;81;519;305;214;213.0;200.0;62.0;79.0;771.0;793.0;584
6990;Oud-Beijerland;2014;23167;5439;13757;3971;20583;1436;500;936;1148;581;567;224;110;114;106;39;67;127;50;77;159;74;85;532;308;224;214.0;207.0;63.0;82.0;797.0;821.0;584
6991;Oud-Beijerland;2015;23134;5337;13664;4133;20516;1443;500;943;1175;595;580;223;111;112;107;41;66;133;50;83;164;76;88;548;317;231;213.0;205.0;71.0;78.0;661.0;813.0;584
6992;Oud-Beijerland;2016;22986;5221;13472;4293;20323;1449;516;933;1214;603;611;231;105;126;104;40;64;144;56;88;178;84;94;557;318;239;208.0;214.0;61.0;76.0;784.0;791.0;584
6993;Oud-Beijerland;2017;22961;5124;13447;4390;20260;1456;506;950;1245;624;621;228;105;123;110;41;69;152;63;89;182;85;97;573;330;243;208.0;216.0;61.0;74.0;786.0;785.0;584
6994;Oud-Beijerland;2018;22946;5064;13396;4486;20184;1469;518;951;1293;630;663;239;106;133;111;41;70;169;66;103;190;84;106;584;333;251;209.0;219.0;61.0;79.0;759.0;778.0;584
6995;Oud-Beijerland;2019;22902;4980;13322;4600;20070;1494;526;968;1338;647;691;252;112;140;106;41;65;180;65;115;193;80;113;607;349;258;206.0;223.0;62.0;83.0;788.0;787.0;584
6996;Oud-Beijerland;2020;22868;4880;13265;4723;20009;1505;517;988;1354;645;709;248;106;142;112;40;72;190;75;115;195;80;115;609;344;265;208.0;222.0;58.0;76.0;721.0;800.0;584
6997;Oud-Beijerland;2021;22761;4788;13138;4835;19860;1483;509;974;1418;667;751;256;109;147;125;44;81;201;80;121;209;82;127;627;352;275;212.0;230.0;56.0;73.0;829.0;792.0;584
6998;Oud-Beijerland;2022;22764;4723;13098;4943;19790;1494;520;974;1480;687;793;269;105;164;133;50;83;209;82;127;218;84;134;651;366;285;219.0;230.0;65.0;75.0;787.0;796.0;584
6999;Oud-Beijerland;2023;22736;4674;12991;5071;19713;1514;524;990;1509;703;806;275;112;163;135;49;86;221;90;131;222;85;137;656;367;289;211.0;237.0;55.0;74.0;686.0;782.0;584
7000;Oud-Beijerland;2024;22597;4570;12860;5167;19539;1514;536;978;1544;718;826;267;108;159;146;57;89;227;91;136;237;88;149;667;374;293;209.0;238.0;60.0;73.0;751.0;778.0;584
7001;Oud-Beijerland;2025;22530;4489;12732;5309;19430;1519;531;988;1581;726;855;266;107;159;150;61;89;237;95;142;253;86;167;675;377;298;;;;;;;584
7002;Ouder-Amstel;2008;13127;3207;7857;2063;10577;1412;603;809;1138;644;494;391;217;174;79;39;40;78;44;34;95;34;61;495;310;185;125.0;114.0;94.0;100.0;591.0;677.0;437
7003;Ouder-Amstel;2009;13050;3131;7839;2080;10448;1448;619;829;1154;643;511;383;216;167;78;41;37;85;41;44;104;37;67;504;308;196;122.0;115.0;89.0;101.0;579.0;683.0;437
7004;Ouder-Amstel;2010;12943;3062;7746;2135;10307;1470;634;836;1166;645;521;378;213;165;78;39;39;81;41;40;113;42;71;516;310;206;118.0;111.0;100.0;95.0;643.0;661.0;437
7005;Ouder-Amstel;2011;12937;3022;7756;2159;10223;1495;668;827;1219;664;555;384;212;172;84;39;45;92;46;46;123;43;80;536;324;212;117.0;112.0;105.0;94.0;701.0;677.0;437
7006;Ouder-Amstel;2012;12980;3010;7731;2239;10188;1525;690;835;1267;688;579;384;213;171;86;39;47;99;48;51;131;45;86;567;343;224;118.0;112.0;101.0;103.0;639.0;671.0;437
7007;Ouder-Amstel;2013;12953;2938;7670;2345;10128;1538;719;819;1287;696;591;378;208;170;83;38;45;107;51;56;148;52;96;571;347;224;117.0;112.0;108.0;101.0;739.0;681.0;437
7008;Ouder-Amstel;2014;13024;2919;7671;2434;10119;1584;752;832;1321;716;605;391;216;175;96;45;51;107;50;57;145;49;96;582;356;226;118.0;118.0;99.0;101.0;694.0;685.0;437
7009;Ouder-Amstel;2015;13036;2878;7646;2512;10096;1606;781;825;1334;716;618;389;210;179;98;47;51;115;55;60;164;56;108;568;348;220;124.0;117.0;93.0;99.0;603.0;639.0;437
7010;Ouder-Amstel;2016;13002;2855;7561;2586;10030;1613;773;840;1359;734;625;395;216;179;96;49;47;125;62;63;170;59;111;573;348;225;127.0;116.0;96.0;93.0;706.0;658.0;437
7011;Ouder-Amstel;2017;13065;2844;7602;2619;10037;1636;792;844;1392;733;659;400;212;188;99;49;50;133;67;66;170;57;113;590;348;242;131.0;117.0;97.0;89.0;767.0;665.0;437
7012;Ouder-Amstel;2018;13190;2856;7653;2681;10086;1691;838;853;1413;733;680;415;219;196;105;54;51;132;65;67;171;56;115;590;339;251;135.0;119.0;97.0;95.0;704.0;686.0;437
7013;Ouder-Amstel;2019;13226;2864;7654;2708;10030;1734;853;881;1462;739;723;416;213;203;111;59;52;143;69;74;176;57;119;616;341;275;135.0;122.0;100.0;95.0;602.0;666.0;437
7014;Ouder-Amstel;2020;13181;2830;7560;2791;9951;1777;884;893;1453;735;718;405;207;198;119;68;51;141;66;75;176;56;120;612;338;274;138.0;126.0;100.0;104.0;736.0;663.0;437
7015;Ouder-Amstel;2021;13260;2815;7630;2815;9935;1819;909;910;1506;754;752;405;207;198;119;68;51;152;67;85;191;62;129;639;350;289;138.0;124.0;97.0;97.0;758.0;680.0;437
7016;Ouder-Amstel;2022;13353;2824;7648;2881;9934;1865;944;921;1554;763;791;411;209;202;119;64;55;153;67;86;205;66;139;666;357;309;134.0;130.0;111.0;98.0;716.0;677.0;437
7017;Ouder-Amstel;2023;13410;2780;7673;2957;9912;1904;973;931;1594;791;803;410;210;200;128;74;54;164;71;93;204;69;135;688;367;321;142.0;127.0;104.0;102.0;716.0;695.0;437
7018;Ouder-Amstel;2024;13447;2771;7654;3022;9910;1930;986;944;1607;799;808;407;203;204;136;79;57;164;72;92;202;67;135;698;378;320;135.0;131.0;102.0;95.0;718.0;689.0;437
7019;Ouder-Amstel;2025;13488;2729;7705;3054;9885;1970;1018;952;1633;819;814;408;202;206;146;89;57;166;77;89;200;66;134;713;385;328;;;;;;;437
7020;Ouderkerk;2008;7998;2155;4660;1183;7476;292;90;202;230;125;105;31;13;18;10;6;4;13;4;9;37;16;21;139;86;53;96.0;66.0;12.0;27.0;164.0;281.0;644
7021;Ouderkerk;2009;7898;2108;4569;1221;7362;299;93;206;237;126;111;34;15;19;8;5;3;17;5;12;44;19;25;134;82;52;95.0;66.0;15.0;23.0;185.0;290.0;644
7022;Ouderkerk;2010;7815;2073;4489;1253;7248;318;99;219;249;126;123;36;16;20;9;4;5;21;8;13;53;22;31;130;76;54;91.0;69.0;17.0;26.0;242.0;270.0;644
7023;Ouderkerk;2011;7801;2046;4489;1266;7195;346;113;233;260;135;125;41;18;23;11;6;5;19;8;11;56;23;33;133;80;53;89.0;70.0;21.0;27.0;173.0;260.0;644
7024;Ouderkerk;2012;7728;1976;4422;1330;7112;348;107;241;268;134;134;44;18;26;10;5;5;22;9;13;49;23;26;143;79;64;86.0;71.0;23.0;24.0;183.0;250.0;644
7025;Ouderkerk;2013;7676;1963;4322;1391;7033;354;107;247;289;154;135;47;21;26;12;7;5;26;14;12;55;24;31;149;88;61;88.0;72.0;17.0;25.0;165.0;240.0;644
7026;Ouderkerk;2014;7611;1926;4270;1415;6943;369;108;261;299;155;144;49;22;27;17;9;8;30;17;13;55;22;33;148;85;63;82.0;71.0;20.0;23.0;158.0;254.0;644
7027;Ouderkerk;2015;7523;1890;4171;1462;6829;379;116;263;315;158;157;54;23;31;21;11;10;27;14;13;61;23;38;152;87;65;81.0;74.0;17.0;23.0;181.0;245.0;644
7028;Ouderkerk;2016;7461;1845;4112;1504;6772;364;112;252;325;163;162;57;25;32;18;7;11;34;19;15;60;23;37;156;89;67;77.0;75.0;19.0;23.0;114.0;251.0;644
7029;Ouderkerk;2017;7323;1800;4014;1509;6636;358;108;250;329;163;166;55;24;31;17;6;11;38;19;19;64;23;41;155;91;64;78.0;72.0;18.0;21.0;160.0;230.0;644
7030;Ouderkerk;2018;7257;1759;3984;1514;6541;367;106;261;349;175;174;63;25;38;19;6;13;49;25;24;60;24;36;158;95;63;73.0;73.0;18.0;19.0;181.0;234.0;644
7031;Ouderkerk;2019;7203;1719;3943;1541;6448;379;112;267;376;186;190;68;27;41;21;8;13;62;26;36;60;26;34;165;99;66;74.0;74.0;25.0;22.0;163.0;239.0;644
7032;Ouderkerk;2020;7131;1682;3905;1544;6363;382;115;267;386;187;199;72;30;42;25;11;14;63;26;37;65;27;38;161;93;68;73.0;78.0;16.0;22.0;165.0;228.0;644
7033;Ouderkerk;2021;7058;1638;3854;1566;6285;390;121;269;383;182;201;69;29;40;25;12;13;62;25;37;70;28;42;157;88;69;71.0;80.0;17.0;23.0;195.0;232.0;644
7034;Ouderkerk;2022;7007;1587;3817;1603;6212;392;127;265;403;187;216;72;31;41;26;11;15;65;23;42;80;34;46;160;88;72;69.0;79.0;16.0;22.0;159.0;228.0;644
7035;Ouderkerk;2023;6923;1557;3752;1614;6118;386;123;263;419;198;221;79;34;45;28;12;16;65;24;41;83;35;48;164;93;71;67.0;78.0;14.0;22.0;181.0;232.0;644
7036;Ouderkerk;2024;6852;1514;3730;1608;6037;386;123;263;429;200;229;80;34;46;29;11;18;69;27;42;86;35;51;165;93;72;65.0;79.0;15.0;21.0;164.0;227.0;644
7037;Ouderkerk;2025;6772;1481;3665;1626;5956;371;121;250;445;209;236;84;34;50;27;11;16;78;32;46;87;37;50;169;95;74;;;;;;;644
7038;Oudewater;2008;9676;2556;5666;1454;9043;352;114;238;281;166;115;40;17;23;10;4;6;16;7;9;51;28;23;164;110;54;98.0;80.0;28.0;36.0;306.0;313.0;589
7039;Oudewater;2009;9680;2535;5655;1490;8987;361;122;239;332;192;140;48;19;29;15;8;7;21;12;9;62;31;31;186;122;64;94.0;78.0;22.0;37.0;325.0;304.0;589
7040;Oudewater;2010;9703;2499;5677;1527;8963;376;126;250;364;207;157;52;20;32;17;8;9;30;16;14;68;33;35;197;130;67;93.0;81.0;27.0;39.0;321.0;325.0;589
7041;Oudewater;2011;9700;2437;5701;1562;8904;390;129;261;406;228;178;57;25;32;20;10;10;40;21;19;81;40;41;208;132;76;91.0;80.0;29.0;35.0;277.0;336.0;589
7042;Oudewater;2012;9645;2383;5648;1614;8807;400;133;267;438;238;200;68;28;40;23;14;9;47;26;21;83;40;43;217;130;87;95.0;83.0;27.0;34.0;294.0;339.0;589
7043;Oudewater;2013;9606;2328;5601;1677;8707;431;148;283;468;257;211;74;34;40;25;14;11;50;27;23;83;42;41;236;140;96;91.0;82.0;35.0;36.0;276.0;323.0;589
7044;Oudewater;2014;9568;2299;5517;1752;8630;435;150;285;503;274;229;76;37;39;29;16;13;56;26;30;89;46;43;253;149;104;91.0;84.0;32.0;33.0;280.0;322.0;589
7045;Oudewater;2015;9533;2253;5479;1801;8551;475;170;305;507;269;238;80;39;41;31;15;16;63;29;34;94;50;44;239;136;103;95.0;84.0;28.0;32.0;209.0;320.0;589
7046;Oudewater;2016;9430;2184;5414;1832;8435;483;172;311;512;272;240;81;41;40;31;15;16;70;30;40;89;48;41;241;138;103;91.0;85.0;30.0;33.0;212.0;324.0;589
7047;Oudewater;2017;9321;2123;5365;1833;8307;493;178;315;521;273;248;82;40;42;32;16;16;74;31;43;95;50;45;238;136;102;91.0;86.0;29.0;32.0;259.0;307.0;589
7048;Oudewater;2018;9276;2064;5334;1878;8223;503;186;317;550;276;274;85;41;44;34;18;16;85;36;49;99;49;50;247;132;115;88.0;89.0;29.0;33.0;247.0;302.0;589
7049;Oudewater;2019;9216;2013;5298;1905;8126;525;200;325;565;284;281;83;43;40;40;20;20;86;33;53;96;48;48;260;140;120;88.0;85.0;28.0;37.0;270.0;313.0;589
7050;Oudewater;2020;9169;1958;5273;1938;8030;548;200;348;591;289;302;82;44;38;42;19;23;91;37;54;101;48;53;275;141;134;92.0;91.0;36.0;31.0;247.0;314.0;589
7051;Oudewater;2021;9109;1905;5248;1956;7956;549;198;351;604;307;297;84;47;37;41;20;21;89;37;52;101;49;52;289;154;135;89.0;94.0;33.0;32.0;252.0;306.0;589
7052;Oudewater;2022;9051;1862;5225;1964;7862;570;219;351;619;317;302;88;51;37;42;21;21;94;36;58;100;48;52;295;161;134;89.0;94.0;26.0;30.0;289.0;307.0;589
7053;Oudewater;2023;9026;1837;5207;1982;7795;582;227;355;649;328;321;91;52;39;43;23;20;97;35;62;101;45;56;317;173;144;92.0;95.0;32.0;34.0;286.0;316.0;589
7054;Oudewater;2024;8991;1808;5175;2008;7735;575;223;352;681;341;340;93;49;44;44;22;22;101;36;65;104;47;57;339;187;152;92.0;94.0;30.0;27.0;280.0;312.0;589
7055;Oudewater;2025;8961;1782;5136;2043;7689;584;221;363;688;349;339;99;52;47;47;24;23;103;38;65;103;43;60;336;192;144;;;;;;;589
7056;Oude IJsselstreek;2008;39257;9564;23148;6545;34059;2832;824;2008;2366;1333;1033;62;30;32;112;56;56;1638;881;757;81;41;40;473;325;148;350.0;435.0;107.0;162.0;1056.0;1218.0;1509
7057;Oude IJsselstreek;2009;38962;9452;22890;6620;33759;2787;812;1975;2416;1373;1043;90;52;38;119;63;56;1610;873;737;97;48;49;500;337;163;329.0;437.0;108.0;167.0;1148.0;1235.0;1509
7058;Oude IJsselstreek;2010;38710;9308;22726;6676;33528;2753;794;1959;2429;1384;1045;106;65;41;120;66;54;1572;847;725;117;56;61;514;350;164;327.0;437.0;120.0;154.0;1227.0;1272.0;1509
7059;Oude IJsselstreek;2011;38526;9148;22628;6750;33335;2709;789;1920;2482;1412;1070;123;70;53;130;73;57;1542;836;706;135;67;68;552;366;186;320.0;430.0;123.0;150.0;1267.0;1278.0;1509
7060;Oude IJsselstreek;2012;38384;8978;22436;6970;33195;2672;781;1891;2517;1433;1084;138;80;58;138;78;60;1528;839;689;157;74;83;556;362;194;326.0;445.0;127.0;156.0;1221.0;1299.0;1509
7061;Oude IJsselstreek;2013;38162;8816;22195;7151;33004;2618;767;1851;2540;1454;1086;156;86;70;152;91;61;1508;831;677;161;73;88;563;373;190;307.0;441.0;120.0;145.0;1127.0;1319.0;1509
7062;Oude IJsselstreek;2014;37814;8589;21948;7277;32667;2590;763;1827;2557;1464;1093;158;90;68;168;99;69;1478;817;661;181;81;100;572;377;195;315.0;439.0;130.0;144.0;1236.0;1299.0;1509
7063;Oude IJsselstreek;2015;37616;8372;21857;7387;32436;2588;762;1826;2592;1485;1107;177;100;77;170;102;68;1443;813;630;199;85;114;603;385;218;318.0;443.0;108.0;148.0;1254.0;1294.0;1509
7064;Oude IJsselstreek;2016;37414;8184;21695;7535;32221;2577;782;1795;2616;1500;1116;197;111;86;172;105;67;1421;806;615;211;85;126;615;393;222;323.0;444.0;124.0;139.0;1330.0;1297.0;1509
7065;Oude IJsselstreek;2017;37317;8071;21545;7701;32123;2561;771;1790;2633;1501;1132;209;112;97;173;106;67;1397;797;600;236;94;142;618;392;226;320.0;455.0;129.0;140.0;1335.0;1293.0;1509
7066;Oude IJsselstreek;2018;37222;7940;21432;7850;32043;2526;754;1772;2653;1527;1126;228;126;102;177;108;69;1371;797;574;233;95;138;644;401;243;328.0;459.0;111.0;135.0;1365.0;1312.0;1509
7067;Oude IJsselstreek;2019;37125;7799;21337;7989;31907;2534;762;1772;2684;1548;1136;233;130;103;181;107;74;1374;813;561;250;103;147;646;395;251;336.0;460.0;113.0;137.0;1396.0;1310.0;1509
7068;Oude IJsselstreek;2020;37070;7664;21298;8108;31814;2527;770;1757;2729;1587;1142;256;140;116;193;115;78;1350;807;543;256;107;149;674;418;256;345.0;465.0;109.0;129.0;1391.0;1331.0;1509
7069;Oude IJsselstreek;2021;36994;7498;21253;8243;31724;2504;759;1745;2766;1610;1156;253;135;118;212;128;84;1331;811;520;257;108;149;713;428;285;355.0;477.0;103.0;138.0;1378.0;1333.0;1509
7070;Oude IJsselstreek;2022;36888;7408;21135;8345;31587;2494;746;1748;2807;1640;1167;260;140;120;206;127;79;1331;815;516;275;117;158;735;441;294;360.0;473.0;108.0;128.0;1472.0;1344.0;1509
7071;Oude IJsselstreek;2023;36887;7307;21065;8515;31567;2463;750;1713;2857;1639;1218;269;146;123;219;134;85;1323;803;520;301;120;181;745;436;309;368.0;487.0;108.0;131.0;1308.0;1357.0;1509
7072;Oude IJsselstreek;2024;36704;7247;20840;8617;31374;2462;744;1718;2868;1644;1224;273;149;124;225;138;87;1313;797;516;310;129;181;747;431;316;374.0;489.0;115.0;130.0;1396.0;1336.0;1509
7073;Oude IJsselstreek;2025;36637;7223;20676;8738;31256;2464;753;1711;2917;1689;1228;288;161;127;232;139;93;1295;798;497;312;132;180;790;459;331;;;;;;;1509
7074;Overbetuwe;2008;43474;11682;25909;5883;38811;3108;998;2110;1555;846;709;218;78;140;132;61;71;332;166;166;137;62;75;736;479;257;438.0;290.0;130.0;195.0;1861.0;1401.0;1734
7075;Overbetuwe;2009;44020;11709;26165;6146;39124;3138;1024;2114;1758;932;826;260;94;166;146;64;82;357;171;186;174;77;97;821;526;295;441.0;304.0;140.0;202.0;1760.0;1450.0;1734
7076;Overbetuwe;2010;44411;11689;26288;6434;39323;3172;1019;2153;1916;980;936;283;95;188;160;64;96;393;176;217;211;88;123;869;557;312;429.0;316.0;145.0;200.0;1698.0;1481.0;1734
7077;Overbetuwe;2011;44687;11564;26401;6722;39413;3217;1044;2173;2057;1022;1035;294;98;196;173;75;98;438;194;244;241;100;141;911;555;356;434.0;325.0;152.0;197.0;1599.0;1441.0;1734
7078;Overbetuwe;2012;44913;11461;26320;7132;39498;3207;1025;2182;2208;1095;1113;323;113;210;190;84;106;472;208;264;269;110;159;954;580;374;442.0;333.0;169.0;202.0;1497.0;1455.0;1734
7079;Overbetuwe;2013;45034;11360;26157;7517;39452;3209;1044;2165;2373;1163;1210;363;132;231;205;91;114;483;215;268;321;130;191;1001;595;406;433.0;351.0;185.0;194.0;1714.0;1438.0;1734
7080;Overbetuwe;2014;45396;11337;26235;7824;39597;3231;1048;2183;2568;1234;1334;396;143;253;222;95;127;548;233;315;361;144;217;1041;619;422;442.0;358.0;174.0;203.0;1565.0;1466.0;1734
7081;Overbetuwe;2015;45558;11257;26204;8097;39599;3234;1057;2177;2725;1324;1401;404;151;253;236;108;128;564;241;323;393;149;244;1128;675;453;443.0;361.0;174.0;200.0;1564.0;1493.0;1734
7082;Overbetuwe;2016;45693;11142;26158;8393;39557;3259;1076;2183;2877;1383;1494;430;160;270;250;115;135;593;244;349;417;164;253;1187;700;487;449.0;370.0;182.0;197.0;1604.0;1473.0;1734
7083;Overbetuwe;2017;45892;11030;26209;8653;39529;3319;1097;2222;3044;1456;1588;465;179;286;267;125;142;612;260;352;458;183;275;1242;709;533;452.0;383.0;180.0;200.0;1690.0;1513.0;1734
7084;Overbetuwe;2018;46123;10961;26222;8940;39621;3356;1126;2230;3146;1503;1643;480;188;292;290;144;146;642;273;369;473;184;289;1261;714;547;451.0;398.0;189.0;195.0;1738.0;1558.0;1734
7085;Overbetuwe;2019;46357;10893;26260;9204;39684;3341;1114;2227;3332;1579;1753;510;198;312;299;148;151;674;281;393;526;203;323;1323;749;574;459.0;403.0;203.0;200.0;1570.0;1531.0;1734
7086;Overbetuwe;2020;46463;10697;26327;9439;39640;3357;1113;2244;3466;1646;1820;532;212;320;323;164;159;693;284;409;554;209;345;1364;777;587;453.0;414.0;181.0;204.0;1612.0;1563.0;1734
7087;Overbetuwe;2021;46531;10547;26305;9679;39552;3379;1124;2255;3600;1709;1891;548;224;324;348;176;172;716;286;430;578;216;362;1410;807;603;469.0;421.0;193.0;199.0;1706.0;1588.0;1734
7088;Overbetuwe;2022;46693;10483;26296;9914;39507;3387;1128;2259;3799;1791;2008;563;226;337;367;189;178;748;300;448;631;237;394;1490;839;651;459.0;431.0;196.0;206.0;1671.0;1585.0;1734
7089;Overbetuwe;2023;46803;10374;26310;10119;39424;3421;1156;2265;3958;1865;2093;604;247;357;392;199;193;762;316;446;668;245;423;1532;858;674;478.0;437.0;172.0;204.0;1617.0;1560.0;1734
7090;Overbetuwe;2024;46872;10242;26267;10363;39365;3425;1146;2279;4082;1910;2172;636;260;376;404;208;196;785;323;462;682;251;431;1575;868;707;478.0;451.0;198.0;206.0;1564.0;1557.0;1734
7091;Overbetuwe;2025;46904;10217;26080;10607;39248;3444;1158;2286;4212;1953;2259;650;270;380;424;209;215;810;331;479;705;261;444;1623;882;741;;;;;;;1734
7092;Papendrecht;2008;32000;7828;19260;4912;27158;2523;939;1584;2319;1307;1012;465;244;221;225;114;111;352;167;185;316;146;170;961;636;325;353.0;229.0;95.0;139.0;1368.0;1318.0;590
7093;Papendrecht;2009;32137;7825;19201;5111;27288;2509;939;1570;2340;1300;1040;459;233;226;227;112;115;361;171;190;336;154;182;957;630;327;349.0;235.0;99.0;128.0;1257.0;1304.0;590
7094;Papendrecht;2010;32179;7750;19125;5304;27303;2479;932;1547;2397;1329;1068;466;236;230;225;119;106;388;182;206;351;162;189;967;630;337;340.0;242.0;106.0;127.0;1342.0;1220.0;590
7095;Papendrecht;2011;32381;7718;19232;5431;27480;2447;902;1545;2454;1356;1098;471;241;230;216;120;96;410;187;223;375;172;203;982;636;346;341.0;256.0;111.0;120.0;1193.0;1264.0;590
7096;Papendrecht;2012;32390;7642;18978;5770;27457;2430;885;1545;2503;1367;1136;487;245;242;225;126;99;425;190;235;376;167;209;990;639;351;330.0;264.0;97.0;115.0;1211.0;1219.0;590
7097;Papendrecht;2013;32432;7552;18861;6019;27479;2398;866;1532;2555;1383;1172;487;242;245;239;134;105;430;194;236;399;176;223;1000;637;363;328.0;269.0;99.0;121.0;957.0;1217.0;590
7098;Papendrecht;2014;32210;7423;18598;6189;27245;2392;867;1525;2573;1383;1190;477;239;238;237;132;105;457;202;255;411;184;227;991;626;365;316.0;274.0;101.0;120.0;1089.0;1202.0;590
7099;Papendrecht;2015;32123;7338;18429;6356;27149;2363;857;1506;2611;1400;1211;486;235;251;244;137;107;445;199;246;417;189;228;1019;640;379;307.0;281.0;103.0;118.0;1109.0;1172.0;590
7100;Papendrecht;2016;32072;7232;18357;6483;27076;2349;873;1476;2647;1408;1239;503;234;269;242;142;100;446;193;253;434;199;235;1022;640;382;308.0;283.0;106.0;119.0;1043.0;1161.0;590
7101;Papendrecht;2017;31972;7146;18223;6603;26941;2349;861;1488;2682;1414;1268;509;232;277;244;147;97;458;192;266;437;201;236;1034;642;392;312.0;289.0;100.0;116.0;1057.0;1167.0;590
7102;Papendrecht;2018;31871;7110;18062;6699;26793;2338;854;1484;2740;1415;1325;521;227;294;250;145;105;470;199;271;446;207;239;1053;637;416;306.0;297.0;97.0;112.0;1099.0;1184.0;590
7103;Papendrecht;2019;31783;6946;18079;6758;26700;2329;855;1474;2754;1422;1332;531;238;293;257;146;111;466;197;269;459;214;245;1041;627;414;309.0;306.0;90.0;105.0;1137.0;1146.0;590
7104;Papendrecht;2020;31767;6898;18020;6849;26687;2290;847;1443;2790;1434;1356;537;244;293;259;142;117;468;198;270;471;218;253;1055;632;423;306.0;305.0;99.0;107.0;1123.0;1180.0;590
7105;Papendrecht;2021;31705;6758;17979;6968;26565;2273;849;1424;2867;1467;1400;546;243;303;277;150;127;486;201;285;485;227;258;1073;646;427;312.0;312.0;89.0;108.0;1166.0;1160.0;590
7106;Papendrecht;2022;31695;6682;17943;7070;26515;2284;854;1430;2896;1471;1425;537;240;297;271;148;123;490;202;288;514;241;273;1084;640;444;307.0;313.0;96.0;97.0;1149.0;1175.0;590
7107;Papendrecht;2023;31665;6580;17905;7180;26504;2249;831;1418;2912;1482;1430;532;245;287;269;146;123;491;200;291;508;239;269;1112;652;460;312.0;318.0;99.0;104.0;1158.0;1152.0;590
7108;Papendrecht;2024;31664;6540;17815;7309;26456;2267;833;1434;2941;1483;1458;538;248;290;276;148;128;512;207;305;510;236;274;1105;644;461;316.0;312.0;92.0;109.0;1194.0;1205.0;590
7109;Papendrecht;2025;31645;6541;17644;7460;26382;2286;860;1426;2977;1498;1479;550;254;296;276;150;126;512;207;305;518;239;279;1121;648;473;;;;;;;590
7110;Pekela;2008;13310;3092;8056;2162;11932;843;361;482;535;374;161;56;30;26;15;10;5;72;42;30;10;4;6;382;288;94;124.0;140.0;50.0;90.0;665.0;670.0;765
7111;Pekela;2009;13250;3042;7980;2228;11837;844;354;490;569;387;182;58;31;27;19;13;6;73;43;30;16;5;11;403;295;108;123.0;140.0;52.0;88.0;645.0;673.0;765
7112;Pekela;2010;13172;2988;7922;2262;11743;841;361;480;588;390;198;66;40;26;24;15;9;82;46;36;20;9;11;396;280;116;115.0;138.0;64.0;88.0;685.0;677.0;765
7113;Pekela;2011;13133;2952;7866;2315;11668;846;360;486;619;405;214;62;38;24;29;17;12;93;50;43;20;9;11;415;291;124;114.0;143.0;54.0;88.0;639.0;687.0;765
7114;Pekela;2012;13023;2896;7712;2415;11560;817;348;469;646;403;243;72;41;31;30;18;12;98;52;46;28;11;17;418;281;137;113.0;144.0;54.0;85.0;639.0;632.0;765
7115;Pekela;2013;12969;2818;7644;2507;11507;809;338;471;653;393;260;72;41;31;32;17;15;106;54;52;32;13;19;411;268;143;110.0;147.0;55.0;82.0;633.0;640.0;765
7116;Pekela;2014;12899;2777;7536;2586;11413;811;331;480;675;396;279;83;45;38;37;18;19;107;55;52;32;12;20;416;266;150;112.0;148.0;60.0;82.0;670.0;644.0;765
7117;Pekela;2015;12871;2751;7478;2642;11359;801;331;470;711;406;305;87;48;39;37;17;20;122;63;59;38;16;22;427;262;165;110.0;144.0;59.0;81.0;654.0;666.0;765
7118;Pekela;2016;12805;2684;7448;2673;11290;810;331;479;705;404;301;91;50;41;40;19;21;107;57;50;43;17;26;424;261;163;117.0;146.0;53.0;77.0;670.0;634.0;765
7119;Pekela;2017;12790;2665;7374;2751;11224;813;328;485;753;414;339;110;55;55;42;19;23;130;64;66;57;25;32;414;251;163;109.0;150.0;51.0;73.0;641.0;650.0;765
7120;Pekela;2018;12720;2592;7316;2812;11154;811;330;481;755;413;342;110;59;51;45;21;24;143;75;68;56;22;34;401;236;165;112.0;151.0;67.0;72.0;605.0;656.0;765
7121;Pekela;2019;12627;2560;7219;2848;11035;809;329;480;783;424;359;114;61;53;52;24;28;150;80;70;60;25;35;407;234;173;109.0;150.0;47.0;71.0;627.0;662.0;765
7122;Pekela;2020;12527;2493;7137;2897;10907;830;330;500;790;430;360;112;60;52;52;23;29;161;88;73;61;29;32;404;230;174;113.0;153.0;47.0;72.0;634.0;642.0;765
7123;Pekela;2021;12456;2458;7068;2930;10826;820;320;500;810;441;369;114;60;54;59;28;31;176;95;81;64;31;33;397;227;170;111.0;155.0;48.0;69.0;594.0;644.0;765
7124;Pekela;2022;12342;2386;6976;2980;10705;809;321;488;828;439;389;124;66;58;59;28;31;182;94;88;72;32;40;391;219;172;111.0;154.0;50.0;67.0;591.0;604.0;765
7125;Pekela;2023;12270;2348;6925;2997;10607;814;327;487;849;457;392;125;69;56;64;31;33;187;97;90;75;31;44;398;229;169;115.0;158.0;52.0;66.0;637.0;605.0;765
7126;Pekela;2024;12247;2338;6852;3057;10541;834;333;501;872;480;392;122;68;54;68;32;36;193;98;95;73;29;44;416;253;163;111.0;161.0;48.0;66.0;616.0;622.0;765
7127;Pekela;2025;12171;2305;6765;3101;10454;847;343;504;870;472;398;121;68;53;69;34;35;187;92;95;76;32;44;417;246;171;;;;;;;765
7128;Purmerend;2008;78447;19282;48405;10760;60666;6816;2481;4335;10965;6040;4925;3568;1803;1765;745;407;338;1078;514;564;1154;541;613;4420;2775;1645;867.0;670.0;284.0;299.0;2596.0;2423.0;439
7129;Purmerend;2009;78808;19228;48619;10961;60830;6896;2533;4363;11082;6028;5054;3531;1773;1758;739;404;335;1112;529;583;1216;562;654;4484;2760;1724;847.0;676.0;300.0;290.0;2610.0;2424.0;439
7130;Purmerend;2010;79183;19171;48699;11313;61047;6919;2552;4367;11217;6059;5158;3487;1741;1746;738;405;333;1152;556;596;1279;584;695;4561;2773;1788;833.0;685.0;306.0;292.0;2451.0;2511.0;439
7131;Purmerend;2011;79292;19064;48764;11464;60994;6944;2589;4355;11354;6069;5285;3453;1723;1730;744;408;336;1189;552;637;1337;598;739;4631;2788;1843;799.0;715.0;298.0;294.0;2572.0;2498.0;439
7132;Purmerend;2012;79463;18878;48564;12021;60969;6980;2626;4354;11514;6065;5449;3447;1711;1736;759;413;346;1234;554;680;1393;620;773;4681;2767;1914;813.0;712.0;309.0;285.0;2613.0;2488.0;439
7133;Purmerend;2013;79724;18721;48482;12521;61059;7030;2663;4367;11635;6067;5568;3419;1678;1741;764;419;345;1297;592;705;1425;628;797;4730;2750;1980;816.0;729.0;304.0;273.0;2465.0;2513.0;439
7134;Purmerend;2014;79799;18552;48391;12856;61006;7024;2666;4358;11769;6108;5661;3395;1647;1748;765;422;343;1343;609;734;1450;627;823;4816;2803;2013;800.0;735.0;315.0;281.0;2624.0;2462.0;439
7135;Purmerend;2015;80072;18433;48476;13163;61067;7085;2726;4359;11920;6125;5795;3379;1630;1749;776;414;362;1397;611;786;1492;648;844;4876;2822;2054;806.0;736.0;299.0;260.0;2493.0;2491.0;439
7136;Purmerend;2016;80187;18295;48356;13536;61088;7098;2759;4339;12001;6106;5895;3341;1607;1734;763;410;353;1418;611;807;1543;658;885;4936;2820;2116;809.0;754.0;294.0;266.0;2674.0;2459.0;439
7137;Purmerend;2017;80493;18250;48401;13842;61235;7179;2842;4337;12079;6123;5956;3288;1574;1714;767;409;358;1437;621;816;1573;664;909;5014;2855;2159;813.0;766.0;296.0;266.0;2539.0;2496.0;439
7138;Purmerend;2018;80622;18104;48361;14157;61181;7247;2893;4354;12194;6184;6010;3250;1556;1694;770;427;343;1496;641;855;1594;669;925;5084;2891;2193;814.0;773.0;310.0;257.0;2615.0;2494.0;439
7139;Purmerend;2019;80844;18048;48251;14545;61218;7275;2908;4367;12351;6224;6127;3246;1554;1692;776;417;359;1524;660;864;1640;686;954;5165;2907;2258;813.0;795.0;318.0;248.0;2480.0;2490.0;439
7140;Purmerend;2020;80928;17898;48057;14973;61143;7362;2993;4369;12423;6268;6155;3205;1544;1661;797;423;374;1548;675;873;1658;695;963;5215;2931;2284;820.0;797.0;290.0;263.0;2746.0;2459.0;439
7141;Purmerend;2021;81272;17809;48118;15345;61227;7472;3052;4420;12573;6281;6292;3192;1521;1671;813;430;383;1598;679;919;1682;700;982;5288;2951;2337;816.0;809.0;300.0;256.0;2550.0;2478.0;439
7142;Purmerend;2022;81405;17702;47995;15708;61191;7532;3076;4456;12682;6326;6356;3169;1511;1658;843;442;401;1628;688;940;1699;706;993;5343;2979;2364;835.0;820.0;296.0;248.0;2576.0;2504.0;439
7143;Purmerend;2023;81548;17700;47699;16149;61171;7618;3146;4472;12759;6372;6387;3162;1503;1659;842;444;398;1661;712;949;1710;712;998;5384;3001;2383;840.0;840.0;279.0;254.0;2747.0;2505.0;439
7144;Purmerend;2024;81826;17683;47593;16550;61221;7690;3220;4470;12915;6402;6513;3156;1509;1647;864;449;415;1697;717;980;1748;712;1036;5450;3015;2435;858.0;841.0;294.0;254.0;2714.0;2489.0;439
7145;Purmerend;2025;82114;17623;47427;17064;61360;7764;3295;4469;12990;6421;6569;3123;1482;1641;878;448;430;1709;731;978;1758;712;1046;5522;3048;2474;;;;;;;439
7146;Putten;2008;22987;6146;13321;3520;21475;873;344;529;639;355;284;51;23;28;35;18;17;144;78;66;80;38;42;329;198;131;274.0;185.0;77.0;89.0;638.0;820.0;273
7147;Putten;2009;22887;6046;13221;3620;21303;888;347;541;696;383;313;59;27;32;34;18;16;162;83;79;91;41;50;350;214;136;266.0;192.0;87.0;89.0;624.0;797.0;273
7148;Putten;2010;22785;5936;13166;3683;21162;893;352;541;730;400;330;70;33;37;39;23;16;165;86;79;97;45;52;359;213;146;268.0;189.0;88.0;90.0;663.0;825.0;273
7149;Putten;2011;22706;5828;13142;3736;21016;905;355;550;785;416;369;84;38;46;52;27;25;173;84;89;103;49;54;373;218;155;266.0;193.0;90.0;95.0;649.0;821.0;273
7150;Putten;2012;22604;5702;13030;3872;20828;957;384;573;819;448;371;91;43;48;56;31;25;176;88;88;111;56;55;385;230;155;259.0;190.0;91.0;83.0;696.0;852.0;273
7151;Putten;2013;22527;5615;12884;4028;20695;978;393;585;854;462;392;100;46;54;59;31;28;184;90;94;113;55;58;398;240;158;257.0;194.0;97.0;87.0;669.0;839.0;273
7152;Putten;2014;22430;5495;12795;4140;20556;986;407;579;888;478;410;109;49;60;65;36;29;197;98;99;122;59;63;395;236;159;258.0;202.0;92.0;82.0;735.0;825.0;273
7153;Putten;2015;22408;5437;12775;4196;20485;1014;418;596;909;498;411;110;53;57;69;37;32;202;99;103;117;60;57;411;249;162;257.0;206.0;82.0;79.0;662.0;831.0;273
7154;Putten;2016;22293;5307;12711;4275;20327;1022;425;597;944;510;434;109;54;55;71;35;36;217;102;115;122;65;57;425;254;171;255.0;202.0;87.0;73.0;686.0;841.0;273
7155;Putten;2017;22206;5223;12636;4347;20171;1057;440;617;978;523;455;116;58;58;71;33;38;231;102;129;132;69;63;428;261;167;257.0;208.0;93.0;83.0;670.0;849.0;273
7156;Putten;2018;22087;5149;12492;4446;20009;1079;430;649;999;549;450;117;64;53;74;37;37;235;104;131;147;73;74;426;271;155;255.0;209.0;91.0;83.0;651.0;825.0;273
7157;Putten;2019;21967;5098;12338;4531;19821;1105;444;661;1041;565;476;123;70;53;81;40;41;246;106;140;154;76;78;437;273;164;253.0;215.0;81.0;86.0;739.0;806.0;273
7158;Putten;2020;21937;5032;12288;4617;19736;1122;454;668;1079;588;491;129;77;52;92;45;47;237;106;131;166;79;87;455;281;174;252.0;214.0;87.0;80.0;688.0;802.0;273
7159;Putten;2021;21870;4974;12227;4669;19619;1138;474;664;1113;607;506;127;75;52;92;47;45;238;108;130;174;79;95;482;298;184;248.0;220.0;91.0;84.0;763.0;799.0;273
7160;Putten;2022;21872;4924;12189;4759;19556;1164;487;677;1152;619;533;133;75;58;100;51;49;242;106;136;176;73;103;501;314;187;252.0;219.0;80.0;83.0;699.0;827.0;273
7161;Putten;2023;21778;4859;12134;4785;19417;1185;497;688;1176;635;541;145;77;68;103;54;49;242;109;133;179;76;103;507;319;188;245.0;226.0;90.0;79.0;695.0;784.0;273
7162;Putten;2024;21720;4809;12017;4894;19308;1210;512;698;1202;653;549;146;79;67;111;59;52;247;114;133;179;79;100;519;322;197;250.0;226.0;83.0;77.0;671.0;794.0;273
7163;Putten;2025;21630;4784;11888;4958;19191;1231;525;706;1208;658;550;159;82;77;115;60;55;251;115;136;172;77;95;511;324;187;;;;;;;273
7164;Pijnacker-Nootdorp;2008;45400;13374;27015;5011;38389;3261;1194;2067;3750;1860;1890;1246;499;747;356;186;170;418;216;202;399;170;229;1331;789;542;590.0;237.0;218.0;269.0;3005.0;2095.0;1926
7165;Pijnacker-Nootdorp;2009;46615;13506;27769;5340;39173;3440;1287;2153;4002;1950;2052;1312;506;806;370;190;180;508;267;241;424;182;242;1388;805;583;603.0;254.0;238.0;271.0;2877.0;2085.0;1926
7166;Pijnacker-Nootdorp;2010;47703;13630;28401;5672;39874;3596;1377;2219;4233;2008;2225;1371;498;873;389;199;190;536;278;258;458;183;275;1479;850;629;589.0;266.0;266.0;288.0;2466.0;2103.0;1926
7167;Pijnacker-Nootdorp;2011;48372;13603;28871;5898;40242;3727;1429;2298;4403;2061;2342;1400;499;901;411;205;206;574;291;283;475;190;285;1543;876;667;578.0;283.0;263.0;285.0;2536.0;2057.0;1926
7168;Pijnacker-Nootdorp;2012;49128;13576;29206;6346;40670;3822;1495;2327;4636;2138;2498;1449;502;947;438;217;221;613;303;310;513;200;313;1623;916;707;578.0;293.0;266.0;288.0;2575.0;2046.0;1926
7169;Pijnacker-Nootdorp;2013;49923;13610;29492;6821;41139;3945;1575;2370;4839;2169;2670;1485;501;984;458;218;240;665;310;355;543;210;333;1688;930;758;576.0;303.0;278.0;288.0;2482.0;2059.0;1926
7170;Pijnacker-Nootdorp;2014;50611;13503;29943;7165;41524;4062;1642;2420;5025;2207;2818;1510;501;1009;463;215;248;703;321;382;572;218;354;1777;952;825;573.0;319.0;280.0;290.0;2406.0;2017.0;1926
7171;Pijnacker-Nootdorp;2015;51250;13479;30241;7530;41890;4173;1719;2454;5187;2245;2942;1537;508;1029;480;214;266;727;329;398;596;220;376;1847;974;873;582.0;339.0;291.0;299.0;2372.0;1990.0;1926
7172;Pijnacker-Nootdorp;2016;51874;13486;30528;7860;42232;4292;1789;2503;5350;2276;3074;1559;505;1054;493;219;274;777;343;434;643;233;410;1878;976;902;576.0;351.0;295.0;301.0;2446.0;2058.0;1926
7173;Pijnacker-Nootdorp;2017;52486;13472;30885;8129;42632;4424;1883;2541;5430;2283;3147;1568;503;1065;512;220;292;795;340;455;666;247;419;1889;973;916;592.0;359.0;289.0;305.0;2440.0;2024.0;1926
7174;Pijnacker-Nootdorp;2018;53123;13466;31157;8500;42953;4595;1970;2625;5575;2309;3266;1595;505;1090;515;220;295;826;353;473;700;255;445;1939;976;963;599.0;357.0;313.0;302.0;2478.0;2045.0;1926
7175;Pijnacker-Nootdorp;2019;53812;13530;31464;8818;43380;4686;2035;2651;5746;2385;3361;1611;503;1108;530;219;311;864;375;489;717;269;448;2024;1019;1005;610.0;385.0;284.0;306.0;2549.0;2048.0;1926
7176;Pijnacker-Nootdorp;2020;54521;13567;31786;9168;43815;4836;2130;2706;5870;2409;3461;1655;509;1146;543;217;326;889;395;494;726;264;462;2057;1024;1033;619.0;393.0;296.0;303.0;2564.0;2085.0;1926
7177;Pijnacker-Nootdorp;2021;55222;13614;32073;9535;44247;4953;2203;2750;6022;2449;3573;1674;522;1152;553;225;328;931;403;528;759;276;483;2105;1023;1082;621.0;403.0;311.0;305.0;2495.0;2109.0;1926
7178;Pijnacker-Nootdorp;2022;55837;13584;32332;9921;44529;5140;2288;2852;6168;2486;3682;1665;519;1146;583;237;346;982;420;562;779;276;503;2159;1034;1125;623.0;428.0;296.0;310.0;2409.0;2140.0;1926
7179;Pijnacker-Nootdorp;2023;56291;13572;32421;10298;44775;5270;2360;2910;6246;2513;3733;1687;531;1156;584;238;346;983;422;561;781;279;502;2211;1043;1168;626.0;438.0;309.0;320.0;2536.0;2146.0;1926
7180;Pijnacker-Nootdorp;2024;56862;13567;32615;10680;45108;5416;2444;2972;6338;2567;3771;1673;539;1134;595;237;358;997;431;566;807;290;517;2266;1070;1196;621.0;451.0;303.0;312.0;2573.0;2148.0;1926
7181;Pijnacker-Nootdorp;2025;57453;13610;32720;11123;45389;5576;2531;3045;6488;2651;3837;1675;543;1132;604;248;356;1023;458;565;853;297;556;2333;1105;1228;;;;;;;1926
7182;Raalte;2008;36919;9557;21784;5578;34585;1256;502;754;1078;678;400;58;26;32;46;21;25;294;158;136;48;25;23;632;448;184;353.0;290.0;81.0;192.0;1036.0;1120.0;177
7183;Raalte;2009;36792;9322;21785;5685;34378;1306;517;789;1108;686;422;68;30;38;54;28;26;296;164;132;53;28;25;637;436;201;341.0;293.0;87.0;191.0;1048.0;1143.0;177
7184;Raalte;2010;36645;9107;21753;5785;34150;1327;526;801;1168;715;453;76;32;44;60;35;25;322;176;146;66;32;34;644;440;204;336.0;294.0;102.0;189.0;1089.0;1147.0;177
7185;Raalte;2011;36547;8871;21794;5882;33937;1349;535;814;1261;750;511;90;39;51;67;40;27;346;181;165;81;37;44;677;453;224;332.0;291.0;91.0;188.0;1086.0;1140.0;177
7186;Raalte;2012;36441;8646;21675;6120;33759;1357;539;818;1325;773;552;101;47;54;72;43;29;361;185;176;90;34;56;701;464;237;319.0;300.0;107.0;188.0;1095.0;1165.0;177
7187;Raalte;2013;36314;8449;21518;6347;33569;1355;537;818;1390;800;590;124;60;64;78;52;26;372;186;186;106;42;64;710;460;250;327.0;311.0;90.0;181.0;1097.0;1163.0;177
7188;Raalte;2014;36177;8220;21409;6548;33351;1388;556;832;1438;826;612;132;65;67;77;52;25;364;182;182;120;47;73;745;480;265;326.0;311.0;92.0;181.0;1119.0;1135.0;177
7189;Raalte;2015;36092;8043;21318;6731;33186;1417;576;841;1489;851;638;149;72;77;79;53;26;364;189;175;125;45;80;772;492;280;324.0;309.0;98.0;187.0;1087.0;1155.0;177
7190;Raalte;2016;35955;7898;21172;6885;32937;1482;608;874;1536;848;688;168;78;90;86;59;27;379;191;188;133;48;85;770;472;298;321.0;320.0;97.0;191.0;1123.0;1144.0;177
7191;Raalte;2017;35844;7699;21089;7056;32757;1513;630;883;1574;864;710;182;86;96;89;59;30;379;186;193;134;48;86;790;485;305;329.0;323.0;97.0;187.0;1157.0;1158.0;177
7192;Raalte;2018;35767;7587;20927;7253;32604;1545;647;898;1618;895;723;195;93;102;99;63;36;387;194;193;140;47;93;797;498;299;334.0;330.0;95.0;185.0;1173.0;1177.0;177
7193;Raalte;2019;35683;7422;20828;7433;32405;1589;658;931;1689;924;765;215;103;112;103;65;38;396;196;200;152;53;99;823;507;316;343.0;331.0;97.0;188.0;1127.0;1160.0;177
7194;Raalte;2020;35575;7308;20643;7624;32194;1617;677;940;1764;953;811;233;111;122;101;59;42;416;197;219;160;56;104;854;530;324;344.0;340.0;93.0;192.0;1246.0;1137.0;177
7195;Raalte;2021;35595;7203;20560;7832;32098;1665;700;965;1832;989;843;252;125;127;107;64;43;429;203;226;169;61;108;875;536;339;353.0;348.0;129.0;190.0;1196.0;1163.0;177
7196;Raalte;2022;35577;7108;20420;8049;31981;1715;740;975;1881;1015;866;265;133;132;116;74;42;438;210;228;165;60;105;897;538;359;348.0;356.0;93.0;182.0;1196.0;1167.0;177
7197;Raalte;2023;35512;7022;20248;8242;31854;1741;746;995;1917;1025;892;276;136;140;124;77;47;442;208;234;171;57;114;904;547;357;360.0;359.0;96.0;186.0;1108.0;1157.0;177
7198;Raalte;2024;35377;6902;20021;8454;31649;1774;782;992;1954;1046;908;277;143;134;130;76;54;444;208;236;172;59;113;931;560;371;366.0;360.0;96.0;185.0;1173.0;1119.0;177
7199;Raalte;2025;35353;6873;19820;8660;31519;1791;798;993;2043;1073;970;292;151;141;138;80;58;457;214;243;184;62;122;972;566;406;;;;;;;177
7200;Reeuwijk;2008;12462;3217;7257;1988;11461;614;221;393;387;222;165;56;32;24;38;10;28;8;3;5;60;33;27;225;144;81;108.0;103.0;32.0;43.0;503.0;498.0;595
7201;Reeuwijk;2009;12464;3156;7263;2045;11411;624;228;396;429;249;180;60;35;25;45;13;32;20;10;10;66;37;29;238;154;84;116.0;101.0;33.0;38.0;605.0;501.0;595
7202;Reeuwijk;2010;12580;3124;7363;2093;11437;658;246;412;485;268;217;70;34;36;46;13;33;38;19;19;79;41;38;252;161;91;118.0;105.0;41.0;43.0;530.0;513.0;595
7203;Reeuwijk;2011;12610;3053;7390;2167;11435;662;249;413;513;271;242;78;38;40;48;15;33;52;24;28;81;38;43;254;156;98;122.0;110.0;35.0;44.0;573.0;519.0;595
7204;Reeuwijk;2012;12669;3018;7361;2290;11447;688;259;429;534;279;255;87;40;47;48;12;36;53;26;27;86;39;47;260;162;98;123.0;116.0;36.0;42.0;497.0;508.0;595
7205;Reeuwijk;2013;12660;2948;7353;2359;11403;691;246;445;566;302;264;82;39;43;50;19;31;61;32;29;93;40;53;280;172;108;126.0;115.0;37.0;43.0;488.0;501.0;595
7206;Reeuwijk;2014;12653;2907;7300;2446;11357;697;240;457;599;306;293;89;41;48;54;26;28;67;32;35;101;43;58;288;164;124;130.0;117.0;36.0;42.0;561.0;511.0;595
7207;Reeuwijk;2015;12712;2862;7300;2550;11362;717;243;474;633;305;328;100;43;57;52;19;33;75;33;42;113;48;65;293;162;131;127.0;120.0;39.0;45.0;473.0;507.0;595
7208;Reeuwijk;2016;12681;2824;7265;2592;11308;730;249;481;643;321;322;97;46;51;50;21;29;77;37;40;116;52;64;303;165;138;133.0;121.0;36.0;44.0;590.0;488.0;595
7209;Reeuwijk;2017;12786;2838;7288;2660;11357;750;251;499;679;327;352;105;48;57;51;23;28;87;43;44;119;49;70;317;164;153;134.0;122.0;38.0;43.0;621.0;551.0;595
7210;Reeuwijk;2018;12866;2841;7288;2737;11392;770;256;514;704;332;372;110;49;61;59;23;36;93;44;49;117;46;71;325;170;155;136.0;122.0;39.0;40.0;587.0;519.0;595
7211;Reeuwijk;2019;12949;2833;7289;2827;11423;795;276;519;731;338;393;117;52;65;64;27;37;97;44;53;129;49;80;324;166;158;142.0;129.0;36.0;40.0;459.0;514.0;595
7212;Reeuwijk;2020;12903;2788;7232;2883;11339;798;272;526;766;351;415;120;51;69;61;27;34;103;45;58;130;51;79;352;177;175;138.0;127.0;41.0;41.0;479.0;500.0;595
7213;Reeuwijk;2021;12894;2758;7179;2957;11294;794;267;527;806;366;440;120;50;70;66;32;34;102;45;57;151;56;95;367;183;184;139.0;131.0;40.0;40.0;586.0;527.0;595
7214;Reeuwijk;2022;12962;2730;7202;3030;11306;823;274;549;833;371;462;128;48;80;69;32;37;107;48;59;159;58;101;370;185;185;140.0;136.0;37.0;45.0;541.0;525.0;595
7215;Reeuwijk;2023;12976;2728;7165;3083;11273;835;275;560;868;384;484;130;51;79;73;34;39;117;48;69;157;59;98;391;192;199;141.0;133.0;37.0;41.0;569.0;530.0;595
7216;Reeuwijk;2024;13021;2705;7158;3158;11290;847;282;565;884;387;497;131;50;81;76;32;44;123;52;71;155;54;101;399;199;200;150.0;141.0;38.0;46.0;602.0;537.0;595
7217;Reeuwijk;2025;13087;2723;7150;3214;11340;853;279;574;894;393;501;131;51;80;80;33;47;125;49;76;158;56;102;400;204;196;;;;;;;595
7218;Reiderland;2008;6865;1507;4147;1211;5884;801;327;474;180;107;73;32;15;17;12;8;4;20;8;12;11;5;6;105;71;34;60.0;88.0;23.0;44.0;374.0;387.0;1661
7219;Reiderland;2009;6804;1523;4038;1243;5843;779;312;467;182;102;80;33;17;16;18;10;8;25;10;15;10;4;6;96;61;35;54.0;85.0;23.0;42.0;346.0;391.0;1661
7220;Reiderland;2010;6710;1507;3927;1276;5771;750;296;454;189;100;89;29;16;13;20;11;9;31;12;19;12;4;8;97;57;40;52.0;83.0;22.0;40.0;372.0;390.0;1661
7221;Reiderland;2011;6643;1516;3833;1294;5702;743;283;460;198;107;91;29;17;12;25;14;11;31;15;16;13;3;10;100;58;42;50.0;82.0;26.0;43.0;360.0;376.0;1661
7222;Reiderland;2012;6581;1492;3750;1339;5664;711;264;447;206;112;94;32;19;13;26;12;14;35;16;19;18;7;11;95;58;37;48.0;84.0;23.0;37.0;353.0;367.0;1661
7223;Reiderland;2013;6518;1498;3643;1377;5604;706;255;451;208;114;94;27;15;12;27;13;14;34;15;19;22;7;15;98;64;34;49.0;85.0;24.0;34.0;327.0;370.0;1661
7224;Reiderland;2014;6428;1475;3566;1387;5509;693;251;442;226;118;108;29;18;11;28;12;16;42;16;26;21;7;14;106;65;41;46.0;86.0;23.0;38.0;340.0;346.0;1661
7225;Reiderland;2015;6369;1468;3480;1421;5458;656;233;423;255;131;124;34;20;14;29;12;17;51;19;32;26;8;18;115;72;43;44.0;84.0;22.0;36.0;362.0;373.0;1661
7226;Reiderland;2016;6305;1448;3409;1448;5396;649;230;419;260;130;130;35;20;15;29;12;17;56;22;34;27;8;19;113;68;45;46.0;81.0;33.0;36.0;324.0;363.0;1661
7227;Reiderland;2017;6228;1460;3289;1479;5337;630;216;414;261;134;127;36;21;15;27;11;16;49;20;29;28;10;18;121;72;49;47.0;84.0;24.0;35.0;359.0;340.0;1661
7228;Reiderland;2018;6199;1472;3227;1500;5305;621;203;418;273;138;135;39;23;16;25;11;14;59;23;36;33;11;22;117;70;47;46.0;87.0;21.0;34.0;330.0;354.0;1661
7229;Reiderland;2019;6122;1436;3171;1515;5238;598;194;404;286;141;145;39;25;14;28;11;17;65;26;39;39;12;27;115;67;48;46.0;83.0;23.0;33.0;331.0;336.0;1661
7230;Reiderland;2020;6071;1413;3131;1527;5201;571;180;391;299;147;152;44;29;15;32;12;20;67;24;43;39;14;25;117;68;49;43.0;83.0;23.0;33.0;333.0;338.0;1661
7231;Reiderland;2021;6016;1380;3100;1536;5145;568;174;394;303;144;159;45;31;14;35;14;21;70;24;46;42;15;27;111;60;51;43.0;86.0;28.0;34.0;318.0;321.0;1661
7232;Reiderland;2022;5964;1358;3059;1547;5088;557;168;389;319;151;168;43;30;13;37;16;21;82;29;53;42;12;30;115;64;51;44.0;84.0;26.0;31.0;319.0;322.0;1661
7233;Reiderland;2023;5916;1344;3022;1550;5039;541;163;378;336;160;176;47;30;17;38;17;21;83;32;51;48;15;33;120;66;54;41.0;89.0;20.0;29.0;321.0;323.0;1661
7234;Reiderland;2024;5857;1338;2967;1552;4967;547;166;381;343;160;183;49;30;19;44;17;27;83;33;50;41;12;29;126;68;58;41.0;86.0;18.0;30.0;306.0;332.0;1661
7235;Reiderland;2025;5775;1304;2914;1557;4881;549;166;383;345;159;186;46;27;19;42;16;26;84;30;54;45;15;30;128;71;57;;;;;;;1661
7236;Reimerswaal;2008;21179;6140;11928;3111;19107;1255;536;719;817;488;329;72;41;31;26;13;13;233;128;105;73;36;37;413;270;143;338.0;179.0;79.0;87.0;609.0;822.0;703
7237;Reimerswaal;2009;21120;6133;11851;3136;18989;1273;549;724;858;506;352;66;37;29;30;13;17;241;133;108;75;34;41;446;289;157;338.0;181.0;80.0;80.0;638.0;827.0;703
7238;Reimerswaal;2010;21092;6147;11745;3200;18884;1295;563;732;913;530;383;76;42;34;29;14;15;240;130;110;82;41;41;486;303;183;325.0;182.0;82.0;82.0;753.0;828.0;703
7239;Reimerswaal;2011;21161;6134;11797;3230;18890;1305;561;744;966;560;406;90;50;40;31;17;14;243;132;111;92;45;47;510;316;194;323.0;181.0;87.0;81.0;754.0;833.0;703
7240;Reimerswaal;2012;21234;6142;11738;3354;18896;1323;571;752;1015;571;444;99;55;44;37;17;20;256;133;123;96;48;48;527;318;209;326.0;181.0;89.0;82.0;770.0;864.0;703
7241;Reimerswaal;2013;21295;6155;11673;3467;18885;1356;595;761;1054;579;475;103;57;46;40;15;25;253;133;120;105;47;58;553;327;226;319.0;182.0;89.0;76.0;776.0;853.0;703
7242;Reimerswaal;2014;21369;6134;11651;3584;18906;1376;613;763;1087;573;514;108;57;51;41;19;22;274;136;138;112;53;59;552;308;244;320.0;179.0;84.0;77.0;823.0;863.0;703
7243;Reimerswaal;2015;21479;6114;11722;3643;18932;1402;633;769;1145;615;530;117;64;53;48;23;25;271;131;140;127;58;69;582;339;243;329.0;188.0;91.0;75.0;806.0;887.0;703
7244;Reimerswaal;2016;21559;6140;11714;3705;18935;1438;662;776;1186;634;552;118;65;53;51;24;27;276;135;141;133;60;73;608;350;258;325.0;184.0;84.0;83.0;673.0;855.0;703
7245;Reimerswaal;2017;21523;6078;11685;3760;18838;1455;670;785;1230;653;577;123;70;53;62;32;30;292;143;149;140;63;77;613;345;268;323.0;187.0;95.0;79.0;790.0;855.0;703
7246;Reimerswaal;2018;21612;6083;11707;3822;18861;1484;677;807;1267;663;604;125;70;55;63;33;30;295;137;158;146;67;79;638;356;282;318.0;184.0;97.0;80.0;685.0;885.0;703
7247;Reimerswaal;2019;21565;6067;11596;3902;18770;1483;684;799;1312;676;636;137;75;62;67;37;30;299;135;164;153;66;87;656;363;293;318.0;190.0;93.0;74.0;757.0;885.0;703
7248;Reimerswaal;2020;21586;6076;11526;3984;18734;1508;688;820;1344;694;650;143;78;65;68;37;31;307;144;163;162;65;97;664;370;294;314.0;188.0;93.0;79.0;828.0;889.0;703
7249;Reimerswaal;2021;21666;6030;11549;4087;18744;1552;703;849;1370;703;667;145;80;65;71;41;30;321;148;173;165;65;100;668;369;299;310.0;195.0;99.0;78.0;788.0;895.0;703
7250;Reimerswaal;2022;21697;6008;11533;4156;18711;1588;724;864;1398;709;689;153;83;70;69;36;33;325;153;172;167;66;101;684;371;313;302.0;195.0;78.0;74.0;728.0;869.0;703
7251;Reimerswaal;2023;21671;5953;11462;4256;18621;1618;736;882;1432;728;704;150;82;68;77;43;34;327;153;174;180;67;113;698;383;315;303.0;200.0;98.0;74.0;688.0;878.0;703
7252;Reimerswaal;2024;21611;5907;11403;4301;18533;1621;756;865;1457;734;723;161;92;69;89;47;42;324;149;175;180;65;115;703;381;322;296.0;204.0;96.0;71.0;708.0;871.0;703
7253;Reimerswaal;2025;21568;5903;11291;4374;18451;1631;759;872;1486;749;737;166;96;70;91;50;41;335;148;187;179;73;106;715;382;333;;;;;;;703
7254;Renkum;2008;31620;6860;17954;6806;27199;2824;998;1826;1597;949;648;158;85;73;118;52;66;403;209;194;125;57;68;793;546;247;274.0;375.0;106.0;200.0;1913.0;1681.0;274
7255;Renkum;2009;31660;6753;18142;6765;27137;2839;1021;1818;1684;984;700;174;96;78;123;54;69;425;211;214;156;72;84;806;551;255;281.0;372.0;126.0;210.0;1901.0;1739.0;274
7256;Renkum;2010;31651;6630;18252;6769;27068;2839;1005;1834;1744;994;750;185;99;86;126;61;65;427;215;212;186;86;100;820;533;287;277.0;365.0;136.0;198.0;1918.0;1745.0;274
7257;Renkum;2011;31676;6583;18371;6722;26975;2880;1035;1845;1821;1015;806;196;105;91;128;58;70;452;225;227;208;92;116;837;535;302;277.0;359.0;123.0;204.0;1856.0;1720.0;274
7258;Renkum;2012;31652;6467;18338;6847;26885;2883;1030;1853;1884;1034;850;191;100;91;137;62;75;455;222;233;232;101;131;869;549;320;292.0;352.0;138.0;200.0;1773.0;1731.0;274
7259;Renkum;2013;31579;6365;18258;6956;26767;2861;1034;1827;1951;1073;878;196;100;96;147;69;78;466;229;237;261;111;150;881;564;317;293.0;345.0;133.0;191.0;1802.0;1752.0;274
7260;Renkum;2014;31523;6242;18205;7076;26634;2864;1036;1828;2025;1110;915;216;110;106;154;77;77;463;224;239;286;121;165;906;578;328;296.0;351.0;132.0;195.0;1827.0;1743.0;274
7261;Renkum;2015;31489;6172;18148;7169;26554;2857;1034;1823;2078;1130;948;228;108;120;155;78;77;465;231;234;304;119;185;926;594;332;297.0;342.0;126.0;189.0;1839.0;1758.0;274
7262;Renkum;2016;31465;6096;18152;7217;26474;2869;1043;1826;2122;1119;1003;238;114;124;158;76;82;487;235;252;320;131;189;919;563;356;304.0;344.0;118.0;196.0;1829.0;1757.0;274
7263;Renkum;2017;31421;6075;18066;7280;26377;2872;1029;1843;2172;1143;1029;253;122;131;166;76;90;492;237;255;338;135;203;923;573;350;304.0;351.0;125.0;186.0;1772.0;1750.0;274
7264;Renkum;2018;31336;6083;17885;7368;26232;2866;1020;1846;2238;1154;1084;267;130;137;178;83;95;489;228;261;370;150;220;934;563;371;302.0;347.0;122.0;194.0;1845.0;1695.0;274
7265;Renkum;2019;31373;6089;17843;7441;26200;2874;1028;1846;2299;1153;1146;267;122;145;189;89;100;501;231;270;391;148;243;951;563;388;308.0;344.0;119.0;187.0;1824.0;1703.0;274
7266;Renkum;2020;31391;6056;17821;7514;26206;2858;1018;1840;2327;1178;1149;271;125;146;212;103;109;494;223;271;395;151;244;955;576;379;308.0;340.0;121.0;184.0;1819.0;1742.0;274
7267;Renkum;2021;31376;6028;17769;7579;26095;2883;1015;1868;2398;1181;1217;282;127;155;208;98;110;501;225;276;421;155;266;986;576;410;318.0;344.0;130.0;182.0;1856.0;1708.0;274
7268;Renkum;2022;31449;6053;17761;7635;26083;2903;1040;1863;2463;1203;1260;296;136;160;204;97;107;516;228;288;451;159;292;996;583;413;314.0;341.0;117.0;172.0;1805.0;1725.0;274
7269;Renkum;2023;31455;6036;17677;7742;26031;2907;1034;1873;2517;1229;1288;288;141;147;218;108;110;527;235;292;462;161;301;1022;584;438;304.0;340.0;114.0;180.0;1821.0;1690.0;274
7270;Renkum;2024;31488;5997;17626;7865;26025;2894;1045;1849;2569;1261;1308;307;150;157;227;116;111;529;240;289;480;174;306;1026;581;445;305.0;350.0;117.0;174.0;1769.0;1708.0;274
7271;Renkum;2025;31449;5978;17537;7934;25985;2880;1041;1839;2584;1257;1327;309;156;153;226;116;110;532;237;295;493;173;320;1024;575;449;;;;;;;274
7272;Renswoude;2008;4457;1370;2620;467;4230;144;60;84;83;49;34;11;3;8;3;3;0;13;6;7;7;4;3;49;33;16;77.0;24.0;9.0;18.0;111.0;188.0;339
7273;Renswoude;2009;4425;1354;2573;498;4185;153;57;96;87;51;36;10;3;7;5;4;1;17;7;10;7;3;4;48;34;14;76.0;26.0;15.0;15.0;56.0;171.0;339
7274;Renswoude;2010;4360;1327;2501;532;4109;156;61;95;95;52;43;10;2;8;6;4;2;17;7;10;9;4;5;53;35;18;70.0;26.0;12.0;15.0;167.0;176.0;339
7275;Renswoude;2011;4393;1318;2527;548;4118;161;60;101;114;58;56;14;2;12;8;4;4;20;7;13;14;7;7;58;38;20;71.0;29.0;12.0;17.0;163.0;177.0;339
7276;Renswoude;2012;4417;1300;2522;595;4136;158;60;98;123;62;61;15;4;11;10;5;5;22;9;13;15;7;8;61;37;24;67.0;28.0;11.0;15.0;163.0;172.0;339
7277;Renswoude;2013;4443;1299;2496;648;4150;163;62;101;130;63;67;16;5;11;9;4;5;27;11;16;17;7;10;61;36;25;66.0;31.0;12.0;15.0;99.0;182.0;339
7278;Renswoude;2014;4392;1278;2433;681;4099;159;63;96;134;68;66;14;5;9;10;5;5;26;10;16;17;7;10;67;41;26;61.0;32.0;10.0;14.0;180.0;165.0;339
7279;Renswoude;2015;4432;1288;2438;706;4121;158;59;99;153;77;76;18;8;10;12;5;7;26;11;15;23;11;12;74;42;32;60.0;30.0;11.0;14.0;217.0;166.0;339
7280;Renswoude;2016;4511;1311;2470;730;4170;178;65;113;163;79;84;20;8;12;11;5;6;31;12;19;24;10;14;77;44;33;62.0;32.0;12.0;13.0;206.0;169.0;339
7281;Renswoude;2017;4577;1312;2497;768;4222;184;72;112;171;87;84;21;9;12;12;6;6;30;12;18;28;13;15;80;47;33;61.0;35.0;13.0;17.0;119.0;184.0;339
7282;Renswoude;2018;4534;1296;2457;781;4180;184;71;113;170;87;83;21;8;13;13;7;6;29;11;18;25;13;12;82;48;34;58.0;34.0;14.0;14.0;192.0;168.0;339
7283;Renswoude;2019;4582;1296;2480;806;4214;193;76;117;175;90;85;20;8;12;11;6;5;31;13;18;27;12;15;86;51;35;57.0;36.0;12.0;15.0;140.0;159.0;339
7284;Renswoude;2020;4580;1281;2473;826;4191;207;85;122;182;86;96;19;7;12;11;6;5;33;13;20;27;11;16;92;49;43;53.0;35.0;11.0;16.0;110.0;177.0;339
7285;Renswoude;2021;4526;1249;2433;844;4134;202;83;119;190;89;101;19;7;12;16;9;7;34;14;20;27;11;16;94;48;46;50.0;38.0;10.0;15.0;193.0;183.0;339
7286;Renswoude;2022;4543;1228;2443;872;4141;208;84;124;194;91;103;17;7;10;18;11;7;37;15;22;29;13;16;93;45;48;53.0;37.0;11.0;14.0;167.0;174.0;339
7287;Renswoude;2023;4549;1216;2422;911;4133;210;85;125;206;96;110;21;8;13;18;11;7;41;15;26;31;14;17;95;48;47;51.0;37.0;13.0;13.0;127.0;175.0;339
7288;Renswoude;2024;4516;1190;2395;931;4090;220;88;132;206;96;110;17;7;10;18;11;7;42;14;28;32;15;17;97;49;48;51.0;38.0;10.0;13.0;165.0;175.0;339
7289;Renswoude;2025;4516;1165;2396;955;4079;214;83;131;223;111;112;19;9;10;20;12;8;43;14;29;34;19;15;107;57;50;;;;;;;339
7290;Reusel-De Mierden;2008;12169;2955;7615;1599;11191;715;219;496;263;161;102;21;10;11;16;9;7;32;12;20;24;7;17;170;123;47;116.0;89.0;48.0;68.0;267.0;333.0;1667
7291;Reusel-De Mierden;2009;12113;2900;7555;1658;11131;686;203;483;296;179;117;25;11;14;20;10;10;30;11;19;33;10;23;188;137;51;121.0;92.0;51.0;69.0;246.0;349.0;1667
7292;Reusel-De Mierden;2010;12024;2806;7510;1708;11022;677;200;477;325;196;129;30;17;13;21;10;11;34;12;22;39;10;29;201;147;54;121.0;94.0;53.0;66.0;308.0;345.0;1667
7293;Reusel-De Mierden;2011;12002;2743;7479;1780;10981;664;202;462;357;219;138;39;26;13;24;13;11;43;15;28;49;12;37;202;153;49;121.0;99.0;59.0;64.0;331.0;353.0;1667
7294;Reusel-De Mierden;2012;11999;2684;7463;1852;10949;660;203;457;390;232;158;45;28;17;28;15;13;49;18;31;53;12;41;215;159;56;121.0;102.0;51.0;61.0;354.0;350.0;1667
7295;Reusel-De Mierden;2013;12012;2659;7419;1934;10920;666;210;456;426;255;171;54;36;18;28;16;12;52;19;33;63;16;47;229;168;61;127.0;105.0;53.0;59.0;347.0;371.0;1667
7296;Reusel-De Mierden;2014;12005;2621;7381;2003;10873;668;210;458;464;276;188;57;36;21;30;17;13;55;20;35;69;16;53;253;187;66;126.0;105.0;56.0;62.0;376.0;349.0;1667
7297;Reusel-De Mierden;2015;12048;2594;7351;2103;10891;657;219;438;500;286;214;62;38;24;32;16;16;69;25;44;78;19;59;259;188;71;130.0;108.0;52.0;61.0;452.0;361.0;1667
7298;Reusel-De Mierden;2016;12154;2629;7327;2198;10949;665;226;439;540;306;234;62;40;22;37;18;19;73;26;47;88;20;68;280;202;78;133.0;109.0;62.0;61.0;403.0;371.0;1667
7299;Reusel-De Mierden;2017;12212;2619;7300;2293;10967;675;236;439;570;309;261;67;43;24;42;24;18;83;26;57;95;26;69;283;190;93;134.0;114.0;63.0;59.0;392.0;368.0;1667
7300;Reusel-De Mierden;2018;12262;2635;7207;2420;10985;667;234;433;610;326;284;66;43;23;51;29;22;95;28;67;98;29;69;300;197;103;136.0;117.0;59.0;61.0;350.0;353.0;1667
7301;Reusel-De Mierden;2019;12277;2623;7142;2512;10959;678;244;434;640;334;306;66;45;21;49;25;24;98;30;68;115;28;87;312;206;106;132.0;119.0;58.0;63.0;404.0;359.0;1667
7302;Reusel-De Mierden;2020;12329;2608;7107;2614;10990;671;245;426;668;351;317;67;43;24;50;27;23;108;37;71;116;28;88;327;216;111;136.0;125.0;61.0;58.0;435.0;365.0;1667
7303;Reusel-De Mierden;2021;12415;2640;7064;2711;11047;672;251;421;696;364;332;69;45;24;57;31;26;104;35;69;121;31;90;345;222;123;135.0;126.0;74.0;60.0;384.0;366.0;1667
7304;Reusel-De Mierden;2022;12457;2656;6995;2806;11067;669;251;418;721;368;353;78;49;29;56;31;25;107;38;69;128;32;96;352;218;134;134.0;131.0;59.0;58.0;344.0;368.0;1667
7305;Reusel-De Mierden;2023;12439;2647;6901;2891;11020;663;246;417;756;383;373;77;47;30;56;30;26;111;41;70;144;37;107;368;228;140;134.0;131.0;66.0;57.0;424.0;359.0;1667
7306;Reusel-De Mierden;2024;12516;2664;6871;2981;11056;665;259;406;795;401;394;77;47;30;63;37;26;117;40;77;155;39;116;383;238;145;130.0;137.0;55.0;57.0;434.0;369.0;1667
7307;Reusel-De Mierden;2025;12574;2674;6819;3081;11071;671;261;410;832;415;417;85;55;30;67;39;28;128;42;86;167;38;129;385;241;144;;;;;;;1667
7308;Rheden;2008;43953;9248;25253;9452;37612;3841;1345;2496;2500;1469;1031;199;96;103;142;69;73;919;458;461;202;102;100;1038;744;294;366.0;543.0;161.0;227.0;2419.0;2354.0;275
7309;Rheden;2009;43783;9085;25373;9325;37421;3794;1329;2465;2568;1503;1065;216;99;117;156;82;74;921;464;457;218;109;109;1057;749;308;376.0;531.0;161.0;217.0;2316.0;2368.0;275
7310;Rheden;2010;43526;8938;25300;9288;37106;3758;1320;2438;2662;1521;1141;248;109;139;174;92;82;944;470;474;237;118;119;1059;732;327;377.0;533.0;174.0;212.0;2491.0;2407.0;275
7311;Rheden;2011;43418;8813;25408;9197;36905;3745;1316;2429;2768;1552;1216;263;117;146;196;105;91;969;481;488;249;122;127;1091;727;364;396.0;518.0;169.0;218.0;2169.0;2348.0;275
7312;Rheden;2012;43072;8587;25153;9332;36577;3691;1302;2389;2804;1567;1237;272;127;145;198;106;92;962;473;489;260;128;132;1112;733;379;379.0;509.0;168.0;207.0;2244.0;2332.0;275
7313;Rheden;2013;42820;8499;24924;9397;36291;3668;1326;2342;2861;1592;1269;286;139;147;208;110;98;965;475;490;267;125;142;1135;743;392;386.0;511.0;180.0;202.0;2133.0;2331.0;275
7314;Rheden;2014;42476;8368;24694;9414;35916;3647;1309;2338;2913;1617;1296;285;144;141;217;121;96;967;476;491;283;126;157;1161;750;411;387.0;503.0;190.0;199.0;2260.0;2300.0;275
7315;Rheden;2015;42317;8274;24569;9474;35658;3678;1303;2375;2981;1628;1353;299;150;149;230;132;98;989;485;504;294;123;171;1169;738;431;381.0;499.0;174.0;194.0;2300.0;2335.0;275
7316;Rheden;2016;42149;8224;24445;9480;35425;3676;1290;2386;3048;1641;1407;306;151;155;242;137;105;989;481;508;304;126;178;1207;746;461;398.0;495.0;178.0;194.0;2087.0;2337.0;275
7317;Rheden;2017;41790;8094;24210;9486;35046;3668;1283;2385;3076;1650;1426;316;152;164;254;141;113;998;483;515;304;124;180;1204;750;454;402.0;496.0;168.0;188.0;2136.0;2296.0;275
7318;Rheden;2018;41521;7981;24038;9502;34730;3631;1273;2358;3160;1668;1492;333;158;175;257;144;113;1007;479;528;311;128;183;1252;759;493;404.0;491.0;160.0;188.0;2020.0;2235.0;275
7319;Rheden;2019;41196;7861;23837;9498;34368;3608;1255;2353;3220;1691;1529;332;160;172;278;160;118;1001;470;531;320;128;192;1289;773;516;394.0;482.0;151.0;188.0;2053.0;2210.0;275
7320;Rheden;2020;40918;7759;23651;9508;34058;3583;1218;2365;3277;1717;1560;352;173;179;291;172;119;1002;474;528;327;134;193;1305;764;541;406.0;473.0;162.0;179.0;2035.0;2187.0;275
7321;Rheden;2021;40685;7650;23518;9517;33795;3542;1205;2337;3348;1741;1607;358;176;182;305;180;125;1005;468;537;340;143;197;1340;774;566;404.0;477.0;139.0;184.0;2006.0;2176.0;275
7322;Rheden;2022;40404;7581;23280;9543;33580;3471;1176;2295;3353;1748;1605;368;185;183;310;177;133;1000;467;533;343;148;195;1332;771;561;399.0;477.0;150.0;175.0;1995.0;2146.0;275
7323;Rheden;2023;40154;7500;23039;9615;33307;3459;1182;2277;3388;1750;1638;381;192;189;307;174;133;990;457;533;356;154;202;1354;773;581;405.0;481.0;149.0;170.0;2123.0;2151.0;275
7324;Rheden;2024;40035;7492;22846;9697;33181;3454;1201;2253;3400;1758;1642;382;197;185;312;176;136;984;458;526;359;159;200;1363;768;595;409.0;485.0;163.0;168.0;1993.0;2125.0;275
7325;Rheden;2025;39825;7495;22573;9757;32925;3437;1220;2217;3463;1780;1683;392;207;185;313;176;137;1013;464;549;373;166;207;1372;767;605;;;;;;;275
7326;Rhenen;2008;18190;4605;10507;3078;16409;1013;351;662;768;401;367;50;29;21;33;17;16;60;26;34;360;174;186;265;155;110;221.0;161.0;48.0;76.0;772.0;780.0;340
7327;Rhenen;2009;18216;4608;10455;3153;16399;1008;344;664;809;421;388;52;30;22;41;19;22;70;33;37;364;173;191;282;166;116;221.0;168.0;53.0;75.0;789.0;785.0;340
7328;Rhenen;2010;18254;4585;10460;3209;16363;1024;342;682;867;456;411;56;35;21;45;21;24;84;38;46;369;175;194;313;187;126;215.0;172.0;56.0;77.0;723.0;809.0;340
7329;Rhenen;2011;18193;4545;10402;3246;16289;1003;334;669;901;468;433;65;37;28;54;28;26;96;43;53;364;178;186;322;182;140;209.0;170.0;59.0;68.0;687.0;798.0;340
7330;Rhenen;2012;18114;4457;10297;3360;16158;1040;360;680;916;477;439;70;39;31;57;30;27;104;45;59;353;175;178;332;188;144;202.0;174.0;60.0;72.0;727.0;796.0;340
7331;Rhenen;2013;18064;4407;10210;3447;16070;1062;366;696;932;486;446;69;39;30;58;28;30;114;50;64;342;174;168;349;195;154;202.0;176.0;71.0;77.0;786.0;799.0;340
7332;Rhenen;2014;18074;4362;10199;3513;16064;1069;367;702;941;483;458;75;41;34;60;27;33;119;53;66;339;173;166;348;189;159;206.0;179.0;58.0;68.0;816.0;771.0;340
7333;Rhenen;2015;18138;4348;10185;3605;16080;1074;371;703;984;498;486;82;44;38;60;26;34;140;63;77;344;171;173;358;194;164;202.0;186.0;66.0;70.0;708.0;819.0;340
7334;Rhenen;2016;18041;4305;10047;3689;15962;1068;368;700;1011;510;501;89;51;38;66;31;35;150;67;83;338;165;173;368;196;172;199.0;187.0;65.0;69.0;720.0;812.0;340
7335;Rhenen;2017;17959;4218;9935;3806;15849;1080;368;712;1030;522;508;92;52;40;65;30;35;149;66;83;337;163;174;387;211;176;190.0;190.0;57.0;63.0;764.0;789.0;340
7336;Rhenen;2018;17932;4183;9897;3852;15777;1082;361;721;1073;550;523;97;51;46;72;37;35;170;78;92;338;169;169;396;215;181;200.0;192.0;51.0;63.0;814.0;795.0;340
7337;Rhenen;2019;17949;4138;9930;3881;15781;1074;352;722;1094;553;541;98;48;50;73;35;38;177;77;100;333;167;166;413;226;187;195.0;190.0;69.0;66.0;788.0;820.0;340
7338;Rhenen;2020;17927;4080;9891;3956;15742;1075;351;724;1110;566;544;99;48;51;76;38;38;188;88;100;333;163;170;414;229;185;202.0;193.0;65.0;67.0;818.0;832.0;340
7339;Rhenen;2021;17923;4030;9889;4004;15703;1087;365;722;1133;576;557;99;50;49;84;40;44;183;83;100;340;169;171;427;234;193;199.0;192.0;58.0;63.0;749.0;819.0;340
7340;Rhenen;2022;17856;3983;9789;4084;15604;1093;370;723;1159;585;574;106;53;53;86;41;45;190;85;105;337;168;169;440;238;202;194.0;194.0;54.0;62.0;783.0;802.0;340
7341;Rhenen;2023;17831;3922;9767;4142;15546;1101;372;729;1184;599;585;114;56;58;93;45;48;197;89;108;334;171;163;446;238;208;196.0;199.0;60.0;64.0;779.0;820.0;340
7342;Rhenen;2024;17784;3857;9726;4201;15494;1109;381;728;1181;615;566;118;63;55;84;40;44;201;89;112;318;171;147;460;252;208;192.0;206.0;53.0;57.0;824.0;803.0;340
7343;Rhenen;2025;17788;3833;9678;4277;15487;1103;391;712;1198;604;594;120;64;56;82;35;47;208;93;115;331;170;161;457;242;215;;;;;;;340
7344;Ridderkerk;2008;44360;9381;26475;8504;38102;3335;1343;1992;2923;1612;1311;529;261;268;259;129;130;645;322;323;333;151;182;1157;749;408;339.0;420.0;131.0;182.0;1602.0;1662.0;597
7345;Ridderkerk;2009;44175;9257;26304;8614;37786;3325;1325;2000;3064;1657;1407;574;279;295;268;129;139;661;322;339;365;162;203;1196;765;431;337.0;417.0;135.0;192.0;1736.0;1658.0;597
7346;Ridderkerk;2010;44122;9131;26230;8761;37591;3329;1320;2009;3202;1686;1516;600;284;316;279;127;152;682;324;358;393;168;225;1248;783;465;345.0;427.0;165.0;191.0;1795.0;1640.0;597
7347;Ridderkerk;2011;44171;9050;26306;8815;37478;3364;1326;2038;3329;1727;1602;615;288;327;294;142;152;711;333;378;422;175;247;1287;789;498;351.0;438.0;161.0;182.0;1612.0;1628.0;597
7348;Ridderkerk;2012;44051;8936;25877;9238;37223;3399;1326;2073;3429;1754;1675;639;293;346;304;148;156;728;328;400;452;188;264;1306;797;509;346.0;439.0;147.0;172.0;1884.0;1584.0;597
7349;Ridderkerk;2013;44236;8882;25824;9530;37186;3444;1354;2090;3606;1818;1788;676;303;373;321;154;167;755;346;409;485;196;289;1369;819;550;360.0;445.0;154.0;181.0;1738.0;1636.0;597
7350;Ridderkerk;2014;44229;8770;25706;9753;37062;3484;1370;2114;3683;1866;1817;679;300;379;337;163;174;768;350;418;503;209;294;1396;844;552;356.0;456.0;157.0;174.0;1820.0;1637.0;597
7351;Ridderkerk;2015;44297;8669;25728;9900;37011;3490;1356;2134;3796;1872;1924;706;302;404;343;169;174;794;346;448;541;225;316;1412;830;582;362.0;463.0;164.0;164.0;1683.0;1616.0;597
7352;Ridderkerk;2016;44271;8597;25598;10076;36898;3470;1348;2122;3903;1942;1961;726;310;416;354;179;175;822;366;456;555;235;320;1446;852;594;371.0;459.0;162.0;163.0;1799.0;1601.0;597
7353;Ridderkerk;2017;44385;8576;25610;10199;36899;3481;1354;2127;4005;1986;2019;737;320;417;368;188;180;850;378;472;593;258;335;1457;842;615;366.0;467.0;150.0;168.0;1760.0;1605.0;597
7354;Ridderkerk;2018;44425;8507;25604;10314;36774;3533;1385;2148;4118;2017;2101;749;319;430;388;190;198;881;387;494;604;263;341;1496;858;638;375.0;474.0;137.0;168.0;1934.0;1588.0;597
7355;Ridderkerk;2019;44643;8553;25675;10415;36836;3555;1382;2173;4252;2074;2178;767;335;432;400;197;203;909;384;525;629;272;357;1547;886;661;381.0;472.0;152.0;173.0;1892.0;1600.0;597
7356;Ridderkerk;2020;44824;8551;25654;10619;36927;3554;1377;2177;4343;2103;2240;787;344;443;399;192;207;911;387;524;662;277;385;1584;903;681;394.0;485.0;153.0;165.0;1819.0;1600.0;597
7357;Ridderkerk;2021;44946;8578;25644;10724;36942;3565;1370;2195;4439;2129;2310;819;348;471;405;189;216;925;386;539;676;286;390;1614;920;694;394.0;485.0;149.0;168.0;1734.0;1632.0;597
7358;Ridderkerk;2022;44940;8554;25517;10869;36791;3608;1385;2223;4541;2187;2354;825;349;476;407;189;218;970;406;564;673;293;380;1666;950;716;406.0;495.0;150.0;166.0;1737.0;1604.0;597
7359;Ridderkerk;2023;44972;8512;25509;10951;36758;3613;1385;2228;4601;2190;2411;845;356;489;414;198;216;985;407;578;675;297;378;1682;932;750;412.0;502.0;142.0;175.0;1819.0;1595.0;597
7360;Ridderkerk;2024;45076;8515;25512;11049;36807;3648;1420;2228;4621;2195;2426;844;355;489;417;201;216;996;414;582;687;296;391;1677;929;748;422.0;502.0;143.0;164.0;1832.0;1621.0;597
7361;Ridderkerk;2025;45189;8615;25385;11189;36807;3659;1413;2246;4723;2230;2493;868;363;505;413;187;226;1012;422;590;699;297;402;1731;961;770;;;;;;;597
7362;Rijnwaarden;2008;10931;2593;6826;1512;9641;1077;300;777;213;117;96;15;4;11;12;3;9;58;32;26;24;14;10;104;64;40;94.0;80.0;37.0;49.0;327.0;355.0;196
7363;Rijnwaarden;2009;10907;2586;6770;1551;9616;1060;299;761;231;130;101;19;6;13;12;5;7;62;33;29;21;13;8;117;73;44;97.0;83.0;33.0;51.0;328.0;365.0;196
7364;Rijnwaarden;2010;10868;2529;6743;1596;9572;1053;301;752;243;143;100;20;10;10;17;7;10;65;32;33;21;14;7;120;80;40;90.0;81.0;36.0;45.0;332.0;368.0;196
7365;Rijnwaarden;2011;10834;2477;6699;1658;9539;1031;300;731;264;156;108;23;11;12;17;7;10;68;35;33;27;17;10;129;86;43;92.0;88.0;31.0;48.0;314.0;381.0;196
7366;Rijnwaarden;2012;10756;2385;6622;1749;9463;1011;287;724;282;164;118;24;13;11;19;9;10;78;39;39;30;18;12;131;85;46;90.0;93.0;36.0;51.0;330.0;382.0;196
7367;Rijnwaarden;2013;10688;2336;6543;1809;9379;1005;288;717;304;170;134;33;18;15;22;11;11;86;39;47;31;17;14;132;85;47;89.0;88.0;38.0;46.0;352.0;367.0;196
7368;Rijnwaarden;2014;10668;2285;6473;1910;9340;996;285;711;332;191;141;31;18;13;25;13;12;97;45;52;37;22;15;142;93;49;84.0;92.0;40.0;42.0;332.0;389.0;196
7369;Rijnwaarden;2015;10604;2213;6410;1981;9263;979;284;695;362;213;149;37;22;15;28;15;13;99;47;52;34;23;11;164;106;58;93.0;92.0;68.0;40.0;339.0;412.0;196
7370;Rijnwaarden;2016;10562;2177;6310;2075;9200;971;283;688;391;225;166;45;25;20;30;15;15;104;49;55;37;25;12;175;111;64;87.0;97.0;29.0;43.0;303.0;391.0;196
7371;Rijnwaarden;2017;10451;2092;6231;2128;9104;953;286;667;394;221;173;50;26;24;30;16;14;107;52;55;40;28;12;167;99;68;85.0;101.0;35.0;42.0;325.0;401.0;196
7372;Rijnwaarden;2018;10353;2011;6125;2217;9015;938;288;650;400;223;177;48;26;22;31;18;13;108;56;52;46;28;18;167;95;72;86.0;102.0;33.0;42.0;387.0;383.0;196
7373;Rijnwaarden;2019;10333;1964;6086;2283;8993;924;284;640;416;231;185;54;29;25;32;19;13;108;53;55;51;27;24;171;103;68;89.0;106.0;38.0;44.0;329.0;383.0;196
7374;Rijnwaarden;2020;10258;1913;6007;2338;8929;896;279;617;433;237;196;58;30;28;36;24;12;113;52;61;51;27;24;175;104;71;91.0;109.0;33.0;36.0;319.0;390.0;196
7375;Rijnwaarden;2021;10168;1850;5921;2397;8837;902;284;618;429;245;184;62;31;31;37;26;11;104;50;54;49;27;22;177;111;66;87.0;110.0;42.0;36.0;335.0;380.0;196
7376;Rijnwaarden;2022;10108;1804;5850;2454;8763;904;302;602;441;244;197;66;33;33;36;25;11;103;49;54;54;29;25;182;108;74;92.0;112.0;33.0;37.0;364.0;391.0;196
7377;Rijnwaarden;2023;10059;1790;5795;2474;8714;896;297;599;449;240;209;64;34;30;40;28;12;106;49;57;56;30;26;183;99;84;90.0;114.0;31.0;39.0;353.0;390.0;196
7378;Rijnwaarden;2024;9991;1749;5736;2506;8643;881;289;592;467;242;225;66;35;31;47;30;17;110;50;60;53;31;22;191;96;95;92.0;117.0;31.0;35.0;423.0;379.0;196
7379;Rijnwaarden;2025;10006;1746;5700;2560;8644;867;286;581;495;245;250;61;32;29;51;33;18;118;50;68;59;31;28;206;99;107;;;;;;;196
7380;Rijnwoude;2008;18820;4818;11345;2657;17296;942;335;607;582;300;282;104;54;50;67;28;39;54;23;31;59;26;33;298;169;129;188.0;127.0;42.0;61.0;709.0;680.0;1672
7381;Rijnwoude;2009;18895;4780;11329;2786;17260;982;351;631;653;334;319;111;58;53;69;29;40;72;32;40;70;29;41;331;186;145;187.0;126.0;46.0;57.0;628.0;695.0;1672
7382;Rijnwoude;2010;18880;4693;11262;2925;17179;996;365;631;705;361;344;119;63;56;69;30;39;81;37;44;80;33;47;356;198;158;190.0;132.0;55.0;65.0;734.0;678.0;1672
7383;Rijnwoude;2011;18984;4654;11313;3017;17156;1053;384;669;775;405;370;121;62;59;75;35;40;106;50;56;94;44;50;379;214;165;187.0;136.0;55.0;62.0;724.0;696.0;1672
7384;Rijnwoude;2012;19056;4613;11214;3229;17158;1072;388;684;826;410;416;138;68;70;78;34;44;124;55;69;110;47;63;376;206;170;183.0;142.0;54.0;64.0;737.0;688.0;1672
7385;Rijnwoude;2013;19139;4568;11145;3426;17142;1111;405;706;886;438;448;137;70;67;85;37;48;137;55;82;117;50;67;410;226;184;196.0;148.0;61.0;73.0;793.0;664.0;1672
7386;Rijnwoude;2014;19305;4545;11162;3598;17201;1151;429;722;953;467;486;145;67;78;91;39;52;151;64;87;136;56;80;430;241;189;196.0;150.0;54.0;62.0;716.0;696.0;1672
7387;Rijnwoude;2015;19365;4533;11095;3737;17184;1174;440;734;1007;493;514;159;73;86;87;35;52;155;66;89;147;61;86;459;258;201;199.0;153.0;60.0;59.0;651.0;670.0;1672
7388;Rijnwoude;2016;19395;4543;11003;3849;17149;1195;435;760;1051;507;544;169;77;92;87;34;53;163;76;87;157;65;92;475;255;220;206.0;157.0;61.0;61.0;705.0;684.0;1672
7389;Rijnwoude;2017;19467;4504;10976;3987;17124;1245;455;790;1098;518;580;171;76;95;87;35;52;189;80;109;163;67;96;488;260;228;209.0;162.0;56.0;62.0;695.0;663.0;1672
7390;Rijnwoude;2018;19542;4479;10941;4122;17136;1276;463;813;1130;538;592;174;76;98;94;39;55;199;84;115;167;67;100;496;272;224;210.0;166.0;55.0;66.0;740.0;680.0;1672
7391;Rijnwoude;2019;19639;4493;10916;4230;17118;1334;489;845;1187;557;630;182;76;106;102;47;55;207;87;120;178;67;111;518;280;238;214.0;169.0;64.0;67.0;729.0;697.0;1672
7392;Rijnwoude;2020;19716;4441;10937;4338;17114;1385;522;863;1217;560;657;189;79;110;104;50;54;212;85;127;186;65;121;526;281;245;215.0;173.0;60.0;59.0;755.0;698.0;1672
7393;Rijnwoude;2021;19820;4463;10938;4419;17143;1427;539;888;1250;561;689;191;76;115;102;45;57;225;92;133;192;63;129;540;285;255;216.0;179.0;57.0;66.0;699.0;667.0;1672
7394;Rijnwoude;2022;19881;4467;10891;4523;17122;1468;550;918;1291;593;698;189;74;115;103;49;54;234;95;139;204;68;136;561;307;254;229.0;187.0;61.0;69.0;745.0;688.0;1672
7395;Rijnwoude;2023;19974;4517;10838;4619;17151;1505;572;933;1318;602;716;194;71;123;108;51;57;238;100;138;209;73;136;569;307;262;222.0;187.0;66.0;61.0;749.0;713.0;1672
7396;Rijnwoude;2024;20050;4513;10839;4698;17177;1527;598;929;1346;618;728;195;75;120;115;55;60;250;109;141;218;76;142;568;303;265;220.0;190.0;60.0;64.0;704.0;686.0;1672
7397;Rijnwoude;2025;20097;4517;10809;4771;17155;1552;612;940;1390;632;758;207;80;127;131;63;68;249;106;143;224;79;145;579;304;275;;;;;;;1672
7398;Rijssen-Holten;2008;35984;10590;19963;5431;33402;1100;391;709;1482;792;690;63;27;36;34;14;20;891;455;436;47;17;30;447;279;168;512.0;290.0;82.0;112.0;510.0;834.0;1742
7399;Rijssen-Holten;2009;35854;10534;19810;5510;33196;1117;400;717;1541;818;723;78;38;40;42;17;25;879;445;434;60;21;39;482;297;185;510.0;291.0;101.0;113.0;599.0;865.0;1742
7400;Rijssen-Holten;2010;35800;10487;19656;5657;33021;1163;419;744;1616;841;775;94;46;48;49;18;31;870;434;436;83;30;53;520;313;207;488.0;293.0;89.0;108.0;674.0;864.0;1742
7401;Rijssen-Holten;2011;35788;10437;19573;5778;32930;1184;426;758;1674;863;811;107;51;56;53;20;33;861;425;436;108;45;63;545;322;223;478.0;300.0;97.0;109.0;574.0;868.0;1742
7402;Rijssen-Holten;2012;35660;10347;19336;5977;32714;1231;450;781;1715;865;850;117;56;61;60;23;37;864;423;441;116;43;73;558;320;238;474.0;302.0;103.0;106.0;627.0;855.0;1742
7403;Rijssen-Holten;2013;35605;10255;19185;6165;32594;1249;464;785;1762;883;879;134;60;74;60;22;38;846;420;426;132;52;80;590;329;261;472.0;317.0;110.0;102.0;758.0;871.0;1742
7404;Rijssen-Holten;2014;35659;10198;19130;6331;32520;1285;474;811;1854;920;934;146;70;76;78;31;47;845;410;435;144;56;88;641;353;288;472.0;318.0;104.0;111.0;674.0;861.0;1742
7405;Rijssen-Holten;2015;35624;10101;19081;6442;32383;1291;479;812;1950;965;985;169;89;80;89;35;54;830;398;432;158;62;96;704;381;323;459.0;323.0;104.0;102.0;817.0;873.0;1742
7406;Rijssen-Holten;2016;35709;10058;19081;6570;32347;1335;503;832;2027;990;1037;185;97;88;101;41;60;821;388;433;171;66;105;749;398;351;464.0;330.0;104.0;101.0;802.0;914.0;1742
7407;Rijssen-Holten;2017;35739;9950;19120;6669;32255;1364;528;836;2120;1025;1095;198;98;100;108;50;58;818;383;435;184;68;116;812;426;386;471.0;334.0;110.0;102.0;827.0;920.0;1742
7408;Rijssen-Holten;2018;35796;9895;19121;6780;32189;1393;537;856;2214;1090;1124;216;109;107;119;63;56;826;388;438;189;73;116;864;457;407;477.0;335.0;115.0;108.0;830.0;908.0;1742
7409;Rijssen-Holten;2019;35870;9867;19079;6924;32189;1414;551;863;2267;1128;1139;225;112;113;125;66;59;819;390;429;209;78;131;889;482;407;476.0;336.0;120.0;101.0;725.0;917.0;1742
7410;Rijssen-Holten;2020;35841;9775;19025;7041;32063;1444;562;882;2334;1178;1156;230;119;111;136;75;61;809;392;417;229;84;145;930;508;422;469.0;341.0;153.0;110.0;769.0;911.0;1742
7411;Rijssen-Holten;2021;35883;9729;18965;7189;31997;1467;581;886;2419;1228;1191;249;135;114;144;79;65;809;396;413;254;88;166;963;530;433;483.0;352.0;127.0;105.0;900.0;910.0;1742
7412;Rijssen-Holten;2022;36025;9690;19046;7289;32013;1495;582;913;2517;1285;1232;266;147;119;154;83;71;808;405;403;279;98;181;1010;552;458;475.0;355.0;111.0;111.0;872.0;921.0;1742
7413;Rijssen-Holten;2023;36102;9633;19087;7382;32000;1528;600;928;2574;1331;1243;278;152;126;162;93;69;787;399;388;288;98;190;1059;589;470;483.0;354.0;119.0;104.0;841.0;904.0;1742
7414;Rijssen-Holten;2024;36186;9594;19036;7556;31982;1543;623;920;2661;1355;1306;296;157;139;168;94;74;780;390;390;303;100;203;1114;614;500;489.0;361.0;113.0;100.0;820.0;927.0;1742
7415;Rijssen-Holten;2025;36226;9562;18938;7726;31953;1565;636;929;2708;1375;1333;299;162;137;174;96;78;775;384;391;309;105;204;1151;628;523;;;;;;;1742
7416;Rijswijk (ZH.);2008;46671;8925;27899;9847;34051;6836;3409;3427;5784;3483;2301;1600;880;720;496;318;178;499;260;239;789;419;370;2400;1606;794;429.0;569.0;444.0;350.0;2808.0;2873.0;603
7417;Rijswijk (ZH.);2009;46562;9048;27897;9617;33663;6901;3490;3411;5998;3560;2438;1614;864;750;495;307;188;539;281;258;869;455;414;2481;1653;828;445.0;557.0;451.0;352.0;2773.0;2919.0;603
7418;Rijswijk (ZH.);2010;46407;9137;27744;9526;33277;6944;3556;3388;6186;3614;2572;1623;854;769;515;311;204;559;293;266;931;486;445;2558;1670;888;438.0;549.0;471.0;353.0;2656.0;2898.0;603
7419;Rijswijk (ZH.);2011;46175;9134;27704;9337;32808;7013;3601;3412;6354;3671;2683;1633;860;773;533;316;217;583;294;289;986;507;479;2619;1694;925;451.0;542.0;464.0;344.0;2671.0;2928.0;603
7420;Rijswijk (ZH.);2012;45951;9151;27318;9482;32432;7083;3713;3370;6436;3701;2735;1633;855;778;534;310;224;594;310;284;1013;527;486;2662;1699;963;448.0;525.0;465.0;340.0;2633.0;2790.0;603
7421;Rijswijk (ZH.);2013;45846;9205;27074;9567;32103;7157;3776;3381;6586;3730;2856;1632;846;786;546;309;237;628;306;322;1049;535;514;2731;1734;997;438.0;524.0;458.0;344.0;2434.0;2730.0;603
7422;Rijswijk (ZH.);2014;45581;9245;26739;9597;31614;7238;3823;3415;6729;3758;2971;1657;848;809;544;303;241;649;315;334;1091;558;533;2788;1734;1054;434.0;527.0;454.0;353.0;2381.0;2677.0;603
7423;Rijswijk (ZH.);2015;45297;9233;26459;9605;31243;7313;3867;3446;6741;3728;3013;1638;827;811;551;313;238;664;321;343;1145;574;571;2743;1693;1050;452.0;517.0;463.0;333.0;2283.0;2626.0;603
7424;Rijswijk (ZH.);2016;45023;9229;26134;9660;30828;7422;3965;3457;6773;3721;3052;1620;810;810;554;314;240;684;332;352;1166;589;577;2749;1676;1073;446.0;499.0;477.0;332.0;2255.0;2592.0;603
7425;Rijswijk (ZH.);2017;44781;9215;25930;9636;30427;7514;4024;3490;6840;3764;3076;1587;798;789;567;314;253;706;341;365;1184;605;579;2796;1706;1090;439.0;498.0;455.0;326.0;2239.0;2551.0;603
7426;Rijswijk (ZH.);2018;44540;9193;25724;9623;30052;7593;4047;3546;6895;3782;3113;1576;783;793;565;317;248;724;346;378;1194;614;580;2836;1722;1114;442.0;487.0;450.0;323.0;2303.0;2555.0;603
7427;Rijswijk (ZH.);2019;44372;9189;25491;9692;29770;7641;4055;3586;6961;3771;3190;1544;769;775;579;318;261;753;349;404;1222;626;596;2863;1709;1154;443.0;484.0;455.0;328.0;2167.0;2482.0;603
7428;Rijswijk (ZH.);2020;44147;9158;25266;9723;29407;7751;4114;3637;6989;3759;3230;1539;759;780;581;327;254;760;347;413;1241;627;614;2868;1699;1169;443.0;486.0;455.0;336.0;2229.0;2529.0;603
7429;Rijswijk (ZH.);2021;43925;9163;25021;9741;29021;7867;4176;3691;7037;3783;3254;1544;765;779;597;331;266;766;353;413;1252;616;636;2878;1718;1160;441.0;481.0;455.0;319.0;2176.0;2547.0;603
7430;Rijswijk (ZH.);2022;43654;9137;24785;9732;28676;7962;4215;3747;7016;3745;3271;1503;731;772;616;348;268;767;352;415;1260;612;648;2870;1702;1168;442.0;477.0;435.0;325.0;2122.0;2502.0;603
7431;Rijswijk (ZH.);2023;43356;9056;24551;9749;28308;8009;4249;3760;7039;3757;3282;1494;730;764;601;340;261;767;355;412;1269;621;648;2908;1711;1197;443.0;472.0;432.0;325.0;2153.0;2446.0;603
7432;Rijswijk (ZH.);2024;43143;8996;24357;9790;28051;8092;4310;3782;7000;3704;3296;1470;720;750;600;339;261;764;356;408;1261;618;643;2905;1671;1234;436.0;470.0;423.0;308.0;2204.0;2456.0;603
7433;Rijswijk (ZH.);2025;42976;8940;24258;9778;27760;8199;4360;3839;7017;3665;3352;1458;702;756;595;325;270;772;357;415;1267;617;650;2925;1664;1261;;;;;;;603
7434;Roerdalen;2008;20834;4409;12765;3660;17576;2764;1054;1710;494;302;192;58;27;31;53;29;24;33;16;17;44;20;24;306;210;96;150.0;167.0;114.0;137.0;820.0;900.0;1669
7435;Roerdalen;2009;20716;4284;12638;3794;17458;2730;1038;1692;528;313;215;72;35;37;51;30;21;42;20;22;60;26;34;303;202;101;152.0;167.0;115.0;134.0;781.0;953.0;1669
7436;Roerdalen;2010;20514;4217;12391;3906;17272;2662;1015;1647;580;325;255;81;41;40;63;32;31;58;27;31;73;27;46;305;198;107;148.0;169.0;122.0;141.0;888.0;935.0;1669
7437;Roerdalen;2011;20428;4104;12304;4020;17181;2622;999;1623;625;343;282;90;47;43;71;35;36;62;29;33;81;26;55;321;206;115;138.0;179.0;121.0;129.0;821.0;933.0;1669
7438;Roerdalen;2012;20268;4033;12054;4181;17014;2603;998;1605;651;347;304;86;47;39;83;41;42;71;31;40;86;30;56;325;198;127;144.0;178.0;120.0;130.0;791.0;943.0;1669
7439;Roerdalen;2013;20073;3926;11817;4330;16815;2592;1016;1576;666;348;318;90;49;41;80;39;41;77;35;42;98;34;64;321;191;130;145.0;184.0;121.0;120.0;778.0;927.0;1669
7440;Roerdalen;2014;19888;3829;11577;4482;16633;2561;997;1564;694;365;329;97;54;43;89;43;46;88;36;52;98;36;62;322;196;126;141.0;188.0;117.0;123.0;773.0;922.0;1669
7441;Roerdalen;2015;19689;3732;11309;4648;16427;2523;994;1529;739;388;351;106;59;47;95;44;51;96;40;56;105;37;68;337;208;129;146.0;194.0;117.0;118.0;756.0;903.0;1669
7442;Roerdalen;2016;19494;3655;11076;4763;16237;2487;993;1494;770;387;383;106;57;49;95;41;54;100;39;61;111;39;72;358;211;147;141.0;199.0;115.0;122.0;717.0;884.0;1669
7443;Roerdalen;2017;19264;3552;10848;4864;16050;2466;969;1497;748;375;373;115;65;50;101;41;60;94;39;55;110;36;74;328;194;134;138.0;192.0;111.0;112.0;722.0;877.0;1669
7444;Roerdalen;2018;19056;3482;10587;4987;15846;2430;957;1473;780;384;396;123;69;54;112;48;64;96;41;55;118;35;83;331;191;140;141.0;202.0;106.0;113.0;748.0;888.0;1669
7445;Roerdalen;2019;18850;3435;10334;5081;15668;2384;940;1444;798;388;410;124;70;54;113;46;67;101;45;56;126;38;88;334;189;145;132.0;207.0;107.0;108.0;709.0;850.0;1669
7446;Roerdalen;2020;18637;3363;10138;5136;15446;2350;934;1416;841;404;437;127;70;57;115;45;70;115;46;69;138;43;95;346;200;146;137.0;203.0;108.0;109.0;709.0;854.0;1669
7447;Roerdalen;2021;18427;3260;9966;5201;15279;2284;902;1382;864;409;455;132;75;57;121;47;74;121;46;75;143;45;98;347;196;151;138.0;202.0;97.0;105.0;701.0;849.0;1669
7448;Roerdalen;2022;18209;3215;9761;5233;15077;2256;885;1371;876;421;455;143;83;60;124;44;80;120;49;71;144;45;99;345;200;145;137.0;205.0;99.0;107.0;705.0;839.0;1669
7449;Roerdalen;2023;18001;3144;9576;5281;14857;2239;890;1349;905;431;474;135;81;54;126;42;84;132;56;76;160;49;111;352;203;149;139.0;212.0;97.0;102.0;671.0;812.0;1669
7450;Roerdalen;2024;17785;3090;9348;5347;14667;2197;878;1319;921;441;480;139;83;56;132;47;85;133;57;76;159;49;110;358;205;153;138.0;214.0;110.0;95.0;657.0;813.0;1669
7451;Roerdalen;2025;17572;3060;9087;5425;14480;2165;866;1299;927;443;484;131;78;53;133;47;86;139;61;78;157;50;107;367;207;160;;;;;;;1669
7452;Roermond;2008;54385;12347;33306;8732;40292;7584;2998;4586;6509;3638;2871;314;172;142;349;206;143;2032;1077;955;1860;896;964;1954;1287;667;573.0;500.0;331.0;498.0;2317.0;1977.0;957
7453;Roermond;2009;54636;12321;33410;8905;40531;7558;2986;4572;6547;3698;2849;330;183;147;355;217;138;2024;1065;959;1824;889;935;2014;1344;670;588.0;524.0;334.0;491.0;2254.0;2043.0;957
7454;Roermond;2010;54762;12307;33348;9107;40726;7561;2981;4580;6475;3671;2804;337;194;143;351;221;130;1994;1044;950;1778;879;899;2015;1333;682;584.0;523.0;347.0;473.0;2253.0;2080.0;957
7455;Roermond;2011;54875;12282;33243;9350;40895;7540;3001;4539;6440;3652;2788;350;209;141;342;212;130;1964;1024;940;1759;857;902;2025;1350;675;576.0;533.0;339.0;474.0;2228.0;2042.0;957
7456;Roermond;2012;54975;12236;33002;9737;41075;7476;2990;4486;6424;3650;2774;360;219;141;359;225;134;1918;1001;917;1733;843;890;2054;1362;692;571.0;546.0;346.0;474.0;2192.0;2036.0;957
7457;Roermond;2013;55034;12218;32738;10078;41230;7411;2970;4441;6393;3614;2779;392;236;156;367;229;138;1866;965;901;1697;828;869;2071;1356;715;556.0;559.0;354.0;437.0;2209.0;2066.0;957
7458;Roermond;2014;55094;12234;32533;10327;41283;7375;2959;4416;6436;3611;2825;422;247;175;379;233;146;1847;949;898;1689;825;864;2099;1357;742;559.0;572.0;344.0;421.0;2222.0;2099.0;957
7459;Roermond;2015;55132;12163;32312;10657;41367;7355;2969;4386;6410;3579;2831;432;249;183;379;223;156;1790;924;866;1692;819;873;2117;1364;753;561.0;564.0;339.0;427.0;2168.0;2035.0;957
7460;Roermond;2016;55178;12180;32090;10908;41418;7330;2981;4349;6430;3615;2815;442;255;187;384;233;151;1772;922;850;1666;809;857;2166;1396;770;567.0;586.0;337.0;436.0;2211.0;2013.0;957
7461;Roermond;2017;55262;12192;31856;11214;41518;7334;2996;4338;6410;3591;2819;464;274;190;377;230;147;1748;910;838;1643;797;846;2178;1380;798;562.0;592.0;325.0;401.0;2182.0;2053.0;957
7462;Roermond;2018;55289;12190;31634;11465;41591;7288;3010;4278;6410;3597;2813;477;279;198;388;236;152;1705;885;820;1648;810;838;2192;1387;805;560.0;597.0;323.0;404.0;2178.0;2047.0;957
7463;Roermond;2019;55306;12129;31500;11677;41576;7276;3003;4273;6454;3622;2832;483;282;201;395;243;152;1681;876;805;1654;814;840;2241;1407;834;559.0;606.0;317.0;416.0;2195.0;2049.0;957
7464;Roermond;2020;55310;12086;31308;11916;41602;7254;3001;4253;6454;3606;2848;500;290;210;398;238;160;1650;865;785;1628;797;831;2278;1416;862;552.0;608.0;330.0;394.0;2148.0;2031.0;957
7465;Roermond;2021;55312;12045;31078;12189;41648;7178;2955;4223;6486;3619;2867;519;290;229;415;245;170;1618;861;757;1628;794;834;2306;1429;877;547.0;609.0;313.0;395.0;2099.0;2053.0;957
7466;Roermond;2022;55216;11956;30907;12353;41637;7112;2947;4165;6467;3607;2860;528;292;236;424;249;175;1580;848;732;1585;776;809;2350;1442;908;542.0;622.0;316.0;379.0;2140.0;2055.0;957
7467;Roermond;2023;55166;11890;30787;12489;41630;7100;2963;4137;6436;3605;2831;536;293;243;443;256;187;1546;835;711;1543;771;772;2368;1450;918;543.0;631.0;299.0;372.0;2130.0;2013.0;957
7468;Roermond;2024;55129;11889;30573;12667;41590;7092;2965;4127;6447;3614;2833;549;297;252;448;262;186;1536;817;719;1508;763;745;2406;1475;931;541.0;638.0;312.0;383.0;2147.0;1994.0;957
7469;Roermond;2025;55120;11875;30356;12889;41527;7126;2986;4140;6467;3642;2825;576;308;268;471;279;192;1482;803;679;1510;777;733;2428;1475;953;;;;;;;957
7470;De Ronde Venen;2008;34438;8801;20905;4732;30192;2363;926;1437;1883;992;891;272;132;140;123;48;75;226;119;107;531;267;264;731;426;305;306.0;247.0;108.0;157.0;1109.0;1086.0;736
7471;De Ronde Venen;2009;34476;8657;20859;4960;30140;2381;934;1447;1955;1029;926;290;137;153;125;51;74;249;135;114;542;262;280;749;444;305;294.0;251.0;112.0;149.0;1201.0;1103.0;736
7472;De Ronde Venen;2010;34583;8532;20834;5217;30140;2413;943;1470;2030;1046;984;308;142;166;137;60;77;258;140;118;554;265;289;773;439;334;295.0;263.0;123.0;157.0;1038.0;1100.0;736
7473;De Ronde Venen;2011;34522;8379;20758;5385;30002;2429;944;1485;2091;1066;1025;326;146;180;134;59;75;274;141;133;561;259;302;796;461;335;288.0;266.0;130.0;138.0;1100.0;1118.0;736
7474;De Ronde Venen;2012;34523;8196;20587;5740;29913;2463;966;1497;2147;1102;1045;341;158;183;139;64;75;283;150;133;576;263;313;808;467;341;291.0;284.0;131.0;142.0;1180.0;1119.0;736
7475;De Ronde Venen;2013;34583;8060;20513;6010;29842;2507;996;1511;2234;1128;1106;342;162;180;145;65;80;318;160;158;591;261;330;838;480;358;290.0;284.0;127.0;143.0;1185.0;1118.0;736
7476;De Ronde Venen;2014;34641;7919;20463;6259;29816;2518;1001;1517;2307;1145;1162;345;162;183;142;63;79;336;165;171;608;257;351;876;498;378;290.0;293.0;122.0;137.0;1141.0;1105.0;736
7477;De Ronde Venen;2015;34662;7784;20393;6485;29742;2557;1021;1536;2363;1182;1181;369;175;194;150;70;80;342;172;170;593;247;346;909;518;391;296.0;305.0;120.0;150.0;1285.0;1100.0;736
7478;De Ronde Venen;2016;34808;7712;20412;6684;29779;2594;1033;1561;2435;1219;1216;379;178;201;156;79;77;364;187;177;611;251;360;925;524;401;304.0;310.0;118.0;145.0;1370.0;1122.0;736
7479;De Ronde Venen;2017;35025;7636;20492;6897;29843;2641;1041;1600;2541;1274;1267;389;179;210;165;83;82;385;201;184;620;256;364;982;555;427;315.0;318.0;128.0;146.0;1291.0;1136.0;736
7480;De Ronde Venen;2018;35167;7524;20584;7059;29831;2710;1053;1657;2626;1309;1317;395;179;216;170;90;80;395;204;191;636;268;368;1030;568;462;317.0;325.0;128.0;143.0;1277.0;1130.0;736
7481;De Ronde Venen;2019;35293;7462;20562;7269;29846;2731;1050;1681;2716;1343;1373;406;182;224;178;92;86;410;209;201;659;274;385;1063;586;477;329.0;336.0;127.0;136.0;1253.0;1154.0;736
7482;De Ronde Venen;2020;35378;7388;20517;7473;29791;2779;1075;1704;2808;1380;1428;423;187;236;190;101;89;432;205;227;669;276;393;1094;611;483;338.0;343.0;114.0;135.0;1316.0;1124.0;736
7483;De Ronde Venen;2021;35546;7316;20577;7653;29785;2842;1124;1718;2919;1426;1493;441;199;242;193;101;92;456;212;244;686;284;402;1143;630;513;354.0;352.0;123.0;144.0;1289.0;1150.0;736
7484;De Ronde Venen;2022;35667;7237;20532;7898;29820;2875;1150;1725;2972;1447;1525;445;203;242;202;106;96;468;220;248;688;280;408;1169;638;531;357.0;361.0;123.0;134.0;1273.0;1164.0;736
7485;De Ronde Venen;2023;35765;7219;20477;8069;29837;2898;1155;1743;3030;1479;1551;462;213;249;210;110;100;474;226;248;684;280;404;1200;650;550;377.0;363.0;129.0;136.0;1274.0;1159.0;736
7486;De Ronde Venen;2024;35892;7174;20467;8251;29840;2932;1197;1735;3120;1526;1594;473;219;254;225;112;113;469;226;243;691;290;401;1262;679;583;377.0;376.0;125.0;137.0;1429.0;1185.0;736
7487;De Ronde Venen;2025;36130;7225;20412;8493;29960;2974;1221;1753;3196;1556;1640;486;221;265;242;120;122;486;229;257;680;291;389;1302;695;607;;;;;;;736
7488;Roosendaal;2008;77173;18364;46589;12220;61308;6710;2621;4089;9155;5077;4078;481;248;233;258;125;133;2197;1185;1012;3451;1674;1777;2768;1845;923;752.0;669.0;455.0;652.0;2030.0;2187.0;1674
7489;Roosendaal;2009;76910;18208;46187;12515;61088;6665;2622;4043;9157;5010;4147;522;262;260;276;141;135;2153;1159;994;3416;1658;1758;2790;1790;1000;754.0;684.0;456.0;629.0;2265.0;2213.0;1674
7490;Roosendaal;2010;76864;18079;45999;12786;60985;6619;2616;4003;9260;5006;4254;555;275;280;299;155;144;2148;1157;991;3427;1667;1760;2831;1752;1079;734.0;690.0;468.0;615.0;2139.0;2219.0;1674
7491;Roosendaal;2011;76697;17975;45634;13088;60736;6628;2633;3995;9333;4993;4340;586;295;291;324;169;155;2143;1153;990;3415;1655;1760;2865;1721;1144;726.0;704.0;478.0;606.0;2347.0;2254.0;1674
7492;Roosendaal;2012;76690;17869;45266;13555;60697;6651;2662;3989;9342;4941;4401;621;311;310;338;174;164;2128;1147;981;3403;1644;1759;2852;1665;1187;713.0;716.0;495.0;600.0;2286.0;2255.0;1674
7493;Roosendaal;2013;76622;17699;44879;14044;60541;6653;2667;3986;9428;4951;4477;655;318;337;355;187;168;2134;1151;983;3394;1646;1748;2890;1649;1241;692.0;723.0;479.0;579.0;2496.0;2278.0;1674
7494;Roosendaal;2014;76716;17570;44636;14510;60512;6646;2662;3984;9558;4997;4561;678;328;350;371;192;179;2169;1175;994;3405;1667;1738;2935;1635;1300;693.0;739.0;482.0;580.0;2415.0;2284.0;1674
7495;Roosendaal;2015;76710;17408;44392;14910;60449;6675;2701;3974;9586;5008;4578;705;345;360;394;214;180;2163;1188;975;3371;1658;1713;2953;1603;1350;695.0;745.0;472.0;557.0;2417.0;2283.0;1674
7496;Roosendaal;2016;76716;17254;44222;15240;60370;6713;2720;3993;9633;5031;4602;724;359;365;419;230;189;2165;1199;966;3353;1656;1697;2972;1587;1385;673.0;765.0;485.0;552.0;2385.0;2246.0;1674
7497;Roosendaal;2017;76703;17080;44073;15550;60302;6742;2734;4008;9659;5039;4620;741;367;374;440;250;190;2147;1205;942;3320;1644;1676;3011;1573;1438;689.0;776.0;478.0;544.0;2396.0;2281.0;1674
7498;Roosendaal;2018;76671;16940;43877;15854;60197;6764;2773;3991;9710;5069;4641;741;370;371;448;251;197;2141;1219;922;3287;1636;1651;3093;1593;1500;687.0;788.0;456.0;550.0;2314.0;2299.0;1674
7499;Roosendaal;2019;76497;16741;43656;16100;59979;6725;2743;3982;9793;5103;4690;794;396;398;459;252;207;2141;1220;921;3237;1630;1607;3162;1605;1557;691.0;794.0;467.0;534.0;2436.0;2230.0;1674
7500;Roosendaal;2020;76536;16605;43515;16416;59904;6776;2792;3984;9856;5119;4737;790;392;398;507;272;235;2130;1224;906;3220;1646;1574;3209;1585;1624;687.0;803.0;459.0;549.0;2548.0;2269.0;1674
7501;Roosendaal;2021;76619;16459;43554;16606;59936;6770;2799;3971;9913;5154;4759;810;402;408;526;287;239;2124;1221;903;3191;1641;1550;3262;1603;1659;702.0;798.0;467.0;511.0;2421.0;2267.0;1674
7502;Roosendaal;2022;76645;16310;43452;16883;59902;6753;2805;3948;9990;5165;4825;843;415;428;540;291;249;2118;1202;916;3142;1625;1517;3347;1632;1715;697.0;825.0;441.0;508.0;2407.0;2345.0;1674
7503;Roosendaal;2023;76519;16154;43248;17117;59834;6768;2839;3929;9917;5132;4785;847;418;429;549;298;251;2082;1189;893;3051;1599;1452;3388;1628;1760;702.0;836.0;437.0;521.0;2577.0;2266.0;1674
7504;Roosendaal;2024;76623;16054;43174;17395;59885;6791;2853;3938;9947;5143;4804;853;418;435;581;314;267;2082;1179;903;3029;1600;1429;3402;1632;1770;686.0;844.0;436.0;505.0;2557.0;2355.0;1674
7505;Roosendaal;2025;76610;15940;42928;17742;59804;6829;2884;3945;9977;5176;4801;872;422;450;626;335;291;2075;1194;881;2966;1569;1397;3438;1656;1782;;;;;;;1674
7506;Rotterdam;2008;583625;133016;365081;85528;326938;57921;29040;28881;198766;113702;85064;49576;28950;20626;18034;11870;6164;43316;22046;21270;35979;17813;18166;51861;33023;18838;7122.0;5764.0;6825.0;10186.0;22525.0;21867.0;599
7507;Rotterdam;2009;582366;132410;364219;85737;328782;58112;28838;29274;195472;110120;85352;48711;28202;20509;17729;11440;6289;42516;21360;21156;35857;17345;18512;50659;31773;18886;7081.0;5768.0;6966.0;9883.0;22261.0;21638.0;599
7508;Rotterdam;2010;581458;131957;363314;86187;330492;58354;28697;29657;192612;106981;85631;47834;27522;20312;17516;11095;6421;41809;20737;21072;35742;16937;18805;49711;30690;19021;7034.0;5729.0;7033.0;9626.0;21607.0;21229.0;599
7509;Rotterdam;2011;580602;131198;363281;86123;332027;58695;28669;30026;189880;104078;85802;47026;26922;20104;17334;10793;6541;41161;20162;20999;35562;16555;19007;48797;29646;19151;7061.0;5738.0;7008.0;9349.0;20914.0;20956.0;599
7510;Rotterdam;2012;579609;130409;360521;88679;333200;59034;28697;30337;187375;101372;86003;46259;26376;19883;17106;10500;6606;40579;19626;20953;35463;16218;19245;47968;28652;19316;6998.0;5714.0;6971.0;9039.0;20955.0;20783.0;599
7511;Rotterdam;2013;579061;129657;358614;90790;334548;59412;28801;30611;185101;99111;85990;45470;25839;19631;16933;10261;6672;39967;19172;20795;35335;15937;19398;47396;27902;19494;6984.0;5689.0;6911.0;8826.0;20565.0;20520.0;599
7512;Rotterdam;2014;578543;129354;356764;92425;335878;59713;28771;30942;182952;96870;86082;44709;25285;19424;16794;10059;6735;39401;18744;20657;35179;15639;19540;46869;27143;19726;7057.0;5702.0;6861.0;8652.0;20806.0;20542.0;599
7513;Rotterdam;2015;578433;129202;355568;93663;337247;60158;28896;31262;181028;94856;86172;43954;24746;19208;16710;9871;6839;38850;18316;20534;35019;15356;19663;46495;26567;19928;7009.0;5668.0;6680.0;8455.0;20692.0;20419.0;599
7514;Rotterdam;2016;578338;129049;354454;94835;338763;60574;28976;31598;179001;92945;86056;43245;24273;18972;16608;9701;6907;38302;17913;20389;34800;15093;19707;46046;25965;20081;7043.0;5685.0;6607.0;8305.0;20757.0;20594.0;599
7515;Rotterdam;2017;578221;129113;353146;95962;340099;60875;29000;31875;177247;91262;85985;42546;23782;18764;16493;9533;6960;37683;17535;20148;34662;14891;19771;45863;25521;20342;7115.0;5676.0;6491.0;8110.0;20471.0;20452.0;599
7516;Rotterdam;2018;578116;128956;351957;97203;341418;61259;29081;32178;175439;89539;85900;41916;23319;18597;16343;9340;7003;37200;17206;19994;34404;14619;19785;45576;25055;20521;7129.0;5688.0;6471.0;8013.0;20332.0;20478.0;599
7517;Rotterdam;2019;577946;128933;350710;98303;342385;61516;29089;32427;174045;87997;86048;41292;22866;18426;16223;9184;7039;36692;16829;19863;34280;14418;19862;45558;24700;20858;7204.0;5747.0;6354.0;7862.0;20906.0;20436.0;599
7518;Rotterdam;2020;578425;129101;349767;99557;343688;61989;29189;32800;172748;86486;86262;40671;22392;18279;16076;8986;7090;36348;16534;19814;34072;14186;19886;45581;24388;21193;7312.0;5756.0;6254.0;7715.0;20580.0;20460.0;599
7519;Rotterdam;2021;578703;128909;348913;100881;344704;62412;29283;33129;171587;85098;86489;40028;21913;18115;16042;8856;7186;35928;16211;19717;33969;13997;19972;45620;24121;21499;7323.0;5748.0;6224.0;7648.0;20461.0;20689.0;599
7520;Rotterdam;2022;578690;128910;347858;101922;345531;62768;29388;33380;170391;83673;86718;39423;21447;17976;15937;8670;7267;35599;15954;19645;33736;13756;19980;45696;23846;21850;7383.0;5797.0;6115.0;7460.0;20573.0;20536.0;599
7521;Rotterdam;2023;579034;128914;346889;103231;346390;63387;29584;33803;169257;82373;86884;38801;21029;17772;15824;8496;7328;35333;15696;19637;33574;13612;19962;45725;23540;22185;7395.0;5814.0;6054.0;7405.0;20767.0;20633.0;599
7522;Rotterdam;2024;579469;129089;345579;104801;347292;63985;29776;34209;168192;81104;87088;38134;20551;17583;15808;8401;7407;34975;15424;19551;33402;13414;19988;45873;23314;22559;7411.0;5907.0;6012.0;7275.0;20428.0;20657.0;599
7523;Rotterdam;2025;579540;129221;343822;106497;347891;64440;29849;34591;167209;79900;87309;37571;20109;17462;15743;8289;7454;34637;15157;19480;33150;13204;19946;46108;23141;22967;;;;;;;599
7524;Rozenburg;2008;12630;2854;7835;1941;10399;1243;531;712;988;573;415;147;80;67;129;77;52;292;155;137;43;24;19;377;237;140;130.0;106.0;51.0;63.0;584.0;605.0;600
7525;Rozenburg;2009;12623;2856;7740;2027;10380;1223;523;700;1020;583;437;143;83;60;129;76;53;297;153;144;54;26;28;397;245;152;122.0;107.0;49.0;59.0;555.0;607.0;600
7526;Rozenburg;2010;12578;2812;7647;2119;10347;1197;505;692;1034;589;445;147;83;64;126;74;52;294;152;142;54;22;32;413;258;155;125.0;111.0;44.0;61.0;479.0;585.0;600
7527;Rozenburg;2011;12471;2737;7569;2165;10232;1213;508;705;1026;575;451;145;84;61;126;68;58;293;152;141;60;26;34;402;245;157;120.0;115.0;44.0;60.0;537.0;596.0;600
7528;Rozenburg;2012;12402;2708;7442;2252;10164;1203;504;699;1035;577;458;149;90;59;125;68;57;289;149;140;71;28;43;401;242;159;119.0;109.0;42.0;61.0;573.0;588.0;600
7529;Rozenburg;2013;12380;2707;7296;2377;10113;1207;502;705;1060;577;483;156;91;65;122;67;55;295;147;148;81;31;50;406;241;165;120.0;119.0;45.0;55.0;590.0;569.0;600
7530;Rozenburg;2014;12393;2651;7293;2449;10095;1214;504;710;1084;588;496;165;95;70;127;69;58;292;145;147;85;34;51;415;245;170;126.0;121.0;44.0;53.0;599.0;594.0;600
7531;Rozenburg;2015;12395;2635;7261;2499;10046;1220;512;708;1129;595;534;180;95;85;128;69;59;291;145;146;94;35;59;436;251;185;117.0;125.0;46.0;50.0;573.0;586.0;600
7532;Rozenburg;2016;12370;2620;7190;2560;10011;1200;507;693;1159;613;546;184;101;83;130;73;57;292;148;144;103;39;64;450;252;198;120.0;126.0;43.0;50.0;557.0;598.0;600
7533;Rozenburg;2017;12317;2576;7140;2601;9964;1203;501;702;1150;618;532;180;101;79;133;76;57;285;148;137;102;39;63;450;254;196;121.0;124.0;49.0;52.0;531.0;595.0;600
7534;Rozenburg;2018;12247;2538;7095;2614;9888;1198;516;682;1161;630;531;181;104;77;135;78;57;286;145;141;101;40;61;458;263;195;115.0;129.0;48.0;47.0;588.0;570.0;600
7535;Rozenburg;2019;12254;2512;7104;2638;9846;1197;514;683;1211;661;550;177;98;79;145;83;62;285;144;141;115;48;67;489;288;201;124.0;129.0;42.0;48.0;541.0;585.0;600
7536;Rozenburg;2020;12200;2505;7026;2669;9778;1193;515;678;1229;677;552;185;102;83;141;79;62;289;145;144;114;45;69;500;306;194;117.0;130.0;41.0;54.0;622.0;587.0;600
7537;Rozenburg;2021;12209;2486;7020;2703;9783;1184;507;677;1242;669;573;180;96;84;141;77;64;286;141;145;121;47;74;514;308;206;118.0;133.0;45.0;48.0;602.0;585.0;600
7538;Rozenburg;2022;12210;2502;6980;2728;9753;1197;519;678;1260;679;581;179;99;80;131;73;58;289;149;140;126;49;77;535;309;226;118.0;138.0;44.0;52.0;633.0;596.0;600
7539;Rozenburg;2023;12220;2487;6990;2743;9750;1177;511;666;1293;691;602;180;99;81;137;72;65;300;157;143;125;52;73;551;311;240;126.0;136.0;43.0;47.0;570.0;593.0;600
7540;Rozenburg;2024;12183;2474;6973;2736;9697;1160;492;668;1326;706;620;181;100;81;134;70;64;293;155;138;140;55;85;578;326;252;125.0;136.0;47.0;49.0;616.0;587.0;600
7541;Rozenburg;2025;12202;2486;6946;2770;9678;1170;506;664;1354;726;628;190;104;86;136;74;62;305;158;147;142;54;88;581;336;245;;;;;;;600
7542;Rozendaal;2008;1570;369;823;378;1359;141;44;97;70;35;35;14;6;8;9;3;6;7;5;2;4;1;3;36;20;16;13.0;19.0;4.0;6.0;158.0;124.0;277
7543;Rozendaal;2009;1595;375;850;370;1378;147;46;101;70;35;35;15;7;8;7;2;5;6;4;2;6;2;4;36;20;16;14.0;19.0;7.0;7.0;145.0;135.0;277
7544;Rozendaal;2010;1600;382;855;363;1378;152;50;102;70;39;31;16;8;8;8;2;6;7;5;2;6;3;3;33;21;12;14.0;18.0;7.0;7.0;99.0;123.0;277
7545;Rozendaal;2011;1573;369;831;373;1360;145;44;101;68;38;30;15;8;7;8;2;6;10;5;5;6;3;3;29;20;9;14.0;18.0;5.0;7.0;123.0;126.0;277
7546;Rozendaal;2012;1564;359;825;380;1349;137;40;97;78;45;33;17;9;8;8;2;6;12;8;4;7;3;4;34;23;11;12.0;18.0;5.0;7.0;138.0;110.0;277
7547;Rozendaal;2013;1584;364;834;386;1352;144;41;103;88;48;40;19;9;10;7;2;5;15;9;6;10;3;7;37;25;12;13.0;18.0;4.0;7.0;148.0;119.0;277
7548;Rozendaal;2014;1605;372;854;379;1355;150;37;113;100;49;51;22;11;11;10;3;7;13;4;9;13;3;10;42;28;14;15.0;16.0;6.0;6.0;127.0;120.0;277
7549;Rozendaal;2015;1611;380;849;382;1355;147;35;112;109;54;55;23;10;13;7;3;4;16;6;10;13;4;9;50;31;19;15.0;20.0;6.0;7.0;119.0;123.0;277
7550;Rozendaal;2016;1601;375;857;369;1342;147;32;115;112;54;58;22;10;12;6;3;3;17;6;11;14;4;10;53;31;22;13.0;18.0;7.0;7.0;112.0;130.0;277
7551;Rozendaal;2017;1578;358;853;367;1314;152;36;116;112;60;52;24;12;12;8;5;3;15;7;8;15;6;9;50;30;20;15.0;19.0;6.0;7.0;159.0;124.0;277
7552;Rozendaal;2018;1608;358;885;365;1355;137;32;105;116;57;59;25;12;13;8;5;3;16;6;10;19;6;13;48;28;20;16.0;17.0;7.0;9.0;154.0;127.0;277
7553;Rozendaal;2019;1632;361;895;376;1380;140;33;107;112;56;56;22;11;11;8;5;3;19;9;10;15;4;11;48;27;21;16.0;18.0;5.0;8.0;109.0;135.0;277
7554;Rozendaal;2020;1601;361;871;369;1339;142;38;104;120;61;59;25;13;12;9;6;3;20;9;11;20;6;14;46;27;19;16.0;18.0;4.0;6.0;150.0;109.0;277
7555;Rozendaal;2021;1638;374;884;380;1365;138;39;99;135;69;66;24;13;11;9;5;4;24;11;13;21;7;14;57;33;24;15.0;19.0;9.0;7.0;130.0;147.0;277
7556;Rozendaal;2022;1619;363;872;384;1356;126;34;92;137;71;66;26;14;12;10;5;5;29;13;16;17;9;8;55;30;25;14.0;17.0;7.0;8.0;133.0;136.0;277
7557;Rozendaal;2023;1612;368;847;397;1351;123;34;89;138;67;71;25;15;10;11;5;6;32;14;18;17;8;9;53;25;28;15.0;18.0;5.0;6.0;144.0;138.0;277
7558;Rozendaal;2024;1614;376;835;403;1368;122;33;89;124;60;64;22;13;9;11;5;6;28;13;15;15;7;8;48;22;26;14.0;19.0;4.0;6.0;162.0;136.0;277
7559;Rozendaal;2025;1634;367;854;413;1369;132;39;93;133;58;75;25;13;12;12;5;7;30;12;18;15;7;8;51;21;30;;;;;;;277
7560;Rucphen;2008;21756;4555;13767;3434;20162;1074;366;708;520;304;216;85;47;38;45;19;26;43;23;20;87;32;55;260;183;77;154.0;226.0;68.0;100.0;442.0;483.0;840
7561;Rucphen;2009;21612;4498;13572;3542;19954;1103;383;720;555;312;243;84;46;38;45;15;30;61;33;28;100;33;67;265;185;80;154.0;234.0;80.0;96.0;410.0;509.0;840
7562;Rucphen;2010;21419;4375;13376;3668;19710;1112;385;727;597;343;254;89;52;37;49;17;32;65;31;34;107;41;66;287;202;85;146.0;236.0;79.0;97.0;413.0;502.0;840
7563;Rucphen;2011;21223;4246;13224;3753;19455;1130;404;726;638;350;288;102;55;47;53;21;32;80;34;46;111;44;67;292;196;96;151.0;239.0;82.0;97.0;511.0;541.0;840
7564;Rucphen;2012;21094;4118;13098;3878;19287;1131;407;724;676;375;301;105;58;47;50;22;28;85;38;47;128;48;80;308;209;99;153.0;246.0;73.0;89.0;536.0;527.0;840
7565;Rucphen;2013;20996;4037;12973;3986;19145;1134;415;719;717;392;325;110;59;51;56;28;28;86;41;45;145;49;96;320;215;105;147.0;255.0;79.0;91.0;521.0;540.0;840
7566;Rucphen;2014;20860;3937;12831;4092;18968;1144;422;722;748;392;356;110;58;52;65;36;29;94;40;54;153;46;107;326;212;114;150.0;250.0;78.0;88.0;552.0;539.0;840
7567;Rucphen;2015;20765;3879;12673;4213;18809;1163;433;730;793;408;385;118;59;59;69;40;29;103;42;61;163;47;116;340;220;120;155.0;257.0;82.0;79.0;628.0;529.0;840
7568;Rucphen;2016;20768;3876;12586;4306;18743;1184;445;739;841;421;420;123;62;61;67;37;30;105;46;59;193;52;141;353;224;129;162.0;262.0;83.0;86.0;531.0;543.0;840
7569;Rucphen;2017;20656;3777;12480;4399;18565;1183;451;732;908;448;460;136;67;69;75;40;35;115;45;70;199;55;144;383;241;142;165.0;261.0;79.0;91.0;578.0;528.0;840
7570;Rucphen;2018;20600;3726;12373;4501;18407;1233;477;756;960;477;483;137;70;67;94;53;41;123;49;74;210;57;153;396;248;148;166.0;264.0;93.0;87.0;559.0;541.0;840
7571;Rucphen;2019;20528;3658;12314;4556;18255;1273;495;778;1000;504;496;145;73;72;94;57;37;128;52;76;210;56;154;423;266;157;172.0;270.0;95.0;91.0;530.0;556.0;840
7572;Rucphen;2020;20410;3628;12145;4637;18066;1285;507;778;1059;519;540;154;76;78;96;55;41;134;53;81;222;55;167;453;280;173;173.0;267.0;83.0;90.0;606.0;535.0;840
7573;Rucphen;2021;20380;3570;12086;4724;17967;1310;520;790;1103;522;581;165;80;85;92;53;39;139;52;87;246;64;182;461;273;188;180.0;275.0;85.0;85.0;603.0;539.0;840
7574;Rucphen;2022;20352;3574;11973;4805;17878;1337;547;790;1137;539;598;172;85;87;93;52;41;146;53;93;254;68;186;472;281;191;183.0;286.0;84.0;89.0;633.0;527.0;840
7575;Rucphen;2023;20351;3578;11855;4918;17805;1349;559;790;1197;570;627;175;88;87;103;54;49;156;58;98;264;68;196;499;302;197;187.0;286.0;80.0;86.0;735.0;535.0;840
7576;Rucphen;2024;20448;3604;11847;4997;17800;1364;562;802;1284;605;679;180;91;89;111;54;57;163;57;106;294;70;224;536;333;203;199.0;294.0;87.0;84.0;565.0;561.0;840
7577;Rucphen;2025;20363;3609;11680;5074;17651;1390;586;804;1322;616;706;188;94;94;110;52;58;170;59;111;312;77;235;542;334;208;;;;;;;840
7578;Schagen;2008;19021;4384;11576;3061;16385;1513;626;887;1123;716;407;154;70;84;94;35;59;86;51;35;40;19;21;749;541;208;199.0;182.0;77.0;114.0;1061.0;977.0;441
7579;Schagen;2009;19087;4363;11570;3154;16425;1525;639;886;1137;720;417;157;72;85;89;33;56;95;56;39;46;20;26;750;539;211;193.0;185.0;82.0;116.0;1099.0;963.0;441
7580;Schagen;2010;19200;4373;11564;3263;16480;1547;663;884;1173;759;414;164;80;84;95;40;55;112;65;47;50;23;27;752;551;201;193.0;178.0;86.0;106.0;1088.0;974.0;441
7581;Schagen;2011;19311;4356;11611;3344;16528;1576;695;881;1207;763;444;169;81;88;96;38;58;132;74;58;57;23;34;753;547;206;194.0;192.0;92.0;113.0;1075.0;978.0;441
7582;Schagen;2012;19392;4330;11540;3522;16546;1616;729;887;1230;765;465;172;82;90;99;40;59;147;75;72;63;27;36;749;541;208;184.0;191.0;92.0;111.0;1083.0;983.0;441
7583;Schagen;2013;19468;4291;11475;3702;16562;1650;747;903;1256;779;477;179;86;93;108;50;58;161;81;80;69;29;40;739;533;206;184.0;191.0;96.0;112.0;1055.0;966.0;441
7584;Schagen;2014;19536;4262;11452;3822;16608;1678;768;910;1250;750;500;181;86;95;107;50;57;173;83;90;68;32;36;721;499;222;182.0;197.0;83.0;108.0;1066.0;967.0;441
7585;Schagen;2015;19596;4235;11408;3953;16632;1675;771;904;1289;768;521;182;86;96;104;47;57;192;95;97;86;36;50;725;504;221;186.0;198.0;85.0;109.0;1116.0;982.0;441
7586;Schagen;2016;19696;4223;11405;4068;16698;1703;778;925;1295;775;520;185;89;96;110;51;59;203;104;99;86;38;48;711;493;218;187.0;205.0;89.0;104.0;1121.0;997.0;441
7587;Schagen;2017;19789;4201;11415;4173;16742;1736;790;946;1311;775;536;189;91;98;116;55;61;209;103;106;82;33;49;715;493;222;184.0;207.0;87.0;109.0;1074.0;1002.0;441
7588;Schagen;2018;19819;4178;11376;4265;16732;1749;793;956;1338;797;541;197;100;97;115;53;62;221;108;113;91;37;54;714;499;215;181.0;210.0;81.0;106.0;1165.0;982.0;441
7589;Schagen;2019;19951;4173;11442;4336;16800;1764;823;941;1387;815;572;204;106;98;117;52;65;243;119;124;102;42;60;721;496;225;190.0;217.0;87.0;107.0;1107.0;980.0;441
7590;Schagen;2020;20034;4176;11449;4409;16811;1783;847;936;1440;830;610;204;103;101;117;50;67;253;123;130;115;49;66;751;505;246;189.0;223.0;81.0;103.0;1101.0;1024.0;441
7591;Schagen;2021;20057;4147;11452;4458;16794;1813;860;953;1450;841;609;205;101;104;124;56;68;257;141;116;116;47;69;748;496;252;185.0;219.0;94.0;99.0;1242.0;1021.0;441
7592;Schagen;2022;20242;4171;11518;4553;16899;1847;894;953;1496;862;634;207;109;98;127;54;73;268;150;118;117;49;68;777;500;277;187.0;231.0;84.0;102.0;1106.0;1039.0;441
7593;Schagen;2023;20249;4153;11515;4581;16857;1889;942;947;1503;882;621;206;111;95;129;57;72;268;146;122;121;55;66;779;513;266;190.0;231.0;80.0;104.0;1158.0;1036.0;441
7594;Schagen;2024;20307;4107;11555;4645;16880;1895;954;941;1532;910;622;212;111;101;129;57;72;268;152;116;119;54;65;804;536;268;194.0;242.0;84.0;98.0;1249.0;1016.0;441
7595;Schagen;2025;20481;4148;11654;4679;16957;1933;978;955;1591;935;656;217;112;105;131;58;73;278;158;120;137;60;77;828;547;281;;;;;;;441
7596;Scheemda;2008;14030;3306;8602;2122;13011;763;279;484;256;160;96;52;25;27;19;9;10;22;14;8;13;9;4;150;103;47;142.0;131.0;41.0;68.0;670.0;724.0;39
7597;Scheemda;2009;13962;3232;8576;2154;12891;766;279;487;305;179;126;56;29;27;20;11;9;33;23;10;23;10;13;173;106;67;132.0;126.0;42.0;75.0;598.0;720.0;39
7598;Scheemda;2010;13814;3129;8485;2200;12714;774;282;492;326;172;154;56;29;27;20;7;13;37;23;14;31;13;18;182;100;82;131.0;129.0;41.0;71.0;639.0;701.0;39
7599;Scheemda;2011;13724;3070;8426;2228;12619;759;275;484;346;187;159;55;29;26;27;10;17;45;30;15;34;15;19;185;103;82;128.0;133.0;43.0;65.0;637.0;720.0;39
7600;Scheemda;2012;13613;2963;8322;2328;12508;746;265;481;359;174;185;63;30;33;32;15;17;46;26;20;39;15;24;179;88;91;126.0;128.0;41.0;67.0;656.0;680.0;39
7601;Scheemda;2013;13562;2916;8214;2432;12430;752;275;477;380;176;204;63;31;32;33;13;20;59;31;28;43;14;29;182;87;95;127.0;126.0;48.0;69.0;624.0;704.0;39
7602;Scheemda;2014;13463;2877;8092;2494;12293;755;278;477;415;189;226;68;32;36;33;15;18;64;32;32;51;15;36;199;95;104;123.0;130.0;45.0;63.0;608.0;707.0;39
7603;Scheemda;2015;13340;2811;7927;2602;12152;755;276;479;433;207;226;62;32;30;37;19;18;73;39;34;53;17;36;208;100;108;121.0;130.0;44.0;63.0;580.0;678.0;39
7604;Scheemda;2016;13214;2735;7817;2662;12016;753;283;470;445;219;226;62;29;33;41;22;19;82;47;35;61;23;38;199;98;101;124.0;127.0;41.0;62.0;636.0;682.0;39
7605;Scheemda;2017;13145;2707;7731;2707;11934;755;281;474;456;226;230;63;33;30;42;23;19;83;45;38;71;24;47;197;101;96;122.0;131.0;40.0;64.0;607.0;686.0;39
7606;Scheemda;2018;13034;2646;7646;2742;11836;741;274;467;457;229;228;67;35;32;45;24;21;82;42;40;71;26;45;192;102;90;122.0;134.0;40.0;59.0;593.0;680.0;39
7607;Scheemda;2019;12917;2611;7508;2798;11714;743;272;471;460;235;225;69;38;31;46;25;21;73;39;34;77;29;48;195;104;91;119.0;135.0;42.0;60.0;565.0;635.0;39
7608;Scheemda;2020;12814;2552;7394;2868;11610;749;273;476;455;226;229;70;42;28;46;25;21;72;37;35;81;29;52;186;93;93;122.0;129.0;39.0;56.0;592.0;659.0;39
7609;Scheemda;2021;12724;2522;7273;2929;11510;744;259;485;470;233;237;78;45;33;50;24;26;70;36;34;76;27;49;196;101;95;122.0;136.0;35.0;59.0;582.0;665.0;39
7610;Scheemda;2022;12605;2465;7164;2976;11385;738;260;478;482;243;239;85;49;36;47;23;24;71;36;35;79;29;50;200;106;94;118.0;138.0;38.0;55.0;588.0;635.0;39
7611;Scheemda;2023;12521;2420;7052;3049;11287;732;269;463;502;252;250;91;53;38;47;24;23;68;33;35;82;31;51;214;111;103;122.0;139.0;39.0;53.0;601.0;650.0;39
7612;Scheemda;2024;12443;2388;6968;3087;11157;743;275;468;543;271;272;94;53;41;53;31;22;71;34;37;86;33;53;239;120;119;119.0;139.0;41.0;57.0;576.0;645.0;39
7613;Scheemda;2025;12339;2361;6863;3115;11061;732;274;458;546;274;272;91;53;38;56;32;24;80;37;43;86;37;49;233;115;118;;;;;;;39
7614;Schermer;2008;5351;1349;3284;718;4970;253;88;165;128;60;68;16;11;5;12;2;10;18;2;16;10;4;6;72;41;31;47.0;36.0;16.0;22.0;322.0;252.0;458
7615;Schermer;2009;5428;1326;3338;764;5037;259;86;173;132;62;70;16;9;7;13;3;10;17;2;15;8;5;3;78;43;35;49.0;37.0;17.0;23.0;243.0;256.0;458
7616;Schermer;2010;5422;1285;3326;811;5016;258;83;175;148;69;79;15;9;6;13;2;11;24;7;17;10;3;7;86;48;38;49.0;38.0;16.0;21.0;239.0;236.0;458
7617;Schermer;2011;5432;1258;3309;865;5013;260;79;181;159;75;84;19;10;9;13;3;10;28;9;19;7;2;5;92;51;41;50.0;41.0;18.0;23.0;243.0;241.0;458
7618;Schermer;2012;5438;1222;3270;946;5008;264;84;180;166;71;95;21;10;11;13;2;11;29;6;23;8;2;6;95;51;44;50.0;43.0;19.0;25.0;223.0;255.0;458
7619;Schermer;2013;5408;1181;3218;1009;4978;259;88;171;171;68;103;22;7;15;13;2;11;30;7;23;9;2;7;97;50;47;50.0;45.0;15.0;20.0;263.0;248.0;458
7620;Schermer;2014;5424;1170;3198;1056;4974;268;87;181;182;74;108;27;8;19;12;2;10;33;9;24;10;3;7;100;52;48;49.0;47.0;24.0;21.0;253.0;239.0;458
7621;Schermer;2015;5445;1144;3215;1086;4981;275;87;188;189;79;110;36;8;28;15;4;11;32;11;21;11;4;7;95;52;43;50.0;47.0;22.0;19.0;286.0;251.0;458
7622;Schermer;2016;5486;1117;3254;1115;4994;275;96;179;217;92;125;43;10;33;20;8;12;36;10;26;17;7;10;101;57;44;52.0;49.0;24.0;20.0;285.0;252.0;458
7623;Schermer;2017;5527;1125;3268;1134;5021;278;101;177;228;91;137;50;10;40;22;8;14;38;12;26;19;7;12;99;54;45;53.0;51.0;18.0;22.0;222.0;270.0;458
7624;Schermer;2018;5478;1103;3224;1151;4961;290;102;188;227;98;129;46;11;35;19;6;13;38;13;25;21;10;11;103;58;45;51.0;51.0;23.0;23.0;246.0;255.0;458
7625;Schermer;2019;5472;1079;3210;1183;4958;292;108;184;222;95;127;46;9;37;21;10;11;39;14;25;19;7;12;97;55;42;53.0;52.0;18.0;20.0;275.0;257.0;458
7626;Schermer;2020;5490;1055;3227;1208;4963;289;108;181;238;108;130;47;11;36;23;13;10;38;13;25;25;8;17;105;63;42;53.0;51.0;17.0;22.0;265.0;242.0;458
7627;Schermer;2021;5510;1050;3225;1235;4968;301;111;190;241;111;130;47;12;35;22;12;10;40;14;26;24;9;15;108;64;44;53.0;55.0;18.0;17.0;288.0;253.0;458
7628;Schermer;2022;5545;1058;3224;1263;4989;307;125;182;249;117;132;43;13;30;27;15;12;41;14;27;29;9;20;109;66;43;54.0;60.0;16.0;23.0;200.0;255.0;458
7629;Schermer;2023;5478;1016;3177;1285;4921;307;123;184;250;113;137;43;15;28;25;15;10;38;12;26;32;6;26;112;65;47;53.0;57.0;15.0;20.0;300.0;249.0;458
7630;Schermer;2024;5522;1025;3190;1307;4934;324;132;192;264;118;146;47;15;32;23;15;8;40;13;27;33;5;28;121;70;51;57.0;58.0;17.0;21.0;263.0;246.0;458
7631;Schermer;2025;5535;1030;3169;1336;4935;333;129;204;267;116;151;47;14;33;22;15;7;39;13;26;34;6;28;125;68;57;;;;;;;458
7632;Scherpenzeel;2008;8815;2475;5100;1240;8292;346;123;223;177;87;90;19;4;15;12;4;8;15;8;7;48;23;25;83;48;35;121.0;68.0;27.0;34.0;318.0;373.0;279
7633;Scherpenzeel;2009;8809;2442;5060;1307;8263;352;124;228;194;99;95;18;4;14;16;6;10;15;9;6;55;27;28;90;53;37;120.0;67.0;25.0;32.0;330.0;374.0;279
7634;Scherpenzeel;2010;8815;2414;5056;1345;8242;361;123;238;212;107;105;20;5;15;16;7;9;21;12;9;60;28;32;95;55;40;115.0;68.0;30.0;35.0;391.0;390.0;279
7635;Scherpenzeel;2011;8860;2410;5044;1406;8262;360;123;237;238;117;121;23;6;17;16;8;8;29;15;14;61;29;32;109;59;50;114.0;73.0;38.0;34.0;345.0;390.0;279
7636;Scherpenzeel;2012;8860;2370;5020;1470;8231;355;125;230;274;137;137;34;11;23;21;9;12;36;15;21;63;36;27;120;66;54;116.0;73.0;37.0;33.0;251.0;387.0;279
7637;Scherpenzeel;2013;8772;2310;4931;1531;8150;349;122;227;273;143;130;33;14;19;19;8;11;39;19;20;59;33;26;123;69;54;111.0;73.0;33.0;31.0;334.0;375.0;279
7638;Scherpenzeel;2014;8772;2278;4902;1592;8136;349;125;224;287;145;142;32;13;19;25;13;12;45;20;25;65;31;34;120;68;52;111.0;75.0;33.0;34.0;309.0;387.0;279
7639;Scherpenzeel;2015;8731;2221;4894;1616;8077;357;125;232;297;161;136;35;18;17;23;12;11;45;21;24;63;30;33;131;80;51;114.0;76.0;32.0;29.0;335.0;388.0;279
7640;Scherpenzeel;2016;8720;2202;4886;1632;8047;356;131;225;317;174;143;45;22;23;26;15;11;47;23;24;65;33;32;134;81;53;110.0;76.0;33.0;32.0;368.0;387.0;279
7641;Scherpenzeel;2017;8738;2171;4896;1671;8043;353;130;223;342;187;155;48;24;24;32;17;15;48;23;25;69;37;32;145;86;59;114.0;78.0;31.0;29.0;348.0;383.0;279
7642;Scherpenzeel;2018;8744;2153;4898;1693;8022;366;137;229;356;196;160;44;20;24;38;21;17;58;26;32;72;38;34;144;91;53;114.0;79.0;33.0;30.0;339.0;390.0;279
7643;Scherpenzeel;2019;8731;2127;4896;1708;7983;376;145;231;372;205;167;46;21;25;35;22;13;67;28;39;71;36;35;153;98;55;116.0;79.0;27.0;31.0;354.0;397.0;279
7644;Scherpenzeel;2020;8720;2075;4911;1734;7940;386;148;238;394;217;177;50;22;28;40;26;14;73;30;43;70;37;33;161;102;59;117.0;80.0;29.0;27.0;342.0;403.0;279
7645;Scherpenzeel;2021;8699;2032;4907;1760;7891;402;154;248;406;218;188;54;24;30;39;25;14;72;26;46;72;37;35;169;106;63;114.0;84.0;31.0;29.0;304.0;383.0;279
7646;Scherpenzeel;2022;8653;2007;4848;1798;7798;423;160;263;432;232;200;59;24;35;46;29;17;65;24;41;84;42;42;178;113;65;109.0;84.0;31.0;28.0;367.0;383.0;279
7647;Scherpenzeel;2023;8664;2032;4806;1826;7796;423;153;270;445;238;207;56;26;30;50;29;21;67;23;44;86;42;44;186;118;68;112.0;84.0;34.0;33.0;371.0;384.0;279
7648;Scherpenzeel;2024;8681;2020;4815;1846;7795;414;146;268;472;258;214;59;29;30;54;31;23;67;24;43;86;45;41;206;129;77;110.0;89.0;32.0;31.0;405.0;391.0;279
7649;Scherpenzeel;2025;8718;2026;4809;1883;7817;421;149;272;480;254;226;59;30;29;52;30;22;71;24;47;87;46;41;211;124;87;;;;;;;279
7650;Schiedam;2008;76280;17692;47163;11425;51649;6583;3168;3415;18048;10098;7950;2588;1397;1191;1473;990;483;7057;3618;3439;2070;1010;1060;4860;3083;1777;877.0;776.0;607.0;803.0;3941.0;3802.0;606
7651;Schiedam;2009;76331;17617;47222;11492;51482;6676;3211;3465;18173;10054;8119;2598;1386;1212;1459;959;500;7089;3633;3456;2181;1066;1115;4846;3010;1836;886.0;782.0;594.0;783.0;3918.0;3757.0;606
7652;Schiedam;2010;76413;17631;47225;11557;51313;6791;3282;3509;18309;10000;8309;2619;1379;1240;1481;931;550;7122;3642;3480;2228;1074;1154;4859;2974;1885;861.0;765.0;650.0;762.0;3891.0;3737.0;606
7653;Schiedam;2011;76557;17507;47516;11534;51206;6916;3345;3571;18435;9955;8480;2626;1369;1257;1469;918;551;7112;3611;3501;2331;1104;1227;4897;2953;1944;857.0;777.0;644.0;748.0;3832.0;3643.0;606
7654;Schiedam;2012;76735;17392;47300;12043;51057;7045;3407;3638;18633;9957;8676;2647;1360;1287;1493;893;600;7137;3608;3529;2426;1141;1285;4930;2955;1975;876.0;771.0;679.0;755.0;3874.0;3677.0;606
7655;Schiedam;2013;76966;17353;47120;12493;51023;7140;3435;3705;18803;9940;8863;2662;1351;1311;1519;898;621;7156;3612;3544;2507;1167;1340;4959;2912;2047;853.0;762.0;648.0;741.0;3761.0;3599.0;606
7656;Schiedam;2014;77134;17261;47052;12821;51000;7293;3499;3794;18841;9912;8929;2652;1352;1300;1509;878;631;7116;3607;3509;2584;1177;1407;4980;2898;2082;856.0;778.0;641.0;739.0;3781.0;3601.0;606
7657;Schiedam;2015;77304;17212;47020;13072;50923;7386;3536;3850;18995;9879;9116;2688;1347;1341;1525;863;662;7109;3603;3506;2671;1204;1467;5002;2862;2140;850.0;773.0;641.0;717.0;3668.0;3584.0;606
7658;Schiedam;2016;77396;17150;46915;13331;50836;7507;3583;3924;19053;9873;9180;2680;1329;1351;1515;861;654;7104;3610;3494;2752;1234;1518;5002;2839;2163;851.0;769.0;637.0;679.0;3768.0;3605.0;606
7659;Schiedam;2017;77605;17143;46921;13541;50743;7650;3647;4003;19212;9854;9358;2702;1321;1381;1498;829;669;7086;3592;3494;2846;1257;1589;5080;2855;2225;846.0;778.0;625.0;690.0;3804.0;3570.0;606
7660;Schiedam;2018;77845;17115;46952;13778;50754;7801;3728;4073;19290;9816;9474;2696;1313;1383;1472;805;667;7061;3560;3501;2936;1281;1655;5125;2857;2268;857.0;798.0;636.0;702.0;3880.0;3604.0;606
7661;Schiedam;2019;78117;17101;47040;13976;50780;7966;3812;4154;19371;9754;9617;2719;1312;1407;1464;781;683;7031;3555;3476;2995;1288;1707;5162;2818;2344;856.0;806.0;626.0;689.0;3826.0;3626.0;606
7662;Schiedam;2020;78310;17080;46993;14237;50748;8073;3890;4183;19489;9719;9770;2730;1309;1421;1470;761;709;7001;3522;3479;3052;1303;1749;5236;2824;2412;871.0;797.0;620.0;661.0;3804.0;3595.0;606
7663;Schiedam;2021;78559;17030;47019;14510;50724;8253;3969;4284;19582;9688;9894;2725;1290;1435;1476;752;724;7006;3530;3476;3092;1297;1795;5283;2819;2464;882.0;805.0;626.0;655.0;3816.0;3614.0;606
7664;Schiedam;2022;78812;17033;46981;14798;50758;8395;4061;4334;19659;9641;10018;2719;1279;1440;1468;739;729;6991;3493;3498;3159;1304;1855;5322;2826;2496;895.0;823.0;652.0;650.0;3833.0;3618.0;606
7665;Schiedam;2023;79107;17019;47012;15076;50827;8539;4135;4404;19741;9614;10127;2703;1272;1431;1489;748;741;6958;3453;3505;3226;1331;1895;5365;2810;2555;913.0;825.0;608.0;624.0;3848.0;3657.0;606
7666;Schiedam;2024;79374;16994;46993;15387;50887;8609;4194;4415;19878;9656;10222;2694;1259;1435;1529;778;751;6936;3421;3515;3280;1345;1935;5439;2853;2586;928.0;837.0;628.0;645.0;3777.0;3715.0;606
7667;Schiedam;2025;79518;17023;46805;15690;50872;8721;4255;4466;19925;9630;10295;2678;1260;1418;1542;758;784;6943;3414;3529;3308;1349;1959;5454;2849;2605;;;;;;;606
7668;Schiermonnikoog;2008;962;197;575;190;890;48;23;25;24;8;16;3;0;3;5;1;4;1;0;1;1;1;0;14;6;8;11.0;11.0;2.0;2.0;46.0;71.0;88
7669;Schiermonnikoog;2009;938;189;556;193;868;47;24;23;23;9;14;2;0;2;4;1;3;1;0;1;0;0;0;16;8;8;10.0;10.0;2.0;3.0;73.0;68.0;88
7670;Schiermonnikoog;2010;942;184;566;192;871;45;23;22;26;13;13;3;1;2;3;1;2;2;1;1;0;0;0;18;10;8;10.0;10.0;2.0;3.0;56.0;70.0;88
7671;Schiermonnikoog;2011;927;174;554;199;859;42;22;20;26;13;13;3;0;3;3;2;1;2;0;2;2;2;0;16;9;7;11.0;10.0;1.0;3.0;62.0;74.0;88
7672;Schiermonnikoog;2012;914;165;532;217;852;38;19;19;24;12;12;2;0;2;3;2;1;2;0;2;1;1;0;16;9;7;9.0;10.0;2.0;3.0;48.0;70.0;88
7673;Schiermonnikoog;2013;890;151;516;223;827;41;21;20;22;10;12;4;0;4;4;2;2;2;0;2;1;1;0;11;7;4;9.0;11.0;3.0;2.0;50.0;55.0;88
7674;Schiermonnikoog;2014;884;150;504;230;829;34;18;16;21;11;10;4;1;3;3;2;1;2;0;2;1;1;0;11;7;4;8.0;10.0;2.0;2.0;61.0;57.0;88
7675;Schiermonnikoog;2015;886;146;501;239;824;37;18;19;25;12;13;5;2;3;5;3;2;2;0;2;2;1;1;11;6;5;8.0;11.0;3.0;2.0;42.0;65.0;88
7676;Schiermonnikoog;2016;861;134;487;240;801;35;19;16;25;15;10;4;2;2;5;3;2;2;0;2;3;3;0;11;7;4;6.0;13.0;3.0;1.0;53.0;53.0;88
7677;Schiermonnikoog;2017;856;133;488;235;789;34;17;17;33;17;16;4;2;2;8;4;4;4;0;4;3;3;0;14;8;6;7.0;12.0;1.0;3.0;41.0;56.0;88
7678;Schiermonnikoog;2018;834;118;475;241;769;32;15;17;33;18;15;3;2;1;7;5;2;5;0;5;3;3;0;15;8;7;7.0;11.0;3.0;2.0;44.0;49.0;88
7679;Schiermonnikoog;2019;826;123;461;242;756;34;14;20;36;21;15;3;2;1;7;5;2;6;1;5;4;3;1;16;10;6;6.0;11.0;1.0;3.0;48.0;55.0;88
7680;Schiermonnikoog;2020;812;120;443;249;738;36;15;21;38;22;16;3;2;1;8;6;2;6;1;5;4;3;1;17;10;7;8.0;11.0;3.0;3.0;54.0;61.0;88
7681;Schiermonnikoog;2021;802;105;440;257;726;36;16;20;40;21;19;5;2;3;10;6;4;7;1;6;3;3;0;15;9;6;9.0;10.0;3.0;4.0;53.0;52.0;88
7682;Schiermonnikoog;2022;801;106;432;263;724;36;16;20;41;23;18;5;2;3;11;6;5;6;1;5;3;3;0;16;11;5;8.0;12.0;2.0;3.0;62.0;53.0;88
7683;Schiermonnikoog;2023;805;103;436;266;717;38;17;21;50;24;26;6;2;4;10;3;7;8;2;6;4;3;1;22;14;8;8.0;12.0;2.0;3.0;57.0;48.0;88
7684;Schiermonnikoog;2024;809;107;430;272;723;36;15;21;50;26;24;6;2;4;9;2;7;7;2;5;4;3;1;24;17;7;8.0;12.0;2.0;4.0;43.0;62.0;88
7685;Schiermonnikoog;2025;784;97;422;265;704;30;12;18;50;27;23;6;2;4;10;3;7;7;2;5;5;4;1;22;16;6;;;;;;;88
7686;Schijndel;2008;22512;5534;13723;3255;20834;1056;458;598;622;386;236;123;77;46;38;21;17;49;28;21;100;51;49;312;209;103;214.0;164.0;65.0;92.0;503.0;739.0;844
7687;Schijndel;2009;22304;5382;13601;3321;20598;1048;465;583;658;411;247;121;77;44;40;23;17;63;38;25;111;53;58;323;220;103;209.0;163.0;65.0;92.0;638.0;755.0;844
7688;Schijndel;2010;22208;5304;13500;3404;20446;1058;474;584;704;445;259;134;87;47;48;27;21;83;50;33;116;61;55;323;220;103;207.0;165.0;61.0;93.0;627.0;781.0;844
7689;Schijndel;2011;22064;5209;13349;3506;20272;1054;469;585;738;477;261;136;92;44;48;28;20;96;60;36;124;62;62;334;235;99;193.0;171.0;61.0;86.0;749.0;791.0;844
7690;Schijndel;2012;22023;5107;13285;3631;20165;1071;473;598;787;498;289;147;97;50;53;33;20;111;65;46;131;63;68;345;240;105;199.0;170.0;66.0;91.0;692.0;819.0;844
7691;Schijndel;2013;21901;4995;13129;3777;20002;1069;469;600;830;517;313;149;99;50;57;34;23;129;73;56;142;67;75;353;244;109;195.0;177.0;62.0;85.0;719.0;803.0;844
7692;Schijndel;2014;21816;4912;13012;3892;19864;1072;463;609;880;538;342;152;95;57;65;40;25;150;85;65;149;68;81;364;250;114;191.0;184.0;69.0;82.0;745.0;815.0;844
7693;Schijndel;2015;21744;4850;12871;4023;19752;1071;454;617;921;548;373;164;97;67;68;41;27;162;88;74;161;79;82;366;243;123;198.0;182.0;67.0;80.0;772.0;826.0;844
7694;Schijndel;2016;21699;4780;12751;4168;19624;1101;459;642;974;574;400;169;99;70;67;39;28;174;99;75;176;79;97;388;258;130;202.0;187.0;71.0;83.0;821.0;819.0;844
7695;Schijndel;2017;21707;4724;12697;4286;19536;1118;473;645;1053;612;441;170;99;71;73;41;32;200;102;98;195;92;103;415;278;137;202.0;191.0;79.0;80.0;806.0;846.0;844
7696;Schijndel;2018;21681;4643;12652;4386;19463;1125;474;651;1093;631;462;172;101;71;79;47;32;212;105;107;207;93;114;423;285;138;209.0;199.0;63.0;83.0;838.0;818.0;844
7697;Schijndel;2019;21694;4592;12615;4487;19383;1151;489;662;1160;652;508;168;97;71;85;49;36;239;109;130;215;94;121;453;303;150;208.0;202.0;63.0;86.0;838.0;835.0;844
7698;Schijndel;2020;21681;4536;12564;4581;19306;1159;506;653;1216;670;546;176;100;76;96;56;40;270;125;145;211;89;122;463;300;163;218.0;206.0;66.0;80.0;841.0;840.0;844
7699;Schijndel;2021;21680;4426;12559;4695;19246;1185;513;672;1249;692;557;182;106;76;101;62;39;275;126;149;218;93;125;473;305;168;224.0;207.0;65.0;92.0;851.0;827.0;844
7700;Schijndel;2022;21698;4380;12519;4799;19212;1193;519;674;1293;702;591;186;106;80;105;64;41;298;134;164;227;94;133;477;304;173;232.0;210.0;66.0;87.0;935.0;853.0;844
7701;Schijndel;2023;21786;4391;12498;4897;19228;1208;525;683;1350;722;628;186;105;81;119;73;46;303;136;167;231;92;139;511;316;195;241.0;211.0;67.0;78.0;865.0;854.0;844
7702;Schijndel;2024;21817;4414;12374;5029;19233;1212;534;678;1372;742;630;190;107;83;129;74;55;316;140;176;234;100;134;503;321;182;239.0;220.0;64.0;74.0;907.0;853.0;844
7703;Schijndel;2025;21882;4437;12318;5127;19218;1235;544;691;1429;772;657;189;106;83;137;81;56;339;152;187;243;102;141;521;331;190;;;;;;;844
7704;Schinnen;2008;13383;2960;8052;2371;11099;1871;503;1368;413;278;135;20;7;13;26;12;14;45;26;19;34;17;17;288;216;72;97.0;123.0;78.0;109.0;792.0;752.0;962
7705;Schinnen;2009;13367;2913;8010;2444;11035;1867;494;1373;465;305;160;34;11;23;23;9;14;51;30;21;43;20;23;314;235;79;96.0;123.0;76.0;107.0;784.0;796.0;962
7706;Schinnen;2010;13298;2840;7955;2503;10929;1861;503;1358;508;340;168;36;16;20;24;9;15;60;36;24;54;26;28;334;253;81;95.0;124.0;93.0;105.0;814.0;809.0;962
7707;Schinnen;2011;13262;2794;7873;2595;10876;1852;501;1351;534;352;182;39;19;20;31;19;12;68;35;33;55;29;26;341;250;91;95.0;132.0;91.0;98.0;787.0;807.0;962
7708;Schinnen;2012;13200;2731;7788;2681;10818;1815;487;1328;567;373;194;43;21;22;33;21;12;72;39;33;64;31;33;355;261;94;98.0;126.0;81.0;102.0;799.0;805.0;962
7709;Schinnen;2013;13147;2681;7682;2784;10779;1752;472;1280;616;401;215;45;23;22;31;20;11;83;43;40;68;32;36;389;283;106;102.0;137.0;92.0;98.0;785.0;805.0;962
7710;Schinnen;2014;13086;2626;7627;2833;10702;1731;485;1246;653;414;239;52;26;26;30;16;14;83;41;42;72;33;39;416;298;118;104.0;139.0;83.0;96.0;800.0;804.0;962
7711;Schinnen;2015;13035;2578;7560;2897;10643;1701;490;1211;691;441;250;55;31;24;34;19;15;90;41;49;70;35;35;442;315;127;105.0;138.0;78.0;91.0;806.0;803.0;962
7712;Schinnen;2016;12995;2538;7506;2951;10614;1671;495;1176;710;443;267;59;38;21;27;15;12;107;47;60;73;35;38;444;308;136;112.0;141.0;86.0;89.0;776.0;823.0;962
7713;Schinnen;2017;12917;2489;7419;3009;10528;1636;500;1136;753;462;291;62;42;20;29;14;15;115;52;63;80;34;46;467;320;147;111.0;145.0;79.0;93.0;772.0;793.0;962
7714;Schinnen;2018;12849;2453;7330;3066;10450;1618;497;1121;781;468;313;66;40;26;27;11;16;119;46;73;88;38;50;481;333;148;113.0;144.0;83.0;89.0;808.0;790.0;962
7715;Schinnen;2019;12831;2422;7281;3128;10409;1626;515;1111;796;478;318;66;42;24;34;12;22;117;47;70;89;39;50;490;338;152;119.0;149.0;74.0;92.0;768.0;803.0;962
7716;Schinnen;2020;12748;2430;7156;3162;10366;1592;523;1069;790;466;324;74;47;27;35;14;21;118;45;73;83;34;49;480;326;154;119.0;148.0;81.0;89.0;760.0;797.0;962
7717;Schinnen;2021;12677;2374;7103;3200;10267;1582;532;1050;828;481;347;71;46;25;38;15;23;120;46;74;91;34;57;508;340;168;118.0;147.0;74.0;88.0;757.0;781.0;962
7718;Schinnen;2022;12612;2340;7018;3254;10215;1547;534;1013;850;505;345;77;47;30;39;18;21;128;51;77;91;37;54;515;352;163;121.0;156.0;71.0;89.0;741.0;751.0;962
7719;Schinnen;2023;12551;2339;6929;3283;10143;1517;531;986;891;530;361;83;51;32;42;16;26;132;57;75;94;44;50;540;362;178;121.0;154.0;84.0;87.0;725.0;728.0;962
7720;Schinnen;2024;12514;2339;6864;3311;10114;1497;525;972;903;529;374;85;52;33;43;16;27;141;62;79;97;43;54;537;356;181;122.0;161.0;71.0;79.0;721.0;747.0;962
7721;Schinnen;2025;12440;2357;6740;3343;10055;1473;526;947;912;536;376;91;51;40;42;15;27;139;62;77;97;43;54;543;365;178;;;;;;;962
7722;Schoonhoven;2008;12163;2999;7436;1728;10372;728;226;502;1063;566;497;73;26;47;52;23;29;36;10;26;657;356;301;245;151;94;143.0;97.0;34.0;42.0;509.0;554.0;608
7723;Schoonhoven;2009;12164;2976;7403;1785;10378;711;218;493;1075;581;494;77;33;44;60;27;33;48;16;32;637;343;294;253;162;91;137.0;98.0;38.0;47.0;479.0;565.0;608
7724;Schoonhoven;2010;12110;2967;7296;1847;10321;713;228;485;1076;565;511;80;37;43;64;31;33;52;20;32;622;321;301;258;156;102;141.0;100.0;36.0;44.0;520.0;525.0;608
7725;Schoonhoven;2011;12139;2976;7257;1906;10349;722;248;474;1068;555;513;85;36;49;60;30;30;64;25;39;602;312;290;257;152;105;135.0;102.0;41.0;42.0;525.0;528.0;608
7726;Schoonhoven;2012;12169;2933;7224;2012;10356;732;252;480;1081;548;533;87;35;52;64;32;32;71;27;44;590;297;293;269;157;112;132.0;102.0;42.0;48.0;495.0;512.0;608
7727;Schoonhoven;2013;12177;2909;7190;2078;10318;761;267;494;1098;548;550;89;35;54;67;33;34;84;28;56;586;292;294;272;160;112;132.0;107.0;36.0;48.0;492.0;514.0;608
7728;Schoonhoven;2014;12169;2883;7111;2175;10313;753;260;493;1103;547;556;93;41;52;73;35;38;87;25;62;574;284;290;276;162;114;130.0;104.0;39.0;51.0;493.0;510.0;608
7729;Schoonhoven;2015;12166;2846;7114;2206;10303;757;256;501;1106;543;563;99;41;58;71;31;40;92;25;67;567;282;285;277;164;113;128.0;106.0;44.0;46.0;504.0;487.0;608
7730;Schoonhoven;2016;12203;2851;7072;2280;10334;766;252;514;1103;550;553;101;39;62;71;34;37;91;29;62;565;281;284;275;167;108;133.0;112.0;38.0;43.0;453.0;489.0;608
7731;Schoonhoven;2017;12184;2831;7033;2320;10302;759;264;495;1123;564;559;105;41;64;76;38;38;103;31;72;556;277;279;283;177;106;122.0;114.0;47.0;43.0;541.0;505.0;608
7732;Schoonhoven;2018;12233;2814;7018;2401;10337;781;287;494;1115;551;564;109;42;67;82;39;43;106;31;75;541;266;275;277;173;104;129.0;117.0;38.0;41.0;435.0;514.0;608
7733;Schoonhoven;2019;12163;2752;6955;2456;10293;775;280;495;1095;557;538;113;48;65;77;39;38;114;37;77;512;256;256;279;177;102;126.0;114.0;36.0;42.0;545.0;497.0;608
7734;Schoonhoven;2020;12217;2750;6969;2498;10330;772;290;482;1115;576;539;113;51;62;88;48;40;123;43;80;498;247;251;293;187;106;127.0;115.0;38.0;43.0;476.0;505.0;608
7735;Schoonhoven;2021;12196;2713;6961;2522;10301;787;295;492;1108;581;527;117;55;62;91;47;44;123;49;74;483;244;239;294;186;108;126.0;116.0;39.0;39.0;477.0;531.0;608
7736;Schoonhoven;2022;12153;2660;6931;2562;10266;783;296;487;1104;580;524;119;53;66;82;42;40;126;54;72;472;238;234;305;193;112;122.0;121.0;35.0;40.0;456.0;502.0;608
7737;Schoonhoven;2023;12105;2618;6886;2601;10223;785;302;483;1097;571;526;120;53;67;87;45;42;128;55;73;461;234;227;301;184;117;121.0;122.0;41.0;39.0;511.0;509.0;608
7738;Schoonhoven;2024;12110;2598;6849;2663;10218;792;302;490;1100;572;528;130;57;73;88;46;42;134;54;80;447;234;213;301;181;120;124.0;124.0;39.0;44.0;495.0;503.0;608
7739;Schoonhoven;2025;12098;2598;6809;2691;10207;778;297;481;1113;582;531;128;58;70;94;49;45;140;55;85;450;238;212;301;182;119;;;;;;;608
7740;Schouwen-Duiveland;2008;34300;7816;19684;6800;31056;2265;989;1276;979;536;443;129;52;77;61;23;38;108;54;54;67;27;40;614;380;234;299.0;346.0;125.0;133.0;1017.0;1099.0;1676
7741;Schouwen-Duiveland;2009;34168;7750;19427;6991;30770;2326;1004;1322;1072;579;493;140;55;85;67;28;39;123;60;63;101;43;58;641;393;248;288.0;353.0;144.0;136.0;1121.0;1110.0;1676
7742;Schouwen-Duiveland;2010;34128;7703;19228;7197;30574;2388;1036;1352;1166;638;528;163;70;93;74;33;41;149;68;81;112;50;62;668;417;251;282.0;353.0;144.0;135.0;989.0;1100.0;1676
7743;Schouwen-Duiveland;2011;33957;7583;19077;7297;30216;2456;1064;1392;1285;699;586;185;79;106;90;42;48;170;80;90;132;64;68;708;434;274;275.0;361.0;149.0;138.0;1192.0;1108.0;1676
7744;Schouwen-Duiveland;2012;33969;7503;18823;7643;30057;2512;1097;1415;1400;763;637;206;92;114;101;52;49;205;104;101;161;76;85;727;439;288;269.0;359.0;156.0;138.0;1070.0;1134.0;1676
7745;Schouwen-Duiveland;2013;33837;7431;18453;7953;29779;2553;1130;1423;1505;821;684;219;101;118;109;58;51;235;119;116;182;85;97;760;458;302;267.0;360.0;139.0;131.0;1153.0;1090.0;1676
7746;Schouwen-Duiveland;2014;33818;7346;18289;8183;29637;2608;1151;1457;1573;861;712;239;115;124;110;57;53;249;134;115;196;89;107;779;466;313;271.0;366.0;149.0;131.0;1111.0;1108.0;1676
7747;Schouwen-Duiveland;2015;33746;7269;18098;8379;29446;2663;1172;1491;1637;880;757;253;122;131;113;59;54;263;137;126;197;84;113;811;478;333;264.0;367.0;147.0;130.0;1245.0;1080.0;1676
7748;Schouwen-Duiveland;2016;33827;7215;18021;8591;29345;2742;1218;1524;1740;917;823;275;129;146;118;60;58;283;142;141;224;95;129;840;491;349;263.0;370.0;149.0;132.0;1294.0;1089.0;1676
7749;Schouwen-Duiveland;2017;33945;7199;17964;8782;29315;2799;1244;1555;1831;962;869;288;133;155;126;64;62;321;162;159;238;105;133;858;498;360;273.0;384.0;149.0;135.0;1189.0;1118.0;1676
7750;Schouwen-Duiveland;2018;33920;7134;17854;8932;29149;2863;1267;1596;1908;986;922;293;135;158;137;69;68;340;164;176;253;111;142;885;507;378;273.0;389.0;145.0;132.0;1369.0;1101.0;1676
7751;Schouwen-Duiveland;2019;34086;7097;17907;9082;29140;2921;1277;1644;2025;1039;986;311;146;165;151;72;79;364;170;194;276;123;153;923;528;395;270.0;394.0;147.0;131.0;1141.0;1114.0;1676
7752;Schouwen-Duiveland;2020;34006;6964;17826;9216;28902;2978;1289;1689;2126;1084;1042;328;147;181;159;76;83;386;184;202;299;135;164;954;542;412;275.0;388.0;166.0;133.0;1108.0;1120.0;1676
7753;Schouwen-Duiveland;2021;33918;6854;17717;9347;28691;3026;1335;1691;2201;1113;1088;335;148;187;167;77;90;410;199;211;311;138;173;978;551;427;277.0;398.0;151.0;136.0;1226.0;1102.0;1676
7754;Schouwen-Duiveland;2022;33938;6778;17666;9494;28570;3077;1353;1724;2291;1159;1132;342;152;190;177;81;96;431;209;222;319;136;183;1022;581;441;286.0;412.0;150.0;128.0;1100.0;1125.0;1676
7755;Schouwen-Duiveland;2023;33813;6712;17456;9645;28350;3092;1373;1719;2371;1203;1168;352;161;191;191;89;102;444;212;232;351;153;198;1033;588;445;284.0;418.0;148.0;132.0;1160.0;1075.0;1676
7756;Schouwen-Duiveland;2024;33784;6655;17377;9752;28210;3131;1403;1728;2443;1240;1203;359;166;193;198;88;110;471;234;237;358;150;208;1057;602;455;293.0;425.0;162.0;136.0;1296.0;1103.0;1676
7757;Schouwen-Duiveland;2025;33873;6659;17323;9891;28153;3187;1438;1749;2533;1270;1263;367;163;204;217;98;119;502;242;260;363;153;210;1084;614;470;;;;;;;1676
7758;Sevenum;2008;7507;1935;4429;1143;7021;374;116;258;112;75;37;15;8;7;10;5;5;12;8;4;14;7;7;61;47;14;76.0;63.0;18.0;25.0;229.0;232.0;964
7759;Sevenum;2009;7512;1934;4397;1181;6992;391;128;263;129;77;52;14;8;6;13;6;7;19;12;7;22;8;14;61;43;18;72.0;60.0;17.0;24.0;251.0;264.0;964
7760;Sevenum;2010;7506;1901;4380;1225;6959;399;130;269;148;87;61;15;9;6;15;8;7;26;16;10;22;7;15;70;47;23;75.0;64.0;20.0;22.0;256.0;257.0;964
7761;Sevenum;2011;7515;1891;4393;1231;6953;398;132;266;164;96;68;20;11;9;18;9;9;32;18;14;19;5;14;75;53;22;71.0;64.0;24.0;23.0;283.0;264.0;964
7762;Sevenum;2012;7543;1876;4376;1291;6956;407;143;264;180;105;75;18;10;8;18;8;10;40;21;19;23;9;14;81;57;24;72.0;67.0;26.0;26.0;259.0;266.0;964
7763;Sevenum;2013;7542;1852;4366;1324;6923;418;138;280;201;114;87;19;10;9;24;11;13;47;23;24;25;10;15;86;60;26;69.0;67.0;22.0;24.0;316.0;263.0;964
7764;Sevenum;2014;7597;1860;4384;1353;6938;429;145;284;230;124;106;22;10;12;25;12;13;49;23;26;31;11;20;103;68;35;70.0;70.0;25.0;27.0;277.0;278.0;964
7765;Sevenum;2015;7595;1834;4355;1406;6890;450;155;295;255;132;123;28;12;16;27;13;14;57;27;30;34;13;21;109;67;42;71.0;69.0;25.0;24.0;268.0;281.0;964
7766;Sevenum;2016;7586;1797;4343;1446;6845;463;155;308;278;149;129;38;17;21;30;15;15;58;30;28;39;14;25;113;73;40;70.0;71.0;29.0;25.0;250.0;281.0;964
7767;Sevenum;2017;7560;1775;4308;1477;6804;461;145;316;295;155;140;38;17;21;34;15;19;58;29;29;42;17;25;123;77;46;72.0;71.0;23.0;24.0;268.0;273.0;964
7768;Sevenum;2018;7555;1757;4295;1503;6747;471;145;326;337;179;158;44;21;23;38;19;19;67;33;34;48;18;30;140;88;52;75.0;74.0;25.0;27.0;263.0;285.0;964
7769;Sevenum;2019;7533;1731;4277;1525;6682;492;158;334;359;187;172;45;22;23;46;24;22;74;35;39;51;19;32;143;87;56;73.0;77.0;28.0;27.0;280.0;276.0;964
7770;Sevenum;2020;7535;1700;4274;1561;6668;502;168;334;365;189;176;48;24;24;46;25;21;75;36;39;50;19;31;146;85;61;75.0;76.0;27.0;25.0;266.0;287.0;964
7771;Sevenum;2021;7516;1668;4271;1577;6623;516;171;345;377;196;181;50;26;24;48;26;22;82;39;43;46;18;28;151;87;64;75.0;77.0;25.0;24.0;329.0;277.0;964
7772;Sevenum;2022;7567;1670;4281;1616;6631;540;172;368;396;200;196;52;27;25;49;26;23;88;41;47;50;21;29;157;85;72;80.0;82.0;29.0;28.0;315.0;289.0;964
7773;Sevenum;2023;7593;1658;4278;1657;6618;560;180;380;415;205;210;55;30;25;53;29;24;90;40;50;56;22;34;161;84;77;77.0;82.0;25.0;29.0;275.0;296.0;964
7774;Sevenum;2024;7565;1642;4238;1685;6578;553;176;377;434;223;211;55;33;22;56;33;23;93;44;49;57;22;35;173;91;82;79.0;82.0;27.0;28.0;300.0;280.0;964
7775;Sevenum;2025;7582;1630;4228;1724;6576;566;184;382;440;230;210;60;35;25;52;31;21;92;44;48;60;22;38;176;98;78;;;;;;;964
7776;Simpelveld;2008;11144;2281;6727;2136;8959;1992;850;1142;193;118;75;21;6;15;10;7;3;28;10;18;19;9;10;115;86;29;69.0;109.0;64.0;91.0;455.0;403.0;965
7777;Simpelveld;2009;11130;2247;6699;2184;8973;1942;822;1120;215;132;83;24;11;13;12;7;5;27;8;19;24;11;13;128;95;33;69.0;110.0;63.0;92.0;378.0;450.0;965
7778;Simpelveld;2010;10991;2162;6614;2215;8816;1934;813;1121;241;145;96;28;14;14;11;7;4;31;12;19;32;13;19;139;99;40;71.0;111.0;76.0;81.0;410.0;444.0;965
7779;Simpelveld;2011;10913;2112;6508;2293;8737;1907;803;1104;269;157;112;31;17;14;16;8;8;38;13;25;35;15;20;149;104;45;71.0;113.0;76.0;84.0;448.0;431.0;965
7780;Simpelveld;2012;10882;2074;6462;2346;8688;1885;797;1088;309;178;131;34;17;17;18;9;9;45;14;31;42;18;24;170;120;50;72.0;116.0;80.0;80.0;471.0;440.0;965
7781;Simpelveld;2013;10870;2033;6443;2394;8646;1876;812;1064;348;201;147;42;22;20;20;10;10;54;19;35;45;22;23;187;128;59;69.0;115.0;78.0;84.0;394.0;453.0;965
7782;Simpelveld;2014;10760;1969;6334;2457;8558;1828;787;1041;374;212;162;43;23;20;23;13;10;62;18;44;53;27;26;193;131;62;76.0;117.0;67.0;75.0;450.0;443.0;965
7783;Simpelveld;2015;10718;1914;6306;2498;8494;1829;782;1047;395;218;177;43;24;19;24;14;10;68;17;51;59;25;34;201;138;63;77.0;120.0;66.0;79.0;493.0;427.0;965
7784;Simpelveld;2016;10731;1912;6273;2546;8519;1797;768;1029;415;225;190;45;25;20;26;17;9;76;20;56;62;23;39;206;140;66;78.0;126.0;70.0;77.0;499.0;440.0;965
7785;Simpelveld;2017;10737;1890;6276;2571;8496;1796;766;1030;445;236;209;49;30;19;32;21;11;92;25;67;66;24;42;206;136;70;79.0;126.0;62.0;79.0;476.0;461.0;965
7786;Simpelveld;2018;10688;1866;6230;2592;8442;1781;752;1029;465;246;219;54;31;23;33;22;11;96;27;69;66;25;41;216;141;75;85.0;125.0;66.0;76.0;465.0;447.0;965
7787;Simpelveld;2019;10657;1837;6185;2635;8451;1719;731;988;487;254;233;55;32;23;36;24;12;106;29;77;70;25;45;220;144;76;87.0;128.0;59.0;70.0;454.0;441.0;965
7788;Simpelveld;2020;10619;1833;6115;2671;8397;1703;719;984;519;257;262;58;32;26;38;24;14;119;31;88;70;22;48;234;148;86;86.0;125.0;64.0;73.0;465.0;437.0;965
7789;Simpelveld;2021;10600;1825;6094;2681;8378;1684;713;971;538;268;270;58;34;24;37;24;13;128;34;94;70;22;48;245;154;91;88.0;127.0;63.0;73.0;466.0;436.0;965
7790;Simpelveld;2022;10583;1817;6050;2716;8359;1654;701;953;570;276;294;59;35;24;45;29;16;151;43;108;77;24;53;238;145;93;87.0;134.0;65.0;67.0;479.0;439.0;965
7791;Simpelveld;2023;10576;1825;5981;2770;8347;1629;696;933;600;287;313;62;38;24;50;31;19;163;45;118;82;27;55;243;146;97;89.0;136.0;64.0;68.0;473.0;445.0;965
7792;Simpelveld;2024;10554;1826;5928;2800;8315;1614;691;923;625;299;326;65;37;28;47;32;15;165;45;120;88;30;58;260;155;105;89.0;131.0;61.0;62.0;414.0;444.0;965
7793;Simpelveld;2025;10482;1804;5827;2851;8261;1566;668;898;655;317;338;73;43;30;59;37;22;169;45;124;85;30;55;269;162;107;;;;;;;965
7794;Sint Anthonis;2008;11528;3100;6615;1813;10891;407;133;274;230;138;92;33;15;18;16;5;11;42;20;22;11;5;6;128;93;35;96.0;99.0;24.0;39.0;348.0;389.0;1702
7795;Sint Anthonis;2009;11471;3018;6637;1816;10781;423;133;290;267;159;108;37;14;23;17;5;12;45;23;22;18;7;11;150;110;40;94.0;100.0;23.0;39.0;410.0;420.0;1702
7796;Sint Anthonis;2010;11441;2952;6654;1835;10695;427;133;294;319;191;128;40;15;25;20;10;10;59;28;31;24;12;12;176;126;50;95.0;97.0;31.0;41.0;333.0;432.0;1702
7797;Sint Anthonis;2011;11332;2881;6619;1832;10561;423;137;286;348;202;146;38;14;24;24;10;14;62;30;32;29;13;16;195;135;60;93.0;104.0;28.0;39.0;497.0;439.0;1702
7798;Sint Anthonis;2012;11371;2853;6665;1853;10539;425;138;287;407;239;168;39;17;22;28;13;15;67;34;33;36;15;21;237;160;77;96.0;100.0;37.0;42.0;398.0;431.0;1702
7799;Sint Anthonis;2013;11331;2754;6667;1910;10463;423;142;281;445;252;193;51;22;29;36;15;21;71;37;34;38;16;22;249;162;87;96.0;103.0;36.0;40.0;344.0;438.0;1702
7800;Sint Anthonis;2014;11228;2680;6575;1973;10320;433;150;283;475;265;210;50;23;27;36;14;22;76;41;35;43;20;23;270;167;103;93.0;103.0;33.0;40.0;456.0;429.0;1702
7801;Sint Anthonis;2015;11241;2607;6588;2046;10304;436;150;286;501;277;224;58;24;34;38;17;21;87;42;45;47;20;27;271;174;97;100.0;109.0;33.0;38.0;431.0;443.0;1702
7802;Sint Anthonis;2016;11216;2551;6554;2111;10274;444;149;295;498;266;232;59;24;35;35;15;20;93;42;51;45;19;26;266;166;100;97.0;110.0;33.0;36.0;464.0;446.0;1702
7803;Sint Anthonis;2017;11220;2526;6516;2178;10220;449;159;290;551;293;258;62;26;36;39;15;24;101;40;61;45;20;25;304;192;112;101.0;111.0;25.0;43.0;486.0;463.0;1702
7804;Sint Anthonis;2018;11216;2471;6498;2247;10207;444;157;287;565;294;271;71;32;39;39;15;24;101;42;59;45;19;26;309;186;123;102.0;115.0;32.0;36.0;409.0;467.0;1702
7805;Sint Anthonis;2019;11142;2406;6431;2305;10105;448;153;295;589;307;282;72;32;40;35;14;21;108;42;66;49;22;27;325;197;128;102.0;114.0;28.0;37.0;526.0;441.0;1702
7806;Sint Anthonis;2020;11207;2380;6462;2365;10148;457;160;297;602;321;281;71;33;38;35;15;20;108;46;62;51;23;28;337;204;133;105.0;116.0;34.0;35.0;487.0;445.0;1702
7807;Sint Anthonis;2021;11239;2352;6455;2432;10129;472;166;306;638;327;311;78;35;43;40;17;23;116;48;68;54;20;34;350;207;143;112.0;118.0;36.0;42.0;485.0;457.0;1702
7808;Sint Anthonis;2022;11256;2328;6425;2503;10104;485;176;309;667;343;324;85;41;44;46;22;24;117;49;68;54;18;36;365;213;152;108.0;118.0;28.0;39.0;460.0;470.0;1702
7809;Sint Anthonis;2023;11227;2272;6384;2571;10052;481;173;308;694;352;342;89;43;46;44;22;22;118;46;72;53;18;35;390;223;167;116.0;121.0;31.0;41.0;497.0;463.0;1702
7810;Sint Anthonis;2024;11247;2244;6363;2640;10036;493;182;311;718;362;356;89;42;47;52;22;30;117;47;70;58;21;37;402;230;172;115.0;130.0;29.0;43.0;473.0;460.0;1702
7811;Sint Anthonis;2025;11232;2226;6302;2704;9994;496;181;315;742;373;369;94;44;50;54;22;32;120;52;68;61;23;38;413;232;181;;;;;;;1702
7812;Sint-Michielsgestel;2008;27647;6943;16199;4505;25738;1182;397;785;727;427;300;148;72;76;66;34;32;69;46;23;66;30;36;378;245;133;232.0;220.0;77.0;116.0;785.0;920.0;845
7813;Sint-Michielsgestel;2009;27487;6759;16115;4613;25535;1196;409;787;756;432;324;151;72;79;72;39;33;85;48;37;74;35;39;374;238;136;224.0;230.0;78.0;111.0;846.0;964.0;845
7814;Sint-Michielsgestel;2010;27331;6614;16036;4681;25298;1223;437;786;810;468;342;150;77;73;79;42;37;101;54;47;88;39;49;392;256;136;216.0;232.0;83.0;110.0;987.0;964.0;845
7815;Sint-Michielsgestel;2011;27314;6469;16010;4835;25197;1258;448;810;859;492;367;155;75;80;86;46;40;115;65;50;98;45;53;405;261;144;212.0;235.0;83.0;108.0;925.0;1036.0;845
7816;Sint-Michielsgestel;2012;27156;6298;15862;4996;24991;1277;475;802;888;500;388;159;80;79;80;42;38;126;70;56;102;45;57;421;263;158;212.0;243.0;85.0;111.0;963.0;1015.0;845
7817;Sint-Michielsgestel;2013;27048;6123;15749;5176;24794;1340;497;843;914;506;408;155;76;79;83;44;39;134;72;62;121;53;68;421;261;160;219.0;249.0;96.0;105.0;946.0;1014.0;845
7818;Sint-Michielsgestel;2014;26946;5964;15682;5300;24586;1376;525;851;984;545;439;165;83;82;95;51;44;147;79;68;128;58;70;449;274;175;220.0;251.0;89.0;111.0;1055.0;1030.0;845
7819;Sint-Michielsgestel;2015;26919;5845;15659;5415;24490;1392;543;849;1037;565;472;161;81;80;91;49;42;168;80;88;143;61;82;474;294;180;227.0;262.0;85.0;105.0;1049.0;1038.0;845
7820;Sint-Michielsgestel;2016;26877;5703;15662;5512;24338;1439;568;871;1100;597;503;173;84;89;101;58;43;177;82;95;156;67;89;493;306;187;233.0;260.0;83.0;106.0;1109.0;1026.0;845
7821;Sint-Michielsgestel;2017;26911;5635;15643;5633;24310;1445;575;870;1156;620;536;172;80;92;104;58;46;193;92;101;160;73;87;527;317;210;243.0;267.0;91.0;107.0;1004.0;1059.0;845
7822;Sint-Michielsgestel;2018;26819;5552;15531;5736;24182;1451;581;870;1186;617;569;179;84;95;108;60;48;198;89;109;173;71;102;528;313;215;247.0;270.0;79.0;108.0;1051.0;1028.0;845
7823;Sint-Michielsgestel;2019;26793;5442;15522;5829;24126;1463;581;882;1204;634;570;185;88;97;110;63;47;210;94;116;171;75;96;528;314;214;257.0;275.0;84.0;100.0;1044.0;1040.0;845
7824;Sint-Michielsgestel;2020;26767;5331;15520;5916;24012;1496;605;891;1259;660;599;190;94;96;113;64;49;219;95;124;184;78;106;553;329;224;258.0;282.0;89.0;104.0;1091.0;1055.0;845
7825;Sint-Michielsgestel;2021;26768;5228;15494;6046;23955;1517;612;905;1296;675;621;209;103;106;119;69;50;220;95;125;198;83;115;550;325;225;264.0;287.0;79.0;103.0;1261.0;1061.0;845
7826;Sint-Michielsgestel;2022;26921;5203;15557;6161;24027;1549;636;913;1345;702;643;220;107;113;121;67;54;229;98;131;200;87;113;575;343;232;269.0;285.0;74.0;105.0;1057.0;1056.0;845
7827;Sint-Michielsgestel;2023;26877;5143;15462;6272;23927;1554;645;909;1396;715;681;224;109;115;126;70;56;238;103;135;220;93;127;588;340;248;269.0;293.0;86.0;102.0;1078.0;1081.0;845
7828;Sint-Michielsgestel;2024;26837;5080;15372;6385;23823;1586;670;916;1428;730;698;226;110;116;123;67;56;249;106;143;219;88;131;611;359;252;277.0;296.0;95.0;100.0;1122.0;1088.0;845
7829;Sint-Michielsgestel;2025;26849;5088;15256;6505;23779;1608;667;941;1462;748;714;229;116;113;136;74;62;259;109;150;219;88;131;619;361;258;;;;;;;845
7830;Sint-Oedenrode;2008;17260;4437;10239;2584;16112;713;245;468;435;267;168;63;34;29;10;7;3;38;18;20;63;31;32;261;177;84;169.0;135.0;45.0;71.0;549.0;552.0;846
7831;Sint-Oedenrode;2009;17267;4389;10192;2686;16063;717;242;475;487;289;198;70;37;33;14;9;5;52;26;26;75;30;45;276;187;89;164.0;137.0;55.0;72.0;568.0;565.0;846
7832;Sint-Oedenrode;2010;17282;4340;10176;2766;16039;727;248;479;516;308;208;77;41;36;23;14;9;57;27;30;78;33;45;281;193;88;164.0;145.0;52.0;73.0;563.0;600.0;846
7833;Sint-Oedenrode;2011;17244;4226;10173;2845;15953;740;252;488;551;320;231;78;38;40;24;13;11;73;30;43;78;36;42;298;203;95;164.0;147.0;53.0;71.0;556.0;613.0;846
7834;Sint-Oedenrode;2012;17188;4118;10114;2956;15832;772;274;498;584;337;247;75;39;36;29;15;14;76;33;43;91;40;51;313;210;103;166.0;152.0;50.0;73.0;615.0;602.0;846
7835;Sint-Oedenrode;2013;17195;4059;10074;3062;15805;788;281;507;602;345;257;82;43;39;26;14;12;90;38;52;97;42;55;307;208;99;166.0;153.0;52.0;71.0;578.0;617.0;846
7836;Sint-Oedenrode;2014;17153;3984;10019;3150;15708;795;295;500;650;362;288;92;49;43;29;17;12;96;37;59;104;39;65;329;220;109;172.0;160.0;51.0;66.0;657.0;599.0;846
7837;Sint-Oedenrode;2015;17212;3947;10003;3262;15707;815;305;510;690;376;314;100;51;49;39;23;16;103;38;65;116;41;75;332;223;109;173.0;159.0;54.0;69.0;614.0;630.0;846
7838;Sint-Oedenrode;2016;17196;3901;9964;3331;15687;815;307;508;694;384;310;95;51;44;42;25;17;109;40;69;109;41;68;339;227;112;175.0;163.0;48.0;67.0;635.0;622.0;846
7839;Sint-Oedenrode;2017;17202;3859;9928;3415;15642;829;306;523;731;395;336;99;53;46;48;29;19;116;42;74;119;45;74;349;226;123;179.0;165.0;52.0;69.0;592.0;628.0;846
7840;Sint-Oedenrode;2018;17163;3764;9880;3519;15558;838;309;529;767;403;364;104;53;51;52;26;26;127;44;83;121;48;73;363;232;131;183.0;174.0;48.0;69.0;598.0;640.0;846
7841;Sint-Oedenrode;2019;17112;3699;9831;3582;15474;862;321;541;776;401;375;107;53;54;52;25;27;130;44;86;123;51;72;364;228;136;184.0;173.0;51.0;67.0;597.0;600.0;846
7842;Sint-Oedenrode;2020;17105;3668;9773;3664;15455;860;320;540;790;406;384;108;52;56;50;28;22;134;48;86;127;49;78;371;229;142;188.0;176.0;50.0;64.0;694.0;602.0;846
7843;Sint-Oedenrode;2021;17198;3664;9805;3729;15459;888;341;547;851;430;421;114;58;56;57;31;26;153;57;96;138;52;86;389;232;157;190.0;176.0;54.0;63.0;613.0;625.0;846
7844;Sint-Oedenrode;2022;17193;3652;9738;3803;15400;902;344;558;891;442;449;123;59;64;64;36;28;151;55;96;158;57;101;395;235;160;189.0;177.0;57.0;67.0;575.0;631.0;846
7845;Sint-Oedenrode;2023;17141;3585;9679;3877;15298;931;348;583;912;456;456;126;61;65;67;38;29;156;60;96;161;58;103;402;239;163;190.0;178.0;50.0;64.0;647.0;621.0;846
7846;Sint-Oedenrode;2024;17166;3560;9634;3972;15287;943;357;586;936;474;462;127;65;62;65;35;30;156;59;97;162;56;106;426;259;167;186.0;181.0;74.0;67.0;609.0;623.0;846
7847;Sint-Oedenrode;2025;17166;3566;9564;4036;15218;965;359;606;983;498;485;134;69;65;73;40;33;166;63;103;169;56;113;441;270;171;;;;;;;846
7848;Sittard-Geleen;2008;96243;20830;58603;16810;75942;14626;4402;10224;5675;3392;2283;385;203;182;326;181;145;641;384;257;1938;1030;908;2385;1594;791;855.0;991.0;518.0;744.0;3062.0;2767.0;1883
7849;Sittard-Geleen;2009;96190;20660;58533;16997;75980;14381;4369;10012;5829;3445;2384;436;240;196;360;200;160;685;386;299;1911;1003;908;2437;1616;821;845.0;999.0;556.0;731.0;2973.0;2836.0;1883
7850;Sittard-Geleen;2010;96010;20396;58395;17219;75961;14111;4336;9775;5938;3488;2450;460;251;209;379;211;168;722;406;316;1922;1008;914;2455;1612;843;847.0;1009.0;577.0;699.0;2970.0;2865.0;1883
7851;Sittard-Geleen;2011;95843;20135;58182;17526;75966;13775;4270;9505;6102;3545;2557;513;277;236;398;230;168;764;410;354;1924;994;930;2503;1634;869;837.0;1034.0;570.0;683.0;2812.0;2833.0;1883
7852;Sittard-Geleen;2012;95526;19822;57815;17889;75732;13500;4259;9241;6294;3624;2670;548;295;253;430;245;185;827;431;396;1908;980;928;2581;1673;908;812.0;1048.0;577.0;673.0;2780.0;2859.0;1883
7853;Sittard-Geleen;2013;95124;19511;57326;18287;75515;13236;4200;9036;6373;3616;2757;571;303;268;454;257;197;881;448;433;1891;956;935;2576;1652;924;826.0;1052.0;558.0;647.0;2754.0;2866.0;1883
7854;Sittard-Geleen;2014;94702;19231;56847;18624;75231;12985;4158;8827;6486;3649;2837;614;318;296;468;273;195;918;449;469;1901;945;956;2585;1664;921;820.0;1060.0;539.0;637.0;2754.0;2874.0;1883
7855;Sittard-Geleen;2015;94253;18962;56302;18989;74915;12739;4125;8614;6599;3689;2910;643;333;310;492;289;203;961;445;516;1895;940;955;2608;1682;926;821.0;1069.0;546.0;615.0;2726.0;2811.0;1883
7856;Sittard-Geleen;2016;93863;18676;55834;19353;74648;12470;4063;8407;6745;3740;3005;663;345;318;525;316;209;992;449;543;1927;949;978;2638;1681;957;812.0;1073.0;523.0;618.0;2790.0;2792.0;1883
7857;Sittard-Geleen;2017;93516;18416;55397;19703;74397;12263;4057;8206;6856;3793;3063;704;367;337;563;332;231;1013;462;551;1937;945;992;2639;1687;952;815.0;1088.0;501.0;594.0;2698.0;2769.0;1883
7858;Sittard-Geleen;2018;93090;18245;54750;20095;74092;12006;4028;7978;6992;3833;3159;749;387;362;574;342;232;1043;465;578;1955;948;1007;2671;1691;980;815.0;1101.0;503.0;578.0;2758.0;2791.0;1883
7859;Sittard-Geleen;2019;92701;17962;54387;20352;73819;11756;3978;7778;7126;3879;3247;770;394;376;589;347;242;1077;482;595;1975;951;1024;2715;1705;1010;814.0;1104.0;501.0;564.0;2730.0;2796.0;1883
7860;Sittard-Geleen;2020;92292;17762;53935;20595;73468;11531;3950;7581;7293;3940;3353;803;414;389;618;349;269;1114;502;612;1990;940;1050;2768;1735;1033;816.0;1109.0;484.0;566.0;2689.0;2756.0;1883
7861;Sittard-Geleen;2021;91865;17558;53441;20866;73137;11377;3944;7433;7351;3986;3365;827;426;401;646;357;289;1120;510;610;1951;919;1032;2807;1774;1033;811.0;1107.0;478.0;566.0;2654.0;2760.0;1883
7862;Sittard-Geleen;2022;91387;17296;52877;21214;72806;11126;3878;7248;7455;4012;3443;831;438;393;666;368;298;1155;523;632;1952;906;1046;2851;1777;1074;786.0;1118.0;495.0;550.0;2683.0;2708.0;1883
7863;Sittard-Geleen;2023;90990;17163;52274;21553;72482;10974;3878;7096;7534;4038;3496;860;448;412;685;392;293;1185;539;646;1971;906;1065;2833;1753;1080;792.0;1137.0;476.0;534.0;2664.0;2666.0;1883
7864;Sittard-Geleen;2024;90590;16994;51713;21883;72138;10768;3858;6910;7684;4090;3594;890;468;422;722;400;322;1197;543;654;2001;903;1098;2874;1776;1098;770.0;1136.0;462.0;530.0;2623.0;2633.0;1883
7865;Sittard-Geleen;2025;90157;16957;50971;22229;71770;10612;3870;6742;7775;4105;3670;915;484;431;734;409;325;1207;539;668;2011;892;1119;2908;1781;1127;;;;;;;1883
7866;Skarsterlân;2008;27128;6967;15925;4236;25612;1054;330;724;462;257;205;72;33;39;42;18;24;43;22;21;29;18;11;276;166;110;282.0;226.0;53.0;105.0;993.0;1033.0;51
7867;Skarsterlân;2009;27096;6847;15923;4326;25481;1088;345;743;527;284;243;81;36;45;46;20;26;56;28;28;46;24;22;298;176;122;267.0;227.0;70.0;97.0;989.0;1048.0;51
7868;Skarsterlân;2010;27055;6698;15889;4468;25418;1080;348;732;557;293;264;87;38;49;45;20;25;76;37;39;45;28;17;304;170;134;263.0;235.0;62.0;102.0;1010.0;1065.0;51
7869;Skarsterlân;2011;26993;6565;15836;4592;25326;1082;352;730;585;308;277;87;41;46;55;25;30;80;39;41;50;31;19;313;172;141;264.0;233.0;67.0;102.0;975.0;1062.0;51
7870;Skarsterlân;2012;26905;6406;15726;4773;25186;1080;353;727;639;349;290;103;48;55;61;27;34;86;46;40;57;36;21;332;192;140;253.0;238.0;75.0;98.0;992.0;1059.0;51
7871;Skarsterlân;2013;26833;6255;15617;4961;25088;1074;346;728;671;365;306;107;50;57;63;29;34;101;53;48;65;38;27;335;195;140;255.0;248.0;66.0;99.0;1018.0;1013.0;51
7872;Skarsterlân;2014;26816;6162;15543;5111;25020;1083;347;736;713;382;331;120;56;64;68;34;34;109;58;51;78;38;40;338;196;142;256.0;241.0;76.0;95.0;990.0;1046.0;51
7873;Skarsterlân;2015;26759;6032;15459;5268;24914;1088;355;733;757;402;355;128;62;66;66;32;34;120;61;59;85;41;44;358;206;152;255.0;248.0;71.0;88.0;934.0;1069.0;51
7874;Skarsterlân;2016;26617;5867;15340;5410;24732;1096;362;734;789;424;365;133;65;68;75;39;36;125;62;63;92;44;48;364;214;150;252.0;254.0;71.0;95.0;1037.0;1031.0;51
7875;Skarsterlân;2017;26599;5770;15281;5548;24662;1115;366;749;822;442;380;147;70;77;79;43;36;125;64;61;98;47;51;373;218;155;251.0;256.0;62.0;98.0;1081.0;1055.0;51
7876;Skarsterlân;2018;26586;5691;15222;5673;24590;1128;369;759;868;463;405;144;72;72;84;47;37;151;71;80;101;46;55;388;227;161;250.0;262.0;75.0;90.0;1041.0;1053.0;51
7877;Skarsterlân;2019;26550;5596;15157;5797;24529;1105;370;735;916;496;420;155;88;67;92;54;38;163;69;94;106;47;59;400;238;162;250.0;266.0;70.0;98.0;996.0;1050.0;51
7878;Skarsterlân;2020;26456;5462;15067;5927;24412;1110;373;737;934;493;441;156;86;70;92;56;36;164;71;93;114;46;68;408;234;174;246.0;270.0;66.0;100.0;1047.0;1037.0;51
7879;Skarsterlân;2021;26413;5342;15028;6043;24323;1107;384;723;983;516;467;169;90;79;96;59;37;166;74;92;129;50;79;423;243;180;251.0;278.0;75.0;87.0;992.0;1032.0;51
7880;Skarsterlân;2022;26335;5263;14912;6160;24201;1119;386;733;1015;537;478;171;96;75;102;61;41;177;77;100;135;53;82;430;250;180;250.0;283.0;72.0;96.0;1031.0;1060.0;51
7881;Skarsterlân;2023;26253;5169;14807;6277;24080;1113;380;733;1060;563;497;177;104;73;105;64;41;193;83;110;144;56;88;441;256;185;248.0;280.0;71.0;93.0;1136.0;1032.0;51
7882;Skarsterlân;2024;26306;5137;14769;6400;24091;1134;394;740;1081;567;514;187;109;78;104;62;42;198;79;119;150;58;92;442;259;183;253.0;292.0;72.0;90.0;1059.0;1046.0;51
7883;Skarsterlân;2025;26265;5080;14692;6493;24008;1136;405;731;1121;577;544;196;112;84;107;62;45;210;75;135;151;60;91;457;268;189;;;;;;;51
7884;Sliedrecht;2008;23503;5893;13780;3830;20936;1023;341;682;1544;841;703;127;68;59;112;64;48;554;271;283;137;58;79;614;380;234;283.0;250.0;62.0;89.0;823.0;892.0;610
7885;Sliedrecht;2009;23446;5843;13754;3849;20810;1041;350;691;1595;862;733;133;71;62;110;67;43;559;267;292;154;68;86;639;389;250;288.0;239.0;69.0;90.0;828.0;888.0;610
7886;Sliedrecht;2010;23418;5817;13729;3872;20726;1052;366;686;1640;891;749;140;80;60;125;73;52;548;263;285;168;71;97;659;404;255;288.0;242.0;73.0;85.0;784.0;912.0;610
7887;Sliedrecht;2011;23327;5782;13653;3892;20593;1058;375;683;1676;901;775;151;87;64;124;73;51;544;260;284;177;76;101;680;405;275;286.0;241.0;70.0;86.0;804.0;888.0;610
7888;Sliedrecht;2012;23275;5740;13494;4041;20531;1052;368;684;1692;906;786;166;95;71;123;72;51;539;264;275;188;82;106;676;393;283;287.0;238.0;72.0;85.0;911.0;877.0;610
7889;Sliedrecht;2013;23349;5737;13469;4143;20566;1065;373;692;1718;917;801;176;101;75;124;75;49;541;266;275;198;86;112;679;389;290;284.0;241.0;66.0;81.0;924.0;891.0;610
7890;Sliedrecht;2014;23412;5741;13435;4236;20561;1086;369;717;1765;929;836;185;101;84;132;78;54;529;258;271;203;90;113;716;402;314;279.0;238.0;79.0;88.0;866.0;911.0;610
7891;Sliedrecht;2015;23402;5687;13440;4275;20545;1088;359;729;1769;923;846;197;106;91;126;75;51;526;257;269;204;91;113;716;394;322;276.0;238.0;67.0;85.0;813.0;885.0;610
7892;Sliedrecht;2016;23352;5688;13341;4323;20475;1079;346;733;1798;929;869;209;108;101;128;71;57;527;262;265;214;91;123;720;397;323;270.0;239.0;68.0;79.0;846.0;897.0;610
7893;Sliedrecht;2017;23323;5657;13321;4345;20413;1072;348;724;1838;938;900;219;111;108;129;68;61;530;267;263;220;94;126;740;398;342;283.0;240.0;63.0;77.0;800.0;855.0;610
7894;Sliedrecht;2018;23300;5614;13272;4414;20370;1084;348;736;1846;933;913;223;118;105;133;71;62;532;259;273;223;96;127;735;389;346;284.0;238.0;64.0;83.0;839.0;879.0;610
7895;Sliedrecht;2019;23289;5575;13255;4459;20318;1105;354;751;1866;938;928;232;120;112;135;74;61;529;253;276;225;99;126;745;392;353;280.0;233.0;67.0;80.0;822.0;869.0;610
7896;Sliedrecht;2020;23278;5554;13192;4532;20273;1131;367;764;1874;922;952;239;118;121;135;78;57;543;254;289;214;91;123;743;381;362;278.0;239.0;60.0;73.0;823.0;872.0;610
7897;Sliedrecht;2021;23258;5526;13118;4614;20233;1136;369;767;1889;910;979;252;124;128;143;79;64;531;250;281;222;89;133;741;368;373;273.0;242.0;94.0;79.0;792.0;904.0;610
7898;Sliedrecht;2022;23203;5479;13051;4673;20173;1149;377;772;1881;919;962;264;128;136;150;85;65;529;251;278;218;91;127;720;364;356;273.0;244.0;68.0;73.0;845.0;865.0;610
7899;Sliedrecht;2023;23206;5453;13029;4724;20136;1142;387;755;1928;944;984;270;130;140;151;84;67;522;253;269;232;99;133;753;378;375;265.0;250.0;92.0;72.0;846.0;893.0;610
7900;Sliedrecht;2024;23197;5461;12940;4796;20025;1179;411;768;1993;971;1022;278;130;148;155;87;68;533;253;280;251;111;140;776;390;386;267.0;249.0;71.0;69.0;896.0;870.0;610
7901;Sliedrecht;2025;23244;5461;12921;4862;20008;1213;431;782;2023;986;1037;287;136;151;165;93;72;538;256;282;260;113;147;773;388;385;;;;;;;610
7902;Slochteren;2008;15074;3690;9232;2152;14124;638;243;395;312;177;135;47;22;25;58;27;31;39;16;23;15;14;1;153;98;55;133.0;128.0;39.0;61.0;736.0;733.0;40
7903;Slochteren;2009;15063;3627;9251;2185;14063;646;242;404;354;201;153;49;24;25;59;27;32;44;20;24;33;23;10;169;107;62;134.0;123.0;45.0;61.0;863.0;754.0;40
7904;Slochteren;2010;15168;3594;9327;2247;14089;660;253;407;419;234;185;64;30;34;71;33;38;48;21;27;42;30;12;194;120;74;139.0;129.0;41.0;64.0;648.0;753.0;40
7905;Slochteren;2011;15051;3498;9248;2305;13928;662;248;414;461;268;193;70;36;34;70;39;31;56;25;31;54;37;17;211;131;80;137.0;132.0;44.0;63.0;764.0;747.0;40
7906;Slochteren;2012;15054;3433;9196;2425;13882;667;254;413;505;285;220;83;39;44;73;38;35;69;31;38;58;40;18;222;137;85;139.0;128.0;44.0;62.0;813.0;739.0;40
7907;Slochteren;2013;15120;3401;9158;2561;13889;677;250;427;554;303;251;100;46;54;84;40;44;72;35;37;64;42;22;234;140;94;145.0;127.0;48.0;64.0;624.0;769.0;40
7908;Slochteren;2014;14980;3328;8985;2667;13739;680;252;428;561;293;268;101;50;51;80;33;47;75;33;42;76;44;32;229;133;96;148.0;134.0;41.0;57.0;715.0;696.0;40
7909;Slochteren;2015;14998;3250;8996;2752;13718;686;262;424;594;311;283;100;52;48;87;36;51;86;39;47;85;45;40;236;139;97;149.0;132.0;46.0;63.0;649.0;749.0;40
7910;Slochteren;2016;14897;3182;8897;2818;13587;683;262;421;627;329;298;102;49;53;86;36;50;91;39;52;102;53;49;246;152;94;152.0;135.0;47.0;60.0;692.0;733.0;40
7911;Slochteren;2017;14861;3127;8835;2899;13528;683;253;430;650;335;315;102;51;51;87;37;50;100;44;56;112;57;55;249;146;103;154.0;137.0;45.0;62.0;781.0;720.0;40
7912;Slochteren;2018;14923;3132;8783;3008;13548;680;245;435;695;363;332;103;52;51;101;43;58;109;49;60;118;62;56;264;157;107;151.0;140.0;50.0;63.0;748.0;738.0;40
7913;Slochteren;2019;14932;3123;8731;3078;13534;680;251;429;718;375;343;110;53;57;108;49;59;112;52;60;130;68;62;258;153;105;156.0;145.0;50.0;61.0;666.0;744.0;40
7914;Slochteren;2020;14855;3070;8647;3138;13446;678;243;435;731;383;348;119;58;61;99;44;55;110;53;57;136;68;68;267;160;107;158.0;143.0;43.0;61.0;652.0;716.0;40
7915;Slochteren;2021;14790;3040;8572;3178;13337;700;262;438;753;380;373;129;63;66;101;45;56;113;57;56;145;68;77;265;147;118;159.0;148.0;48.0;60.0;771.0;724.0;40
7916;Slochteren;2022;14837;3015;8571;3251;13349;715;264;451;773;386;387;132;65;67;105;47;58;120;55;65;150;72;78;266;147;119;158.0;148.0;45.0;58.0;759.0;738.0;40
7917;Slochteren;2023;14855;2992;8557;3306;13355;722;251;471;778;390;388;136;65;71;101;44;57;121;56;65;145;71;74;275;154;121;164.0;152.0;45.0;58.0;631.0;752.0;40
7918;Slochteren;2024;14734;2962;8418;3354;13226;710;251;459;798;403;395;136;66;70;105;47;58;129;61;68;156;78;78;272;151;121;162.0;154.0;48.0;55.0;637.0;701.0;40
7919;Slochteren;2025;14674;2954;8328;3392;13137;705;253;452;832;419;413;143;65;78;112;52;60;144;68;76;169;82;87;264;152;112;;;;;;;40
7920;Sluis;2008;24127;4981;13938;5208;18706;4789;2572;2217;632;391;241;88;43;45;41;21;20;76;47;29;54;24;30;373;256;117;189.0;296.0;204.0;221.0;609.0;581.0;1714
7921;Sluis;2009;24033;5013;13766;5254;18534;4785;2590;2195;714;425;289;101;48;53;44;22;22;83;47;36;60;25;35;426;283;143;184.0;296.0;213.0;209.0;614.0;575.0;1714
7922;Sluis;2010;23965;5025;13609;5331;18333;4813;2591;2222;819;479;340;115;59;56;47;22;25;93;51;42;61;25;36;503;322;181;178.0;300.0;215.0;223.0;611.0;604.0;1714
7923;Sluis;2011;23844;4975;13456;5413;18145;4806;2609;2197;893;500;393;118;64;54;51;25;26;101;51;50;63;25;38;560;335;225;172.0;295.0;215.0;213.0;578.0;610.0;1714
7924;Sluis;2012;23690;4873;13184;5633;17931;4830;2629;2201;929;506;423;123;67;56;59;33;26;102;48;54;67;26;41;578;332;246;178.0;307.0;225.0;219.0;625.0;608.0;1714
7925;Sluis;2013;23586;4804;13005;5777;17734;4857;2667;2190;995;523;472;135;69;66;66;37;29;100;49;51;75;31;44;619;337;282;182.0;298.0;223.0;226.0;608.0;611.0;1714
7926;Sluis;2014;23468;4724;12838;5906;17542;4887;2687;2200;1039;540;499;143;72;71;66;38;28;114;52;62;72;32;40;644;346;298;175.0;301.0;217.0;213.0;604.0;598.0;1714
7927;Sluis;2015;23354;4657;12660;6037;17361;4885;2685;2200;1108;580;528;147;77;70;76;42;34;127;57;70;83;40;43;675;364;311;185.0;304.0;221.0;209.0;662.0;606.0;1714
7928;Sluis;2016;23304;4638;12520;6146;17215;4920;2702;2218;1169;599;570;154;81;73;78;41;37;143;65;78;102;47;55;692;365;327;184.0;305.0;222.0;201.0;624.0;613.0;1714
7929;Sluis;2017;23219;4568;12406;6245;17021;4972;2736;2236;1226;620;606;157;83;74;88;46;42;153;65;88;117;53;64;711;373;338;183.0;309.0;223.0;209.0;593.0;622.0;1714
7930;Sluis;2018;23079;4483;12276;6320;16811;4981;2729;2252;1287;655;632;160;87;73;91;47;44;160;73;87;118;54;64;758;394;364;184.0;306.0;215.0;205.0;587.0;621.0;1714
7931;Sluis;2019;22933;4427;12129;6377;16623;4958;2705;2253;1352;682;670;172;91;81;97;49;48;164;71;93;122;59;63;797;412;385;192.0;312.0;221.0;205.0;674.0;610.0;1714
7932;Sluis;2020;22894;4386;12058;6450;16559;4961;2725;2236;1374;678;696;175;94;81;102;53;49;176;74;102;131;54;77;790;403;387;195.0;310.0;210.0;204.0;586.0;624.0;1714
7933;Sluis;2021;22750;4312;11896;6542;16387;4942;2712;2230;1421;703;718;179;97;82;112;61;51;188;78;110;130;52;78;812;415;397;197.0;310.0;207.0;205.0;622.0;607.0;1714
7934;Sluis;2022;22655;4255;11777;6623;16255;4931;2703;2228;1469;725;744;189;102;87;117;67;50;194;81;113;133;54;79;836;421;415;196.0;313.0;205.0;199.0;657.0;602.0;1714
7935;Sluis;2023;22601;4215;11715;6671;16143;4930;2697;2233;1528;751;777;186;99;87;130;73;57;202;86;116;147;59;88;863;434;429;201.0;319.0;212.0;202.0;645.0;629.0;1714
7936;Sluis;2024;22510;4166;11607;6737;16036;4909;2677;2232;1565;766;799;193;101;92;139;75;64;202;83;119;153;61;92;878;446;432;203.0;316.0;201.0;195.0;576.0;604.0;1714
7937;Sluis;2025;22376;4112;11491;6773;15852;4919;2663;2256;1605;789;816;198;107;91;147;77;70;203;78;125;156;64;92;901;463;438;;;;;;;1714
7938;Smallingerland;2008;55181;13803;32484;8894;49814;2784;1121;1663;2583;1586;997;344;173;171;316;185;131;154;80;74;222;105;117;1547;1043;504;654.0;474.0;190.0;233.0;2066.0;2007.0;90
7939;Smallingerland;2009;55390;13792;32480;9118;49948;2828;1151;1677;2614;1576;1038;349;176;173;303;172;131;177;90;87;252;120;132;1533;1018;515;650.0;489.0;209.0;234.0;2035.0;2030.0;90
7940;Smallingerland;2010;55539;13750;32438;9351;49973;2852;1152;1700;2714;1618;1096;365;187;178;300;172;128;201;102;99;280;122;158;1568;1035;533;645.0;499.0;210.0;228.0;2069.0;2025.0;90
7941;Smallingerland;2011;55718;13657;32527;9534;50045;2846;1140;1706;2827;1682;1145;381;196;185;320;187;133;230;118;112;280;123;157;1616;1058;558;638.0;504.0;216.0;227.0;2104.0;2067.0;90
7942;Smallingerland;2012;55881;13575;32396;9910;50114;2873;1151;1722;2894;1704;1190;389;198;191;314;182;132;253;127;126;293;127;166;1645;1070;575;643.0;513.0;232.0;230.0;2126.0;2076.0;90
7943;Smallingerland;2013;56071;13544;32311;10216;50246;2894;1157;1737;2931;1687;1244;404;212;192;315;181;134;276;135;141;289;126;163;1647;1033;614;636.0;525.0;217.0;220.0;2171.0;2062.0;90
7944;Smallingerland;2014;56298;13532;32268;10498;50363;2921;1176;1745;3014;1719;1295;409;216;193;314;173;141;294;140;154;308;136;172;1689;1054;635;637.0;528.0;215.0;219.0;2038.0;2074.0;90
7945;Smallingerland;2015;56374;13421;32282;10671;50305;2947;1164;1783;3122;1776;1346;430;231;199;322;185;137;329;159;170;327;143;184;1714;1058;656;636.0;544.0;209.0;218.0;2066.0;2084.0;90
7946;Smallingerland;2016;56442;13321;32274;10847;50311;2963;1181;1782;3168;1781;1387;432;233;199;323;179;144;345;170;175;345;149;196;1723;1050;673;625.0;546.0;232.0;216.0;2225.0;2093.0;90
7947;Smallingerland;2017;56674;13286;32333;11055;50426;2976;1193;1783;3272;1849;1423;454;234;220;345;195;150;365;184;181;355;158;197;1753;1078;675;631.0;559.0;228.0;212.0;2208.0;2085.0;90
7948;Smallingerland;2018;56888;13250;32390;11248;50556;2994;1205;1789;3338;1850;1488;472;246;226;336;186;150;390;187;203;357;157;200;1783;1074;709;637.0;558.0;203.0;213.0;2200.0;2121.0;90
7949;Smallingerland;2019;57043;13175;32363;11505;50568;3054;1238;1816;3421;1881;1540;479;244;235;358;199;159;407;194;213;373;158;215;1804;1086;718;641.0;575.0;212.0;213.0;2142.0;2119.0;90
7950;Smallingerland;2020;57141;13080;32340;11721;50517;3102;1276;1826;3522;1927;1595;512;262;250;351;194;157;428;195;233;390;162;228;1841;1114;727;651.0;584.0;210.0;199.0;2160.0;2108.0;90
7951;Smallingerland;2021;57277;13047;32266;11964;50567;3110;1264;1846;3600;1982;1618;523;271;252;359;194;165;448;209;239;409;170;239;1861;1138;723;654.0;579.0;221.0;205.0;2107.0;2101.0;90
7952;Smallingerland;2022;57382;12974;32232;12176;50590;3130;1282;1848;3662;2024;1638;526;275;251;354;188;166;456;214;242;424;176;248;1902;1171;731;647.0;598.0;221.0;209.0;2217.0;2086.0;90
7953;Smallingerland;2023;57580;12993;32198;12389;50627;3172;1303;1869;3781;2078;1703;553;291;262;367;194;173;480;227;253;449;180;269;1932;1186;746;647.0;604.0;214.0;207.0;2197.0;2132.0;90
7954;Smallingerland;2024;57700;12938;32207;12555;50633;3213;1318;1895;3854;2118;1736;569;304;265;365;182;183;526;250;276;462;191;271;1932;1191;741;650.0;607.0;208.0;194.0;2268.0;2095.0;90
7955;Smallingerland;2025;57933;12970;32162;12801;50755;3232;1321;1911;3946;2160;1786;580;312;268;361;175;186;540;256;284;492;201;291;1973;1216;757;;;;;;;90
7956;Sneek;2008;33151;8244;19520;5387;29746;2090;716;1374;1315;719;596;195;98;97;64;26;38;160;85;75;98;41;57;798;469;329;378.0;322.0;96.0;146.0;1552.0;1400.0;91
7957;Sneek;2009;33315;8245;19587;5483;29880;2062;713;1349;1373;750;623;205;101;104;71;31;40;179;91;88;116;53;63;802;474;328;377.0;318.0;98.0;152.0;1340.0;1361.0;91
7958;Sneek;2010;33304;8220;19548;5536;29831;2058;697;1361;1415;785;630;206;103;103;71;30;41;194;108;86;134;63;71;810;481;329;375.0;320.0;100.0;151.0;1430.0;1388.0;91
7959;Sneek;2011;33356;8198;19508;5650;29852;2044;695;1349;1460;829;631;206;106;100;72;33;39;204;116;88;149;75;74;829;499;330;368.0;319.0;118.0;143.0;1405.0;1347.0;91
7960;Sneek;2012;33443;8153;19411;5879;29881;2040;701;1339;1522;859;663;204;109;95;83;46;37;217;117;100;168;80;88;850;507;343;353.0;325.0;112.0;142.0;1311.0;1356.0;91
7961;Sneek;2013;33398;8062;19300;6036;29786;2020;689;1331;1592;902;690;214;117;97;98;51;47;225;119;106;187;86;101;868;529;339;362.0;326.0;106.0;137.0;1365.0;1380.0;91
7962;Sneek;2014;33390;8035;19239;6116;29752;1998;687;1311;1640;936;704;224;125;99;104;56;48;231;119;112;200;93;107;881;543;338;353.0;325.0;110.0;134.0;1443.0;1403.0;91
7963;Sneek;2015;33438;8004;19209;6225;29764;1965;667;1298;1709;974;735;236;131;105;114;66;48;248;127;121;218;99;119;893;551;342;355.0;326.0;117.0;135.0;1419.0;1359.0;91
7964;Sneek;2016;33513;7996;19210;6307;29765;1971;683;1288;1777;1005;772;245;132;113;119;70;49;270;141;129;241;107;134;902;555;347;359.0;336.0;116.0;143.0;1446.0;1424.0;91
7965;Sneek;2017;33535;7978;19166;6391;29762;1955;692;1263;1818;1011;807;259;137;122;119;68;51;296;153;143;255;114;141;889;539;350;366.0;337.0;119.0;138.0;1381.0;1395.0;91
7966;Sneek;2018;33537;7973;19071;6493;29709;1961;681;1280;1867;1044;823;260;142;118;126;74;52;307;160;147;272;126;146;902;542;360;353.0;337.0;113.0;134.0;1317.0;1451.0;91
7967;Sneek;2019;33403;7880;18961;6562;29517;1954;671;1283;1932;1058;874;268;144;124;141;77;64;313;162;151;296;129;167;914;546;368;363.0;338.0;108.0;129.0;1336.0;1429.0;91
7968;Sneek;2020;33318;7748;18927;6643;29421;1915;651;1264;1982;1103;879;279;149;130;150;86;64;333;169;164;298;126;172;922;573;349;369.0;342.0;134.0;132.0;1359.0;1432.0;91
7969;Sneek;2021;33284;7656;18901;6727;29330;1931;664;1267;2023;1104;919;287;154;133;153;82;71;343;167;176;309;131;178;931;570;361;371.0;347.0;113.0;132.0;1430.0;1443.0;91
7970;Sneek;2022;33278;7586;18893;6799;29273;1948;673;1275;2057;1118;939;292;156;136;163;91;72;357;170;187;323;136;187;922;565;357;371.0;348.0;103.0;127.0;1349.0;1425.0;91
7971;Sneek;2023;33205;7529;18747;6929;29152;1943;671;1272;2110;1144;966;298;158;140;169;99;70;357;168;189;346;141;205;940;578;362;374.0;357.0;111.0;128.0;1301.0;1405.0;91
7972;Sneek;2024;33105;7511;18535;7059;29052;1935;674;1261;2118;1150;968;296;162;134;179;102;77;358;173;185;349;137;212;936;576;360;375.0;363.0;105.0;124.0;1386.0;1379.0;91
7973;Sneek;2025;33108;7513;18416;7179;28999;1928;677;1251;2181;1173;1008;294;163;131;195;107;88;369;178;191;363;141;222;960;584;376;;;;;;;91
7974;Soest;2008;45150;10899;26790;7461;36731;3986;1420;2566;4433;2440;1993;354;172;182;285;132;153;2019;1045;974;525;268;257;1250;823;427;403.0;434.0;197.0;246.0;1630.0;1653.0;342
7975;Soest;2009;45054;10742;26732;7580;36632;3954;1401;2553;4468;2457;2011;385;191;194;283;134;149;1989;1027;962;530;265;265;1281;840;441;401.0;435.0;199.0;235.0;1814.0;1673.0;342
7976;Soest;2010;45131;10557;26793;7781;36642;3937;1383;2554;4552;2494;2058;395;206;189;294;142;152;1983;1013;970;537;263;274;1343;870;473;396.0;435.0;194.0;240.0;1833.0;1694.0;342
7977;Soest;2011;45187;10419;26884;7884;36625;3964;1386;2578;4598;2515;2083;402;207;195;300;147;153;1963;1003;960;558;268;290;1375;890;485;397.0;433.0;191.0;239.0;1943.0;1706.0;342
7978;Soest;2012;45344;10286;26765;8293;36740;3957;1359;2598;4647;2537;2110;414;213;201;301;146;155;1944;992;952;570;271;299;1418;915;503;406.0;437.0;198.0;221.0;1829.0;1704.0;342
7979;Soest;2013;45419;10141;26614;8664;36739;3991;1377;2614;4689;2544;2145;430;218;212;299;148;151;1900;972;928;597;275;322;1463;931;532;409.0;444.0;204.0;232.0;1900.0;1722.0;342
7980;Soest;2014;45539;10061;26525;8953;36822;4000;1361;2639;4717;2548;2169;435;228;207;303;150;153;1882;955;927;620;274;346;1477;941;536;422.0;449.0;199.0;221.0;1836.0;1732.0;342
7981;Soest;2015;45599;9951;26491;9157;36798;3998;1368;2630;4803;2591;2212;462;238;224;298;149;149;1879;954;925;631;282;349;1533;968;565;425.0;454.0;207.0;232.0;1804.0;1700.0;342
7982;Soest;2016;45652;9838;26424;9390;36831;3994;1355;2639;4827;2620;2207;484;246;238;300;158;142;1865;955;910;641;291;350;1537;970;567;421.0;456.0;189.0;220.0;1856.0;1675.0;342
7983;Soest;2017;45772;9752;26457;9563;36874;4003;1354;2649;4895;2648;2247;500;251;249;296;162;134;1856;940;916;649;297;352;1594;998;596;427.0;458.0;190.0;213.0;1862.0;1704.0;342
7984;Soest;2018;45882;9690;26467;9725;36889;3994;1362;2632;4999;2655;2344;527;253;274;325;173;152;1865;940;925;666;301;365;1616;988;628;432.0;467.0;183.0;216.0;1698.0;1705.0;342
7985;Soest;2019;45813;9500;26418;9895;36784;4011;1372;2639;5018;2638;2380;530;254;276;320;167;153;1844;926;918;677;304;373;1647;987;660;430.0;467.0;198.0;213.0;1939.0;1660.0;342
7986;Soest;2020;46043;9459;26472;10112;36882;4073;1397;2676;5088;2686;2402;539;262;277;326;174;152;1839;923;916;689;307;382;1695;1020;675;443.0;483.0;181.0;196.0;1869.0;1729.0;342
7987;Soest;2021;46134;9384;26471;10279;36883;4093;1414;2679;5158;2725;2433;551;271;280;323;179;144;1843;926;917;708;313;395;1733;1036;697;447.0;483.0;197.0;205.0;1826.0;1754.0;342
7988;Soest;2022;46165;9289;26424;10452;36842;4102;1414;2688;5221;2749;2472;558;277;281;334;186;148;1835;918;917;708;304;404;1786;1064;722;453.0;499.0;183.0;200.0;2026.0;1755.0;342
7989;Soest;2023;46375;9269;26488;10618;36914;4166;1436;2730;5295;2784;2511;566;284;282;346;192;154;1798;906;892;727;301;426;1858;1101;757;450.0;496.0;186.0;201.0;1957.0;1750.0;342
7990;Soest;2024;46523;9200;26528;10795;36963;4218;1454;2764;5342;2776;2566;574;283;291;352;186;166;1815;904;911;753;308;445;1848;1095;753;458.0;507.0;194.0;214.0;1816.0;1753.0;342
7991;Soest;2025;46522;9169;26392;10961;36911;4247;1480;2767;5364;2778;2586;582;292;290;364;189;175;1789;880;909;750;309;441;1879;1108;771;;;;;;;342
7992;Someren;2008;17822;4727;10478;2617;16751;726;248;478;345;208;137;31;14;17;13;6;7;29;15;14;66;33;33;206;140;66;147.0;137.0;59.0;70.0;318.0;489.0;847
7993;Someren;2009;17652;4569;10395;2688;16549;732;253;479;371;226;145;33;16;17;14;7;7;35;17;18;66;34;32;223;152;71;143.0;133.0;65.0;68.0;317.0;500.0;847
7994;Someren;2010;17477;4414;10287;2776;16327;738;254;484;412;253;159;43;22;21;19;11;8;43;20;23;70;35;35;237;165;72;140.0;138.0;69.0;67.0;427.0;516.0;847
7995;Someren;2011;17392;4291;10283;2818;16219;726;255;471;447;271;176;45;25;20;16;10;6;55;17;38;75;35;40;256;184;72;138.0;148.0;78.0;65.0;430.0;508.0;847
7996;Someren;2012;17318;4153;10254;2911;16069;751;271;480;498;286;212;54;27;27;22;15;7;70;24;46;84;35;49;268;185;83;138.0;144.0;78.0;66.0;529.0;555.0;847
7997;Someren;2013;17300;4026;10225;3049;16002;761;276;485;537;313;224;58;29;29;25;16;9;79;28;51;86;38;48;289;202;87;141.0;149.0;79.0;67.0;566.0;562.0;847
7998;Someren;2014;17311;3908;10244;3159;15968;765;274;491;578;331;247;60;32;28;32;19;13;82;29;53;84;32;52;320;219;101;146.0;157.0;75.0;65.0;602.0;564.0;847
7999;Someren;2015;17350;3825;10256;3269;15950;791;280;511;609;359;250;67;36;31;31;18;13;83;33;50;86;31;55;342;241;101;144.0;164.0;77.0;70.0;587.0;570.0;847
8000;Someren;2016;17354;3747;10263;3344;15904;812;294;518;638;372;266;76;39;37;31;20;11;90;38;52;99;33;66;342;242;100;151.0;166.0;74.0;63.0;584.0;567.0;847
8001;Someren;2017;17369;3645;10300;3424;15859;843;308;535;667;386;281;78;43;35;32;19;13;101;41;60;102;37;65;354;246;108;156.0;171.0;75.0;64.0;556.0;563.0;847
8002;Someren;2018;17359;3573;10286;3500;15803;860;319;541;696;394;302;82;44;38;34;19;15;112;42;70;105;36;69;363;253;110;163.0;174.0;77.0;65.0;595.0;562.0;847
8003;Someren;2019;17394;3515;10355;3524;15776;882;331;551;736;418;318;85;47;38;47;28;19;112;44;68;103;34;69;389;265;124;159.0;179.0;80.0;65.0;664.0;568.0;847
8004;Someren;2020;17486;3498;10373;3615;15805;906;334;572;775;449;326;95;52;43;50;31;19;112;46;66;109;37;72;409;283;126;174.0;180.0;76.0;64.0;572.0;582.0;847
8005;Someren;2021;17486;3455;10333;3698;15745;926;347;579;815;462;353;103;58;45;52;33;19;119;47;72;120;36;84;421;288;133;176.0;181.0;72.0;63.0;590.0;568.0;847
8006;Someren;2022;17514;3425;10290;3799;15722;946;360;586;846;481;365;106;61;45;56;36;20;127;51;76;128;42;86;429;291;138;178.0;187.0;75.0;65.0;616.0;573.0;847
8007;Someren;2023;17561;3409;10241;3911;15738;962;382;580;861;492;369;109;63;46;58;38;20;130;49;81;127;46;81;437;296;141;184.0;192.0;72.0;65.0;630.0;582.0;847
8008;Someren;2024;17610;3397;10174;4039;15749;965;380;585;896;508;388;108;60;48;59;38;21;140;55;85;137;48;89;452;307;145;184.0;195.0;80.0;64.0;616.0;565.0;847
8009;Someren;2025;17668;3401;10116;4151;15763;980;388;592;925;521;404;115;62;53;67;42;25;150;55;95;137;48;89;456;314;142;;;;;;;847
8010;Son en Breugel;2008;15293;3881;8513;2899;13565;1181;439;742;547;313;234;61;25;36;61;26;35;55;23;32;44;19;25;326;220;106;152.0;124.0;71.0;97.0;587.0;588.0;848
8011;Son en Breugel;2009;15296;3873;8476;2947;13514;1188;435;753;594;351;243;64;30;34;69;30;39;61;29;32;55;26;29;345;236;109;142.0;131.0;94.0;94.0;632.0;605.0;848
8012;Son en Breugel;2010;15335;3821;8514;3000;13510;1188;438;750;637;376;261;70;29;41;69;32;37;68;33;35;67;32;35;363;250;113;143.0;133.0;78.0;92.0;616.0;619.0;848
8013;Son en Breugel;2011;15329;3754;8540;3035;13461;1178;440;738;690;398;292;79;35;44;69;35;34;80;33;47;82;40;42;380;255;125;143.0;136.0;87.0;90.0;538.0;637.0;848
8014;Son en Breugel;2012;15235;3661;8483;3091;13334;1174;434;740;727;412;315;83;37;46;73;38;35;90;37;53;82;39;43;399;261;138;134.0;137.0;89.0;82.0;581.0;619.0;848
8015;Son en Breugel;2013;15203;3584;8474;3145;13272;1166;432;734;765;440;325;87;44;43;68;39;29;95;40;55;90;42;48;425;275;150;136.0;139.0;85.0;90.0;613.0;631.0;848
8016;Son en Breugel;2014;15178;3524;8471;3183;13222;1158;427;731;798;450;348;89;47;42;71;37;34;106;41;65;92;44;48;440;281;159;134.0;144.0;85.0;85.0;566.0;642.0;848
8017;Son en Breugel;2015;15093;3421;8478;3194;13106;1163;428;735;824;460;364;92;47;45;69;36;33;108;42;66;111;49;62;444;286;158;137.0;144.0;81.0;85.0;610.0;648.0;848
8018;Son en Breugel;2016;15046;3341;8498;3207;13000;1163;423;740;883;490;393;100;51;49;66;35;31;119;47;72;120;50;70;478;307;171;138.0;151.0;80.0;81.0;549.0;643.0;848
8019;Son en Breugel;2017;14939;3273;8443;3223;12876;1156;420;736;907;508;399;104;54;50;67;35;32;123;51;72;122;50;72;491;318;173;138.0;148.0;75.0;81.0;578.0;651.0;848
8020;Son en Breugel;2018;14851;3217;8387;3247;12754;1157;421;736;940;518;422;103;53;50;73;40;33;131;53;78;131;53;78;502;319;183;139.0;150.0;82.0;81.0;548.0;649.0;848
8021;Son en Breugel;2019;14741;3147;8366;3228;12634;1155;424;731;952;526;426;105;60;45;78;43;35;136;54;82;134;56;78;499;313;186;145.0;146.0;82.0;85.0;532.0;616.0;848
8022;Son en Breugel;2020;14655;3112;8310;3233;12497;1184;428;756;974;537;437;111;62;49;85;48;37;143;58;85;147;59;88;488;310;178;146.0;152.0;83.0;88.0;561.0;638.0;848
8023;Son en Breugel;2021;14571;3059;8280;3232;12361;1211;444;767;999;534;465;119;59;60;84;47;37;138;55;83;165;69;96;493;304;189;153.0;151.0;78.0;76.0;550.0;646.0;848
8024;Son en Breugel;2022;14481;3020;8205;3256;12242;1207;436;771;1032;560;472;116;60;56;85;45;40;139;58;81;178;76;102;514;321;193;150.0;151.0;84.0;81.0;523.0;638.0;848
8025;Son en Breugel;2023;14370;2989;8107;3274;12079;1220;442;778;1071;580;491;117;61;56;91;51;40;145;63;82;193;84;109;525;321;204;150.0;155.0;74.0;76.0;511.0;601.0;848
8026;Son en Breugel;2024;14274;2960;8035;3279;11958;1214;442;772;1102;588;514;120;62;58;99;55;44;153;66;87;201;87;114;529;318;211;144.0;149.0;85.0;80.0;546.0;627.0;848
8027;Son en Breugel;2025;14194;2925;7925;3344;11853;1213;438;775;1128;604;524;128;67;61;103;59;44;154;68;86;213;89;124;530;321;209;;;;;;;848
8028;Spijkenisse;2008;73077;17276;46379;9422;56734;6843;2785;4058;9500;5319;4181;3059;1619;1440;1683;1027;656;1065;510;555;513;237;276;3180;1926;1254;767.0;516.0;299.0;543.0;2305.0;2885.0;612
8029;Spijkenisse;2009;72515;16945;45835;9735;56151;6811;2770;4041;9553;5271;4282;3011;1583;1428;1644;988;656;1087;518;569;590;261;329;3221;1921;1300;742.0;537.0;331.0;513.0;2562.0;2845.0;612
8030;Spijkenisse;2010;72268;16671;45551;10046;55792;6796;2774;4022;9680;5274;4406;3012;1575;1437;1601;954;647;1120;519;601;656;276;380;3291;1950;1341;731.0;553.0;324.0;507.0;2419.0;2823.0;612
8031;Spijkenisse;2011;71867;16368;45251;10248;55382;6746;2771;3975;9739;5231;4508;2985;1556;1429;1533;901;632;1175;533;642;728;299;429;3318;1942;1376;715.0;565.0;342.0;501.0;2570.0;2847.0;612
8032;Spijkenisse;2012;71589;16077;44667;10845;55019;6735;2778;3957;9835;5226;4609;2927;1515;1412;1502;874;628;1212;547;665;777;311;466;3417;1979;1438;708.0;583.0;328.0;486.0;2601.0;2765.0;612
8033;Spijkenisse;2013;71398;15866;44111;11421;54770;6765;2822;3943;9863;5181;4682;2859;1461;1398;1466;849;617;1279;573;706;839;334;505;3420;1964;1456;681.0;591.0;314.0;481.0;2491.0;2693.0;612
8034;Spijkenisse;2014;71125;15609;43579;11937;54448;6716;2783;3933;9961;5200;4761;2844;1438;1406;1464;849;615;1333;586;747;887;361;526;3433;1966;1467;675.0;613.0;305.0;467.0;2570.0;2714.0;612
8035;Spijkenisse;2015;70891;15405;43206;12280;54181;6679;2757;3922;10031;5194;4837;2831;1442;1389;1446;832;614;1333;588;745;933;376;557;3488;1956;1532;660.0;625.0;310.0;459.0;2649.0;2692.0;612
8036;Spijkenisse;2016;70741;15205;42839;12697;53867;6705;2788;3917;10169;5219;4950;2827;1439;1388;1421;812;609;1366;600;766;983;381;602;3572;1987;1585;666.0;633.0;310.0;452.0;2990.0;2663.0;612
8037;Spijkenisse;2017;70966;15202;42651;13113;53838;6750;2824;3926;10378;5267;5111;2829;1432;1397;1418;791;627;1451;623;828;1020;387;633;3660;2034;1626;676.0;646.0;295.0;443.0;2879.0;2663.0;612
8038;Spijkenisse;2018;71075;15121;42471;13483;53738;6805;2849;3956;10532;5327;5205;2811;1412;1399;1408;782;626;1470;635;835;1087;404;683;3756;2094;1662;677.0;653.0;307.0;443.0;2938.0;2710.0;612
8039;Spijkenisse;2019;71198;15053;42176;13969;53691;6846;2887;3959;10661;5349;5312;2805;1404;1401;1361;743;618;1525;647;878;1123;412;711;3847;2143;1704;668.0;676.0;303.0;440.0;2941.0;2722.0;612
8040;Spijkenisse;2020;71277;15037;41815;14425;53591;6919;2934;3985;10767;5331;5436;2804;1399;1405;1376;745;631;1542;645;897;1162;418;744;3883;2124;1759;664.0;672.0;295.0;423.0;2840.0;2691.0;612
8041;Spijkenisse;2021;71297;14924;41485;14888;53462;6960;2942;4018;10875;5360;5515;2768;1374;1394;1365;742;623;1576;644;932;1198;425;773;3968;2175;1793;673.0;691.0;320.0;428.0;3016.0;2726.0;612
8042;Spijkenisse;2022;71469;14893;41256;15320;53393;7067;3016;4051;11009;5381;5628;2738;1358;1380;1370;749;621;1617;650;967;1221;428;793;4063;2196;1867;667.0;713.0;300.0;426.0;2949.0;2727.0;612
8043;Spijkenisse;2023;71525;14845;40959;15721;53252;7106;3070;4036;11167;5403;5764;2733;1352;1381;1379;746;633;1666;676;990;1253;438;815;4136;2191;1945;673.0;721.0;297.0;428.0;2898.0;2735.0;612
8044;Spijkenisse;2024;71513;14803;40633;16077;53019;7170;3103;4067;11324;5453;5871;2710;1335;1375;1368;742;626;1700;680;1020;1321;469;852;4225;2227;1998;682.0;733.0;286.0;425.0;2997.0;2718.0;612
8045;Spijkenisse;2025;71611;14753;40412;16446;52872;7268;3177;4091;11471;5484;5987;2694;1327;1367;1347;715;632;1745;694;1051;1386;490;896;4299;2258;2041;;;;;;;612
8046;Stadskanaal;2008;33859;7867;19687;6305;30949;1758;762;996;1152;794;358;145;78;67;53;31;22;66;37;29;72;30;42;816;618;198;358.0;352.0;112.0;208.0;1470.0;1394.0;37
8047;Stadskanaal;2009;33848;7847;19631;6370;30920;1741;764;977;1187;787;400;162;83;79;60;38;22;86;37;49;83;32;51;796;597;199;354.0;350.0;118.0;204.0;1568.0;1413.0;37
8048;Stadskanaal;2010;33927;7880;19592;6455;30952;1740;747;993;1235;783;452;185;91;94;63;37;26;109;49;60;89;32;57;789;574;215;350.0;357.0;131.0;196.0;1555.0;1433.0;37
8049;Stadskanaal;2011;33979;7900;19555;6524;30923;1761;761;1000;1295;798;497;194;96;98;84;52;32;130;54;76;96;39;57;791;557;234;354.0;359.0;131.0;196.0;1568.0;1447.0;37
8050;Stadskanaal;2012;34034;7864;19432;6738;30919;1783;768;1015;1332;805;527;210;100;110;89;58;31;133;56;77;114;43;71;786;548;238;357.0;365.0;123.0;193.0;1578.0;1449.0;37
8051;Stadskanaal;2013;34091;7839;19366;6886;30903;1812;773;1039;1376;822;554;220;105;115;98;63;35;158;70;88;118;47;71;782;537;245;348.0;365.0;130.0;189.0;1533.0;1469.0;37
8052;Stadskanaal;2014;34081;7801;19293;6987;30829;1830;761;1069;1422;838;584;224;109;115;111;71;40;162;69;93;137;50;87;788;539;249;347.0;367.0;145.0;185.0;1516.0;1454.0;37
8053;Stadskanaal;2015;34086;7743;19313;7030;30727;1854;770;1084;1505;881;624;230;113;117;137;85;52;190;81;109;146;57;89;802;545;257;351.0;371.0;124.0;187.0;1573.0;1479.0;37
8054;Stadskanaal;2016;34101;7749;19204;7148;30685;1859;760;1099;1557;896;661;237;115;122;148;93;55;207;87;120;153;58;95;812;543;269;346.0;367.0;122.0;181.0;1565.0;1462.0;37
8055;Stadskanaal;2017;34128;7699;19207;7222;30645;1875;766;1109;1608;906;702;259;126;133;158;95;63;222;91;131;160;58;102;809;536;273;354.0;371.0;139.0;188.0;1520.0;1463.0;37
8056;Stadskanaal;2018;34130;7667;19165;7298;30542;1916;785;1131;1672;926;746;268;132;136;172;102;70;237;95;142;172;60;112;823;537;286;356.0;372.0;125.0;177.0;1561.0;1473.0;37
8057;Stadskanaal;2019;34159;7582;19178;7399;30503;1913;772;1141;1743;951;792;280;142;138;187;105;82;250;103;147;187;60;127;839;541;298;355.0;376.0;124.0;183.0;1538.0;1489.0;37
8058;Stadskanaal;2020;34130;7546;19095;7489;30444;1920;793;1127;1766;953;813;279;142;137;204;116;88;273;114;159;184;57;127;826;524;302;340.0;382.0;146.0;177.0;1515.0;1482.0;37
8059;Stadskanaal;2021;34094;7514;18957;7623;30339;1933;799;1134;1822;977;845;289;152;137;208;120;88;293;122;171;197;55;142;835;528;307;357.0;391.0;126.0;171.0;1558.0;1447.0;37
8060;Stadskanaal;2022;34129;7476;18929;7724;30309;1966;828;1138;1854;990;864;292;152;140;234;126;108;298;125;173;202;65;137;828;522;306;347.0;399.0;131.0;170.0;1503.0;1453.0;37
8061;Stadskanaal;2023;34096;7451;18823;7822;30196;1979;833;1146;1921;1011;910;316;166;150;240;131;109;308;127;181;216;64;152;841;523;318;355.0;401.0;127.0;168.0;1513.0;1458.0;37
8062;Stadskanaal;2024;34067;7433;18705;7929;30099;2025;858;1167;1943;1020;923;325;169;156;248;142;106;306;128;178;221;63;158;843;518;325;350.0;405.0;123.0;167.0;1507.0;1428.0;37
8063;Stadskanaal;2025;34051;7393;18596;8062;30003;2033;874;1159;2015;1066;949;332;176;156;260;148;112;314;137;177;238;69;169;871;536;335;;;;;;;37
8064;Staphorst;2008;15706;5271;8611;1824;15199;255;84;171;252;161;91;39;23;16;10;6;4;19;9;10;10;2;8;174;121;53;277.0;106.0;27.0;44.0;345.0;556.0;180
8065;Staphorst;2009;15651;5235;8537;1879;15088;276;94;182;287;173;114;45;26;19;12;7;5;28;11;17;13;4;9;189;125;64;268.0;108.0;33.0;41.0;405.0;558.0;180
8066;Staphorst;2010;15652;5206;8544;1902;15032;287;97;190;333;201;132;53;31;22;14;7;7;33;14;19;18;8;10;215;141;74;263.0;110.0;48.0;45.0;334.0;552.0;180
8067;Staphorst;2011;15596;5133;8483;1980;14908;316;114;202;372;214;158;61;36;25;16;9;7;42;15;27;25;7;18;228;147;81;258.0;108.0;38.0;45.0;398.0;549.0;180
8068;Staphorst;2012;15588;5081;8419;2088;14850;340;121;219;398;231;167;69;44;25;17;9;8;47;18;29;32;9;23;233;151;82;250.0;109.0;41.0;43.0;393.0;549.0;180
8069;Staphorst;2013;15572;5039;8363;2170;14796;356;132;224;420;234;186;69;45;24;19;10;9;54;19;35;34;10;24;244;150;94;250.0;116.0;39.0;43.0;488.0;549.0;180
8070;Staphorst;2014;15643;5025;8367;2251;14808;373;132;241;462;257;205;74;45;29;22;11;11;59;21;38;43;15;28;264;165;99;251.0;117.0;45.0;45.0;409.0;557.0;180
8071;Staphorst;2015;15629;4990;8331;2308;14718;395;144;251;516;276;240;85;51;34;26;13;13;77;26;51;55;21;34;273;165;108;246.0;116.0;40.0;39.0;427.0;566.0;180
8072;Staphorst;2016;15619;4924;8345;2350;14669;409;146;263;541;284;257;88;50;38;28;15;13;88;33;55;61;19;42;276;167;109;244.0;122.0;51.0;45.0;431.0;574.0;180
8073;Staphorst;2017;15604;4869;8331;2404;14580;425;154;271;599;314;285;91;56;35;36;18;18;100;37;63;69;22;47;303;181;122;243.0;115.0;40.0;47.0;516.0;557.0;180
8074;Staphorst;2018;15687;4834;8365;2488;14622;441;157;284;624;329;295;97;59;38;40;21;19;97;37;60;78;26;52;312;186;126;240.0;123.0;44.0;44.0;418.0;571.0;180
8075;Staphorst;2019;15652;4757;8347;2548;14527;458;167;291;667;353;314;103;66;37;37;21;16;104;40;64;89;29;60;334;197;137;244.0;123.0;34.0;45.0;505.0;563.0;180
8076;Staphorst;2020;15705;4690;8388;2627;14533;483;185;298;689;359;330;110;68;42;36;21;15;105;39;66;90;32;58;348;199;149;241.0;124.0;43.0;40.0;482.0;587.0;180
8077;Staphorst;2021;15721;4608;8423;2690;14506;490;182;308;725;370;355;111;67;44;42;25;17;117;44;73;97;32;65;358;202;156;242.0;132.0;35.0;48.0;491.0;572.0;180
8078;Staphorst;2022;15741;4595;8402;2744;14478;502;184;318;761;376;385;112;70;42;43;21;22;124;47;77;107;34;73;375;204;171;240.0;131.0;42.0;47.0;462.0;565.0;180
8079;Staphorst;2023;15746;4521;8407;2818;14444;520;191;329;782;366;416;119;72;47;43;20;23;130;49;81;108;30;78;382;195;187;238.0;137.0;39.0;47.0;437.0;570.0;180
8080;Staphorst;2024;15707;4477;8324;2906;14383;513;181;332;811;381;430;122;73;49;53;28;25;129;49;80;111;34;77;396;197;199;235.0;137.0;38.0;48.0;497.0;569.0;180
8081;Staphorst;2025;15726;4452;8302;2972;14364;533;189;344;829;402;427;128;76;52;53;30;23;128;50;78;118;38;80;402;208;194;;;;;;;180
8082;Stede Broec;2008;21008;5413;12930;2665;18943;1120;401;719;945;517;428;191;98;93;57;33;24;116;71;45;112;47;65;469;268;201;222.0;167.0;74.0;104.0;787.0;897.0;532
8083;Stede Broec;2009;20925;5333;12789;2803;18845;1106;389;717;974;526;448;194;100;94;58;33;25;124;77;47;114;47;67;484;269;215;215.0;173.0;72.0;100.0;797.0;913.0;532
8084;Stede Broec;2010;20825;5215;12614;2996;18715;1086;387;699;1024;550;474;191;97;94;65;36;29;142;86;56;123;52;71;503;279;224;208.0;177.0;73.0;98.0;833.0;926.0;532
8085;Stede Broec;2011;20742;5110;12510;3122;18605;1085;386;699;1052;562;490;196;99;97;70;40;30;147;89;58;127;53;74;512;281;231;204.0;178.0;75.0;95.0;901.0;918.0;532
8086;Stede Broec;2012;20732;5006;12347;3379;18576;1079;383;696;1077;566;511;192;96;96;68;39;29;159;90;69;132;54;78;526;287;239;205.0;184.0;77.0;94.0;912.0;930.0;532
8087;Stede Broec;2013;20720;4938;12202;3580;18548;1083;386;697;1089;570;519;193;100;93;70;41;29;161;90;71;133;52;81;532;287;245;205.0;190.0;71.0;93.0;986.0;926.0;532
8088;Stede Broec;2014;20776;4878;12150;3748;18570;1100;382;718;1106;569;537;197;101;96;73;43;30;168;89;79;134;49;85;534;287;247;205.0;194.0;76.0;93.0;910.0;928.0;532
8089;Stede Broec;2015;20756;4787;12065;3904;18516;1101;380;721;1139;590;549;202;102;100;78;44;34;173;96;77;134;50;84;552;298;254;205.0;194.0;78.0;87.0;962.0;937.0;532
8090;Stede Broec;2016;20786;4745;12028;4013;18469;1132;384;748;1185;618;567;202;101;101;85;52;33;190;100;90;142;55;87;566;310;256;205.0;198.0;74.0;96.0;914.0;924.0;532
8091;Stede Broec;2017;20763;4641;11971;4151;18435;1138;393;745;1190;618;572;208;106;102;88;56;32;199;103;96;144;54;90;551;299;252;208.0;202.0;71.0;86.0;887.0;940.0;532
8092;Stede Broec;2018;20706;4558;11881;4267;18372;1140;393;747;1194;614;580;214;105;109;84;56;28;197;100;97;147;52;95;552;301;251;210.0;207.0;72.0;86.0;979.0;920.0;532
8093;Stede Broec;2019;20756;4551;11853;4352;18396;1122;399;723;1238;630;608;218;108;110;92;55;37;218;102;116;147;55;92;563;310;253;215.0;211.0;69.0;84.0;851.0;930.0;532
8094;Stede Broec;2020;20668;4479;11749;4440;18278;1113;383;730;1277;641;636;227;107;120;93;59;34;226;112;114;154;56;98;577;307;270;210.0;217.0;96.0;88.0;967.0;922.0;532
8095;Stede Broec;2021;20723;4462;11743;4518;18264;1132;390;742;1327;649;678;228;112;116;94;55;39;253;121;132;159;57;102;593;304;289;219.0;224.0;78.0;89.0;977.0;936.0;532
8096;Stede Broec;2022;20752;4413;11738;4601;18263;1128;387;741;1361;666;695;226;115;111;103;63;40;256;125;131;155;53;102;621;310;311;216.0;223.0;71.0;87.0;979.0;936.0;532
8097;Stede Broec;2023;20775;4406;11693;4676;18258;1108;378;730;1409;690;719;229;118;111;109;64;45;260;129;131;167;55;112;644;324;320;222.0;235.0;80.0;85.0;1011.0;942.0;532
8098;Stede Broec;2024;20829;4401;11701;4727;18286;1109;376;733;1434;710;724;229;122;107;116;68;48;269;128;141;175;60;115;645;332;313;225.0;240.0;67.0;82.0;936.0;943.0;532
8099;Stede Broec;2025;20794;4380;11570;4844;18247;1102;379;723;1445;718;727;230;124;106;118;67;51;264;132;132;178;64;114;655;331;324;;;;;;;532
8100;Steenbergen;2008;22942;5278;14024;3640;20971;1218;468;750;753;413;340;163;83;80;61;29;32;61;25;36;90;46;44;378;230;148;197.0;209.0;94.0;115.0;741.0;879.0;851
8101;Steenbergen;2009;22774;5191;13843;3740;20734;1249;483;766;791;439;352;152;85;67;67;31;36;76;31;45;98;51;47;398;241;157;187.0;212.0;94.0;109.0;786.0;892.0;851
8102;Steenbergen;2010;22630;5074;13717;3839;20522;1273;493;780;835;460;375;165;87;78;71;35;36;78;36;42;111;51;60;410;251;159;191.0;218.0;88.0;111.0;804.0;866.0;851
8103;Steenbergen;2011;22520;4991;13602;3927;20341;1295;502;793;884;482;402;167;92;75;75;34;41;93;42;51;120;58;62;429;256;173;187.0;215.0;90.0;109.0;796.0;936.0;851
8104;Steenbergen;2012;22333;4870;13351;4112;20081;1335;527;808;917;478;439;168;93;75;80;35;45;110;44;66;130;61;69;429;245;184;188.0;217.0;94.0;107.0;853.0;863.0;851
8105;Steenbergen;2013;22285;4763;13237;4285;19957;1350;543;807;978;504;474;180;95;85;90;39;51;117;49;68;141;63;78;450;258;192;186.0;215.0;98.0;106.0;826.0;879.0;851
8106;Steenbergen;2014;22197;4651;13098;4448;19796;1371;555;816;1030;537;493;188;105;83;94;43;51;127;50;77;152;71;81;469;268;201;182.0;222.0;90.0;109.0;850.0;891.0;851
8107;Steenbergen;2015;22100;4558;12970;4572;19648;1398;563;835;1054;531;523;194;107;87;95;43;52;135;53;82;165;72;93;465;256;209;184.0;225.0;89.0;102.0;885.0;889.0;851
8108;Steenbergen;2016;22044;4475;12915;4654;19487;1437;578;859;1120;563;557;205;111;94;108;52;56;142;60;82;177;78;99;488;262;226;189.0;230.0;95.0;104.0;861.0;888.0;851
8109;Steenbergen;2017;21969;4413;12815;4741;19343;1455;593;862;1171;581;590;201;111;90;109;53;56;164;70;94;193;86;107;504;261;243;188.0;232.0;93.0;101.0;770.0;906.0;851
8110;Steenbergen;2018;21783;4292;12649;4842;19115;1462;591;871;1206;601;605;206;114;92;112;57;55;171;74;97;204;89;115;513;267;246;187.0;238.0;94.0;101.0;870.0;866.0;851
8111;Steenbergen;2019;21729;4245;12552;4932;18946;1503;618;885;1280;625;655;212;116;96;108;55;53;196;84;112;220;85;135;544;285;259;188.0;238.0;94.0;99.0;954.0;835.0;851
8112;Steenbergen;2020;21794;4227;12562;5005;18905;1558;640;918;1331;664;667;220;119;101;109;53;56;201;84;117;227;95;132;574;313;261;183.0;245.0;98.0;102.0;854.0;889.0;851
8113;Steenbergen;2021;21696;4152;12453;5091;18755;1578;651;927;1363;682;681;229;124;105;104;51;53;201;82;119;240;106;134;589;319;270;190.0;246.0;98.0;97.0;965.0;897.0;851
8114;Steenbergen;2022;21712;4128;12346;5238;18707;1614;655;959;1391;685;706;223;126;97;107;47;60;221;86;135;233;106;127;607;320;287;185.0;250.0;99.0;108.0;862.0;894.0;851
8115;Steenbergen;2023;21611;4053;12242;5316;18587;1608;653;955;1416;697;719;228;131;97;107;45;62;220;89;131;242;111;131;619;321;298;184.0;253.0;101.0;96.0;840.0;871.0;851
8116;Steenbergen;2024;21518;4023;12108;5387;18412;1643;676;967;1463;719;744;232;132;100;113;51;62;227;90;137;248;111;137;643;335;308;188.0;255.0;95.0;96.0;885.0;856.0;851
8117;Steenbergen;2025;21481;3978;12021;5482;18326;1660;693;967;1495;734;761;243;138;105;116;53;63;238;96;142;253;111;142;645;336;309;;;;;;;851
8118;Steenwijkerland;2008;43169;10908;24865;7396;40132;1743;588;1155;1294;710;584;150;64;86;128;71;57;309;143;166;94;31;63;613;401;212;458.0;378.0;99.0;161.0;1596.0;1606.0;1708
8119;Steenwijkerland;2009;43183;10847;24679;7657;40026;1763;579;1184;1394;752;642;170;76;94;141;71;70;326;151;175;111;39;72;646;415;231;445.0;392.0;102.0;158.0;1631.0;1612.0;1708
8120;Steenwijkerland;2010;43208;10767;24571;7870;39928;1794;577;1217;1486;798;688;184;80;104;154;73;81;343;164;179;124;44;80;681;437;244;442.0;389.0;124.0;158.0;1704.0;1634.0;1708
8121;Steenwijkerland;2011;43304;10687;24538;8079;39902;1821;566;1255;1581;820;761;191;83;108;158;71;87;372;177;195;149;53;96;711;436;275;443.0;405.0;140.0;165.0;1597.0;1632.0;1708
8122;Steenwijkerland;2012;43282;10562;24292;8428;39790;1832;554;1278;1660;860;800;212;94;118;172;70;102;374;181;193;166;63;103;736;452;284;436.0;413.0;121.0;159.0;1635.0;1638.0;1708
8123;Steenwijkerland;2013;43269;10498;24011;8760;39647;1874;559;1315;1748;886;862;215;98;117;179;72;107;404;192;212;200;74;126;750;450;300;431.0;421.0;132.0;156.0;1546.0;1628.0;1708
8124;Steenwijkerland;2014;43183;10427;23734;9022;39463;1894;555;1339;1826;917;909;235;105;130;179;67;112;424;193;231;204;76;128;784;476;308;416.0;426.0;114.0;154.0;1623.0;1610.0;1708
8125;Steenwijkerland;2015;43149;10345;23601;9203;39340;1918;556;1362;1891;943;948;251;113;138;176;65;111;444;194;250;215;81;134;805;490;315;430.0;434.0;143.0;153.0;1569.0;1614.0;1708
8126;Steenwijkerland;2016;43097;10314;23417;9366;39157;1950;568;1382;1990;989;1001;265;121;144;184;67;117;466;204;262;239;89;150;836;508;328;419.0;443.0;132.0;151.0;1464.0;1623.0;1708
8127;Steenwijkerland;2017;42899;10194;23154;9551;38830;1980;580;1400;2089;1032;1057;277;130;147;196;72;124;493;209;284;248;89;159;875;532;343;426.0;447.0;125.0;153.0;1553.0;1635.0;1708
8128;Steenwijkerland;2018;42770;10109;22892;9769;38650;1976;578;1398;2144;1036;1108;283;128;155;206;68;138;504;207;297;268;97;171;883;536;347;425.0;439.0;112.0;149.0;1619.0;1632.0;1708
8129;Steenwijkerland;2019;42708;10007;22754;9947;38494;2004;567;1437;2210;1056;1154;296;135;161;206;69;137;520;213;307;278;91;187;910;548;362;429.0;449.0;126.0;151.0;1523.0;1627.0;1708
8130;Steenwijkerland;2020;42563;9812;22649;10102;38209;2046;585;1461;2308;1121;1187;318;148;170;208;70;138;539;225;314;282;92;190;961;586;375;431.0;456.0;139.0;151.0;1479.0;1595.0;1708
8131;Steenwijkerland;2021;42414;9617;22490;10307;37977;2039;591;1448;2398;1162;1236;324;154;170;212;73;139;574;229;345;312;96;216;976;610;366;435.0;470.0;129.0;152.0;1612.0;1616.0;1708
8132;Steenwijkerland;2022;42354;9543;22330;10481;37791;2059;591;1468;2504;1197;1307;334;156;178;217;80;137;604;237;367;318;98;220;1031;626;405;445.0;473.0;135.0;152.0;1556.0;1593.0;1708
8133;Steenwijkerland;2023;42286;9485;22150;10651;37594;2075;598;1477;2617;1237;1380;352;166;186;240;84;156;623;236;387;333;108;225;1069;643;426;443.0;475.0;135.0;148.0;1616.0;1605.0;1708
8134;Steenwijkerland;2024;42257;9459;21964;10834;37451;2094;614;1480;2712;1272;1440;364;171;193;246;90;156;638;241;397;366;128;238;1098;642;456;440.0;488.0;146.0;155.0;1650.0;1596.0;1708
8135;Steenwijkerland;2025;42261;9408;21828;11025;37323;2126;616;1510;2812;1319;1493;378;177;201;265;97;168;650;244;406;380;135;245;1139;666;473;;;;;;;1708
8136;Stein (L.);2008;26074;5492;16074;4508;22459;2977;787;2190;638;352;286;48;18;30;33;20;13;43;14;29;225;101;124;289;199;90;203.0;222.0;133.0;187.0;793.0;953.0;971
8137;Stein (L.);2009;25844;5411;15838;4595;22218;2930;793;2137;696;372;324;64;26;38;34;19;15;60;21;39;246;109;137;292;197;95;194.0;228.0;141.0;188.0;820.0;974.0;971
8138;Stein (L.);2010;25614;5288;15611;4715;21982;2870;769;2101;762;409;353;71;31;40;37;22;15;76;31;45;262;111;151;316;214;102;193.0;231.0;135.0;176.0;903.0;970.0;971
8139;Stein (L.);2011;25471;5164;15441;4866;21810;2858;780;2078;803;419;384;77;35;42;44;26;18;82;36;46;286;115;171;314;207;107;194.0;235.0;144.0;175.0;864.0;975.0;971
8140;Stein (L.);2012;25291;5042;15211;5038;21621;2818;783;2035;852;433;419;84;43;41;48;29;19;97;41;56;302;112;190;321;208;113;196.0;237.0;143.0;169.0;907.0;973.0;971
8141;Stein (L.);2013;25163;4945;14990;5228;21492;2751;779;1972;920;461;459;101;52;49;45;26;19;116;46;70;319;114;205;339;223;116;192.0;242.0;145.0;169.0;893.0;976.0;971
8142;Stein (L.);2014;25008;4871;14775;5362;21327;2698;789;1909;983;487;496;109;51;58;47;27;20;131;53;78;339;122;217;357;234;123;202.0;250.0;137.0;166.0;912.0;971.0;971
8143;Stein (L.);2015;24875;4801;14545;5529;21196;2668;795;1873;1011;489;522;109;53;56;51;25;26;143;54;89;351;125;226;357;232;125;199.0;250.0;138.0;157.0;872.0;979.0;971
8144;Stein (L.);2016;24701;4740;14305;5656;21014;2621;799;1822;1066;516;550;121;61;60;54;26;28;159;57;102;365;134;231;367;238;129;201.0;254.0;128.0;156.0;866.0;953.0;971
8145;Stein (L.);2017;24536;4664;14128;5744;20842;2584;802;1782;1110;538;572;133;69;64;49;24;25;185;63;122;372;140;232;371;242;129;205.0;253.0;128.0;161.0;845.0;957.0;971
8146;Stein (L.);2018;24346;4574;13911;5861;20636;2557;803;1754;1153;548;605;138;75;63;52;24;28;204;66;138;376;138;238;383;245;138;204.0;257.0;137.0;152.0;845.0;966.0;971
8147;Stein (L.);2019;24161;4519;13683;5959;20465;2506;792;1714;1190;547;643;138;69;69;57;24;33;224;73;151;383;137;246;388;244;144;212.0;265.0;125.0;148.0;891.0;944.0;971
8148;Stein (L.);2020;24034;4471;13518;6045;20314;2467;795;1672;1253;573;680;143;75;68;64;27;37;238;77;161;410;145;265;398;249;149;210.0;271.0;120.0;142.0;849.0;950.0;971
8149;Stein (L.);2021;23852;4392;13323;6137;20129;2432;790;1642;1291;568;723;145;73;72;75;34;41;246;74;172;415;143;272;410;244;166;213.0;264.0;121.0;137.0;880.0;946.0;971
8150;Stein (L.);2022;23722;4328;13178;6216;20006;2402;797;1605;1314;578;736;154;78;76;84;40;44;248;71;177;423;144;279;405;245;160;209.0;273.0;117.0;139.0;843.0;936.0;971
8151;Stein (L.);2023;23543;4296;12974;6273;19816;2385;812;1573;1342;578;764;147;75;72;81;36;45;256;74;182;452;148;304;406;245;161;214.0;277.0;110.0;135.0;897.0;919.0;971
8152;Stein (L.);2024;23435;4276;12816;6343;19642;2388;817;1571;1405;600;805;159;81;78;82;36;46;274;75;199;474;151;323;416;257;159;205.0;279.0;109.0;136.0;813.0;942.0;971
8153;Stein (L.);2025;23206;4228;12617;6361;19399;2372;825;1547;1435;617;818;165;92;73;84;38;46;300;86;214;468;146;322;418;255;163;;;;;;;971
8154;Strijen;2008;9041;2143;5625;1273;8337;457;162;295;247;140;107;65;33;32;15;5;10;17;7;10;24;10;14;126;85;41;68.0;76.0;19.0;29.0;375.0;380.0;617
8155;Strijen;2009;9019;2105;5593;1321;8291;450;161;289;278;144;134;71;33;38;18;7;11;28;10;18;24;8;16;137;86;51;66.0;80.0;21.0;28.0;410.0;379.0;617
8156;Strijen;2010;9030;2051;5590;1389;8272;448;167;281;310;159;151;79;37;42;23;8;15;33;15;18;30;10;20;145;89;56;69.0;80.0;24.0;31.0;305.0;369.0;617
8157;Strijen;2011;8949;1990;5540;1419;8180;440;161;279;329;166;163;80;37;43;31;12;19;37;19;18;35;13;22;146;85;61;64.0;78.0;24.0;29.0;429.0;358.0;617
8158;Strijen;2012;9001;1956;5511;1534;8184;452;164;288;365;179;186;84;35;49;35;15;20;48;23;25;36;15;21;162;91;71;66.0;80.0;25.0;27.0;333.0;371.0;617
8159;Strijen;2013;8948;1903;5457;1588;8106;453;168;285;389;187;202;89;37;52;38;17;21;45;23;22;41;14;27;176;96;80;65.0;81.0;24.0;27.0;307.0;369.0;617
8160;Strijen;2014;8868;1854;5362;1652;8003;467;173;294;398;183;215;90;37;53;36;14;22;49;22;27;43;15;28;180;95;85;69.0;83.0;22.0;29.0;367.0;358.0;617
8161;Strijen;2015;8857;1812;5320;1725;7973;469;179;290;415;199;216;90;37;53;38;16;22;59;27;32;46;17;29;182;102;80;66.0;83.0;23.0;28.0;358.0;369.0;617
8162;Strijen;2016;8825;1764;5253;1808;7918;472;182;290;435;210;225;93;44;49;40;17;23;67;28;39;54;19;35;181;102;79;66.0;89.0;25.0;26.0;411.0;372.0;617
8163;Strijen;2017;8842;1717;5285;1840;7917;483;182;301;442;213;229;96;45;51;39;16;23;62;24;38;58;19;39;187;109;78;66.0;87.0;29.0;28.0;378.0;388.0;617
8164;Strijen;2018;8813;1684;5247;1882;7856;500;190;310;457;229;228;97;46;51;41;19;22;69;27;42;58;20;38;192;117;75;72.0;90.0;20.0;29.0;404.0;378.0;617
8165;Strijen;2019;8813;1677;5187;1949;7849;488;176;312;476;236;240;98;47;51;45;16;29;80;30;50;57;20;37;196;123;73;71.0;92.0;26.0;30.0;387.0;371.0;617
8166;Strijen;2020;8805;1644;5173;1988;7809;492;178;314;504;248;256;108;52;56;48;17;31;77;29;48;60;21;39;211;129;82;68.0;99.0;22.0;26.0;402.0;359.0;617
8167;Strijen;2021;8814;1598;5171;2045;7795;500;182;318;519;253;266;112;51;61;48;17;31;84;33;51;63;21;42;212;131;81;75.0;96.0;23.0;29.0;394.0;372.0;617
8168;Strijen;2022;8810;1588;5128;2094;7733;514;185;329;563;273;290;120;54;66;61;24;37;85;34;51;69;21;48;228;140;88;72.0;98.0;23.0;29.0;397.0;376.0;617
8169;Strijen;2023;8799;1567;5083;2149;7703;520;192;328;576;270;306;126;57;69;61;20;41;89;36;53;72;22;50;228;135;93;73.0;98.0;29.0;25.0;388.0;367.0;617
8170;Strijen;2024;8800;1558;5039;2203;7665;531;191;340;604;280;324;129;59;70;69;20;49;97;38;59;76;23;53;233;140;93;74.0;105.0;18.0;26.0;369.0;362.0;617
8171;Strijen;2025;8770;1528;4997;2245;7609;556;198;358;605;272;333;125;56;69;71;19;52;102;42;60;77;24;53;230;131;99;;;;;;;617
8172;Terneuzen;2008;55337;12703;32424;10210;43060;8749;4017;4732;3528;1894;1634;321;170;151;473;289;184;1344;611;733;345;154;191;1045;670;375;583.0;558.0;408.0;495.0;1449.0;1279.0;715
8173;Terneuzen;2009;55449;12675;32364;10410;43011;8808;4042;4766;3630;1921;1709;336;178;158;472;286;186;1345;611;734;389;163;226;1088;683;405;570.0;555.0;450.0;505.0;1410.0;1325.0;715
8174;Terneuzen;2010;55503;12643;32169;10691;42924;8829;4051;4778;3750;1959;1791;369;197;172;479;282;197;1346;606;740;435;179;256;1121;695;426;577.0;565.0;466.0;496.0;1333.0;1353.0;715
8175;Terneuzen;2011;55469;12529;31961;10979;42759;8827;4037;4790;3883;1993;1890;394;209;185;494;273;221;1340;593;747;473;195;278;1182;723;459;559.0;569.0;482.0;497.0;1502.0;1352.0;715
8176;Terneuzen;2012;55602;12449;31738;11415;42717;8850;4066;4784;4035;2054;1981;436;230;206;481;259;222;1342;603;739;552;220;332;1224;742;482;569.0;585.0;471.0;468.0;1335.0;1365.0;715
8177;Terneuzen;2013;55564;12336;31419;11809;42553;8860;4065;4795;4151;2098;2053;465;256;209;493;268;225;1337;584;753;597;235;362;1259;755;504;565.0;586.0;464.0;478.0;1333.0;1347.0;715
8178;Terneuzen;2014;55521;12284;31144;12093;42390;8865;4071;4794;4266;2151;2115;499;273;226;517;279;238;1336;589;747;648;262;386;1266;748;518;565.0;585.0;478.0;461.0;1334.0;1369.0;715
8179;Terneuzen;2015;55489;12198;30971;12320;42165;8906;4107;4799;4418;2179;2239;532;277;255;526;277;249;1335;582;753;702;275;427;1323;768;555;572.0;592.0;464.0;458.0;1447.0;1374.0;715
8180;Terneuzen;2016;55554;12145;30861;12548;42014;8987;4143;4844;4553;2213;2340;556;284;272;539;278;261;1339;574;765;747;290;457;1372;787;585;577.0;607.0;465.0;464.0;1427.0;1360.0;715
8181;Terneuzen;2017;55591;12140;30724;12727;41910;9006;4143;4863;4675;2260;2415;570;287;283;542;274;268;1352;584;768;802;313;489;1409;802;607;575.0;618.0;458.0;463.0;1445.0;1391.0;715
8182;Terneuzen;2018;55603;12090;30651;12862;41738;9049;4169;4880;4816;2306;2510;567;286;281;554;279;275;1379;594;785;851;326;525;1465;821;644;584.0;608.0;454.0;451.0;1470.0;1380.0;715
8183;Terneuzen;2019;55674;12034;30535;13105;41665;9094;4188;4906;4915;2338;2577;578;292;286;574;292;282;1387;597;790;890;335;555;1486;822;664;594.0;620.0;444.0;446.0;1311.0;1384.0;715
8184;Terneuzen;2020;55578;11926;30375;13277;41442;9098;4194;4904;5038;2388;2650;600;296;304;580;283;297;1399;594;805;935;361;574;1524;854;670;581.0;631.0;452.0;428.0;1350.0;1367.0;715
8185;Terneuzen;2021;55539;11859;30255;13425;41283;9135;4203;4932;5121;2401;2720;623;309;314;577;278;299;1406;588;818;973;376;597;1542;850;692;599.0;629.0;441.0;437.0;1514.0;1371.0;715
8186;Terneuzen;2022;55659;11893;30178;13588;41238;9152;4216;4936;5269;2442;2827;643;315;328;581;280;301;1421;577;844;1017;385;632;1607;885;722;599.0;646.0;433.0;429.0;1498.0;1417.0;715
8187;Terneuzen;2023;55703;11862;30050;13791;41145;9197;4248;4949;5361;2458;2903;664;322;342;592;279;313;1421;576;845;1061;406;655;1623;875;748;604.0;644.0;440.0;436.0;1527.0;1395.0;715
8188;Terneuzen;2024;55803;11947;29884;13972;41156;9205;4240;4965;5442;2488;2954;676;330;346;577;270;307;1431;571;860;1086;420;666;1672;897;775;621.0;657.0;439.0;422.0;1473.0;1415.0;715
8189;Terneuzen;2025;55850;11977;29795;14078;41024;9242;4195;5047;5584;2557;3027;698;341;357;583;282;301;1456;572;884;1120;434;686;1727;928;799;;;;;;;715
8190;Terschelling;2008;4672;951;2925;796;4336;251;74;177;85;46;39;8;6;2;21;8;13;3;1;2;8;5;3;45;26;19;37.0;48.0;11.0;16.0;224.0;239.0;93
8191;Terschelling;2009;4642;940;2905;797;4303;246;74;172;93;56;37;8;5;3;23;9;14;5;4;1;9;6;3;48;32;16;32.0;50.0;12.0;16.0;225.0;215.0;93
8192;Terschelling;2010;4631;909;2892;830;4287;251;75;176;93;53;40;8;4;4;22;8;14;8;6;2;12;6;6;43;29;14;32.0;50.0;10.0;19.0;228.0;215.0;93
8193;Terschelling;2011;4618;905;2875;838;4268;246;70;176;104;55;49;7;4;3;18;6;12;10;5;5;15;7;8;54;33;21;29.0;48.0;12.0;18.0;237.0;232.0;93
8194;Terschelling;2012;4599;891;2829;879;4231;250;74;176;118;68;50;6;5;1;17;7;10;13;7;6;21;8;13;61;41;20;33.0;48.0;13.0;16.0;248.0;236.0;93
8195;Terschelling;2013;4594;869;2794;931;4228;243;81;162;123;70;53;7;5;2;19;9;10;12;6;6;24;10;14;61;40;21;31.0;52.0;14.0;17.0;258.0;206.0;93
8196;Terschelling;2014;4622;859;2794;969;4238;253;83;170;131;73;58;7;5;2;23;12;11;14;8;6;30;9;21;57;39;18;30.0;52.0;11.0;15.0;218.0;230.0;93
8197;Terschelling;2015;4585;832;2771;982;4179;258;88;170;148;84;64;10;6;4;25;16;9;16;6;10;35;13;22;62;43;19;29.0;50.0;11.0;18.0;244.0;218.0;93
8198;Terschelling;2016;4584;815;2771;998;4158;267;96;171;159;85;74;14;9;5;25;16;9;20;6;14;35;13;22;65;41;24;28.0;51.0;11.0;18.0;249.0;228.0;93
8199;Terschelling;2017;4576;788;2788;1000;4132;265;92;173;179;95;84;21;13;8;24;16;8;24;7;17;34;12;22;76;47;29;30.0;52.0;12.0;15.0;264.0;220.0;93
8200;Terschelling;2018;4596;787;2789;1020;4158;257;88;169;181;99;82;24;14;10;24;15;9;23;8;15;34;12;22;76;50;26;29.0;57.0;10.0;17.0;261.0;222.0;93
8201;Terschelling;2019;4600;770;2806;1024;4137;267;94;173;196;116;80;24;16;8;27;18;9;26;9;17;31;13;18;88;60;28;32.0;56.0;16.0;17.0;259.0;233.0;93
8202;Terschelling;2020;4602;747;2820;1035;4115;275;98;177;212;128;84;26;19;7;30;20;10;33;12;21;29;13;16;94;64;30;31.0;58.0;16.0;18.0;260.0;221.0;93
8203;Terschelling;2021;4613;733;2832;1048;4107;285;98;187;221;133;88;32;19;13;33;22;11;32;13;19;28;14;14;96;65;31;31.0;55.0;13.0;18.0;249.0;232.0;93
8204;Terschelling;2022;4601;710;2843;1048;4095;279;92;187;227;136;91;32;20;12;29;19;10;31;13;18;36;18;18;99;66;33;30.0;57.0;13.0;17.0;304.0;232.0;93
8205;Terschelling;2023;4643;697;2885;1061;4140;274;89;185;229;137;92;33;21;12;32;23;9;31;15;16;38;17;21;95;61;34;31.0;56.0;16.0;17.0;223.0;234.0;93
8206;Terschelling;2024;4607;685;2849;1073;4097;267;80;187;243;139;104;34;22;12;33;22;11;37;16;21;41;19;22;98;60;38;33.0;57.0;14.0;14.0;246.0;223.0;93
8207;Terschelling;2025;4607;682;2826;1099;4097;269;80;189;241;142;99;33;23;10;30;20;10;34;13;21;41;18;23;103;68;35;;;;;;;93
8208;Texel;2008;13849;3359;8285;2205;12543;951;397;554;355;206;149;32;11;21;25;11;14;24;11;13;29;14;15;245;159;86;126.0;114.0;43.0;65.0;578.0;507.0;448
8209;Texel;2009;13913;3356;8255;2302;12592;945;390;555;376;214;162;41;17;24;32;11;21;29;12;17;30;16;14;244;158;86;127.0;120.0;45.0;65.0;655.0;539.0;448
8210;Texel;2010;14016;3356;8263;2397;12649;955;385;570;412;234;178;53;20;33;36;13;23;34;13;21;35;22;13;254;166;88;123.0;119.0;47.0;63.0;545.0;546.0;448
8211;Texel;2011;14007;3287;8233;2487;12598;975;400;575;434;244;190;61;22;39;38;12;26;43;15;28;42;28;14;250;167;83;123.0;121.0;43.0;64.0;564.0;545.0;448
8212;Texel;2012;14009;3250;8117;2642;12566;982;393;589;461;256;205;64;25;39;35;11;24;52;20;32;48;29;19;262;171;91;129.0;122.0;48.0;63.0;518.0;556.0;448
8213;Texel;2013;13966;3145;8059;2762;12506;981;389;592;479;268;211;67;24;43;43;17;26;51;19;32;54;33;21;264;175;89;126.0;126.0;45.0;61.0;524.0;540.0;448
8214;Texel;2014;13935;3105;7987;2843;12445;989;387;602;501;282;219;75;30;45;48;24;24;54;20;34;59;36;23;265;172;93;120.0;127.0;46.0;57.0;491.0;533.0;448
8215;Texel;2015;13877;3066;7879;2932;12341;995;380;615;541;301;240;83;35;48;54;28;26;63;22;41;63;37;26;278;179;99;122.0;127.0;41.0;58.0;514.0;534.0;448
8216;Texel;2016;13834;3030;7803;3001;12291;972;371;601;571;317;254;88;38;50;55;27;28;68;25;43;65;37;28;295;190;105;116.0;131.0;43.0;57.0;498.0;533.0;448
8217;Texel;2017;13771;2959;7740;3072;12213;966;374;592;592;324;268;97;47;50;53;26;27;79;29;50;70;41;29;293;181;112;124.0;130.0;49.0;62.0;504.0;550.0;448
8218;Texel;2018;13707;2921;7623;3163;12143;953;375;578;611;339;272;97;50;47;58;28;30;82;32;50;71;43;28;303;186;117;124.0;132.0;42.0;65.0;540.0;535.0;448
8219;Texel;2019;13682;2858;7579;3245;12120;932;362;570;630;343;287;101;52;49;59;30;29;96;33;63;73;42;31;301;186;115;121.0;137.0;45.0;55.0;518.0;533.0;448
8220;Texel;2020;13642;2814;7508;3320;12075;931;362;569;636;349;287;103;53;50;60;31;29;99;36;63;78;43;35;296;186;110;129.0;137.0;48.0;58.0;525.0;530.0;448
8221;Texel;2021;13619;2790;7442;3387;12013;928;353;575;678;379;299;109;58;51;65;32;33;106;42;64;87;46;41;311;201;110;134.0;144.0;42.0;59.0;500.0;514.0;448
8222;Texel;2022;13579;2728;7406;3445;11956;916;333;583;707;388;319;110;59;51;71;33;38;113;47;66;95;49;46;318;200;118;128.0;141.0;51.0;52.0;490.0;517.0;448
8223;Texel;2023;13539;2714;7310;3515;11884;925;347;578;730;400;330;113;61;52;72;35;37;117;50;67;100;52;48;328;202;126;126.0;143.0;50.0;56.0;506.0;519.0;448
8224;Texel;2024;13504;2702;7227;3575;11828;923;342;581;753;411;342;116;61;55;67;36;31;127;52;75;102;50;52;341;212;129;126.0;145.0;33.0;51.0;523.0;509.0;448
8225;Texel;2025;13484;2697;7155;3632;11797;930;343;587;757;413;344;117;61;56;70;36;34;122;51;71;103;50;53;345;215;130;;;;;;;448
8226;Teylingen;2008;34350;9292;20036;5022;30191;2597;1021;1576;1562;847;715;249;123;126;103;50;53;154;76;78;242;116;126;814;482;332;347.0;259.0;132.0;196.0;1518.0;1463.0;1525
8227;Teylingen;2009;34432;9245;20076;5111;30164;2644;1052;1592;1624;890;734;261;129;132;108;53;55;176;88;88;253;124;129;826;496;330;337.0;264.0;135.0;194.0;1567.0;1465.0;1525
8228;Teylingen;2010;34552;9164;20119;5269;30163;2679;1063;1616;1710;913;797;265;132;133;121;61;60;196;89;107;273;133;140;855;498;357;324.0;267.0;131.0;196.0;1478.0;1470.0;1525
8229;Teylingen;2011;34557;9024;20169;5364;30086;2710;1066;1644;1761;930;831;288;151;137;123;63;60;218;92;126;292;134;158;840;490;350;319.0;269.0;145.0;204.0;1396.0;1497.0;1525
8230;Teylingen;2012;34451;8838;20021;5592;29945;2672;1066;1606;1834;979;855;304;157;147;130;69;61;222;97;125;311;150;161;867;506;361;313.0;268.0;145.0;190.0;1372.0;1456.0;1525
8231;Teylingen;2013;34369;8621;19940;5808;29791;2677;1058;1619;1901;1007;894;312;155;157;143;81;62;226;104;122;320;150;170;900;517;383;310.0;272.0;140.0;186.0;1437.0;1405.0;1525
8232;Teylingen;2014;34395;8556;19855;5984;29726;2693;1061;1632;1976;1045;931;322;163;159;143;81;62;243;120;123;327;151;176;941;530;411;301.0;290.0;152.0;188.0;1325.0;1400.0;1525
8233;Teylingen;2015;34299;8381;19800;6118;29570;2692;1063;1629;2037;1069;968;334;171;163;152;79;73;253;122;131;331;154;177;967;543;424;309.0;288.0;132.0;177.0;1543.0;1374.0;1525
8234;Teylingen;2016;34446;8310;19860;6276;29613;2723;1085;1638;2110;1085;1025;349;173;176;165;82;83;256;120;136;336;156;180;1004;554;450;315.0;290.0;139.0;179.0;1372.0;1442.0;1525
8235;Teylingen;2017;34365;8176;19754;6435;29466;2750;1093;1657;2149;1102;1047;353;175;178;160;80;80;264;123;141;356;161;195;1016;563;453;321.0;299.0;151.0;187.0;1466.0;1427.0;1525
8236;Teylingen;2018;34394;8101;19677;6616;29388;2800;1117;1683;2206;1115;1091;365;183;182;175;90;85;286;131;155;370;163;207;1010;548;462;318.0;310.0;148.0;184.0;1394.0;1422.0;1525
8237;Teylingen;2019;34341;7936;19626;6779;29284;2817;1118;1699;2240;1129;1111;375;189;186;177;88;89;293;137;156;369;164;205;1026;551;475;321.0;309.0;146.0;180.0;1444.0;1419.0;1525
8238;Teylingen;2020;34345;7814;19558;6973;29156;2853;1123;1730;2336;1174;1162;381;190;191;188;96;92;320;144;176;385;176;209;1062;568;494;325.0;304.0;141.0;172.0;1386.0;1430.0;1525
8239;Teylingen;2021;34295;7703;19453;7139;28999;2901;1141;1760;2395;1177;1218;385;184;201;191;93;98;325;151;174;391;172;219;1103;577;526;328.0;321.0;145.0;175.0;1500.0;1427.0;1525
8240;Teylingen;2022;34349;7603;19446;7300;28953;2959;1186;1773;2437;1205;1232;393;185;208;198;104;94;326;150;176;402;172;230;1118;594;524;332.0;323.0;144.0;181.0;1436.0;1431.0;1525
8241;Teylingen;2023;34328;7539;19303;7486;28878;2972;1189;1783;2478;1209;1269;401;185;216;210;107;103;335;152;183;408;174;234;1124;591;533;335.0;329.0;135.0;174.0;1623.0;1474.0;1525
8242;Teylingen;2024;34447;7513;19266;7668;28814;3052;1255;1797;2581;1246;1335;426;193;233;230;114;116;348;160;188;418;181;237;1159;598;561;339.0;334.0;160.0;181.0;1527.0;1480.0;1525
8243;Teylingen;2025;34487;7471;19162;7854;28693;3141;1302;1839;2653;1276;1377;440;200;240;234;120;114;355;160;195;432;184;248;1192;612;580;;;;;;;1525
8244;Tholen;2008;24997;7054;14364;3579;23071;1127;456;671;799;439;360;86;40;46;59;20;39;74;44;30;215;100;115;365;235;130;327.0;204.0;89.0;86.0;694.0;750.0;716
8245;Tholen;2009;25068;7070;14291;3707;22986;1197;478;719;885;468;417;100;45;55;68;22;46;103;58;45;224;100;124;390;243;147;330.0;205.0;82.0;88.0;675.0;785.0;716
8246;Tholen;2010;25079;7015;14265;3799;22874;1254;496;758;951;492;459;115;54;61;72;21;51;114;65;49;231;99;132;419;253;166;321.0;205.0;90.0;87.0;601.0;758.0;716
8247;Tholen;2011;25044;6956;14222;3866;22733;1302;523;779;1009;512;497;126;59;67;75;25;50;129;73;56;236;104;132;443;251;192;311.0;208.0;93.0;90.0;672.0;751.0;716
8248;Tholen;2012;25073;6914;14103;4056;22650;1350;531;819;1073;545;528;136;66;70;87;29;58;154;91;63;235;101;134;461;258;203;314.0;205.0;92.0;89.0;572.0;758.0;716
8249;Tholen;2013;25003;6829;13993;4181;22466;1403;544;859;1134;563;571;142;67;75;102;35;67;166;93;73;247;106;141;477;262;215;302.0;215.0;114.0;82.0;669.0;735.0;716
8250;Tholen;2014;25056;6802;13931;4323;22364;1464;581;883;1228;594;634;160;69;91;124;41;83;189;104;85;261;109;152;494;271;223;297.0;215.0;107.0;90.0;728.0;752.0;716
8251;Tholen;2015;25134;6735;13955;4444;22290;1547;604;943;1297;628;669;170;75;95;130;44;86;200;104;96;276;117;159;521;288;233;295.0;219.0;98.0;91.0;729.0;738.0;716
8252;Tholen;2016;25211;6696;13963;4552;22221;1609;624;985;1381;656;725;190;84;106;142;43;99;224;107;117;283;122;161;542;300;242;301.0;223.0;109.0;85.0;711.0;759.0;716
8253;Tholen;2017;25268;6622;14001;4645;22164;1654;651;1003;1450;684;766;198;89;109;154;44;110;237;114;123;284;121;163;577;316;261;300.0;224.0;102.0;86.0;703.0;757.0;716
8254;Tholen;2018;25308;6568;13938;4802;22093;1703;679;1024;1512;712;800;214;97;117;159;43;116;259;131;128;294;122;172;586;319;267;302.0;236.0;99.0;88.0;691.0;760.0;716
8255;Tholen;2019;25321;6497;13953;4871;22002;1742;700;1042;1577;746;831;235;107;128;154;41;113;280;139;141;298;126;172;610;333;277;305.0;230.0;108.0;87.0;466.0;773.0;716
8256;Tholen;2020;25114;6367;13766;4981;21710;1773;708;1065;1631;774;857;242;109;133;162;42;120;292;148;144;304;128;176;631;347;284;296.0;234.0;125.0;93.0;675.0;751.0;716
8257;Tholen;2021;25133;6351;13712;5070;21557;1837;749;1088;1739;816;923;266;121;145;175;51;124;310;149;161;315;131;184;673;364;309;296.0;236.0;109.0;87.0;706.0;768.0;716
8258;Tholen;2022;25157;6323;13636;5198;21428;1912;782;1130;1817;848;969;286;132;154;187;53;134;323;152;171;324;135;189;697;376;321;298.0;241.0;104.0;88.0;695.0;775.0;716
8259;Tholen;2023;25152;6244;13618;5290;21291;1991;820;1171;1870;867;1003;301;136;165;187;55;132;331;153;178;339;147;192;712;376;336;299.0;251.0;110.0;92.0;635.0;755.0;716
8260;Tholen;2024;25098;6193;13503;5402;21117;2052;848;1204;1929;899;1030;305;136;169;202;65;137;343;159;184;350;149;201;729;390;339;294.0;248.0;108.0;95.0;739.0;745.0;716
8261;Tholen;2025;25151;6183;13469;5499;21057;2088;874;1214;2006;936;1070;312;137;175;209;68;141;363;170;193;361;154;207;761;407;354;;;;;;;716
8262;Tiel;2008;41092;10934;25185;4973;32472;3372;1187;2185;5248;2801;2447;246;115;131;168;86;82;2147;1102;1045;1653;854;799;1034;644;390;491.0;342.0;139.0;231.0;1471.0;1428.0;281
8263;Tiel;2009;41196;10895;25157;5144;32665;3314;1153;2161;5217;2781;2436;254;121;133;173;90;83;2102;1071;1031;1634;850;784;1054;649;405;488.0;353.0;161.0;226.0;1609.0;1457.0;281
8264;Tiel;2010;41422;10842;25271;5309;32944;3256;1120;2136;5222;2769;2453;279;131;148;186;99;87;2048;1047;1001;1656;851;805;1053;641;412;482.0;348.0;144.0;223.0;1628.0;1460.0;281
8265;Tiel;2011;41647;10775;25410;5462;33199;3265;1116;2149;5183;2732;2451;276;133;143;194;106;88;1998;1019;979;1656;847;809;1059;627;432;469.0;364.0;148.0;227.0;1568.0;1519.0;281
8266;Tiel;2012;41725;10723;25264;5738;33331;3250;1104;2146;5144;2694;2450;293;137;156;197;104;93;1957;1000;957;1649;834;815;1048;619;429;473.0;362.0;144.0;207.0;1594.0;1484.0;281
8267;Tiel;2013;41889;10645;25210;6034;33516;3256;1102;2154;5117;2716;2401;306;148;158;203;115;88;1909;983;926;1632;831;801;1067;639;428;459.0;372.0;143.0;205.0;1597.0;1509.0;281
8268;Tiel;2014;42008;10552;25167;6289;33687;3242;1082;2160;5079;2720;2359;305;154;151;213;123;90;1845;967;878;1628;823;805;1088;653;435;448.0;374.0;135.0;201.0;1676.0;1503.0;281
8269;Tiel;2015;42196;10457;25242;6497;33874;3230;1095;2135;5092;2729;2363;326;163;163;216;127;89;1821;951;870;1594;809;785;1135;679;456;456.0;383.0;143.0;206.0;1604.0;1517.0;281
8270;Tiel;2016;42299;10379;25232;6688;34025;3209;1079;2130;5065;2720;2345;326;162;164;220;128;92;1798;936;862;1573;803;770;1148;691;457;450.0;395.0;137.0;202.0;1702.0;1539.0;281
8271;Tiel;2017;42460;10338;25219;6903;34223;3196;1060;2136;5041;2745;2296;334;169;165;225;136;89;1770;932;838;1547;800;747;1165;708;457;447.0;392.0;144.0;188.0;1485.0;1549.0;281
8272;Tiel;2018;42413;10160;25096;7157;34229;3207;1073;2134;4977;2740;2237;335;172;163;225;136;89;1717;904;813;1511;797;714;1189;731;458;454.0;407.0;144.0;191.0;1638.0;1511.0;281
8273;Tiel;2019;42545;10065;25099;7381;34381;3186;1052;2134;4978;2732;2246;339;173;166;239;146;93;1696;886;810;1519;804;715;1185;723;462;450.0;403.0;137.0;181.0;1485.0;1538.0;281
8274;Tiel;2020;42501;9912;25001;7588;34405;3144;1033;2111;4952;2752;2200;350;181;169;250;158;92;1641;869;772;1503;794;709;1208;750;458;451.0;413.0;133.0;188.0;1507.0;1534.0;281
8275;Tiel;2021;42463;9777;24883;7803;34406;3107;1028;2079;4950;2759;2191;361;187;174;257;158;99;1587;846;741;1478;782;696;1267;786;481;448.0;427.0;127.0;178.0;1570.0;1514.0;281
8276;Tiel;2022;42496;9664;24789;8043;34457;3067;1015;2052;4972;2792;2180;372;190;182;272;159;113;1573;844;729;1460;784;676;1295;815;480;455.0;434.0;132.0;183.0;1641.0;1520.0;281
8277;Tiel;2023;42594;9517;24830;8247;34600;3020;980;2040;4974;2784;2190;387;203;184;269;161;108;1535;818;717;1449;776;673;1334;826;508;465.0;443.0;129.0;173.0;1644.0;1544.0;281
8278;Tiel;2024;42677;9425;24816;8436;34688;2987;975;2012;5002;2781;2221;389;202;187;284;163;121;1523;803;720;1429;765;664;1377;848;529;468.0;454.0;130.0;180.0;1616.0;1528.0;281
8279;Tiel;2025;42736;9392;24659;8685;34759;2996;976;2020;4981;2776;2205;388;202;186;294;167;127;1497;790;707;1391;754;637;1411;863;548;;;;;;;281
8280;Tilburg;2008;202398;46718;128394;27286;158393;16724;6611;10113;27281;15629;11652;3332;1845;1487;3895;2548;1347;7310;3703;3607;5187;2531;2656;7557;5002;2555;2239.0;1680.0;1493.0;1805.0;6447.0;5996.0;855
8281;Tilburg;2009;203136;47120;128000;28016;158802;16809;6669;10140;27525;15546;11979;3367;1849;1518;3875;2499;1376;7328;3653;3675;5303;2537;2766;7652;5008;2644;2236.0;1718.0;1608.0;1774.0;6242.0;6013.0;855
8282;Tilburg;2010;203762;47385;127562;28815;158956;16993;6786;10207;27813;15485;12328;3473;1890;1583;3820;2458;1362;7346;3594;3752;5431;2555;2876;7743;4988;2755;2246.0;1774.0;1628.0;1745.0;6321.0;5892.0;855
8283;Tilburg;2011;204577;47528;127341;29708;159361;17199;6941;10258;28017;15339;12678;3520;1892;1628;3838;2435;1403;7364;3545;3819;5537;2558;2979;7758;4909;2849;2240.0;1811.0;1671.0;1710.0;6395.0;6037.0;855
8284;Tilburg;2012;205357;47816;126703;30838;159637;17410;7074;10336;28310;15294;13016;3606;1936;1670;3828;2404;1424;7371;3527;3844;5665;2575;3090;7840;4852;2988;2240.0;1840.0;1666.0;1679.0;6410.0;5987.0;855
8285;Tilburg;2013;206197;48202;126123;31872;160014;17597;7189;10408;28586;15305;13281;3662;1954;1708;3845;2414;1431;7382;3502;3880;5736;2592;3144;7961;4843;3118;2254.0;1867.0;1689.0;1637.0;6500.0;6037.0;855
8286;Tilburg;2014;207136;48534;125681;32921;160473;17765;7303;10462;28898;15290;13608;3707;1977;1730;3848;2393;1455;7396;3451;3945;5832;2607;3225;8115;4862;3253;2254.0;1893.0;1666.0;1618.0;6486.0;6107.0;855
8287;Tilburg;2015;207946;48729;125290;33927;160811;17945;7438;10507;29190;15307;13883;3790;2010;1780;3860;2388;1472;7385;3409;3976;5946;2642;3304;8209;4858;3351;2252.0;1918.0;1665.0;1614.0;6548.0;6116.0;855
8288;Tilburg;2016;208793;49015;125027;34751;161231;18055;7520;10535;29507;15343;14164;3860;2049;1811;3875;2370;1505;7423;3406;4017;6003;2645;3358;8346;4873;3473;2273.0;1973.0;1658.0;1568.0;6542.0;6095.0;855
8289;Tilburg;2017;209660;49398;124781;35481;161659;18250;7646;10604;29751;15386;14365;3879;2057;1822;3866;2367;1499;7435;3390;4045;6092;2662;3430;8479;4910;3569;2287.0;1981.0;1641.0;1589.0;6492.0;6178.0;855
8290;Tilburg;2018;210368;49591;124643;36134;161935;18406;7753;10653;30027;15477;14550;3932;2083;1849;3876;2358;1518;7454;3383;4071;6098;2655;3443;8667;4998;3669;2293.0;2015.0;1689.0;1559.0;6629.0;6168.0;855
8291;Tilburg;2019;211273;49740;124578;36955;162390;18545;7859;10686;30338;15551;14787;3981;2108;1873;3904;2382;1522;7448;3368;4080;6143;2667;3476;8862;5026;3836;2294.0;2022.0;1622.0;1534.0;6520.0;6267.0;855
8292;Tilburg;2020;211915;49861;124377;37677;162579;18737;7986;10751;30599;15626;14973;4049;2145;1904;3909;2380;1529;7455;3361;4094;6187;2659;3528;8999;5081;3918;2311.0;2081.0;1623.0;1545.0;6633.0;6249.0;855
8293;Tilburg;2021;212638;49841;124466;38331;162910;18878;8064;10814;30850;15719;15131;4083;2169;1914;3915;2378;1537;7437;3339;4098;6240;2652;3588;9175;5181;3994;2315.0;2106.0;1613.0;1514.0;6568.0;6279.0;855
8294;Tilburg;2022;213264;49830;124319;39115;163090;19076;8214;10862;31098;15813;15285;4099;2167;1932;3909;2361;1548;7399;3318;4081;6304;2687;3617;9387;5280;4107;2317.0;2144.0;1576.0;1516.0;6673.0;6319.0;855
8295;Tilburg;2023;213878;49949;124103;39826;163278;19239;8315;10924;31361;15956;15405;4141;2198;1943;3918;2347;1571;7395;3325;4070;6304;2703;3601;9603;5383;4220;2349.0;2188.0;1595.0;1499.0;6600.0;6280.0;855
8296;Tilburg;2024;214482;49974;123924;40584;163444;19366;8402;10964;31672;16060;15612;4179;2206;1973;3947;2352;1595;7390;3306;4084;6376;2736;3640;9780;5460;4320;2345.0;2197.0;1628.0;1498.0;6540.0;6379.0;855
8297;Tilburg;2025;214958;50020;123620;41318;163451;19482;8483;10999;32025;16190;15835;4216;2214;2002;3952;2329;1623;7396;3316;4080;6442;2758;3684;10019;5573;4446;;;;;;;855
8298;Tubbergen;2008;20336;5933;11594;2809;19382;708;163;545;246;166;80;21;11;10;11;8;3;27;19;8;16;8;8;171;120;51;219.0;160.0;46.0;56.0;252.0;456.0;183
8299;Tubbergen;2009;20188;5802;11517;2869;19169;718;175;543;301;206;95;26;14;12;13;10;3;39;24;15;27;15;12;196;143;53;205.0;157.0;45.0;60.0;330.0;479.0;183
8300;Tubbergen;2010;20073;5663;11460;2950;19010;714;177;537;349;229;120;29;18;11;19;14;5;58;31;27;33;18;15;210;148;62;201.0;165.0;46.0;52.0;350.0;511.0;183
8301;Tubbergen;2011;19943;5508;11457;2978;18828;720;189;531;395;255;140;37;25;12;21;15;6;72;37;35;39;20;19;226;158;68;193.0;165.0;46.0;56.0;413.0;479.0;183
8302;Tubbergen;2012;19899;5357;11476;3066;18745;722;196;526;432;269;163;44;28;16;24;16;8;73;39;34;53;21;32;238;165;73;185.0;174.0;51.0;54.0;485.0;492.0;183
8303;Tubbergen;2013;19903;5199;11562;3142;18674;736;205;531;493;303;190;55;38;17;29;17;12;93;51;42;58;24;34;258;173;85;189.0;175.0;47.0;56.0;419.0;505.0;183
8304;Tubbergen;2014;19824;5064;11537;3223;18536;754;209;545;534;324;210;55;38;17;31;20;11;101;57;44;65;27;38;282;182;100;188.0;177.0;50.0;53.0;366.0;495.0;183
8305;Tubbergen;2015;19706;4910;11507;3289;18368;762;217;545;576;338;238;59;41;18;38;25;13;112;56;56;65;25;40;302;191;111;192.0;173.0;79.0;52.0;431.0;506.0;183
8306;Tubbergen;2016;19682;4837;11473;3372;18253;777;229;548;652;377;275;75;46;29;46;30;16;129;67;62;79;30;49;323;204;119;190.0;183.0;57.0;54.0;444.0;512.0;183
8307;Tubbergen;2017;19627;4727;11438;3462;18165;770;226;544;692;398;294;85;54;31;45;30;15;139;72;67;84;29;55;339;213;126;190.0;183.0;52.0;53.0;391.0;506.0;183
8308;Tubbergen;2018;19521;4618;11334;3569;18002;774;233;541;745;436;309;90;58;32;47;31;16;154;84;70;96;32;64;358;231;127;191.0;184.0;52.0;56.0;403.0;514.0;183
8309;Tubbergen;2019;19416;4493;11261;3662;17832;788;243;545;796;459;337;96;60;36;54;37;17;160;86;74;108;36;72;378;240;138;198.0;187.0;69.0;50.0;401.0;525.0;183
8310;Tubbergen;2020;19324;4392;11173;3759;17691;782;238;544;851;493;358;111;67;44;55;39;16;158;88;70;111;40;71;416;259;157;190.0;190.0;49.0;58.0;429.0;512.0;183
8311;Tubbergen;2021;19234;4218;11162;3854;17537;794;247;547;903;512;391;117;68;49;60;40;20;164;89;75;113;41;72;449;274;175;201.0;195.0;52.0;49.0;435.0;529.0;183
8312;Tubbergen;2022;19152;4116;11092;3944;17408;811;256;555;933;514;419;115;66;49;59;37;22;172;92;80;120;44;76;467;275;192;201.0;191.0;47.0;49.0;352.0;508.0;183
8313;Tubbergen;2023;19006;3979;10987;4040;17209;819;261;558;978;533;445;123;73;50;62;38;24;176;90;86;116;45;71;501;287;214;197.0;189.0;56.0;51.0;408.0;489.0;183
8314;Tubbergen;2024;18945;3885;10902;4158;17080;822;257;565;1043;553;490;134;80;54;69;39;30;187;88;99;129;51;78;524;295;229;205.0;201.0;52.0;49.0;380.0;488.0;183
8315;Tubbergen;2025;18846;3828;10759;4259;16936;833;268;565;1077;567;510;135;77;58;70;38;32;199;93;106;130;53;77;543;306;237;;;;;;;183
8316;Twenterand;2008;33075;8980;19682;4413;31532;1026;276;750;517;307;210;37;19;18;28;15;13;84;34;50;23;8;15;345;231;114;416.0;271.0;71.0;97.0;531.0;899.0;1700
8317;Twenterand;2009;32829;8944;19359;4526;31213;1017;271;746;599;355;244;53;29;24;32;21;11;108;47;61;35;14;21;371;244;127;405.0;286.0;79.0;91.0;587.0;890.0;1700
8318;Twenterand;2010;32639;8848;19116;4675;30939;1028;286;742;672;393;279;66;35;31;38;23;15;130;54;76;48;21;27;390;260;130;400.0;290.0;70.0;93.0;629.0;896.0;1700
8319;Twenterand;2011;32464;8772;18887;4805;30672;1037;287;750;755;438;317;75;42;33;52;32;20;150;61;89;57;25;32;421;278;143;383.0;298.0;94.0;87.0;687.0;881.0;1700
8320;Twenterand;2012;32365;8731;18638;4996;30471;1070;299;771;824;453;371;86;47;39;59;34;25;176;69;107;69;24;45;434;279;155;372.0;294.0;81.0;87.0;818.0;911.0;1700
8321;Twenterand;2013;32346;8681;18455;5210;30383;1075;304;771;888;485;403;93;52;41;65;37;28;195;75;120;81;29;52;454;292;162;370.0;308.0;79.0;87.0;777.0;916.0;1700
8322;Twenterand;2014;32265;8606;18291;5368;30228;1089;309;780;948;514;434;110;57;53;76;46;30;206;78;128;96;34;62;460;299;161;364.0;313.0;76.0;87.0;761.0;918.0;1700
8323;Twenterand;2015;32151;8485;18133;5533;30047;1079;328;751;1025;536;489;117;61;56;79;47;32;241;84;157;107;36;71;481;308;173;359.0;328.0;90.0;80.0;870.0;939.0;1700
8324;Twenterand;2016;32128;8479;18016;5633;29935;1098;335;763;1095;569;526;127;67;60;82;49;33;246;79;167;120;42;78;520;332;188;352.0;328.0;101.0;84.0;856.0;933.0;1700
8325;Twenterand;2017;32103;8475;17860;5768;29793;1102;343;759;1208;622;586;138;75;63;92;56;36;284;92;192;144;53;91;550;346;204;356.0;330.0;84.0;85.0;855.0;949.0;1700
8326;Twenterand;2018;32039;8385;17754;5900;29654;1101;355;746;1284;643;641;151;78;73;100;57;43;292;90;202;155;54;101;586;364;222;353.0;342.0;99.0;78.0;953.0;968.0;1700
8327;Twenterand;2019;32060;8295;17752;6013;29579;1110;344;766;1371;675;696;164;82;82;110;63;47;314;92;222;162;51;111;621;387;234;349.0;336.0;85.0;86.0;972.0;983.0;1700
8328;Twenterand;2020;32063;8181;17721;6161;29494;1155;363;792;1414;703;711;172;90;82;121;71;50;307;96;211;171;54;117;643;392;251;353.0;350.0;85.0;81.0;901.0;975.0;1700
8329;Twenterand;2021;31999;8025;17691;6283;29344;1186;385;801;1469;725;744;172;89;83;128;72;56;315;98;217;183;63;120;671;403;268;360.0;353.0;83.0;90.0;834.0;971.0;1700
8330;Twenterand;2022;31866;7929;17549;6388;29141;1201;396;805;1524;756;768;183;94;89;133;73;60;330;101;229;196;73;123;682;415;267;363.0;356.0;95.0;86.0;866.0;952.0;1700
8331;Twenterand;2023;31802;7822;17461;6519;28986;1221;398;823;1595;782;813;197;99;98;140;75;65;345;109;236;207;74;133;706;425;281;364.0;364.0;85.0;83.0;850.0;957.0;1700
8332;Twenterand;2024;31704;7681;17424;6599;28806;1239;405;834;1659;802;857;193;98;95;150;78;72;358;106;252;214;78;136;744;442;302;362.0;363.0;85.0;80.0;846.0;972.0;1700
8333;Twenterand;2025;31585;7586;17286;6713;28596;1255;409;846;1734;845;889;204;105;99;154;81;73;383;119;264;222;77;145;771;463;308;;;;;;;1700
8334;Tynaarlo;2008;31212;7319;17833;6060;28939;1571;569;1002;702;392;310;107;48;59;84;42;42;62;32;30;51;16;35;398;254;144;237.0;314.0;82.0;101.0;1434.0;1701.0;1730
8335;Tynaarlo;2009;30854;7085;17603;6166;28530;1562;562;1000;762;410;352;116;53;63;88;44;44;81;42;39;62;18;44;415;253;162;229.0;315.0;91.0;97.0;1406.0;1703.0;1730
8336;Tynaarlo;2010;30472;6835;17411;6226;28087;1554;559;995;831;445;386;136;61;75;99;50;49;98;48;50;71;21;50;427;265;162;230.0;308.0;83.0;104.0;1415.0;1693.0;1730
8337;Tynaarlo;2011;30096;6556;17257;6283;27707;1497;529;968;892;482;410;153;69;84;101;50;51;101;49;52;86;24;62;451;290;161;231.0;312.0;96.0;93.0;1464.0;1695.0;1730
8338;Tynaarlo;2012;29791;6341;16991;6459;27334;1486;513;973;971;508;463;172;77;95;108;55;53;111;54;57;102;30;72;478;292;186;235.0;310.0;83.0;95.0;1396.0;1668.0;1730
8339;Tynaarlo;2013;29434;6152;16695;6587;26925;1509;517;992;1000;506;494;180;80;100;114;59;55;131;59;72;110;33;77;465;275;190;244.0;309.0;83.0;92.0;1449.0;1674.0;1730
8340;Tynaarlo;2014;29136;5996;16477;6663;26557;1506;511;995;1073;524;549;198;88;110;119;64;55;145;58;87;127;34;93;484;280;204;239.0;308.0;92.0;93.0;1439.0;1654.0;1730
8341;Tynaarlo;2015;28857;5841;16252;6764;26209;1511;511;1000;1137;550;587;218;96;122;124;70;54;159;66;93;135;37;98;501;281;220;245.0;309.0;80.0;95.0;1461.0;1660.0;1730
8342;Tynaarlo;2016;28583;5676;16094;6813;25851;1516;506;1010;1216;584;632;234;105;129;127;67;60;174;73;101;154;45;109;527;294;233;247.0;307.0;88.0;86.0;1497.0;1641.0;1730
8343;Tynaarlo;2017;28381;5561;15961;6859;25633;1530;515;1015;1218;562;656;249;111;138;129;71;58;167;69;98;157;42;115;516;269;247;258.0;314.0;83.0;88.0;1482.0;1626.0;1730
8344;Tynaarlo;2018;28180;5463;15796;6921;25363;1536;508;1028;1281;587;694;256;118;138;130;73;57;157;64;93;184;41;143;554;291;263;263.0;309.0;88.0;91.0;1470.0;1631.0;1730
8345;Tynaarlo;2019;27972;5393;15581;6998;25104;1528;513;1015;1340;620;720;260;123;137;136;74;62;176;75;101;189;48;141;579;300;279;257.0;304.0;80.0;87.0;1467.0;1599.0;1730
8346;Tynaarlo;2020;27787;5259;15426;7102;24871;1551;531;1020;1365;648;717;272;132;140;136;67;69;182;81;101;195;48;147;580;320;260;264.0;314.0;86.0;92.0;1546.0;1603.0;1730
8347;Tynaarlo;2021;27679;5184;15289;7206;24702;1553;549;1004;1424;661;763;267;129;138;153;76;77;191;80;111;208;50;158;605;326;279;270.0;316.0;84.0;85.0;1420.0;1606.0;1730
8348;Tynaarlo;2022;27448;5085;15089;7274;24446;1526;552;974;1476;692;784;277;138;139;169;84;85;189;88;101;215;49;166;626;333;293;278.0;313.0;89.0;88.0;1513.0;1586.0;1730
8349;Tynaarlo;2023;27340;5057;14922;7361;24312;1512;547;965;1516;717;799;280;139;141;189;97;92;187;85;102;221;52;169;639;344;295;282.0;318.0;81.0;87.0;1521.0;1556.0;1730
8350;Tynaarlo;2024;27263;5074;14744;7445;24187;1507;549;958;1569;722;847;292;143;149;194;100;94;198;85;113;236;49;187;649;345;304;275.0;321.0;76.0;84.0;1447.0;1562.0;1730
8351;Tynaarlo;2025;27097;5039;14536;7522;23987;1513;555;958;1597;722;875;299;150;149;191;99;92;206;85;121;254;51;203;647;337;310;;;;;;;1730
8352;Tytsjerksteradiel;2008;32175;7986;18940;5249;30184;1088;392;696;903;619;284;92;43;49;57;23;34;52;33;19;53;28;25;649;492;157;347.0;321.0;90.0;96.0;1173.0;1265.0;737
8353;Tytsjerksteradiel;2009;32107;7859;18890;5358;30017;1118;406;712;972;642;330;112;52;60;68;33;35;60;32;28;66;35;31;666;490;176;350.0;320.0;96.0;97.0;1193.0;1260.0;737
8354;Tytsjerksteradiel;2010;32073;7794;18799;5480;29902;1141;423;718;1030;682;348;120;56;64;70;33;37;70;38;32;79;42;37;691;513;178;342.0;323.0;93.0;96.0;1187.0;1277.0;737
8355;Tytsjerksteradiel;2011;32003;7726;18710;5567;29726;1169;428;741;1108;719;389;124;57;67;73;36;37;84;37;47;94;49;45;733;540;193;345.0;322.0;96.0;94.0;1183.0;1292.0;737
8356;Tytsjerksteradiel;2012;31922;7603;18585;5734;29565;1181;434;747;1176;756;420;144;68;76;82;45;37;100;51;49;101;53;48;749;539;210;337.0;324.0;98.0;103.0;1180.0;1279.0;737
8357;Tytsjerksteradiel;2013;31833;7490;18400;5943;29366;1214;453;761;1253;797;456;155;78;77;84;46;38;114;57;57;114;54;60;786;562;224;344.0;327.0;104.0;87.0;1178.0;1285.0;737
8358;Tytsjerksteradiel;2014;31764;7381;18262;6121;29192;1257;463;794;1315;831;484;158;81;77;93;48;45;122;65;57;122;57;65;820;580;240;346.0;328.0;102.0;95.0;1158.0;1278.0;737
8359;Tytsjerksteradiel;2015;31669;7352;18066;6251;29041;1260;479;781;1368;861;507;164;86;78;106;56;50;129;68;61;136;67;69;833;584;249;342.0;332.0;101.0;91.0;1195.0;1299.0;737
8360;Tytsjerksteradiel;2016;31587;7249;17979;6359;28895;1298;484;814;1394;865;529;170;86;84;111;58;53;141;74;67;160;81;79;812;566;246;348.0;331.0;109.0;91.0;1150.0;1257.0;737
8361;Tytsjerksteradiel;2017;31518;7168;17830;6520;28745;1321;505;816;1452;885;567;186;91;95;116;61;55;148;75;73;191;95;96;811;563;248;349.0;338.0;94.0;90.0;1138.0;1252.0;737
8362;Tytsjerksteradiel;2018;31423;7100;17707;6616;28583;1317;500;817;1523;923;600;196;98;98;128;71;57;171;84;87;207;103;104;821;567;254;347.0;341.0;99.0;92.0;1152.0;1257.0;737
8363;Tytsjerksteradiel;2019;31334;6982;17645;6707;28426;1318;489;829;1590;956;634;201;101;100;139;79;60;188;96;92;223;105;118;839;575;264;351.0;341.0;93.0;88.0;1091.0;1249.0;737
8364;Tytsjerksteradiel;2020;31191;6891;17515;6785;28182;1340;511;829;1669;989;680;220;112;108;151;86;65;212;105;107;244;113;131;842;573;269;358.0;346.0;101.0;83.0;1156.0;1246.0;737
8365;Tytsjerksteradiel;2021;31133;6853;17392;6888;28065;1349;521;828;1719;1027;692;216;115;101;161;90;71;218;114;104;252;124;128;872;584;288;363.0;351.0;107.0;89.0;1106.0;1260.0;737
8366;Tytsjerksteradiel;2022;31010;6734;17266;7010;27873;1358;527;831;1779;1033;746;219;111;108;166;92;74;234;114;120;269;127;142;891;589;302;354.0;360.0;97.0;96.0;1126.0;1235.0;737
8367;Tytsjerksteradiel;2023;30897;6692;17117;7088;27727;1343;514;829;1827;1051;776;229;116;113;169;94;75;249;118;131;277;132;145;903;591;312;367.0;368.0;94.0;82.0;1139.0;1228.0;737
8368;Tytsjerksteradiel;2024;30821;6655;16998;7168;27608;1324;513;811;1889;1078;811;226;117;109;182;99;83;265;120;145;296;142;154;920;600;320;369.0;371.0;104.0;86.0;1169.0;1208.0;737
8369;Tytsjerksteradiel;2025;30798;6656;16889;7253;27525;1341;532;809;1932;1105;827;237;124;113;194;105;89;274;127;147;299;149;150;928;600;328;;;;;;;737
8370;Ubbergen;2008;9536;2127;5642;1767;8262;1022;311;711;252;152;100;22;15;7;27;13;14;41;16;25;27;10;17;135;98;37;78.0;105.0;32.0;40.0;630.0;506.0;282
8371;Ubbergen;2009;9626;2148;5695;1783;8303;1044;324;720;279;163;116;31;20;11;27;14;13;51;20;31;26;9;17;144;100;44;77.0;103.0;30.0;42.0;584.0;521.0;282
8372;Ubbergen;2010;9652;2101;5746;1805;8319;1027;325;702;306;170;136;42;26;16;32;17;15;55;21;34;35;11;24;142;95;47;79.0;103.0;32.0;43.0;620.0;525.0;282
8373;Ubbergen;2011;9713;2104;5793;1816;8390;1007;317;690;316;171;145;44;25;19;31;16;15;57;23;34;41;12;29;143;95;48;84.0;106.0;35.0;45.0;575.0;555.0;282
8374;Ubbergen;2012;9702;2066;5799;1837;8357;999;317;682;346;183;163;42;23;19;37;16;21;63;26;37;45;14;31;159;104;55;83.0;100.0;37.0;45.0;596.0;537.0;282
8375;Ubbergen;2013;9736;2015;5867;1854;8369;994;316;678;373;198;175;45;24;21;34;15;19;74;27;47;44;16;28;176;116;60;84.0;102.0;33.0;45.0;584.0;571.0;282
8376;Ubbergen;2014;9721;1960;5848;1913;8338;995;326;669;388;210;178;50;26;24;38;17;21;71;28;43;45;16;29;184;123;61;87.0;99.0;39.0;39.0;595.0;564.0;282
8377;Ubbergen;2015;9742;1941;5863;1938;8343;989;324;665;410;229;181;48;29;19;44;22;22;74;32;42;49;19;30;195;127;68;92.0;101.0;37.0;43.0;585.0;574.0;282
8378;Ubbergen;2016;9741;1914;5864;1963;8351;963;323;640;427;234;193;52;30;22;37;19;18;71;30;41;54;17;37;213;138;75;92.0;101.0;34.0;46.0;588.0;558.0;282
8379;Ubbergen;2017;9752;1917;5863;1972;8366;947;320;627;439;232;207;54;33;21;40;23;17;80;31;49;58;14;44;207;131;76;94.0;98.0;31.0;41.0;605.0;555.0;282
8380;Ubbergen;2018;9790;1897;5898;1995;8398;940;323;617;452;237;215;52;34;18;39;22;17;82;33;49;68;17;51;211;131;80;97.0;98.0;41.0;42.0;564.0;568.0;282
8381;Ubbergen;2019;9788;1907;5847;2034;8385;930;326;604;473;244;229;55;35;20;41;23;18;89;35;54;77;19;58;211;132;79;98.0;102.0;36.0;41.0;629.0;558.0;282
8382;Ubbergen;2020;9852;1956;5835;2061;8422;931;323;608;499;253;246;60;38;22;47;25;22;91;37;54;85;20;65;216;133;83;100.0;103.0;36.0;38.0;550.0;577.0;282
8383;Ubbergen;2021;9822;1929;5820;2073;8409;902;316;586;511;248;263;63;39;24;52;31;21;93;37;56;89;19;70;214;122;92;97.0;105.0;32.0;43.0;590.0;561.0;282
8384;Ubbergen;2022;9837;1912;5835;2090;8417;890;307;583;530;259;271;69;46;23;51;31;20;101;39;62;90;20;70;219;123;96;95.0;103.0;32.0;39.0;621.0;556.0;282
8385;Ubbergen;2023;9889;1898;5883;2108;8472;891;314;577;526;255;271;67;44;23;52;36;16;103;36;67;94;22;72;210;117;93;100.0;108.0;44.0;35.0;560.0;572.0;282
8386;Ubbergen;2024;9880;1898;5843;2139;8433;892;302;590;555;265;290;74;46;28;50;36;14;103;39;64;107;28;79;221;116;105;104.0;107.0;36.0;38.0;562.0;564.0;282
8387;Ubbergen;2025;9875;1900;5836;2139;8437;879;310;569;559;269;290;70;45;25;49;32;17;109;41;68;107;30;77;224;121;103;;;;;;;282
8388;Uden;2008;40024;10025;24126;5873;34276;2956;1044;1912;2792;1603;1189;489;279;210;210;117;93;1033;546;487;233;113;120;827;548;279;416.0;304.0;149.0;213.0;1125.0;1231.0;856
8389;Uden;2009;39970;9975;23931;6064;34235;2922;1044;1878;2813;1622;1191;486;274;212;214;118;96;999;536;463;250;121;129;864;573;291;404.0;306.0;148.0;214.0;1219.0;1245.0;856
8390;Uden;2010;39981;9877;23865;6239;34215;2928;1078;1850;2838;1627;1211;490;278;212;213;116;97;1011;534;477;263;128;135;861;571;290;400.0;311.0;149.0;215.0;1163.0;1310.0;856
8391;Uden;2011;39861;9734;23697;6430;34088;2947;1088;1859;2826;1627;1199;483;282;201;214;117;97;1002;524;478;279;143;136;848;561;287;382.0;322.0;159.0;207.0;1228.0;1291.0;856
8392;Uden;2012;39814;9629;23458;6727;34055;2916;1069;1847;2843;1636;1207;475;273;202;225;125;100;975;516;459;289;143;146;879;579;300;383.0;333.0;164.0;198.0;1335.0;1308.0;856
8393;Uden;2013;39867;9561;23308;6998;34070;2926;1084;1842;2871;1622;1249;475;268;207;227;129;98;966;504;462;319;147;172;884;574;310;379.0;345.0;160.0;199.0;1314.0;1326.0;856
8394;Uden;2014;39855;9473;23120;7262;34019;2923;1097;1826;2913;1646;1267;483;270;213;232;132;100;946;497;449;338;152;186;914;595;319;375.0;344.0;153.0;195.0;1287.0;1353.0;856
8395;Uden;2015;39783;9332;22929;7522;33913;2932;1126;1806;2938;1640;1298;484;261;223;233;135;98;958;495;463;342;151;191;921;598;323;379.0;369.0;155.0;191.0;1406.0;1349.0;856
8396;Uden;2016;39818;9183;22896;7739;33920;2914;1133;1781;2984;1649;1335;501;271;230;232;133;99;940;488;452;365;161;204;946;596;350;383.0;369.0;168.0;192.0;1400.0;1376.0;856
8397;Uden;2017;39833;9135;22742;7956;33884;2923;1140;1783;3026;1645;1381;513;278;235;246;138;108;947;492;455;377;158;219;943;579;364;376.0;380.0;158.0;188.0;1367.0;1386.0;856
8398;Uden;2018;39782;8987;22677;8118;33803;2943;1180;1763;3036;1648;1388;518;281;237;244;138;106;955;497;458;374;150;224;945;582;363;388.0;393.0;151.0;188.0;1509.0;1399.0;856
8399;Uden;2019;39853;8927;22650;8276;33844;2952;1196;1756;3057;1647;1410;524;278;246;248;148;100;937;480;457;383;148;235;965;593;372;391.0;393.0;147.0;185.0;1459.0;1397.0;856
8400;Uden;2020;39876;8840;22653;8383;33819;2983;1237;1746;3074;1645;1429;519;278;241;262;158;104;931;470;461;402;149;253;960;590;370;397.0;397.0;149.0;171.0;1432.0;1419.0;856
8401;Uden;2021;39873;8736;22577;8560;33758;2984;1242;1742;3131;1678;1453;520;275;245;266;159;107;936;480;456;408;151;257;1001;613;388;394.0;404.0;151.0;175.0;1483.0;1414.0;856
8402;Uden;2022;39910;8610;22623;8677;33744;2985;1267;1718;3181;1712;1469;536;276;260;278;168;110;929;483;446;419;160;259;1019;625;394;412.0;414.0;140.0;175.0;1513.0;1416.0;856
8403;Uden;2023;39976;8526;22638;8812;33734;3004;1288;1716;3238;1738;1500;547;277;270;278;170;108;940;493;447;435;160;275;1038;638;400;418.0;422.0;149.0;178.0;1488.0;1414.0;856
8404;Uden;2024;40021;8471;22590;8960;33706;3014;1328;1686;3301;1748;1553;546;275;271;272;158;114;945;494;451;463;174;289;1075;647;428;427.0;423.0;151.0;175.0;1434.0;1425.0;856
8405;Uden;2025;40013;8421;22535;9057;33603;3036;1351;1685;3374;1791;1583;548;275;273;284;161;123;954;500;454;484;180;304;1104;675;429;;;;;;;856
8406;Uitgeest;2008;11859;3170;7118;1571;10648;756;264;492;455;240;215;67;30;37;39;17;22;66;33;33;25;7;18;258;153;105;116.0;81.0;35.0;42.0;515.0;471.0;450
8407;Uitgeest;2009;11934;3149;7117;1668;10678;781;273;508;475;264;211;65;30;35;38;16;22;71;36;35;29;10;19;272;172;100;112.0;84.0;36.0;41.0;569.0;484.0;450
8408;Uitgeest;2010;12045;3121;7171;1753;10734;787;270;517;524;287;237;77;35;42;37;15;22;80;39;41;41;15;26;289;183;106;110.0;87.0;34.0;40.0;476.0;500.0;450
8409;Uitgeest;2011;12040;3016;7208;1816;10720;793;271;522;527;288;239;84;36;48;35;17;18;81;39;42;42;17;25;285;179;106;106.0;91.0;40.0;39.0;546.0;500.0;450
8410;Uitgeest;2012;12104;2967;7213;1924;10743;808;280;528;553;295;258;92;38;54;36;16;20;88;43;45;51;22;29;286;176;110;106.0;92.0;38.0;45.0;503.0;496.0;450
8411;Uitgeest;2013;12121;2936;7184;2001;10740;808;292;516;573;311;262;94;38;56;42;19;23;88;43;45;59;23;36;290;188;102;104.0;96.0;39.0;43.0;476.0;503.0;450
8412;Uitgeest;2014;12099;2872;7139;2088;10702;813;291;522;584;318;266;98;41;57;44;21;23;93;45;48;59;24;35;290;187;103;104.0;103.0;38.0;40.0;444.0;535.0;450
8413;Uitgeest;2015;12009;2790;7075;2144;10581;816;297;519;612;329;283;109;43;66;48;25;23;95;46;49;61;24;37;299;191;108;105.0;102.0;33.0;39.0;577.0;491.0;450
8414;Uitgeest;2016;12091;2745;7130;2216;10629;815;306;509;647;334;313;115;44;71;60;31;29;101;43;58;72;27;45;299;189;110;103.0;108.0;39.0;38.0;476.0;506.0;450
8415;Uitgeest;2017;12059;2664;7121;2274;10577;821;307;514;661;339;322;109;45;64;65;35;30;108;46;62;73;28;45;306;185;121;105.0;105.0;34.0;36.0;530.0;520.0;450
8416;Uitgeest;2018;12069;2614;7133;2322;10565;817;319;498;687;346;341;113;51;62;63;33;30;118;49;69;80;28;52;313;185;128;113.0;110.0;32.0;40.0;586.0;492.0;450
8417;Uitgeest;2019;12160;2593;7177;2390;10621;829;333;496;710;340;370;116;49;67;62;34;28;131;52;79;87;31;56;314;174;140;120.0;113.0;36.0;36.0;565.0;521.0;450
8418;Uitgeest;2020;12213;2541;7235;2437;10642;835;332;503;736;343;393;134;52;82;63;34;29;129;50;79;91;35;56;319;172;147;121.0;117.0;35.0;33.0;582.0;505.0;450
8419;Uitgeest;2021;12299;2504;7297;2498;10696;853;341;512;750;348;402;134;53;81;67;37;30;130;51;79;96;36;60;323;171;152;122.0;118.0;38.0;40.0;521.0;518.0;450
8420;Uitgeest;2022;12304;2448;7291;2565;10672;850;342;508;782;363;419;135;55;80;73;40;33;140;53;87;109;38;71;325;177;148;125.0;119.0;38.0;41.0;578.0;515.0;450
8421;Uitgeest;2023;12371;2469;7287;2615;10687;875;354;521;809;375;434;148;58;90;75;43;32;145;58;87;111;39;72;330;177;153;130.0;123.0;39.0;39.0;461.0;526.0;450
8422;Uitgeest;2024;12314;2429;7196;2689;10593;899;367;532;822;382;440;151;61;90;75;44;31;145;59;86;117;39;78;334;179;155;130.0;121.0;38.0;40.0;579.0;512.0;450
8423;Uitgeest;2025;12391;2429;7206;2756;10632;904;355;549;855;409;446;147;63;84;81;46;35;151;63;88;124;42;82;352;195;157;;;;;;;450
8424;Uithoorn;2008;27574;6993;16234;4347;22647;2701;1248;1453;2226;1203;1023;345;149;196;115;52;63;145;70;75;570;290;280;1051;642;409;284.0;207.0;175.0;195.0;1450.0;1162.0;451
8425;Uithoorn;2009;27922;7017;16463;4442;22786;2752;1264;1488;2384;1276;1108;380;161;219;127;59;68;168;90;78;613;301;312;1096;665;431;277.0;216.0;178.0;196.0;1493.0;1207.0;451
8426;Uithoorn;2010;28256;7032;16670;4554;22954;2767;1309;1458;2535;1353;1182;406;172;234;143;68;75;199;110;89;621;301;320;1166;702;464;285.0;216.0;194.0;204.0;1417.0;1226.0;451
8427;Uithoorn;2011;28510;7028;16846;4636;23061;2801;1315;1486;2648;1395;1253;426;180;246;152;70;82;216;117;99;662;304;358;1192;724;468;276.0;222.0;192.0;196.0;1321.0;1264.0;451
8428;Uithoorn;2012;28618;6974;16820;4824;23062;2834;1334;1500;2722;1419;1303;420;175;245;174;80;94;238;128;110;698;320;378;1192;716;476;272.0;225.0;182.0;202.0;1356.0;1221.0;451
8429;Uithoorn;2013;28784;6933;16856;4995;23088;2904;1358;1546;2792;1448;1344;438;176;262;188;87;101;248;135;113;690;315;375;1228;735;493;276.0;234.0;196.0;196.0;1384.0;1212.0;451
8430;Uithoorn;2014;29000;6915;16952;5133;23139;2974;1382;1592;2887;1485;1402;445;178;267;195;90;105;273;141;132;717;331;386;1257;745;512;277.0;239.0;199.0;193.0;1356.0;1213.0;451
8431;Uithoorn;2015;29190;6856;17073;5261;23170;3027;1418;1609;2993;1536;1457;451;180;271;196;97;99;297;146;151;738;339;399;1311;774;537;275.0;244.0;202.0;200.0;1193.0;1198.0;451
8432;Uithoorn;2016;29217;6742;17148;5327;23057;3088;1447;1641;3072;1588;1484;458;186;272;209;104;105;317;158;159;767;355;412;1321;785;536;273.0;248.0;207.0;196.0;1222.0;1227.0;451
8433;Uithoorn;2017;29248;6681;17161;5406;22972;3109;1451;1658;3167;1631;1536;484;195;289;220;112;108;352;179;173;776;353;423;1335;792;543;285.0;254.0;207.0;185.0;1106.0;1199.0;451
8434;Uithoorn;2018;29208;6557;17125;5526;22819;3164;1495;1669;3225;1652;1573;491;198;293;228;120;108;357;181;176;799;353;446;1350;800;550;287.0;254.0;202.0;190.0;1241.0;1204.0;451
8435;Uithoorn;2019;29292;6490;17218;5584;22768;3207;1517;1690;3317;1692;1625;495;207;288;238;126;112;368;180;188;822;357;465;1394;822;572;274.0;258.0;200.0;194.0;1206.0;1190.0;451
8436;Uithoorn;2020;29332;6407;17278;5647;22700;3275;1569;1706;3357;1709;1648;496;208;288;261;135;126;380;189;191;822;365;457;1398;812;586;286.0;266.0;196.0;198.0;1251.0;1188.0;451
8437;Uithoorn;2021;29417;6340;17307;5770;22671;3318;1615;1703;3428;1731;1697;507;213;294;275;142;133;406;190;216;832;366;466;1408;820;588;291.0;270.0;204.0;180.0;1284.0;1206.0;451
8438;Uithoorn;2022;29543;6294;17367;5882;22654;3325;1610;1715;3564;1782;1782;523;222;301;279;148;131;444;209;235;864;363;501;1454;840;614;298.0;269.0;203.0;186.0;1293.0;1204.0;451
8439;Uithoorn;2023;29683;6237;17422;6024;22654;3355;1648;1707;3674;1846;1828;523;224;299;297;163;134;453;220;233;896;373;523;1505;866;639;293.0;274.0;202.0;189.0;1183.0;1220.0;451
8440;Uithoorn;2024;29682;6204;17328;6150;22569;3384;1669;1715;3729;1878;1851;531;232;299;306;167;139;457;223;234;915;384;531;1520;872;648;297.0;285.0;201.0;190.0;1273.0;1198.0;451
8441;Uithoorn;2025;29783;6176;17326;6281;22527;3450;1697;1753;3806;1876;1930;538;230;308;309;164;145;461;225;236;954;394;560;1544;863;681;;;;;;;451
8442;Urk;2008;17496;7201;9032;1263;16976;217;77;140;303;180;123;11;7;4;9;2;7;16;7;9;128;63;65;139;101;38;402.0;69.0;48.0;68.0;104.0;383.0;184
8443;Urk;2009;17531;7138;9055;1338;16937;235;82;153;359;210;149;18;10;8;13;3;10;25;11;14;138;64;74;165;122;43;398.0;77.0;55.0;71.0;114.0;382.0;184
8444;Urk;2010;17569;7118;9050;1401;16932;241;80;161;396;224;172;27;12;15;14;4;10;29;14;15;146;69;77;180;125;55;392.0;75.0;64.0;71.0;108.0;398.0;184
8445;Urk;2011;17590;7077;9066;1447;16879;259;87;172;452;244;208;29;12;17;21;9;12;40;18;22;159;72;87;203;133;70;393.0;80.0;68.0;68.0;119.0;405.0;184
8446;Urk;2012;17616;7031;9059;1526;16848;263;92;171;505;264;241;38;15;23;24;12;12;50;20;30;160;72;88;233;145;88;379.0;82.0;72.0;72.0;201.0;399.0;184
8447;Urk;2013;17717;7035;9077;1605;16893;267;91;176;557;277;280;39;17;22;28;13;15;60;20;40;162;69;93;268;158;110;379.0;87.0;77.0;70.0;225.0;399.0;184
8448;Urk;2014;17846;7020;9148;1678;16933;282;102;180;631;310;321;42;17;25;39;15;24;62;22;40;179;75;104;309;181;128;378.0;85.0;89.0;74.0;144.0;420.0;184
8449;Urk;2015;17877;6973;9153;1751;16910;286;114;172;681;344;337;51;25;26;42;19;23;78;29;49;179;71;108;331;200;131;366.0;92.0;79.0;70.0;294.0;405.0;184
8450;Urk;2016;18051;6991;9247;1813;16982;304;121;183;765;374;391;60;29;31;47;21;26;95;34;61;187;76;111;376;214;162;360.0;97.0;82.0;74.0;214.0;407.0;184
8451;Urk;2017;18132;6965;9253;1914;17003;306;121;185;823;396;427;71;33;38;54;27;27;103;37;66;187;73;114;408;226;182;359.0;101.0;90.0;77.0;313.0;415.0;184
8452;Urk;2018;18303;6957;9339;2007;17110;325;129;196;868;411;457;72;34;38;58;29;29;113;38;75;190;75;115;435;235;200;353.0;109.0;108.0;71.0;231.0;422.0;184
8453;Urk;2019;18401;6919;9383;2099;17123;347;137;210;931;439;492;71;35;36;69;30;39;130;46;84;207;79;128;454;249;205;344.0;109.0;92.0;81.0;286.0;439.0;184
8454;Urk;2020;18495;6875;9432;2188;17162;358;145;213;975;462;513;72;36;36;75;34;41;136;49;87;206;79;127;486;264;222;341.0;105.0;91.0;80.0;288.0;438.0;184
8455;Urk;2021;18595;6847;9470;2278;17196;384;150;234;1015;477;538;77;36;41;76;36;40;142;49;93;215;81;134;505;275;230;335.0;114.0;102.0;83.0;321.0;437.0;184
8456;Urk;2022;18721;6830;9527;2364;17228;401;156;245;1092;507;585;88;42;46;83;38;45;157;52;105;229;82;147;535;293;242;337.0;121.0;98.0;81.0;202.0;439.0;184
8457;Urk;2023;18717;6750;9537;2430;17167;416;164;252;1134;534;600;92;45;47;86;41;45;162;54;108;233;84;149;561;310;251;336.0;125.0;93.0;81.0;330.0;440.0;184
8458;Urk;2024;18833;6739;9554;2540;17211;422;169;253;1200;560;640;97;46;51;89;45;44;167;50;117;243;90;153;604;329;275;322.0;126.0;100.0;81.0;305.0;416.0;184
8459;Urk;2025;18938;6709;9589;2640;17246;422;170;252;1270;595;675;102;48;54;97;49;48;175;54;121;249;92;157;647;352;295;;;;;;;184
8460;Utrecht (gemeente);2008;296708;64548;200407;31753;206611;29566;12708;16858;60531;33190;27341;7482;4045;3437;2557;1419;1138;12753;6496;6257;24861;12621;12240;12878;8609;4269;4644.0;2034.0;3626.0;3623.0;18783.0;15493.0;344
8461;Utrecht (gemeente);2009;302689;66839;203183;32667;210992;30416;13064;17352;61281;33085;28196;7564;4050;3514;2706;1496;1210;12753;6362;6391;24894;12314;12580;13364;8863;4501;4725.0;2106.0;3824.0;3622.0;18277.0;15654.0;344
8462;Utrecht (gemeente);2010;308199;68897;205708;33594;215104;31139;13323;17816;61956;32983;28973;7634;4040;3594;2842;1570;1272;12685;6232;6453;24941;12039;12902;13854;9102;4752;4798.0;2167.0;4016.0;3673.0;18312.0;15518.0;344
8463;Utrecht (gemeente);2011;314035;70941;208780;34314;219298;32010;13761;18249;62727;32928;29799;7774;4080;3694;2977;1670;1307;12720;6161;6559;24996;11796;13200;14260;9221;5039;4873.0;2224.0;4170.0;3685.0;18408.0;15649.0;344
8464;Utrecht (gemeente);2012;319987;72980;210958;36049;223628;32835;14175;18660;63524;32964;30560;7852;4097;3755;3138;1789;1349;12727;6087;6640;25056;11588;13468;14751;9403;5348;4934.0;2250.0;4211.0;3706.0;18671.0;15691.0;344
8465;Utrecht (gemeente);2013;326216;75079;213452;37685;228222;33694;14596;19098;64300;32913;31387;7942;4118;3824;3335;1904;1431;12724;5996;6728;25073;11322;13751;15226;9573;5653;5023.0;2302.0;4270.0;3750.0;18629.0;15811.0;344
8466;Utrecht (gemeente);2014;332338;77228;215898;39212;232686;34562;15032;19530;65090;32965;32125;8030;4138;3892;3506;2023;1483;12716;5929;6787;25167;11170;13997;15671;9705;5966;5132.0;2360.0;4317.0;3752.0;18553.0;15958.0;344
8467;Utrecht (gemeente);2015;338319;79303;218359;40657;237121;35391;15480;19911;65807;32938;32869;8119;4173;3946;3649;2102;1547;12740;5888;6852;25183;10975;14208;16116;9800;6316;5176.0;2417.0;4404.0;3761.0;18448.0;16045.0;344
8468;Utrecht (gemeente);2016;344172;81296;220768;42108;241460;36186;15884;20302;66526;32954;33572;8178;4169;4009;3811;2214;1597;12802;5869;6933;25114;10746;14368;16621;9956;6665;5180.0;2474.0;4395.0;3731.0;18354.0;16210.0;344
8469;Utrecht (gemeente);2017;349738;83055;223157;43526;245518;36951;16302;20649;67269;32992;34277;8244;4170;4074;3942;2303;1639;12806;5830;6976;25090;10566;14524;17187;10123;7064;5213.0;2537.0;4439.0;3806.0;18820.0;16240.0;344
8470;Utrecht (gemeente);2018;355688;85036;225698;44954;249864;37805;16731;21074;68019;33052;34967;8309;4192;4117;4124;2394;1730;12871;5805;7066;25080;10426;14654;17635;10235;7400;5266.0;2630.0;4506.0;3782.0;18758.0;16441.0;344
8471;Utrecht (gemeente);2019;361413;86793;228274;46346;253993;38630;17107;21523;68790;33116;35674;8433;4221;4212;4266;2485;1781;12942;5757;7185;25058;10322;14736;18091;10331;7760;5285.0;2633.0;4542.0;3827.0;18579.0;16781.0;344
8472;Utrecht (gemeente);2020;366630;88196;230518;47916;257802;39392;17473;21919;69436;33122;36314;8512;4222;4290;4414;2553;1861;12920;5674;7246;24965;10180;14785;18625;10493;8132;5249.0;2755.0;4572.0;3836.0;19123.0;16840.0;344
8473;Utrecht (gemeente);2021;372192;89528;233181;49483;261664;40277;17917;22360;70251;33313;36938;8613;4239;4374;4557;2665;1892;12993;5647;7346;24847;10060;14787;19241;10702;8539;5294.0;2786.0;4538.0;3886.0;19210.0;17100.0;344
8474;Utrecht (gemeente);2022;377522;90763;235597;51162;265230;41202;18351;22851;71090;33417;37673;8710;4241;4469;4739;2770;1969;13065;5610;7455;24777;9937;14840;19799;10859;8940;5282.0;2848.0;4711.0;3884.0;19034.0;17387.0;344
8475;Utrecht (gemeente);2023;382478;91559;238082;52837;268581;41951;18700;23251;71946;33734;38212;8833;4278;4555;4922;2890;2032;13045;5548;7497;24731;9891;14840;20415;11127;9288;5279.0;2912.0;4626.0;3861.0;19265.0;17568.0;344
8476;Utrecht (gemeente);2024;387367;92249;240440;54678;271961;42705;19079;23626;72701;33929;38772;8884;4278;4606;5102;2993;2109;13107;5503;7604;24620;9765;14855;20988;11390;9598;5245.0;3037.0;4685.0;3876.0;19553.0;17764.0;344
8477;Utrecht (gemeente);2025;392234;92935;242742;56557;275236;43434;19530;23904;73564;34085;39479;8945;4266;4679;5223;3070;2153;13188;5459;7729;24532;9650;14882;21676;11640;10036;;;;;;;344
8478;Utrechtse Heuvelrug;2008;47672;11621;26657;9394;40835;3936;1318;2618;2901;1587;1314;283;122;161;196;78;118;378;208;170;685;334;351;1359;845;514;408.0;540.0;166.0;231.0;1954.0;2207.0;1581
8479;Utrechtse Heuvelrug;2009;47228;11435;26407;9386;40242;3896;1277;2619;3090;1669;1421;301;123;178;198;84;114;407;215;192;703;334;369;1481;913;568;399.0;537.0;176.0;221.0;2032.0;2211.0;1581
8480;Utrechtse Heuvelrug;2010;46876;11285;26190;9401;39731;3901;1264;2637;3244;1730;1514;316;139;177;227;93;134;426;220;206;714;345;369;1561;933;628;392.0;533.0;209.0;205.0;2118.0;2228.0;1581
8481;Utrechtse Heuvelrug;2011;46631;11106;26083;9442;39320;3899;1259;2640;3412;1807;1605;325;142;183;244;109;135;429;226;203;740;353;387;1674;977;697;393.0;526.0;184.0;213.0;2132.0;2254.0;1581
8482;Utrechtse Heuvelrug;2012;46350;10923;25743;9684;38874;3899;1266;2633;3577;1863;1714;366;163;203;241;106;135;452;231;221;738;345;393;1780;1018;762;380.0;526.0;196.0;214.0;2100.0;2271.0;1581
8483;Utrechtse Heuvelrug;2013;46021;10764;25397;9860;38421;3905;1290;2615;3695;1905;1790;391;179;212;249;113;136;459;238;221;740;337;403;1856;1038;818;385.0;518.0;200.0;220.0;2258.0;2283.0;1581
8484;Utrechtse Heuvelrug;2014;45848;10693;25135;10020;38068;3929;1293;2636;3851;1963;1888;422;200;222;256;117;139;494;245;249;727;332;395;1952;1069;883;389.0;514.0;205.0;214.0;2175.0;2284.0;1581
8485;Utrechtse Heuvelrug;2015;45611;10543;24931;10137;37633;3945;1296;2649;4033;2038;1995;447;205;242;256;125;131;514;256;258;742;327;415;2074;1125;949;397.0;513.0;204.0;212.0;2128.0;2249.0;1581
8486;Utrechtse Heuvelrug;2016;45368;10374;24759;10235;37260;3930;1282;2648;4178;2073;2105;463;210;253;271;134;137;517;258;259;764;326;438;2163;1145;1018;386.0;506.0;184.0;214.0;2325.0;2219.0;1581
8487;Utrechtse Heuvelrug;2017;45326;10253;24754;10319;37057;3955;1293;2662;4314;2121;2193;485;221;264;272;131;141;540;265;275;764;322;442;2253;1182;1071;408.0;509.0;204.0;206.0;2187.0;2255.0;1581
8488;Utrechtse Heuvelrug;2018;45159;10103;24639;10417;36742;3954;1299;2655;4463;2183;2280;510;240;270;282;138;144;544;268;276;775;326;449;2352;1211;1141;418.0;510.0;194.0;213.0;2195.0;2258.0;1581
8489;Utrechtse Heuvelrug;2019;44989;9960;24510;10519;36493;3995;1324;2671;4501;2188;2313;519;249;270;280;141;139;554;271;283;764;318;446;2384;1209;1175;412.0;506.0;196.0;197.0;2291.0;2204.0;1581
8490;Utrechtse Heuvelrug;2020;44985;9914;24428;10643;36332;4013;1360;2653;4640;2222;2418;534;260;274;296;149;147;559;268;291;774;321;453;2477;1224;1253;425.0;518.0;200.0;205.0;2354.0;2247.0;1581
8491;Utrechtse Heuvelrug;2021;44995;9814;24515;10666;36202;4039;1347;2692;4754;2266;2488;560;277;283;298;150;148;574;270;304;770;315;455;2552;1254;1298;420.0;520.0;185.0;206.0;2325.0;2301.0;1581
8492;Utrechtse Heuvelrug;2022;44902;9701;24432;10769;35974;4078;1370;2708;4850;2306;2544;574;281;293;311;162;149;589;264;325;771;314;457;2605;1285;1320;427.0;519.0;196.0;204.0;2298.0;2299.0;1581
8493;Utrechtse Heuvelrug;2023;44806;9640;24321;10845;35763;4059;1381;2678;4984;2359;2625;586;281;305;319;166;153;602;275;327;771;315;456;2706;1322;1384;434.0;521.0;184.0;197.0;2296.0;2277.0;1581
8494;Utrechtse Heuvelrug;2024;44731;9556;24204;10971;35589;4099;1397;2702;5043;2374;2669;591;278;313;323;168;155;630;289;341;755;312;443;2744;1327;1417;441.0;513.0;192.0;208.0;2474.0;2325.0;1581
8495;Utrechtse Heuvelrug;2025;44792;9583;24120;11089;35477;4161;1422;2739;5154;2438;2716;604;288;316;344;183;161;624;284;340;760;313;447;2822;1370;1452;;;;;;;1581
8496;Vaals;2008;9815;1897;5933;1985;5015;4412;2925;1487;388;274;114;29;12;17;7;6;1;61;36;25;28;19;9;263;201;62;58.0;112.0;175.0;210.0;329.0;342.0;981
8497;Vaals;2009;9714;1869;5832;2013;5042;4251;2807;1444;421;284;137;28;12;16;12;8;4;69;40;29;42;24;18;270;200;70;56.0;111.0;166.0;200.0;356.0;345.0;981
8498;Vaals;2010;9637;1821;5790;2026;5102;4085;2676;1409;450;299;151;42;18;24;15;12;3;74;42;32;48;27;21;271;200;71;57.0;108.0;162.0;201.0;326.0;366.0;981
8499;Vaals;2011;9507;1795;5661;2051;5091;3950;2569;1381;466;303;163;40;17;23;17;12;5;87;44;43;51;28;23;271;202;69;58.0;110.0;159.0;183.0;296.0;352.0;981
8500;Vaals;2012;9376;1731;5561;2084;5060;3827;2492;1335;489;320;169;49;19;30;20;15;5;93;48;45;48;28;20;279;210;69;60.0;114.0;169.0;184.0;301.0;347.0;981
8501;Vaals;2013;9262;1678;5466;2118;5061;3699;2404;1295;502;321;181;57;26;31;19;14;5;99;51;48;56;31;25;271;199;72;57.0;104.0;158.0;171.0;286.0;345.0;981
8502;Vaals;2014;9144;1627;5351;2166;5050;3576;2317;1259;518;321;197;64;30;34;25;16;9;112;55;57;61;33;28;256;187;69;56.0;112.0;148.0;165.0;339.0;342.0;981
8503;Vaals;2015;9069;1574;5282;2213;5101;3452;2218;1234;516;313;203;63;31;32;27;17;10;108;50;58;63;30;33;255;185;70;60.0;119.0;142.0;159.0;289.0;362.0;981
8504;Vaals;2016;8921;1505;5173;2243;5070;3331;2134;1197;520;311;209;72;37;35;27;16;11;108;49;59;63;29;34;250;180;70;57.0;113.0;138.0;155.0;272.0;326.0;981
8505;Vaals;2017;8795;1451;5070;2274;5040;3229;2055;1174;526;312;214;75;37;38;29;19;10;108;48;60;64;28;36;250;180;70;62.0;113.0;131.0;155.0;306.0;328.0;981
8506;Vaals;2018;8700;1437;4970;2293;5051;3098;1956;1142;551;323;228;87;39;48;28;19;9;110;48;62;63;25;38;263;192;71;63.0;114.0;128.0;147.0;283.0;312.0;981
8507;Vaals;2019;8602;1409;4874;2319;5026;3003;1879;1124;573;320;253;87;37;50;31;21;10;113;46;67;71;27;44;271;189;82;63.0;111.0;118.0;139.0;304.0;322.0;981
8508;Vaals;2020;8517;1404;4781;2332;5033;2906;1817;1089;578;315;263;90;36;54;30;18;12;114;46;68;75;28;47;269;187;82;65.0;113.0;114.0;135.0;258.0;326.0;981
8509;Vaals;2021;8381;1340;4685;2356;4990;2802;1744;1058;589;321;268;99;43;56;31;18;13;119;47;72;71;28;43;269;185;84;63.0;113.0;114.0;128.0;261.0;301.0;981
8510;Vaals;2022;8278;1306;4598;2374;4953;2718;1684;1034;607;327;280;108;47;61;32;18;14;124;50;74;72;27;45;271;185;86;60.0;114.0;107.0;129.0;251.0;294.0;981
8511;Vaals;2023;8160;1303;4467;2390;4913;2634;1607;1027;613;324;289;116;51;65;32;18;14;124;48;76;82;31;51;259;176;83;61.0;115.0;103.0;125.0;253.0;301.0;981
8512;Vaals;2024;8037;1298;4339;2400;4854;2549;1534;1015;634;343;291;119;52;67;36;22;14;123;47;76;81;33;48;275;189;86;66.0;121.0;103.0;117.0;240.0;282.0;981
8513;Vaals;2025;7926;1262;4271;2393;4811;2478;1486;992;637;341;296;120;51;69;32;18;14;125;47;78;78;33;45;282;192;90;;;;;;;981
8514;Valkenburg a/d Geul;2008;17068;3399;10213;3456;14647;1958;675;1283;463;299;164;29;17;12;24;14;10;79;48;31;48;24;24;283;196;87;109.0;204.0;88.0;131.0;934.0;844.0;994
8515;Valkenburg a/d Geul;2009;17022;3383;10150;3489;14519;1983;681;1302;520;339;181;39;23;16;32;20;12;94;59;35;59;30;29;296;207;89;108.0;202.0;101.0;128.0;856.0;868.0;994
8516;Valkenburg a/d Geul;2010;16893;3341;10027;3525;14344;1982;681;1301;567;359;208;52;32;20;37;22;15;101;62;39;61;27;34;316;216;100;108.0;202.0;109.0;126.0;849.0;880.0;994
8517;Valkenburg a/d Geul;2011;16752;3275;9897;3580;14188;1969;684;1285;595;376;219;57;34;23;39;23;16;121;71;50;69;34;35;309;214;95;106.0;199.0;117.0;125.0;870.0;891.0;994
8518;Valkenburg a/d Geul;2012;16633;3194;9816;3623;14064;1949;684;1265;620;378;242;66;34;32;40;22;18;135;80;55;79;39;40;300;203;97;110.0;197.0;100.0;119.0;841.0;862.0;994
8519;Valkenburg a/d Geul;2013;16506;3113;9687;3706;13935;1931;683;1248;640;385;255;71;39;32;41;24;17;144;82;62;86;42;44;298;198;100;110.0;204.0;104.0;118.0;826.0;876.0;994
8520;Valkenburg a/d Geul;2014;16349;3060;9535;3754;13785;1906;673;1233;658;400;258;76;42;34;41;23;18;152;84;68;90;42;48;299;209;90;114.0;204.0;93.0;110.0;841.0;863.0;994
8521;Valkenburg a/d Geul;2015;16221;2980;9456;3785;13630;1909;672;1237;682;409;273;75;44;31;46;29;17;160;88;72;105;43;62;296;205;91;110.0;197.0;94.0;110.0;845.0;874.0;994
8522;Valkenburg a/d Geul;2016;16092;2895;9345;3852;13495;1896;663;1233;701;431;270;78;43;35;40;24;16;172;110;62;110;48;62;301;206;95;117.0;203.0;88.0;114.0;818.0;848.0;994
8523;Valkenburg a/d Geul;2017;15952;2859;9180;3913;13349;1878;650;1228;725;446;279;88;48;40;46;25;21;178;113;65;108;49;59;305;211;94;115.0;202.0;88.0;110.0;804.0;835.0;994
8524;Valkenburg a/d Geul;2018;15813;2819;9043;3951;13188;1885;672;1213;740;446;294;90;51;39;48;28;20;193;113;80;111;53;58;298;201;97;122.0;204.0;92.0;105.0;832.0;827.0;994
8525;Valkenburg a/d Geul;2019;15724;2812;8922;3990;13091;1877;670;1207;756;441;315;89;53;36;46;25;21;204;119;85;128;55;73;289;189;100;119.0;205.0;93.0;107.0;813.0;831.0;994
8526;Valkenburg a/d Geul;2020;15607;2751;8829;4027;12986;1841;678;1163;780;461;319;95;57;38;39;21;18;209;123;86;135;59;76;302;201;101;116.0;205.0;98.0;103.0;845.0;845.0;994
8527;Valkenburg a/d Geul;2021;15513;2687;8778;4048;12865;1840;679;1161;808;478;330;107;65;42;41;23;18;212;126;86;143;59;84;305;205;100;115.0;202.0;105.0;101.0;791.0;834.0;994
8528;Valkenburg a/d Geul;2022;15387;2635;8670;4082;12726;1837;683;1154;824;489;335;118;70;48;46;24;22;202;120;82;138;58;80;320;217;103;118.0;201.0;79.0;104.0;797.0;792.0;994
8529;Valkenburg a/d Geul;2023;15284;2604;8560;4120;12623;1829;699;1130;832;482;350;121;69;52;47;24;23;198;118;80;147;60;87;319;211;108;117.0;206.0;83.0;100.0;775.0;801.0;994
8530;Valkenburg a/d Geul;2024;15153;2601;8407;4145;12488;1812;686;1126;853;489;364;117;67;50;47;25;22;203;123;80;154;59;95;332;215;117;119.0;214.0;90.0;96.0;734.0;801.0;994
8531;Valkenburg a/d Geul;2025;14985;2569;8244;4172;12336;1801;674;1127;848;493;355;124;68;56;50;30;20;212;127;85;140;60;80;322;208;114;;;;;;;994
8532;Valkenswaard;2008;30979;6937;18635;5407;26902;2962;809;2153;1115;679;436;152;77;75;156;93;63;89;53;36;83;39;44;635;417;218;270.0;274.0;153.0;198.0;956.0;979.0;858
8533;Valkenswaard;2009;30911;6857;18473;5581;26798;2937;806;2131;1176;712;464;151;78;73;163;94;69;113;65;48;98;49;49;651;426;225;262.0;282.0;160.0;196.0;932.0;997.0;858
8534;Valkenswaard;2010;30795;6793;18285;5717;26621;2931;841;2090;1243;751;492;160;83;77;160;97;63;118;67;51;120;54;66;685;450;235;266.0;290.0;163.0;194.0;1043.0;989.0;858
8535;Valkenswaard;2011;30797;6703;18189;5905;26565;2905;844;2061;1327;780;547;169;86;83;163;99;64;145;78;67;138;60;78;712;457;255;265.0;289.0;165.0;190.0;987.0;1026.0;858
8536;Valkenswaard;2012;30715;6629;17971;6115;26459;2858;832;2026;1398;823;575;183;93;90;161;100;61;174;87;87;142;64;78;738;479;259;253.0;307.0;174.0;186.0;1022.0;1044.0;858
8537;Valkenswaard;2013;30630;6497;17878;6255;26313;2829;829;2000;1488;865;623;192;95;97;160;95;65;190;100;90;156;69;87;790;506;284;255.0;307.0;176.0;183.0;981.0;1057.0;858
8538;Valkenswaard;2014;30499;6391;17733;6375;26129;2806;830;1976;1564;895;669;212;108;104;166;95;71;205;106;99;177;74;103;804;512;292;258.0;318.0;172.0;186.0;1063.0;1045.0;858
8539;Valkenswaard;2015;30450;6316;17649;6485;26067;2772;834;1938;1611;917;694;223;114;109;172;103;69;221;113;108;185;73;112;810;514;296;264.0;320.0;170.0;179.0;971.0;1054.0;858
8540;Valkenswaard;2016;30305;6235;17492;6578;25848;2772;864;1908;1685;954;731;240;122;118;179;105;74;233;119;114;193;74;119;840;534;306;268.0;324.0;167.0;177.0;989.0;1061.0;858
8541;Valkenswaard;2017;30174;6159;17340;6675;25656;2765;881;1884;1753;970;783;248;124;124;192;108;84;251;124;127;202;73;129;860;541;319;270.0;332.0;176.0;166.0;1056.0;1035.0;858
8542;Valkenswaard;2018;30147;6125;17247;6775;25582;2739;892;1847;1826;1022;804;254;130;124;197;111;86;266;130;136;210;77;133;899;574;325;282.0;329.0;168.0;177.0;995.0;1046.0;858
8543;Valkenswaard;2019;30042;6063;17118;6861;25463;2703;892;1811;1876;1056;820;260;136;124;202;118;84;288;140;148;213;81;132;913;581;332;274.0;333.0;171.0;167.0;1001.0;1037.0;858
8544;Valkenswaard;2020;29953;6018;16980;6955;25314;2692;900;1792;1947;1069;878;268;142;126;201;108;93;315;153;162;229;81;148;934;585;349;285.0;333.0;164.0;171.0;959.0;1033.0;858
8545;Valkenswaard;2021;29826;5970;16813;7043;25145;2676;913;1763;2005;1103;902;275;147;128;200;109;91;330;161;169;240;83;157;960;603;357;289.0;339.0;174.0;172.0;1009.0;1025.0;858
8546;Valkenswaard;2022;29765;5962;16681;7122;25036;2661;917;1744;2068;1128;940;294;156;138;192;103;89;335;158;177;251;83;168;996;628;368;293.0;352.0;156.0;167.0;1072.0;1054.0;858
8547;Valkenswaard;2023;29715;5948;16584;7183;24949;2638;935;1703;2128;1167;961;311;170;141;207;112;95;338;161;177;256;89;167;1016;635;381;294.0;346.0;165.0;164.0;1022.0;1067.0;858
8548;Valkenswaard;2024;29620;5915;16465;7240;24780;2639;963;1676;2201;1203;998;324;174;150;206;114;92;355;172;183;275;90;185;1041;653;388;298.0;356.0;163.0;166.0;1037.0;1035.0;858
8549;Valkenswaard;2025;29564;5907;16300;7357;24655;2628;966;1662;2281;1247;1034;325;177;148;220;117;103;375;180;195;280;94;186;1081;679;402;;;;;;;858
8550;Veendam;2008;27814;6247;16901;4666;24774;1315;455;860;1725;981;744;288;153;135;69;40;29;893;474;419;35;20;15;440;294;146;256.0;291.0;66.0;140.0;1211.0;1137.0;47
8551;Veendam;2009;27782;6184;16888;4710;24754;1308;450;858;1720;977;743;296;159;137;81;45;36;855;458;397;54;27;27;434;288;146;250.0;295.0;77.0;140.0;1312.0;1122.0;47
8552;Veendam;2010;27871;6197;16864;4810;24815;1317;455;862;1739;1003;736;293;162;131;82;49;33;849;459;390;57;28;29;458;305;153;246.0;294.0;103.0;132.0;1220.0;1175.0;47
8553;Veendam;2011;27851;6121;16859;4871;24766;1305;447;858;1780;1034;746;304;169;135;90;55;35;840;456;384;68;35;33;478;319;159;245.0;292.0;86.0;136.0;1294.0;1175.0;47
8554;Veendam;2012;27875;6047;16752;5076;24759;1330;456;874;1786;1041;745;315;172;143;101;61;40;823;451;372;70;34;36;477;323;154;244.0;297.0;85.0;130.0;1319.0;1178.0;47
8555;Veendam;2013;27920;6018;16649;5253;24795;1325;461;864;1800;1049;751;317;170;147;104;65;39;803;443;360;79;40;39;497;331;166;239.0;287.0;82.0;126.0;1188.0;1177.0;47
8556;Veendam;2014;27841;5923;16545;5373;24703;1337;462;875;1801;1049;752;327;174;153;109;67;42;788;433;355;84;43;41;493;332;161;249.0;295.0;76.0;126.0;1224.0;1184.0;47
8557;Veendam;2015;27789;5865;16439;5485;24637;1318;458;860;1834;1053;781;341;180;161;111;68;43;791;427;364;98;50;48;493;328;165;248.0;300.0;85.0;125.0;1299.0;1186.0;47
8558;Veendam;2016;27815;5808;16421;5586;24623;1320;457;863;1872;1057;815;361;187;174;111;69;42;776;421;355;124;55;69;500;325;175;250.0;297.0;82.0;118.0;1312.0;1185.0;47
8559;Veendam;2017;27860;5788;16372;5700;24636;1312;456;856;1912;1072;840;376;186;190;121;73;48;761;423;338;142;62;80;512;328;184;251.0;300.0;79.0;118.0;1098.0;1171.0;47
8560;Veendam;2018;27703;5691;16159;5853;24475;1312;446;866;1916;1065;851;381;184;197;121;75;46;755;419;336;154;67;87;505;320;185;250.0;299.0;84.0;111.0;1262.0;1131.0;47
8561;Veendam;2019;27759;5632;16153;5974;24459;1336;461;875;1964;1088;876;401;192;209;133;84;49;742;415;327;160;69;91;528;328;200;250.0;305.0;82.0;118.0;1296.0;1151.0;47
8562;Veendam;2020;27817;5613;16099;6105;24493;1312;444;868;2012;1117;895;402;195;207;143;93;50;727;405;322;175;69;106;565;355;210;260.0;305.0;80.0;118.0;1250.0;1176.0;47
8563;Veendam;2021;27811;5529;16044;6238;24500;1303;450;853;2008;1110;898;416;210;206;142;90;52;716;398;318;179;72;107;555;340;215;267.0;313.0;71.0;109.0;1262.0;1201.0;47
8564;Veendam;2022;27793;5463;15997;6333;24442;1289;453;836;2062;1129;933;426;213;213;161;98;63;718;402;316;182;74;108;575;342;233;262.0;316.0;83.0;111.0;1212.0;1187.0;47
8565;Veendam;2023;27740;5438;15880;6422;24356;1314;462;852;2070;1133;937;428;217;211;172;107;65;707;394;313;196;75;121;567;340;227;263.0;314.0;83.0;106.0;1190.0;1159.0;47
8566;Veendam;2024;27700;5407;15812;6481;24272;1320;457;863;2108;1142;966;459;227;232;168;102;66;696;385;311;204;76;128;581;352;229;267.0;317.0;82.0;105.0;1231.0;1165.0;47
8567;Veendam;2025;27694;5410;15722;6562;24230;1323;454;869;2141;1167;974;470;233;237;167;106;61;675;370;305;214;80;134;615;378;237;;;;;;;47
8568;Veenendaal;2008;61703;17089;36544;8070;51945;3649;1310;2339;6109;3440;2669;301;175;126;403;247;156;695;365;330;2861;1420;1441;1849;1233;616;826.0;454.0;222.0;289.0;1864.0;1850.0;345
8569;Veenendaal;2009;62033;17131;36633;8269;52138;3658;1314;2344;6237;3501;2736;326;191;135;417;250;167;725;377;348;2866;1419;1447;1903;1264;639;815.0;461.0;241.0;296.0;1907.0;1893.0;345
8570;Veenendaal;2010;62352;17136;36688;8528;52356;3679;1338;2341;6317;3526;2791;351;202;149;432;262;170;752;394;358;2846;1390;1456;1936;1278;658;820.0;482.0;245.0;288.0;1933.0;1929.0;345
8571;Veenendaal;2011;62660;17067;36837;8756;52538;3677;1351;2326;6445;3591;2854;365;208;157;448;277;171;787;410;377;2824;1367;1457;2021;1329;692;810.0;490.0;267.0;284.0;2162.0;1934.0;345
8572;Veenendaal;2012;63199;17102;36874;9223;52854;3771;1385;2386;6574;3630;2944;400;221;179;465;286;179;805;417;388;2841;1359;1482;2063;1347;716;798.0;498.0;256.0;280.0;2084.0;1955.0;345
8573;Veenendaal;2013;63616;17116;36894;9606;53085;3779;1378;2401;6752;3705;3047;443;245;198;492;304;188;838;430;408;2842;1352;1490;2137;1374;763;796.0;512.0;252.0;283.0;1916.0;1965.0;345
8574;Veenendaal;2014;63834;17043;36793;9998;53128;3835;1410;2425;6871;3756;3115;466;264;202;513;319;194;859;429;430;2827;1345;1482;2206;1399;807;791.0;517.0;255.0;267.0;1904.0;2002.0;345
8575;Veenendaal;2015;64006;16930;36714;10362;53174;3866;1411;2455;6966;3789;3177;482;272;210;531;321;210;880;432;448;2801;1338;1463;2272;1426;846;790.0;535.0;258.0;273.0;1983.0;2023.0;345
8576;Veenendaal;2016;64215;16865;36672;10678;53256;3870;1409;2461;7089;3834;3255;514;287;227;533;317;216;896;436;460;2799;1339;1460;2347;1455;892;770.0;534.0;277.0;269.0;1983.0;2001.0;345
8577;Veenendaal;2017;64446;16778;36622;11046;53310;3900;1443;2457;7236;3902;3334;523;292;231;559;331;228;927;444;483;2804;1351;1453;2423;1484;939;778.0;539.0;259.0;277.0;1978.0;2025.0;345
8578;Veenendaal;2018;64632;16699;36554;11379;53345;3919;1451;2468;7368;3979;3389;547;308;239;591;351;240;958;461;497;2797;1340;1457;2475;1519;956;785.0;559.0;266.0;253.0;2058.0;2021.0;345
8579;Veenendaal;2019;64914;16635;36566;11713;53438;3939;1466;2473;7537;4067;3470;575;320;255;625;379;246;984;472;512;2797;1330;1467;2556;1566;990;788.0;567.0;277.0;273.0;1995.0;2046.0;345
8580;Veenendaal;2020;65097;16538;36520;12039;53429;3980;1491;2489;7688;4132;3556;608;335;273;648;398;250;1001;482;519;2802;1321;1481;2629;1596;1033;797.0;583.0;273.0;258.0;1959.0;2077.0;345
8581;Veenendaal;2021;65214;16340;36589;12285;53413;4037;1528;2509;7764;4187;3577;624;345;279;664;410;254;1014;480;534;2802;1323;1479;2660;1629;1031;788.0;591.0;259.0;262.0;1956.0;2024.0;345
8582;Veenendaal;2022;65346;16234;36513;12599;53399;4088;1580;2508;7859;4216;3643;652;357;295;682;418;264;1044;485;559;2789;1315;1474;2692;1641;1051;793.0;596.0;258.0;257.0;1946.0;2051.0;345
8583;Veenendaal;2023;65445;16135;36474;12836;53383;4099;1594;2505;7963;4261;3702;670;362;308;705;428;277;1054;489;565;2761;1294;1467;2773;1688;1085;787.0;613.0;267.0;258.0;1988.0;2044.0;345
8584;Veenendaal;2024;65579;16042;36380;13157;53376;4087;1584;2503;8116;4330;3786;677;368;309;727;436;291;1083;497;586;2754;1293;1461;2875;1736;1139;783.0;624.0;266.0;260.0;2000.0;2037.0;345
8585;Veenendaal;2025;65716;15972;36196;13548;53348;4162;1615;2547;8206;4377;3829;696;373;323;738;435;303;1086;499;587;2738;1289;1449;2948;1781;1167;;;;;;;345
8586;Veere;2008;21728;5153;12475;4100;20043;1245;566;679;440;248;192;55;31;24;43;23;20;42;24;18;28;12;16;272;158;114;198.0;211.0;93.0;80.0;783.0;903.0;717
8587;Veere;2009;21611;5036;12372;4203;19841;1282;580;702;488;271;217;59;32;27;45;25;20;57;32;25;36;17;19;291;165;126;192.0;207.0;71.0;76.0;907.0;930.0;717
8588;Veere;2010;21570;4887;12367;4316;19723;1311;589;722;536;297;239;65;36;29;48;26;22;77;46;31;36;15;21;310;174;136;208.0;210.0;75.0;75.0;893.0;954.0;717
8589;Veere;2011;21508;4763;12361;4384;19584;1324;594;730;600;334;266;74;42;32;53;31;22;99;54;45;42;16;26;332;191;141;206.0;211.0;78.0;75.0;881.0;953.0;717
8590;Veere;2012;21437;4611;12238;4588;19450;1342;606;736;645;352;293;79;44;35;52;29;23;110;57;53;48;18;30;356;204;152;206.0;212.0;87.0;72.0;917.0;940.0;717
8591;Veere;2013;21426;4506;12117;4803;19334;1367;608;759;725;381;344;88;46;42;61;31;30;122;63;59;59;22;37;395;219;176;211.0;214.0;82.0;77.0;906.0;939.0;717
8592;Veere;2014;21395;4404;12003;4988;19231;1398;621;777;766;408;358;89;50;39;60;34;26;132;64;68;67;23;44;418;237;181;216.0;218.0;85.0;75.0;802.0;953.0;717
8593;Veere;2015;21255;4270;11867;5118;19019;1440;645;795;796;416;380;99;52;47;55;32;23;137;63;74;74;26;48;431;243;188;224.0;226.0;85.0;73.0;964.0;946.0;717
8594;Veere;2016;21284;4225;11800;5259;18987;1457;635;822;840;431;409;109;58;51;61;35;26;139;62;77;81;30;51;450;246;204;217.0;224.0;78.0;73.0;897.0;953.0;717
8595;Veere;2017;21227;4139;11722;5366;18882;1474;644;830;871;434;437;112;59;53;65;35;30;153;70;83;89;32;57;452;238;214;218.0;230.0;81.0;72.0;922.0;971.0;717
8596;Veere;2018;21175;4049;11670;5456;18799;1482;654;828;894;449;445;118;66;52;72;39;33;161;70;91;90;28;62;453;246;207;230.0;230.0;82.0;69.0;928.0;941.0;717
8597;Veere;2019;21177;3986;11655;5536;18746;1492;671;821;939;464;475;127;66;61;80;43;37;165;72;93;92;33;59;475;250;225;229.0;231.0;103.0;75.0;930.0;965.0;717
8598;Veere;2020;21171;3974;11572;5625;18683;1522;676;846;966;479;487;133;71;62;84;45;39;170;77;93;102;34;68;477;252;225;234.0;242.0;73.0;75.0;1011.0;971.0;717
8599;Veere;2021;21202;3956;11538;5708;18643;1557;691;866;1002;491;511;140;74;66;82;44;38;177;83;94;110;36;74;493;254;239;235.0;241.0;82.0;67.0;950.0;985.0;717
8600;Veere;2022;21178;3933;11492;5753;18567;1566;690;876;1045;513;532;147;76;71;87;46;41;191;85;106;113;42;71;507;264;243;234.0;248.0;77.0;71.0;988.0;958.0;717
8601;Veere;2023;21203;3951;11432;5820;18529;1594;699;895;1080;528;552;146;77;69;92;46;46;195;85;110;125;44;81;522;276;246;243.0;250.0;77.0;72.0;1013.0;964.0;717
8602;Veere;2024;21252;3950;11402;5900;18483;1623;719;904;1146;554;592;153;80;73;95;49;46;201;87;114;135;46;89;562;292;270;247.0;252.0;91.0;79.0;945.0;946.0;717
8603;Veere;2025;21261;3978;11297;5986;18415;1665;748;917;1181;573;608;158;81;77;101;53;48;204;88;116;141;49;92;577;302;275;;;;;;;717
8604;Veghel;2008;36838;9556;22140;5142;31499;2309;972;1337;3030;1648;1382;358;190;168;106;47;59;1330;673;657;536;270;266;700;468;232;383.0;265.0;123.0;195.0;1152.0;1167.0;860
8605;Veghel;2009;36874;9492;22107;5275;31479;2348;976;1372;3047;1663;1384;365;192;173;116;54;62;1325;671;654;533;276;257;708;470;238;375.0;277.0;139.0;187.0;1171.0;1214.0;860
8606;Veghel;2010;36885;9365;22084;5436;31449;2362;975;1387;3074;1686;1388;378;199;179;122;54;68;1307;673;634;538;278;260;729;482;247;370.0;285.0;145.0;196.0;1190.0;1239.0;860
8607;Veghel;2011;36871;9237;22042;5592;31425;2362;982;1380;3084;1673;1411;386;203;183;132;59;73;1282;665;617;552;278;274;732;468;264;368.0;292.0;144.0;193.0;1193.0;1264.0;860
8608;Veghel;2012;36835;9086;21983;5766;31348;2377;971;1406;3110;1676;1434;381;202;179;134;59;75;1253;653;600;568;276;292;774;486;288;364.0;290.0;155.0;186.0;1335.0;1262.0;860
8609;Veghel;2013;36959;8996;21931;6032;31401;2412;967;1445;3146;1697;1449;404;214;190;129;59;70;1230;640;590;584;282;302;799;502;297;365.0;307.0;138.0;182.0;1328.0;1273.0;860
8610;Veghel;2014;37032;8905;21887;6240;31413;2433;976;1457;3186;1716;1470;418;219;199;137;65;72;1213;642;571;593;280;313;825;510;315;381.0;315.0;148.0;178.0;1271.0;1295.0;860
8611;Veghel;2015;37048;8804;21806;6438;31317;2473;1000;1473;3258;1759;1499;429;221;208;146;69;77;1207;650;557;599;278;321;877;541;336;377.0;324.0;152.0;184.0;1287.0;1271.0;860
8612;Veghel;2016;37091;8730;21739;6622;31269;2496;1022;1474;3326;1765;1561;453;233;220;150;71;79;1202;649;553;615;271;344;906;541;365;379.0;316.0;140.0;183.0;1331.0;1278.0;860
8613;Veghel;2017;37171;8660;21734;6777;31294;2492;1023;1469;3385;1792;1593;468;236;232;170;82;88;1180;637;543;614;269;345;953;568;385;382.0;327.0;149.0;181.0;1375.0;1309.0;860
8614;Veghel;2018;37265;8596;21698;6971;31303;2516;1030;1486;3446;1822;1624;465;239;226;179;88;91;1177;634;543;637;276;361;988;585;403;391.0;334.0;136.0;173.0;1401.0;1289.0;860
8615;Veghel;2019;37398;8538;21715;7145;31311;2534;1038;1496;3553;1873;1680;487;247;240;193;102;91;1149;620;529;651;275;376;1073;629;444;392.0;342.0;150.0;177.0;1430.0;1329.0;860
8616;Veghel;2020;37526;8467;21711;7348;31366;2549;1047;1502;3611;1911;1700;479;240;239;198;102;96;1158;633;525;673;287;386;1103;649;454;395.0;339.0;145.0;181.0;1372.0;1313.0;860
8617;Veghel;2021;37608;8356;21692;7560;31377;2554;1047;1507;3677;1928;1749;492;249;243;203;99;104;1145;630;515;690;294;396;1147;656;491;405.0;353.0;146.0;182.0;1377.0;1327.0;860
8618;Veghel;2022;37676;8249;21694;7733;31337;2591;1062;1529;3748;1935;1813;505;252;253;211;108;103;1129;613;516;715;295;420;1188;667;521;405.0;366.0;139.0;179.0;1492.0;1354.0;860
8619;Veghel;2023;37815;8231;21684;7900;31361;2632;1084;1548;3822;1945;1877;513;251;262;237;118;119;1119;608;511;743;302;441;1210;666;544;417.0;367.0;138.0;175.0;1360.0;1359.0;860
8620;Veghel;2024;37831;8138;21606;8087;31348;2620;1074;1546;3863;1957;1906;512;243;269;253;126;127;1106;608;498;757;305;452;1235;675;560;421.0;363.0;160.0;171.0;1438.0;1325.0;860
8621;Veghel;2025;37996;8132;21531;8333;31381;2660;1106;1554;3955;2021;1934;522;248;274;262;129;133;1094;609;485;783;324;459;1294;711;583;;;;;;;860
8622;Veldhoven;2008;43865;10372;26712;6781;37583;3964;1427;2537;2318;1488;830;296;150;146;158;75;83;154;76;78;274;134;140;1436;1053;383;411.0;310.0;368.0;306.0;1703.0;1761.0;861
8623;Veldhoven;2009;43975;10269;26720;6986;37528;3956;1427;2529;2491;1580;911;313;147;166;173;83;90;194;99;95;284;140;144;1527;1111;416;413.0;319.0;388.0;304.0;1483.0;1811.0;861
8624;Veldhoven;2010;43828;10066;26550;7212;37259;3969;1445;2524;2600;1622;978;323;151;172;183;87;96;216;113;103;303;142;161;1575;1129;446;403.0;335.0;409.0;306.0;1599.0;1775.0;861
8625;Veldhoven;2011;43828;9912;26490;7426;37080;3984;1461;2523;2764;1712;1052;343;160;183;184;90;94;238;125;113;324;150;174;1675;1187;488;398.0;345.0;425.0;296.0;1501.0;1848.0;861
8626;Veldhoven;2012;43668;9680;26298;7690;36821;3963;1437;2526;2884;1778;1106;365;163;202;187;95;92;262;145;117;333;154;179;1737;1221;516;393.0;362.0;404.0;301.0;1631.0;1752.0;861
8627;Veldhoven;2013;43689;9581;26154;7954;36661;3985;1462;2523;3043;1833;1210;385;168;217;203;101;102;289;154;135;347;156;191;1819;1254;565;401.0;361.0;430.0;299.0;1706.0;1791.0;861
8628;Veldhoven;2014;43780;9489;26065;8226;36580;3998;1486;2512;3202;1929;1273;401;172;229;222;122;100;298;154;144;364;165;199;1917;1316;601;406.0;375.0;429.0;283.0;1747.0;1882.0;861
8629;Veldhoven;2015;43828;9403;25955;8470;36464;4037;1516;2521;3327;1964;1363;406;178;228;240;132;108;337;161;176;366;159;207;1978;1334;644;410.0;390.0;420.0;290.0;1681.0;1869.0;861
8630;Veldhoven;2016;43795;9335;25794;8666;36287;4011;1509;2502;3497;2068;1429;411;188;223;254;137;117;363;180;183;378;158;220;2091;1405;686;411.0;399.0;436.0;288.0;1730.0;1860.0;861
8631;Veldhoven;2017;43827;9278;25694;8855;36141;4017;1532;2485;3669;2131;1538;412;192;220;276;139;137;386;191;195;396;158;238;2199;1451;748;409.0;401.0;440.0;291.0;1762.0;1868.0;861
8632;Veldhoven;2018;43887;9209;25673;9005;36028;4057;1562;2495;3802;2176;1626;418;200;218;287;146;141;419;206;213;414;164;250;2264;1460;804;424.0;404.0;446.0;283.0;1675.0;1905.0;861
8633;Veldhoven;2019;43843;9129;25613;9101;35826;4068;1575;2493;3949;2235;1714;447;207;240;288;145;143;448;218;230;431;169;262;2335;1496;839;427.0;414.0;432.0;294.0;1720.0;1886.0;861
8634;Veldhoven;2020;43833;9103;25484;9246;35688;4058;1605;2453;4087;2294;1793;461;215;246;298;154;144;465;226;239;443;173;270;2420;1526;894;433.0;416.0;436.0;290.0;1745.0;1862.0;861
8635;Veldhoven;2021;43882;9034;25416;9432;35547;4048;1585;2463;4287;2391;1896;488;231;257;308;162;146;474;234;240;448;175;273;2569;1589;980;450.0;433.0;435.0;288.0;1726.0;1887.0;861
8636;Veldhoven;2022;43890;8993;25278;9619;35433;4027;1586;2441;4430;2446;1984;499;245;254;318;164;154;521;248;273;462;185;277;2630;1604;1026;452.0;432.0;448.0;284.0;1750.0;1852.0;861
8637;Veldhoven;2023;43976;8961;25185;9830;35307;4054;1608;2446;4615;2535;2080;514;258;256;322;161;161;522;253;269;492;188;304;2765;1675;1090;444.0;436.0;444.0;283.0;1748.0;1903.0;861
8638;Veldhoven;2024;43998;8924;25040;10034;35173;4075;1637;2438;4750;2577;2173;514;257;257;335;159;176;546;258;288;521;192;329;2834;1711;1123;458.0;434.0;440.0;291.0;1748.0;1894.0;861
8639;Veldhoven;2025;44030;8912;24872;10246;35064;4088;1661;2427;4878;2663;2215;522;265;257;353;174;179;559;265;294;537;205;332;2907;1754;1153;;;;;;;861
8640;Velsen;2008;67293;16670;39372;11251;57185;5530;2046;3484;4578;2486;2092;386;157;229;234;99;135;1287;617;670;607;302;305;2064;1311;753;644.0;646.0;271.0;266.0;2188.0;2230.0;453
8641;Velsen;2009;67265;16472;39486;11307;56962;5549;2070;3479;4754;2564;2190;402;167;235;247;111;136;1313;630;683;659;327;332;2133;1329;804;636.0;657.0;284.0;261.0;2103.0;2310.0;453
8642;Velsen;2010;67068;16309;39371;11388;56622;5566;2075;3491;4880;2605;2275;436;178;258;252;116;136;1331;636;695;697;342;355;2164;1333;831;625.0;662.0;307.0;266.0;2166.0;2290.0;453
8643;Velsen;2011;66954;16029;39539;11386;56281;5609;2124;3485;5064;2686;2378;471;189;282;260;120;140;1344;647;697;752;359;393;2237;1371;866;620.0;673.0;267.0;259.0;2283.0;2305.0;453
8644;Velsen;2012;66893;15777;39362;11754;56060;5662;2156;3506;5171;2750;2421;489;203;286;260;120;140;1329;649;680;807;379;428;2286;1399;887;619.0;658.0;274.0;247.0;2245.0;2283.0;453
8645;Velsen;2013;66851;15579;39171;12101;55797;5741;2205;3536;5313;2797;2516;530;216;314;270;125;145;1326;633;693;858;397;461;2329;1426;903;615.0;666.0;284.0;260.0;2146.0;2252.0;453
8646;Velsen;2014;66722;15321;39121;12280;55496;5774;2245;3529;5452;2856;2596;575;235;340;280;132;148;1344;639;705;879;404;475;2374;1446;928;621.0;659.0;293.0;247.0;1998.0;2261.0;453
8647;Velsen;2015;66474;15085;38995;12394;55053;5826;2264;3562;5595;2908;2687;610;247;363;285;136;149;1352;643;709;928;432;496;2420;1450;970;622.0;674.0;282.0;248.0;2124.0;2220.0;453
8648;Velsen;2016;66366;14881;38942;12543;54852;5825;2309;3516;5689;2932;2757;635;261;374;284;137;147;1352;628;724;956;445;511;2462;1461;1001;614.0;666.0;270.0;241.0;2224.0;2271.0;453
8649;Velsen;2017;66302;14690;38886;12726;54630;5846;2345;3501;5826;2990;2836;662;279;383;295;138;157;1383;629;754;962;449;513;2524;1495;1029;641.0;666.0;288.0;232.0;2152.0;2227.0;453
8650;Velsen;2018;66265;14530;38842;12893;54406;5878;2362;3516;5981;3066;2915;687;289;398;309;154;155;1385;628;757;1013;466;547;2587;1529;1058;635.0;673.0;277.0;236.0;2062.0;2231.0;453
8651;Velsen;2019;66106;14264;38772;13070;54114;5922;2394;3528;6070;3102;2968;699;297;402;323;166;157;1383;623;760;1046;472;574;2619;1544;1075;635.0;675.0;265.0;241.0;2273.0;2271.0;453
8652;Velsen;2020;66099;14115;38706;13278;53930;5981;2448;3533;6188;3161;3027;718;312;406;337;176;161;1389;618;771;1064;485;579;2680;1570;1110;649.0;664.0;256.0;228.0;2165.0;2236.0;453
8653;Velsen;2021;66049;13917;38622;13510;53723;5989;2469;3520;6337;3240;3097;737;318;419;345;186;159;1399;625;774;1106;513;593;2750;1598;1152;658.0;673.0;290.0;232.0;2084.0;2236.0;453
8654;Velsen;2022;65946;13738;38437;13771;53506;6041;2532;3509;6399;3260;3139;750;326;424;367;192;175;1386;622;764;1124;517;607;2772;1603;1169;657.0;681.0;284.0;232.0;2178.0;2242.0;453
8655;Velsen;2023;65919;13669;38195;14055;53254;6100;2567;3533;6565;3305;3260;777;335;442;382;198;184;1426;619;807;1169;530;639;2811;1623;1188;660.0;682.0;291.0;225.0;2105.0;2257.0;453
8656;Velsen;2024;65819;13546;37998;14275;53004;6130;2622;3508;6685;3385;3300;788;345;443;396;210;186;1437;619;818;1161;537;624;2903;1674;1229;660.0;688.0;283.0;211.0;2076.0;2253.0;453
8657;Velsen;2025;65699;13475;37636;14588;52687;6146;2648;3498;6866;3456;3410;804;353;451;406;209;197;1478;635;843;1176;548;628;3002;1711;1291;;;;;;;453
8658;Venlo;2008;91825;21093;55909;14823;67951;13407;5504;7903;10467;5930;4537;553;296;257;222;126;96;3958;2114;1844;2819;1459;1360;2915;1935;980;975.0;895.0;619.0;496.0;2087.0;2413.0;983
8659;Venlo;2009;91711;21129;55581;15001;67679;13405;5544;7861;10627;5942;4685;593;325;268;244;139;105;3900;2075;1825;2829;1454;1375;3061;1949;1112;962.0;921.0;642.0;497.0;2322.0;2423.0;983
8660;Venlo;2010;91809;21156;55485;15168;67594;13377;5556;7821;10838;5978;4860;628;352;276;282;152;130;3868;2056;1812;2830;1429;1401;3230;1989;1241;963.0;924.0;662.0;493.0;2332.0;2534.0;983
8661;Venlo;2011;91826;21094;55411;15321;67355;13372;5577;7795;11099;6041;5058;691;381;310;307;170;137;3858;2040;1818;2832;1408;1424;3411;2042;1369;961.0;931.0;654.0;501.0;2345.0;2531.0;983
8662;Venlo;2012;91832;21121;54899;15812;67119;13428;5684;7744;11285;6065;5220;726;398;328;315;179;136;3848;2011;1837;2821;1381;1440;3575;2096;1479;972.0;932.0;672.0;496.0;2337.0;2535.0;983
8663;Venlo;2013;91857;21041;54534;16282;66949;13471;5713;7758;11437;6105;5332;761;423;338;334;183;151;3822;1995;1827;2814;1374;1440;3706;2130;1576;960.0;956.0;672.0;473.0;2248.0;2489.0;983
8664;Venlo;2014;91830;21033;54151;16646;66659;13502;5781;7721;11669;6194;5475;792;439;353;362;206;156;3785;1983;1802;2860;1374;1486;3870;2192;1678;933.0;965.0;670.0;473.0;2291.0;2494.0;983
8665;Venlo;2015;91801;20965;53840;16996;66420;13516;5842;7674;11865;6274;5591;830;467;363;388;219;169;3748;1976;1772;2868;1371;1497;4031;2241;1790;933.0;966.0;666.0;471.0;2322.0;2503.0;983
8666;Venlo;2016;91791;21007;53420;17364;66239;13516;5900;7616;12036;6361;5675;870;482;388;401;239;162;3738;1967;1771;2840;1360;1480;4187;2313;1874;940.0;978.0;695.0;461.0;2194.0;2511.0;983
8667;Venlo;2017;91679;20973;53081;17625;65989;13507;5965;7542;12183;6430;5753;893;496;397;423;258;165;3698;1950;1748;2839;1361;1478;4330;2365;1965;936.0;979.0;665.0;474.0;2286.0;2497.0;983
8668;Venlo;2018;91630;21043;52642;17945;65825;13526;6005;7521;12279;6467;5812;922;509;413;434;268;166;3641;1935;1706;2825;1353;1472;4457;2402;2055;948.0;993.0;649.0;461.0;2272.0;2470.0;983
8669;Venlo;2019;91584;21047;52268;18269;65692;13495;6030;7465;12397;6502;5895;952;520;432;471;290;181;3577;1914;1663;2818;1339;1479;4579;2439;2140;928.0;992.0;627.0;449.0;2210.0;2447.0;983
8670;Venlo;2020;91468;20934;51937;18597;65461;13476;6093;7383;12531;6592;5939;982;541;441;501;312;189;3534;1904;1630;2798;1342;1456;4716;2493;2223;937.0;1021.0;630.0;443.0;2263.0;2459.0;983
8671;Venlo;2021;91382;20831;51703;18848;65217;13455;6128;7327;12710;6667;6043;1010;550;460;533;330;203;3530;1897;1633;2787;1343;1444;4850;2547;2303;944.0;997.0;616.0;434.0;2207.0;2451.0;983
8672;Venlo;2022;91277;20642;51511;19124;65043;13439;6149;7290;12795;6694;6101;1036;562;474;550;339;211;3494;1895;1599;2744;1309;1435;4971;2589;2382;971.0;1021.0;605.0;437.0;2261.0;2406.0;983
8673;Venlo;2023;91261;20600;51256;19405;64900;13406;6188;7218;12955;6748;6207;1061;568;493;567;354;213;3467;1884;1583;2736;1294;1442;5124;2648;2476;982.0;1033.0;630.0;444.0;2167.0;2444.0;983
8674;Venlo;2024;91125;20552;50851;19722;64602;13509;6288;7221;13014;6773;6241;1060;573;487;580;359;221;3412;1860;1552;2742;1296;1446;5220;2685;2535;973.0;1053.0;606.0;427.0;2172.0;2407.0;983
8675;Venlo;2025;90998;20527;50471;20000;64392;13481;6342;7139;13125;6764;6361;1065;572;493;626;391;235;3376;1832;1544;2721;1283;1438;5337;2686;2651;;;;;;;983
8676;Venray;2008;39083;9938;23565;5580;32308;3321;1316;2005;3454;1975;1479;313;172;141;208;134;74;1121;593;528;754;369;385;1058;707;351;388.0;300.0;173.0;196.0;1182.0;1307.0;984
8677;Venray;2009;39030;9808;23458;5764;32202;3306;1281;2025;3522;1997;1525;325;181;144;215;139;76;1141;593;548;761;366;395;1080;718;362;365.0;310.0;195.0;194.0;1086.0;1304.0;984
8678;Venray;2010;38876;9710;23226;5940;32061;3279;1262;2017;3536;1990;1546;338;191;147;230;147;83;1137;587;550;756;362;394;1075;703;372;365.0;313.0;181.0;180.0;1225.0;1323.0;984
8679;Venray;2011;38836;9604;23127;6105;31977;3272;1275;1997;3587;2000;1587;346;195;151;234;150;84;1166;582;584;761;367;394;1080;706;374;351.0;333.0;188.0;182.0;1282.0;1332.0;984
8680;Venray;2012;38812;9471;22980;6361;31936;3219;1235;1984;3657;2029;1628;366;208;158;247;160;87;1165;574;591;782;374;408;1097;713;384;355.0;338.0;172.0;179.0;1309.0;1365.0;984
8681;Venray;2013;38772;9333;22873;6566;31880;3193;1226;1967;3699;2034;1665;384;219;165;251;162;89;1163;564;599;796;374;422;1105;715;390;357.0;341.0;188.0;172.0;1358.0;1386.0;984
8682;Venray;2014;38781;9257;22760;6764;31835;3188;1236;1952;3758;2064;1694;399;231;168;265;169;96;1183;567;616;790;374;416;1121;723;398;359.0;347.0;197.0;167.0;1357.0;1358.0;984
8683;Venray;2015;38829;9127;22658;7044;31808;3204;1242;1962;3817;2077;1740;411;237;174;275;176;99;1194;569;625;796;376;420;1141;719;422;362.0;354.0;168.0;172.0;1347.0;1388.0;984
8684;Venray;2016;38793;8974;22587;7232;31782;3158;1225;1933;3853;2125;1728;421;242;179;284;190;94;1191;573;618;782;378;404;1175;742;433;373.0;368.0;187.0;165.0;1354.0;1376.0;984
8685;Venray;2017;38803;8885;22494;7424;31778;3156;1239;1917;3869;2112;1757;424;247;177;300;195;105;1180;566;614;778;368;410;1187;736;451;372.0;377.0;181.0;159.0;1414.0;1410.0;984
8686;Venray;2018;38828;8821;22358;7649;31752;3173;1251;1922;3903;2142;1761;433;258;175;309;205;104;1181;564;617;782;371;411;1198;744;454;378.0;385.0;167.0;153.0;1383.0;1428.0;984
8687;Venray;2019;38792;8657;22325;7810;31689;3170;1274;1896;3933;2154;1779;446;271;175;329;216;113;1189;563;626;763;365;398;1206;739;467;381.0;392.0;185.0;159.0;1465.0;1389.0;984
8688;Venray;2020;38885;8536;22380;7969;31706;3183;1299;1884;3996;2187;1809;453;276;177;351;229;122;1200;562;638;761;363;398;1231;757;474;393.0;390.0;171.0;150.0;1451.0;1449.0;984
8689;Venray;2021;38917;8408;22423;8086;31714;3180;1306;1874;4023;2212;1811;470;286;184;362;238;124;1178;551;627;741;355;386;1272;782;490;410.0;402.0;173.0;149.0;1360.0;1423.0;984
8690;Venray;2022;38893;8329;22308;8256;31683;3142;1279;1863;4068;2237;1831;473;287;186;376;249;127;1163;542;621;739;364;375;1317;795;522;416.0;409.0;176.0;155.0;1485.0;1446.0;984
8691;Venray;2023;38962;8292;22247;8423;31675;3147;1262;1885;4140;2257;1883;490;298;192;385;257;128;1148;529;619;749;365;384;1368;808;560;412.0;409.0;182.0;147.0;1461.0;1440.0;984
8692;Venray;2024;39024;8306;22089;8629;31692;3132;1258;1874;4200;2293;1907;508;300;208;404;264;140;1134;531;603;746;360;386;1408;838;570;434.0;430.0;166.0;149.0;1459.0;1416.0;984
8693;Venray;2025;39092;8335;21949;8808;31691;3155;1258;1897;4246;2314;1932;518;308;210;421;275;146;1129;538;591;751;357;394;1427;836;591;;;;;;;984
8694;Vianen;2008;19561;4956;12034;2571;16735;1258;459;799;1568;838;730;290;154;136;109;54;55;209;93;116;558;284;274;402;253;149;211.0;129.0;61.0;85.0;700.0;901.0;620
8695;Vianen;2009;19418;4853;11901;2664;16596;1220;451;769;1602;878;724;289;157;132;110;54;56;219;105;114;556;288;268;428;274;154;206.0;130.0;65.0;82.0;787.0;868.0;620
8696;Vianen;2010;19399;4800;11820;2779;16559;1237;458;779;1603;863;740;287;156;131;112;56;56;216;102;114;566;293;273;422;256;166;203.0;137.0;67.0;85.0;772.0;841.0;620
8697;Vianen;2011;19380;4736;11755;2889;16506;1232;456;776;1642;875;767;289;156;133;114;55;59;228;110;118;578;296;282;433;258;175;192.0;135.0;71.0;83.0;827.0;898.0;620
8698;Vianen;2012;19355;4666;11623;3066;16489;1230;455;775;1636;868;768;278;148;130;110;55;55;229;107;122;577;295;282;442;263;179;199.0;142.0;66.0;85.0;791.0;868.0;620
8699;Vianen;2013;19317;4597;11508;3212;16415;1239;462;777;1663;889;774;281;154;127;116;60;56;227;105;122;593;307;286;446;263;183;193.0;146.0;66.0;82.0;819.0;875.0;620
8700;Vianen;2014;19295;4518;11438;3339;16370;1244;471;773;1681;905;776;281;158;123;116;60;56;242;114;128;586;303;283;456;270;186;189.0;147.0;65.0;78.0;789.0;900.0;620
8701;Vianen;2015;19216;4415;11340;3461;16283;1218;458;760;1715;920;795;284;160;124;111;59;52;254;120;134;595;304;291;471;277;194;192.0;151.0;65.0;81.0;807.0;886.0;620
8702;Vianen;2016;19165;4338;11249;3578;16241;1212;445;767;1712;915;797;277;157;120;110;58;52;249;115;134;607;306;301;469;279;190;194.0;157.0;62.0;70.0;808.0;877.0;620
8703;Vianen;2017;19127;4324;11121;3682;16195;1195;441;754;1737;912;825;287;158;129;106;57;49;248;113;135;612;302;310;484;282;202;186.0;159.0;62.0;76.0;852.0;874.0;620
8704;Vianen;2018;19122;4283;11047;3792;16142;1219;455;764;1761;927;834;286;156;130;110;61;49;258;122;136;608;293;315;499;295;204;188.0;162.0;68.0;78.0;833.0;857.0;620
8705;Vianen;2019;19116;4257;10996;3863;16116;1230;464;766;1770;935;835;277;152;125;107;59;48;247;120;127;625;297;328;514;307;207;193.0;170.0;64.0;76.0;827.0;883.0;620
8706;Vianen;2020;19075;4196;10958;3921;16062;1233;469;764;1780;947;833;271;156;115;108;57;51;237;122;115;635;297;338;529;315;214;188.0;169.0;68.0;73.0;797.0;880.0;620
8707;Vianen;2021;19008;4112;10907;3989;15981;1249;476;773;1778;951;827;265;153;112;112;60;52;246;130;116;625;296;329;530;312;218;188.0;167.0;80.0;71.0;770.0;896.0;620
8708;Vianen;2022;18914;4006;10866;4042;15850;1249;478;771;1815;981;834;268;153;115;112;63;49;247;127;120;628;300;328;560;338;222;188.0;172.0;59.0;75.0;746.0;853.0;620
8709;Vianen;2023;18809;3935;10767;4107;15719;1254;468;786;1836;970;866;263;152;111;118;57;61;254;124;130;633;301;332;568;336;232;192.0;178.0;70.0;72.0;795.0;863.0;620
8710;Vianen;2024;18755;3881;10720;4154;15621;1277;504;773;1857;986;871;262;154;108;121;61;60;257;128;129;637;298;339;580;345;235;197.0;176.0;66.0;67.0;811.0;868.0;620
8711;Vianen;2025;18720;3861;10636;4223;15547;1288;514;774;1885;1012;873;262;164;98;127;65;62;270;133;137;634;299;335;592;351;241;;;;;;;620
8712;Vlaardingen;2008;72714;16052;43871;12791;55051;5274;2199;3075;12389;7035;5354;1467;756;711;1327;862;465;4466;2303;2163;1746;877;869;3383;2237;1146;799.0;824.0;388.0;514.0;3428.0;3026.0;622
8713;Vlaardingen;2009;72973;16208;43969;12796;54772;5369;2219;3150;12832;7172;5660;1541;771;770;1315;834;481;4548;2320;2228;1874;941;933;3554;2306;1248;796.0;813.0;417.0;510.0;3406.0;3036.0;622
8714;Vlaardingen;2010;73244;16259;44130;12855;54572;5395;2217;3178;13277;7364;5913;1605;786;819;1344;841;503;4628;2371;2257;1996;983;1013;3704;2383;1321;803.0;827.0;424.0;517.0;3192.0;3030.0;622
8715;Vlaardingen;2011;73295;16303;44188;12804;54255;5431;2212;3219;13609;7458;6151;1672;816;856;1364;840;524;4664;2374;2290;2084;1016;1068;3825;2412;1413;797.0;813.0;453.0;510.0;3350.0;3055.0;622
8716;Vlaardingen;2012;73523;16334;43970;13219;54078;5521;2245;3276;13924;7516;6408;1726;813;913;1394;845;549;4711;2384;2327;2180;1060;1120;3913;2414;1499;796.0;803.0;455.0;498.0;3392.0;3001.0;622
8717;Vlaardingen;2013;73870;16427;43913;13530;54032;5532;2220;3312;14306;7637;6669;1781;817;964;1419;839;580;4748;2400;2348;2307;1098;1209;4051;2483;1568;800.0;805.0;444.0;511.0;3271.0;3017.0;622
8718;Vlaardingen;2014;74058;16390;43867;13801;53832;5642;2248;3394;14584;7682;6902;1856;837;1019;1433;841;592;4755;2387;2368;2388;1115;1273;4152;2502;1650;814.0;796.0;445.0;493.0;3304.0;3028.0;622
8719;Vlaardingen;2015;74311;16468;43843;14000;53784;5700;2282;3418;14827;7718;7109;1897;858;1039;1450;822;628;4745;2370;2375;2492;1152;1340;4243;2516;1727;806.0;793.0;443.0;488.0;3152.0;2978.0;622
8720;Vlaardingen;2016;74460;16515;43788;14157;53612;5829;2356;3473;15019;7746;7273;1909;863;1046;1461;802;659;4784;2378;2406;2551;1174;1377;4314;2529;1785;799.0;801.0;442.0;485.0;3326.0;2960.0;622
8721;Vlaardingen;2017;74787;16579;43871;14337;53606;5909;2385;3524;15272;7812;7460;1951;864;1087;1475;796;679;4806;2388;2418;2622;1199;1423;4418;2565;1853;804.0;801.0;440.0;474.0;3258.0;2996.0;622
8722;Vlaardingen;2018;75022;16616;43860;14546;53542;5966;2409;3557;15514;7881;7633;1981;861;1120;1463;796;667;4814;2394;2420;2716;1250;1466;4540;2580;1960;806.0;791.0;456.0;481.0;3084.0;2989.0;622
8723;Vlaardingen;2019;75116;16556;43801;14759;53472;5991;2426;3565;15653;7947;7706;2007;882;1125;1474;801;673;4768;2396;2372;2794;1269;1525;4610;2599;2011;795.0;797.0;452.0;465.0;3216.0;2970.0;622
8724;Vlaardingen;2020;75349;16631;43825;14893;53422;6026;2434;3592;15901;8036;7865;2049;911;1138;1494;815;679;4752;2382;2370;2886;1303;1583;4720;2625;2095;805.0;815.0;444.0;475.0;3252.0;2969.0;622
8725;Vlaardingen;2021;75595;16641;43834;15120;53348;6073;2466;3607;16174;8114;8060;2098;923;1175;1511;816;695;4745;2385;2360;2997;1332;1665;4823;2658;2165;809.0;807.0;435.0;457.0;3248.0;3004.0;622
8726;Vlaardingen;2022;75826;16642;43841;15343;53296;6157;2504;3653;16373;8167;8206;2120;932;1188;1518;798;720;4768;2393;2375;3081;1367;1714;4886;2677;2209;835.0;804.0;454.0;470.0;2935.0;2965.0;622
8727;Vlaardingen;2023;75817;16694;43541;15582;53122;6165;2500;3665;16530;8208;8322;2125;938;1187;1526;800;726;4787;2396;2391;3129;1365;1764;4963;2709;2254;812.0;827.0;449.0;453.0;3019.0;2967.0;622
8728;Vlaardingen;2024;75857;16723;43427;15707;52954;6218;2529;3689;16685;8218;8467;2154;941;1213;1532;802;730;4753;2370;2383;3209;1381;1828;5037;2724;2313;804.0;821.0;426.0;451.0;2824.0;2949.0;622
8729;Vlaardingen;2025;75695;16664;43179;15852;52666;6269;2547;3722;16760;8218;8542;2180;942;1238;1522;802;720;4696;2346;2350;3275;1412;1863;5087;2716;2371;;;;;;;622
8730;Vlagtwedde;2008;16385;3606;9573;3206;14820;1008;412;596;557;365;192;58;29;29;22;14;8;57;32;25;19;10;9;401;280;121;143.0;173.0;57.0;199.0;982.0;918.0;48
8731;Vlagtwedde;2009;16279;3563;9528;3188;14679;994;388;606;606;389;217;64;33;31;29;18;11;64;39;25;26;14;12;423;285;138;142.0;166.0;57.0;194.0;980.0;921.0;48
8732;Vlagtwedde;2010;16177;3503;9465;3209;14509;1000;390;610;668;406;262;77;36;41;36;21;15;77;47;30;41;21;20;437;281;156;140.0;169.0;61.0;189.0;982.0;907.0;48
8733;Vlagtwedde;2011;16096;3422;9434;3240;14370;996;386;610;730;425;305;85;39;46;37;22;15;97;56;41;51;26;25;460;282;178;140.0;169.0;75.0;191.0;1027.0;938.0;48
8734;Vlagtwedde;2012;16041;3381;9299;3361;14276;987;389;598;778;458;320;85;41;44;47;28;19;108;58;50;52;27;25;486;304;182;141.0;173.0;61.0;191.0;1005.0;942.0;48
8735;Vlagtwedde;2013;15945;3345;9170;3430;14114;1007;378;629;824;475;349;81;38;43;47;22;25;130;69;61;57;28;29;509;318;191;137.0;171.0;65.0;186.0;1036.0;915.0;48
8736;Vlagtwedde;2014;15913;3295;9141;3477;14029;1022;384;638;862;474;388;88;39;49;59;31;28;142;71;71;57;25;32;516;308;208;141.0;169.0;63.0;188.0;1006.0;925.0;48
8737;Vlagtwedde;2015;15843;3240;9047;3556;13920;1027;384;643;896;486;410;87;46;41;71;32;39;145;73;72;55;24;31;538;311;227;133.0;178.0;71.0;182.0;997.0;906.0;48
8738;Vlagtwedde;2016;15780;3178;9013;3589;13799;1040;396;644;941;505;436;98;51;47;64;31;33;153;79;74;62;27;35;564;317;247;133.0;169.0;71.0;177.0;977.0;884.0;48
8739;Vlagtwedde;2017;15732;3160;8952;3620;13677;1075;432;643;980;513;467;112;53;59;70;33;37;168;92;76;69;29;40;561;306;255;134.0;175.0;64.0;183.0;966.0;897.0;48
8740;Vlagtwedde;2018;15643;3117;8845;3681;13578;1067;422;645;998;530;468;119;55;64;81;40;41;183;108;75;68;35;33;547;292;255;134.0;181.0;65.0;178.0;960.0;901.0;48
8741;Vlagtwedde;2019;15543;3089;8750;3704;13432;1076;429;647;1035;555;480;121;57;64;77;38;39;198;114;84;71;40;31;568;306;262;128.0;173.0;62.0;176.0;993.0;874.0;48
8742;Vlagtwedde;2020;15503;3075;8693;3735;13326;1100;439;661;1077;553;524;130;58;72;81;39;42;211;117;94;68;40;28;587;299;288;131.0;173.0;64.0;182.0;956.0;884.0;48
8743;Vlagtwedde;2021;15413;3041;8549;3823;13239;1111;454;657;1063;559;504;128;58;70;78;41;37;217;120;97;66;41;25;574;299;275;131.0;176.0;65.0;165.0;951.0;901.0;48
8744;Vlagtwedde;2022;15319;2965;8459;3895;13132;1100;458;642;1087;577;510;133;60;73;81;41;40;216;126;90;64;37;27;593;313;280;129.0;180.0;80.0;170.0;943.0;849.0;48
8745;Vlagtwedde;2023;15282;2978;8341;3963;13066;1121;474;647;1095;573;522;131;57;74;81;41;40;221;130;91;74;35;39;588;310;278;125.0;182.0;62.0;157.0;954.0;855.0;48
8746;Vlagtwedde;2024;15232;2915;8299;4018;12964;1132;490;642;1136;597;539;131;58;73;87;47;40;241;136;105;82;37;45;595;319;276;134.0;185.0;62.0;169.0;924.0;865.0;48
8747;Vlagtwedde;2025;15134;2911;8150;4073;12844;1136;495;641;1154;610;544;126;60;66;91;50;41;234;137;97;86;39;47;617;324;293;;;;;;;48
8748;Vlieland;2008;1069;262;644;163;950;93;45;48;26;17;9;5;3;2;3;3;0;0;0;0;3;1;2;15;10;5;11.0;8.0;1.0;5.0;69.0;80.0;96
8749;Vlieland;2009;1057;259;633;165;946;89;39;50;22;16;6;4;2;2;5;5;0;1;1;0;3;1;2;9;7;2;11.0;8.0;3.0;4.0;55.0;85.0;96
8750;Vlieland;2010;1029;246;613;170;922;87;35;52;20;12;8;4;2;2;4;4;0;1;0;1;3;1;2;8;5;3;10.0;9.0;1.0;4.0;62.0;72.0;96
8751;Vlieland;2011;1017;239;605;173;906;83;34;49;28;18;10;6;3;3;4;4;0;1;0;1;3;2;1;14;9;5;9.0;8.0;2.0;4.0;58.0;73.0;96
8752;Vlieland;2012;1001;234;585;182;897;79;33;46;25;17;8;7;3;4;4;4;0;2;1;1;3;3;0;9;6;3;8.0;9.0;4.0;4.0;61.0;77.0;96
8753;Vlieland;2013;984;220;572;192;883;80;34;46;21;14;7;7;3;4;3;3;0;0;0;0;3;2;1;8;6;2;8.0;9.0;3.0;3.0;61.0;74.0;96
8754;Vlieland;2014;970;209;570;191;868;80;33;47;22;15;7;5;3;2;4;4;0;1;0;1;3;1;2;9;7;2;8.0;9.0;2.0;3.0;70.0;80.0;96
8755;Vlieland;2015;958;196;567;195;854;78;30;48;26;20;6;6;4;2;4;4;0;2;1;1;3;1;2;11;10;1;8.0;10.0;2.0;3.0;67.0;64.0;96
8756;Vlieland;2016;958;187;572;199;848;77;32;45;33;22;11;7;3;4;6;5;1;5;3;2;3;1;2;12;10;2;8.0;8.0;2.0;5.0;60.0;67.0;96
8757;Vlieland;2017;948;181;556;211;841;74;30;44;33;23;10;8;3;5;7;6;1;3;3;0;3;1;2;12;10;2;8.0;10.0;2.0;4.0;72.0;68.0;96
8758;Vlieland;2018;948;185;538;225;842;71;30;41;35;24;11;9;4;5;6;5;1;3;3;0;5;2;3;12;10;2;9.0;10.0;2.0;3.0;69.0;75.0;96
8759;Vlieland;2019;940;183;527;230;831;72;32;40;37;25;12;11;5;6;6;5;1;5;4;1;4;2;2;11;9;2;7.0;10.0;5.0;3.0;57.0;60.0;96
8760;Vlieland;2020;936;170;527;239;826;68;29;39;42;25;17;14;6;8;5;4;1;6;4;2;9;4;5;8;7;1;7.0;11.0;3.0;3.0;61.0;75.0;96
8761;Vlieland;2021;918;158;519;241;820;60;26;34;38;25;13;12;6;6;5;4;1;7;5;2;7;4;3;7;6;1;8.0;10.0;1.0;4.0;63.0;68.0;96
8762;Vlieland;2022;908;157;504;247;804;61;29;32;43;25;18;13;7;6;5;3;2;7;5;2;7;4;3;11;6;5;8.0;12.0;1.0;3.0;53.0;66.0;96
8763;Vlieland;2023;889;151;496;242;787;53;24;29;49;30;19;14;7;7;6;4;2;7;5;2;8;5;3;14;9;5;8.0;11.0;4.0;5.0;60.0;68.0;96
8764;Vlieland;2024;877;147;489;241;781;48;20;28;48;30;18;15;8;7;6;4;2;5;4;1;8;5;3;14;9;5;9.0;12.0;1.0;4.0;66.0;75.0;96
8765;Vlieland;2025;862;144;472;246;764;51;27;24;47;34;13;12;8;4;9;7;2;6;5;1;10;7;3;10;7;3;;;;;;;96
8766;Vlissingen;2008;45183;9832;27456;7895;35244;5238;2347;2891;4701;2723;1978;790;400;390;683;392;291;493;267;226;970;469;501;1765;1195;570;489.0;448.0;307.0;254.0;1991.0;1955.0;718
8767;Vlissingen;2009;45318;9894;27372;8052;35324;5216;2339;2877;4778;2736;2042;793;401;392;668;386;282;529;280;249;976;475;501;1812;1194;618;485.0;452.0;316.0;266.0;1965.0;1960.0;718
8768;Vlissingen;2010;45410;9902;27287;8221;35308;5215;2365;2850;4887;2737;2150;819;403;416;661;369;292;589;304;285;991;483;508;1827;1178;649;488.0;457.0;330.0;257.0;2028.0;1956.0;718
8769;Vlissingen;2011;45592;9932;27282;8378;35378;5249;2402;2847;4965;2758;2207;800;398;402;656;376;280;621;311;310;1006;472;534;1882;1201;681;488.0;456.0;356.0;259.0;1988.0;1989.0;718
8770;Vlissingen;2012;45723;9951;27069;8703;35371;5285;2414;2871;5067;2770;2297;809;405;404;655;372;283;665;331;334;1029;481;548;1909;1181;728;476.0;477.0;332.0;250.0;1954.0;1962.0;718
8771;Vlissingen;2013;45801;9919;26885;8997;35336;5272;2427;2845;5193;2816;2377;814;408;406;671;389;282;694;344;350;1044;475;569;1970;1200;770;488.0;470.0;340.0;259.0;1970.0;1964.0;718
8772;Vlissingen;2014;45911;9913;26815;9183;35369;5269;2433;2836;5273;2833;2440;810;408;402;668;384;284;735;351;384;1067;474;593;1993;1216;777;488.0;472.0;364.0;249.0;2075.0;1946.0;718
8773;Vlissingen;2015;46175;9970;26779;9426;35477;5279;2454;2825;5419;2899;2520;820;412;408;672;389;283;768;376;392;1095;484;611;2064;1238;826;481.0;480.0;333.0;241.0;2012.0;1982.0;718
8774;Vlissingen;2016;46304;9969;26741;9594;35480;5316;2473;2843;5508;2935;2573;820;421;399;676;389;287;815;402;413;1112;491;621;2085;1232;853;489.0;474.0;331.0;241.0;2026.0;1978.0;718
8775;Vlissingen;2017;46462;10021;26740;9701;35495;5346;2488;2858;5621;2987;2634;828;421;407;681;389;292;841;420;421;1123;502;621;2148;1255;893;476.0;471.0;335.0;249.0;2010.0;1952.0;718
8776;Vlissingen;2018;46615;10085;26675;9855;35564;5368;2483;2885;5683;2999;2684;828;419;409;679;378;301;870;432;438;1139;509;630;2167;1261;906;484.0;473.0;337.0;235.0;2028.0;1956.0;718
8777;Vlissingen;2019;46807;10122;26659;10026;35568;5415;2523;2892;5824;3064;2760;851;428;423;700;392;308;872;438;434;1159;515;644;2242;1291;951;475.0;486.0;344.0;242.0;2126.0;1965.0;718
8778;Vlissingen;2020;47064;10166;26727;10171;35696;5458;2539;2919;5910;3111;2799;849;436;413;708;399;309;887;439;448;1185;524;661;2281;1313;968;479.0;486.0;326.0;232.0;2022.0;1982.0;718
8779;Vlissingen;2021;47195;10204;26638;10353;35712;5498;2570;2928;5985;3135;2850;850;436;414;716;413;303;942;466;476;1202;533;669;2275;1287;988;486.0;482.0;321.0;236.0;1978.0;1976.0;718
8780;Vlissingen;2022;47288;10118;26696;10474;35707;5491;2562;2929;6090;3167;2923;851;438;413;707;413;294;966;473;493;1221;534;687;2345;1309;1036;492.0;491.0;321.0;239.0;1965.0;1959.0;718
8781;Vlissingen;2023;47378;10123;26627;10628;35668;5496;2568;2928;6214;3238;2976;847;432;415;714;415;299;1003;485;518;1221;528;693;2429;1378;1051;494.0;500.0;315.0;235.0;1946.0;1975.0;718
8782;Vlissingen;2024;47432;10118;26561;10753;35596;5548;2593;2955;6288;3271;3017;843;432;411;718;422;296;1009;486;523;1238;526;712;2480;1405;1075;489.0;512.0;332.0;226.0;2025.0;1990.0;718
8783;Vlissingen;2025;47550;10131;26535;10884;35563;5584;2634;2950;6403;3312;3091;853;437;416;730;440;290;1030;495;535;1257;524;733;2533;1416;1117;;;;;;;718
8784;Vlist;2008;9578;2498;5576;1504;8975;376;116;260;227;136;91;19;9;10;9;2;7;21;9;12;23;13;10;155;103;52;91.0;77.0;21.0;31.0;204.0;340.0;623
8785;Vlist;2009;9449;2423;5506;1520;8832;380;116;264;237;142;95;21;11;10;10;2;8;23;13;10;31;16;15;152;100;52;90.0;76.0;22.0;29.0;387.0;343.0;623
8786;Vlist;2010;9501;2394;5520;1587;8826;399;120;279;276;155;121;27;11;16;13;3;10;29;15;14;40;19;21;167;107;60;87.0;82.0;26.0;30.0;366.0;351.0;623
8787;Vlist;2011;9520;2320;5570;1630;8812;396;115;281;312;170;142;35;17;18;17;4;13;37;19;18;45;20;25;178;110;68;85.0;81.0;27.0;32.0;262.0;343.0;623
8788;Vlist;2012;9438;2238;5503;1697;8707;397;114;283;334;182;152;37;18;19;18;4;14;41;20;21;50;23;27;188;117;71;88.0;81.0;24.0;29.0;236.0;334.0;623
8789;Vlist;2013;9343;2171;5404;1768;8580;395;116;279;368;190;178;45;21;24;21;2;19;48;19;29;60;28;32;194;120;74;84.0;81.0;25.0;30.0;241.0;319.0;623
8790;Vlist;2014;9264;2122;5323;1819;8461;396;113;283;407;208;199;54;25;29;21;1;20;59;23;36;66;30;36;207;129;78;82.0;87.0;21.0;29.0;228.0;333.0;623
8791;Vlist;2015;9146;2040;5241;1865;8329;407;120;287;410;206;204;57;28;29;22;2;20;62;24;38;68;30;38;201;122;79;82.0;86.0;23.0;29.0;378.0;308.0;623
8792;Vlist;2016;9209;2012;5292;1905;8350;417;120;297;442;214;228;67;33;34;19;3;16;71;29;42;74;31;43;211;118;93;89.0;91.0;24.0;28.0;382.0;331.0;623
8793;Vlist;2017;9255;1995;5319;1941;8346;433;130;303;476;230;246;70;33;37;24;7;17;83;37;46;84;35;49;215;118;97;88.0;90.0;24.0;29.0;381.0;336.0;623
8794;Vlist;2018;9295;1975;5334;1986;8367;433;127;306;495;240;255;72;33;39;23;6;17;86;41;45;87;35;52;227;125;102;86.0;91.0;29.0;29.0;258.0;318.0;623
8795;Vlist;2019;9231;1926;5271;2034;8266;447;133;314;518;248;270;76;30;46;31;10;21;90;43;47;86;35;51;235;130;105;87.0;93.0;19.0;28.0;253.0;321.0;623
8796;Vlist;2020;9148;1862;5236;2050;8175;449;133;316;524;253;271;77;30;47;31;8;23;100;48;52;84;34;50;232;133;99;89.0;90.0;26.0;27.0;368.0;315.0;623
8797;Vlist;2021;9199;1818;5293;2088;8190;455;134;321;554;270;284;89;35;54;38;10;28;104;50;54;85;33;52;238;142;96;91.0;90.0;25.0;30.0;205.0;323.0;623
8798;Vlist;2022;9078;1778;5176;2124;8058;449;137;312;571;278;293;88;33;55;44;12;32;103;50;53;96;39;57;240;144;96;87.0;95.0;25.0;26.0;343.0;324.0;623
8799;Vlist;2023;9089;1755;5156;2178;8020;452;139;313;617;309;308;94;39;55;46;17;29;111;55;56;102;41;61;264;157;107;90.0;93.0;29.0;28.0;243.0;316.0;623
8800;Vlist;2024;9014;1727;5084;2203;7951;438;138;300;625;311;314;95;38;57;48;17;31;109;54;55;103;40;63;270;162;108;91.0;96.0;24.0;27.0;252.0;294.0;623
8801;Vlist;2025;8965;1715;5025;2225;7891;438;143;295;636;318;318;101;41;60;51;18;33;111;54;57;101;40;61;272;165;107;;;;;;;623
8802;Voerendaal;2008;12764;2766;7590;2408;11078;1409;295;1114;277;154;123;21;10;11;27;8;19;17;11;6;26;12;14;186;113;73;85.0;118.0;56.0;81.0;504.0;539.0;986
8803;Voerendaal;2009;12673;2687;7495;2491;10968;1409;308;1101;296;157;139;28;13;15;28;10;18;19;10;9;32;12;20;189;112;77;87.0;126.0;69.0;78.0;513.0;578.0;986
8804;Voerendaal;2010;12561;2599;7398;2564;10850;1397;319;1078;314;156;158;36;14;22;24;6;18;31;13;18;36;14;22;187;109;78;89.0;131.0;65.0;75.0;542.0;588.0;986
8805;Voerendaal;2011;12464;2518;7329;2617;10751;1385;325;1060;328;162;166;43;17;26;26;7;19;29;13;16;39;16;23;191;109;82;93.0;131.0;58.0;78.0;600.0;574.0;986
8806;Voerendaal;2012;12434;2451;7301;2682;10726;1372;338;1034;336;171;165;51;21;30;26;10;16;35;15;20;41;18;23;183;107;76;91.0;130.0;69.0;73.0;609.0;600.0;986
8807;Voerendaal;2013;12402;2393;7241;2768;10673;1360;345;1015;369;185;184;59;21;38;28;12;16;45;17;28;44;21;23;193;114;79;99.0;135.0;67.0;72.0;577.0;589.0;986
8808;Voerendaal;2014;12350;2336;7137;2877;10609;1371;360;1011;370;183;187;63;22;41;26;12;14;48;20;28;52;24;28;181;105;76;104.0;138.0;67.0;65.0;629.0;598.0;986
8809;Voerendaal;2015;12351;2288;7150;2913;10597;1361;373;988;393;193;200;67;23;44;31;16;15;57;24;33;51;23;28;187;107;80;102.0;143.0;71.0;70.0;621.0;599.0;986
8810;Voerendaal;2016;12333;2262;7111;2960;10573;1354;386;968;406;202;204;71;28;43;34;15;19;58;24;34;54;22;32;189;113;76;106.0;138.0;63.0;70.0;580.0;603.0;986
8811;Voerendaal;2017;12275;2238;7036;3001;10526;1325;379;946;424;206;218;78;32;46;35;14;21;58;24;34;58;25;33;195;111;84;104.0;145.0;60.0;70.0;675.0;595.0;986
8812;Voerendaal;2018;12306;2240;7038;3028;10536;1325;385;940;445;221;224;86;34;52;36;15;21;64;29;35;64;31;33;195;112;83;109.0;147.0;52.0;66.0;596.0;600.0;986
8813;Voerendaal;2019;12252;2194;7017;3041;10491;1303;384;919;458;227;231;90;36;54;41;18;23;68;32;36;62;28;34;197;113;84;114.0;147.0;62.0;64.0;673.0;610.0;986
8814;Voerendaal;2020;12282;2186;7016;3080;10507;1284;376;908;491;240;251;96;42;54;44;18;26;70;34;36;76;33;43;205;113;92;114.0;155.0;55.0;61.0;734.0;608.0;986
8815;Voerendaal;2021;12363;2208;7024;3131;10574;1270;384;886;519;256;263;103;46;57;40;20;20;82;38;44;87;36;51;207;116;91;115.0;159.0;55.0;65.0;655.0;621.0;986
8816;Voerendaal;2022;12342;2194;6953;3195;10541;1252;386;866;549;280;269;103;48;55;43;21;22;95;42;53;87;37;50;221;132;89;117.0;161.0;54.0;69.0;680.0;610.0;986
8817;Voerendaal;2023;12355;2213;6910;3232;10525;1266;394;872;564;293;271;106;51;55;49;22;27;100;49;51;84;37;47;225;134;91;118.0;159.0;51.0;68.0;651.0;618.0;986
8818;Voerendaal;2024;12329;2219;6838;3272;10521;1229;367;862;579;297;282;104;46;58;54;27;27;102;51;51;90;37;53;229;136;93;121.0;163.0;57.0;58.0;658.0;617.0;986
8819;Voerendaal;2025;12328;2219;6813;3296;10510;1234;372;862;584;299;285;107;47;60;46;22;24;107;54;53;89;41;48;235;135;100;;;;;;;986
8820;Voorschoten;2008;23098;5585;13227;4286;18349;3076;1543;1533;1673;951;722;254;126;128;132;61;71;190;109;81;268;142;126;829;513;316;206.0;192.0;210.0;188.0;1191.0;1061.0;626
8821;Voorschoten;2009;23265;5536;13378;4351;18434;3070;1547;1523;1761;991;770;269;126;143;141;67;74;214;126;88;295;152;143;842;520;322;210.0;200.0;211.0;181.0;1255.0;1111.0;626
8822;Voorschoten;2010;23450;5480;13545;4425;18533;3090;1571;1519;1827;1012;815;279;132;147;135;62;73;235;133;102;306;156;150;872;529;343;217.0;199.0;232.0;188.0;1213.0;1097.0;626
8823;Voorschoten;2011;23630;5459;13732;4439;18610;3116;1584;1532;1904;1032;872;295;133;162;145;68;77;266;139;127;322;166;156;876;526;350;223.0;207.0;225.0;185.0;977.0;1130.0;626
8824;Voorschoten;2012;23535;5342;13563;4630;18517;3078;1551;1527;1940;1076;864;296;137;159;151;79;72;265;141;124;333;170;163;895;549;346;221.0;202.0;226.0;184.0;1158.0;1085.0;626
8825;Voorschoten;2013;23670;5289;13580;4801;18537;3097;1538;1559;2036;1134;902;312;144;168;155;81;74;289;157;132;350;174;176;930;578;352;228.0;204.0;232.0;181.0;1044.0;1069.0;626
8826;Voorschoten;2014;23720;5232;13569;4919;18537;3108;1537;1571;2075;1150;925;318;146;172;156;85;71;295;158;137;364;176;188;942;585;357;234.0;205.0;221.0;177.0;1004.0;1066.0;626
8827;Voorschoten;2015;23731;5176;13530;5025;18503;3107;1534;1573;2121;1167;954;319;143;176;164;88;76;304;164;140;363;173;190;971;599;372;227.0;203.0;216.0;177.0;1030.0;1076.0;626
8828;Voorschoten;2016;23749;5134;13477;5138;18494;3089;1508;1581;2166;1193;973;324;150;174;172;90;82;319;166;153;368;178;190;983;609;374;234.0;205.0;207.0;177.0;1096.0;1074.0;626
8829;Voorschoten;2017;23831;5094;13502;5235;18552;3062;1492;1570;2217;1215;1002;330;151;179;176;94;82;344;170;174;384;187;197;983;613;370;238.0;210.0;210.0;175.0;1041.0;1059.0;626
8830;Voorschoten;2018;23878;5067;13455;5356;18550;3054;1471;1583;2274;1246;1028;337;156;181;191;107;84;362;175;187;400;192;208;984;616;368;235.0;215.0;209.0;167.0;1102.0;1062.0;626
8831;Voorschoten;2019;23983;5015;13522;5446;18628;3082;1503;1579;2273;1243;1030;340;157;183;189;106;83;370;176;194;410;199;211;964;605;359;240.0;218.0;205.0;164.0;1118.0;1084.0;626
8832;Voorschoten;2020;24082;5062;13460;5560;18650;3087;1493;1594;2345;1267;1078;352;163;189;195;109;86;398;183;215;419;200;219;981;612;369;246.0;214.0;206.0;167.0;1111.0;1084.0;626
8833;Voorschoten;2021;24181;5082;13434;5665;18691;3084;1486;1598;2406;1296;1110;353;162;191;203;117;86;426;193;233;433;202;231;991;622;369;239.0;236.0;216.0;166.0;1092.0;1086.0;626
8834;Voorschoten;2022;24241;5041;13432;5768;18682;3124;1502;1622;2435;1310;1125;355;167;188;207;122;85;428;191;237;428;200;228;1017;630;387;244.0;224.0;218.0;166.0;993.0;1102.0;626
8835;Voorschoten;2023;24212;5001;13338;5873;18627;3125;1505;1620;2460;1310;1150;366;172;194;200;117;83;452;199;253;423;203;220;1019;619;400;237.0;223.0;218.0;158.0;1098.0;1100.0;626
8836;Voorschoten;2024;24289;5037;13264;5988;18618;3182;1541;1641;2489;1303;1186;374;177;197;200;116;84;460;198;262;420;200;220;1035;612;423;231.0;228.0;211.0;167.0;1119.0;1091.0;626
8837;Voorschoten;2025;24366;5029;13236;6101;18634;3197;1554;1643;2535;1338;1197;380;180;200;209;120;89;467;205;262;431;209;222;1048;624;424;;;;;;;626
8838;Voorst;2008;23394;5413;13923;4058;21472;1216;436;780;706;413;293;59;34;25;42;21;21;287;150;137;29;9;20;289;199;90;187.0;230.0;82.0;94.0;883.0;931.0;285
8839;Voorst;2009;23294;5235;13994;4065;21307;1243;463;780;744;428;316;68;37;31;45;21;24;294;151;143;31;13;18;306;206;100;179.0;227.0;83.0;93.0;808.0;939.0;285
8840;Voorst;2010;23106;5028;13984;4094;21062;1238;460;778;806;458;348;89;48;41;47;19;28;303;153;150;38;14;24;329;224;105;172.0;234.0;94.0;85.0;864.0;892.0;285
8841;Voorst;2011;23026;4856;14016;4154;20925;1255;459;796;846;483;363;100;53;47;58;27;31;296;152;144;50;15;35;342;236;106;171.0;226.0;96.0;94.0;992.0;907.0;285
8842;Voorst;2012;23061;4707;14023;4331;20864;1275;467;808;922;526;396;114;65;49;57;26;31;326;164;162;61;21;40;364;250;114;171.0;229.0;93.0;93.0;769.0;912.0;285
8843;Voorst;2013;22862;4544;13837;4481;20622;1277;459;818;963;539;424;119;68;51;56;24;32;324;164;160;71;23;48;393;260;133;172.0;234.0;100.0;92.0;793.0;899.0;285
8844;Voorst;2014;22705;4414;13726;4565;20439;1276;455;821;990;570;420;124;69;55;64;29;35;326;169;157;73;25;48;403;278;125;175.0;233.0;97.0;89.0;809.0;868.0;285
8845;Voorst;2015;22598;4263;13690;4645;20290;1270;458;812;1038;589;449;131;72;59;64;29;35;330;164;166;90;33;57;423;291;132;178.0;235.0;94.0;84.0;806.0;890.0;285
8846;Voorst;2016;22469;4146;13566;4757;20132;1253;452;801;1084;612;472;136;78;58;61;27;34;334;165;169;101;38;63;452;304;148;179.0;234.0;94.0;81.0;853.0;888.0;285
8847;Voorst;2017;22396;4066;13489;4841;20022;1263;468;795;1111;618;493;141;82;59;66;29;37;337;161;176;106;41;65;461;305;156;181.0;236.0;95.0;93.0;893.0;900.0;285
8848;Voorst;2018;22336;4007;13368;4961;19926;1245;469;776;1165;640;525;152;82;70;73;33;40;330;160;170;116;43;73;494;322;172;190.0;237.0;98.0;86.0;905.0;900.0;285
8849;Voorst;2019;22310;3959;13302;5049;19861;1260;470;790;1189;661;528;159;91;68;79;35;44;334;166;168;119;43;76;498;326;172;187.0;248.0;101.0;88.0;926.0;891.0;285
8850;Voorst;2020;22300;3903;13238;5159;19792;1277;481;796;1231;678;553;161;94;67;76;36;40;343;167;176;130;48;82;521;333;188;192.0;244.0;90.0;84.0;959.0;899.0;285
8851;Voorst;2021;22315;3856;13207;5252;19752;1262;473;789;1301;707;594;174;93;81;85;40;45;346;163;183;144;54;90;552;357;195;193.0;246.0;95.0;89.0;959.0;897.0;285
8852;Voorst;2022;22335;3828;13156;5351;19731;1295;488;807;1309;714;595;176;94;82;85;39;46;344;165;179;144;54;90;560;362;198;191.0;246.0;104.0;93.0;923.0;887.0;285
8853;Voorst;2023;22330;3778;13044;5508;19672;1314;493;821;1344;736;608;188;99;89;95;46;49;344;165;179;149;58;91;568;368;200;198.0;248.0;90.0;90.0;1022.0;867.0;285
8854;Voorst;2024;22437;3753;13011;5673;19732;1329;510;819;1376;748;628;186;100;86;100;45;55;357;171;186;147;57;90;586;375;211;198.0;252.0;96.0;87.0;981.0;913.0;285
8855;Voorst;2025;22462;3778;12912;5772;19703;1363;521;842;1396;766;630;195;107;88;102;51;51;357;170;187;150;62;88;592;376;216;;;;;;;285
8856;Vught;2008;25100;6340;14689;4071;21792;2150;669;1481;1158;668;490;131;50;81;96;53;43;93;41;52;140;52;88;698;472;226;237.0;282.0;89.0;166.0;1512.0;1379.0;865
8857;Vught;2009;25115;6310;14776;4029;21704;2119;667;1452;1292;730;562;148;55;93;100;56;44;113;50;63;169;65;104;762;504;258;237.0;272.0;99.0;167.0;1494.0;1461.0;865
8858;Vught;2010;25047;6257;14789;4001;21565;2082;653;1429;1400;793;607;158;60;98;96;54;42;123;58;65;185;69;116;838;552;286;238.0;276.0;108.0;172.0;1542.0;1493.0;865
8859;Vught;2011;24999;6202;14794;4003;21435;2074;657;1417;1490;805;685;169;62;107;103;61;42;136;59;77;205;73;132;877;550;327;236.0;272.0;108.0;181.0;1565.0;1518.0;865
8860;Vught;2012;24939;6152;14712;4075;21331;2044;652;1392;1564;825;739;166;60;106;113;68;45;158;70;88;222;73;149;905;554;351;242.0;262.0;118.0;166.0;1505.0;1510.0;865
8861;Vught;2013;24869;6066;14623;4180;21210;2012;656;1356;1647;878;769;180;68;112;130;78;52;150;77;73;242;82;160;945;573;372;255.0;266.0;118.0;171.0;1537.0;1528.0;865
8862;Vught;2014;24815;5966;14550;4299;21146;1971;656;1315;1698;908;790;180;70;110;130;80;50;168;87;81;250;81;169;970;590;380;241.0;273.0;120.0;167.0;1525.0;1529.0;865
8863;Vught;2015;24733;5925;14448;4360;20998;1964;657;1307;1771;940;831;190;74;116;138;83;55;185;90;95;259;86;173;999;607;392;251.0;270.0;110.0;170.0;1484.0;1515.0;865
8864;Vught;2016;24626;5801;14388;4437;20844;1959;673;1286;1823;950;873;190;74;116;144;83;61;192;90;102;275;89;186;1022;614;408;256.0;271.0;110.0;157.0;1552.0;1514.0;865
8865;Vught;2017;24605;5768;14347;4490;20715;1980;701;1279;1910;987;923;202;82;120;146;84;62;197;91;106;283;79;204;1082;651;431;258.0;275.0;107.0;168.0;1578.0;1536.0;865
8866;Vught;2018;24570;5784;14228;4558;20614;1970;701;1269;1986;1029;957;210;89;121;154;89;65;204;93;111;290;84;206;1128;674;454;271.0;277.0;116.0;160.0;1526.0;1552.0;865
8867;Vught;2019;24499;5751;14164;4584;20450;1991;706;1285;2058;1044;1014;220;92;128;150;83;67;224;96;128;300;89;211;1164;684;480;267.0;272.0;115.0;156.0;1638.0;1546.0;865
8868;Vught;2020;24549;5730;14168;4651;20462;1987;730;1257;2100;1068;1032;220;93;127;135;83;52;232;99;133;324;97;227;1189;696;493;267.0;270.0;110.0;163.0;1680.0;1567.0;865
8869;Vught;2021;24607;5709;14188;4710;20446;1979;738;1241;2182;1103;1079;223;96;127;150;95;55;247;102;145;333;102;231;1229;708;521;271.0;273.0;102.0;150.0;1602.0;1567.0;865
8870;Vught;2022;24594;5697;14099;4798;20389;1957;752;1205;2248;1125;1123;224;98;126;150;90;60;260;109;151;337;111;226;1277;717;560;279.0;271.0;114.0;158.0;1637.0;1574.0;865
8871;Vught;2023;24623;5667;14091;4865;20347;1946;753;1193;2330;1158;1172;228;104;124;154;94;60;270;115;155;350;114;236;1328;731;597;275.0;273.0;99.0;157.0;1625.0;1565.0;865
8872;Vught;2024;24629;5621;14065;4943;20320;1936;732;1204;2373;1165;1208;236;99;137;158;95;63;271;113;158;358;111;247;1350;747;603;270.0;279.0;118.0;157.0;1548.0;1541.0;865
8873;Vught;2025;24589;5564;13947;5078;20240;1954;756;1198;2395;1186;1209;236;104;132;155;99;56;291;120;171;367;114;253;1346;749;597;;;;;;;865
8874;Waalre;2008;16826;4192;9449;3185;14543;1542;534;1008;741;414;327;124;49;75;69;25;44;59;32;27;52;22;30;437;286;151;147.0;158.0;87.0;113.0;843.0;740.0;866
8875;Waalre;2009;16892;4140;9507;3245;14548;1562;556;1006;782;430;352;124;50;74;69;26;43;75;38;37;61;27;34;453;289;164;156.0;158.0;86.0;118.0;892.0;755.0;866
8876;Waalre;2010;16996;4081;9599;3316;14595;1577;583;994;824;441;383;132;55;77;69;23;46;85;40;45;68;28;40;470;295;175;152.0;163.0;98.0;107.0;756.0;777.0;866
8877;Waalre;2011;16962;3979;9606;3377;14502;1580;589;991;880;469;411;132;57;75;71;22;49;103;48;55;73;36;37;501;306;195;156.0;160.0;101.0;112.0;813.0;777.0;866
8878;Waalre;2012;16985;3932;9586;3467;14447;1602;607;995;936;483;453;134;55;79;78;25;53;115;55;60;84;36;48;525;312;213;151.0;164.0;107.0;108.0;808.0;781.0;866
8879;Waalre;2013;16999;3845;9623;3531;14421;1610;626;984;968;479;489;139;57;82;80;26;54;127;58;69;98;38;60;524;300;224;160.0;164.0;101.0;108.0;764.0;803.0;866
8880;Waalre;2014;16949;3807;9585;3557;14333;1605;626;979;1011;479;532;155;63;92;85;26;59;139;60;79;106;38;68;526;292;234;159.0;166.0;103.0;97.0;756.0;804.0;866
8881;Waalre;2015;16900;3746;9538;3616;14276;1596;637;959;1028;485;543;160;67;93;89;27;62;147;60;87;113;40;73;519;291;228;158.0;169.0;98.0;101.0;875.0;790.0;866
8882;Waalre;2016;16971;3728;9569;3674;14254;1643;662;981;1074;505;569;170;72;98;94;34;60;156;61;95;117;40;77;537;298;239;163.0;164.0;96.0;103.0;696.0;811.0;866
8883;Waalre;2017;16850;3639;9502;3709;14112;1635;662;973;1103;517;586;174;77;97;104;36;68;167;70;97;118;36;82;540;298;242;166.0;172.0;92.0;99.0;685.0;813.0;866
8884;Waalre;2018;16712;3592;9407;3713;13984;1605;655;950;1123;530;593;180;77;103;105;37;68;168;70;98;118;36;82;552;310;242;164.0;174.0;98.0;102.0;864.0;803.0;866
8885;Waalre;2019;16760;3560;9468;3732;13979;1612;671;941;1169;548;621;185;76;109;106;41;65;188;76;112;117;33;84;573;322;251;168.0;170.0;95.0;102.0;862.0;811.0;866
8886;Waalre;2020;16803;3555;9465;3783;13956;1635;676;959;1212;577;635;191;78;113;101;42;59;208;84;124;125;41;84;587;332;255;173.0;175.0;98.0;104.0;812.0;832.0;866
8887;Waalre;2021;16775;3512;9457;3806;13904;1647;680;967;1224;574;650;188;80;108;113;45;68;210;84;126;130;40;90;583;325;258;175.0;173.0;100.0;99.0;808.0;817.0;866
8888;Waalre;2022;16772;3505;9398;3869;13859;1642;676;966;1271;604;667;193;84;109;116;46;70;225;91;134;134;45;89;603;338;265;181.0;180.0;95.0;95.0;768.0;832.0;866
8889;Waalre;2023;16711;3479;9314;3918;13779;1619;672;947;1313;631;682;198;85;113;116;44;72;233;97;136;144;48;96;622;357;265;180.0;181.0;93.0;99.0;845.0;785.0;866
8890;Waalre;2024;16765;3473;9343;3949;13772;1640;680;960;1353;658;695;196;86;110;117;45;72;239;96;143;146;50;96;655;381;274;179.0;178.0;107.0;95.0;863.0;817.0;866
8891;Waalre;2025;16824;3521;9279;4024;13781;1657;694;963;1386;678;708;198;87;111;127;51;76;239;98;141;142;50;92;680;392;288;;;;;;;866
8892;Waalwijk;2008;45857;10763;28008;7086;39675;2953;1186;1767;3229;1791;1438;406;233;173;196;113;83;1485;748;737;244;104;140;898;593;305;440.0;369.0;186.0;243.0;1457.0;1463.0;867
8893;Waalwijk;2009;45871;10712;27833;7326;39612;2951;1188;1763;3308;1833;1475;412;239;173;201;114;87;1472;735;737;260;110;150;963;635;328;425.0;377.0;199.0;237.0;1483.0;1564.0;867
8894;Waalwijk;2010;45804;10643;27622;7539;39462;2961;1202;1759;3381;1862;1519;419;242;177;210;114;96;1470;732;738;282;125;157;1000;649;351;417.0;382.0;218.0;236.0;1462.0;1541.0;867
8895;Waalwijk;2011;45747;10482;27480;7785;39372;2931;1185;1746;3444;1898;1546;428;245;183;219;122;97;1460;733;727;294;134;160;1043;664;379;415.0;392.0;205.0;227.0;1515.0;1617.0;867
8896;Waalwijk;2012;45651;10354;27226;8071;39247;2935;1201;1734;3469;1929;1540;446;258;188;213;120;93;1445;731;714;304;133;171;1061;687;374;414.0;409.0;197.0;224.0;1580.0;1598.0;867
8897;Waalwijk;2013;45617;10257;27005;8355;39131;2925;1195;1730;3561;1979;1582;457;260;197;225;127;98;1425;721;704;329;140;189;1125;731;394;416.0;409.0;215.0;237.0;1487.0;1619.0;867
8898;Waalwijk;2014;45476;10137;26737;8602;38911;2935;1205;1730;3630;2006;1624;472;267;205;216;121;95;1401;715;686;356;146;210;1185;757;428;409.0;426.0;200.0;227.0;1719.0;1664.0;867
8899;Waalwijk;2015;45489;10063;26571;8855;38841;2954;1185;1769;3694;2033;1661;478;278;200;224;122;102;1399;705;694;374;148;226;1219;780;439;415.0;426.0;223.0;214.0;1652.0;1648.0;867
8900;Waalwijk;2016;45497;9992;26406;9099;38739;2965;1180;1785;3793;2086;1707;485;281;204;239;130;109;1402;702;700;388;152;236;1279;821;458;414.0;439.0;204.0;219.0;1628.0;1664.0;867
8901;Waalwijk;2017;45427;9933;26217;9277;38588;2964;1166;1798;3875;2108;1767;498;288;210;253;132;121;1389;701;688;417;155;262;1318;832;486;415.0;444.0;216.0;216.0;1679.0;1683.0;867
8902;Waalwijk;2018;45399;9899;26044;9456;38472;2992;1186;1806;3935;2156;1779;503;293;210;253;136;117;1378;699;679;437;163;274;1364;865;499;416.0;451.0;208.0;214.0;1771.0;1669.0;867
8903;Waalwijk;2019;45467;9816;26000;9651;38361;3048;1213;1835;4058;2222;1836;513;301;212;262;140;122;1376;709;667;453;158;295;1454;914;540;425.0;458.0;211.0;217.0;1764.0;1676.0;867
8904;Waalwijk;2020;45519;9712;25943;9864;38286;3094;1216;1878;4139;2251;1888;513;296;217;265;139;126;1389;706;683;469;166;303;1503;944;559;430.0;463.0;215.0;216.0;1711.0;1689.0;867
8905;Waalwijk;2021;45512;9620;25869;10023;38158;3114;1228;1886;4240;2299;1941;530;301;229;272;143;129;1384;696;688;478;165;313;1576;994;582;440.0;479.0;209.0;208.0;1759.0;1701.0;867
8906;Waalwijk;2022;45537;9580;25837;10120;38085;3074;1209;1865;4378;2336;2042;541;311;230;282;150;132;1399;694;705;505;171;334;1651;1010;641;441.0;483.0;216.0;215.0;1702.0;1721.0;867
8907;Waalwijk;2023;45483;9477;25760;10246;37894;3081;1206;1875;4508;2402;2106;552;316;236;296;157;139;1398;684;714;533;174;359;1729;1071;658;456.0;496.0;214.0;207.0;1772.0;1720.0;867
8908;Waalwijk;2024;45511;9457;25667;10387;37752;3125;1225;1900;4634;2469;2165;565;326;239;302;159;143;1408;691;717;557;189;368;1802;1104;698;466.0;497.0;216.0;208.0;1824.0;1695.0;867
8909;Waalwijk;2025;45621;9466;25627;10528;37766;3149;1246;1903;4706;2483;2223;559;327;232;302;166;136;1404;685;719;565;184;381;1876;1121;755;;;;;;;867
8910;Waddinxveen;2008;25686;6542;15306;3838;22411;1548;572;976;1727;942;785;220;113;107;113;51;62;281;162;119;531;253;278;582;363;219;266.0;170.0;77.0;103.0;862.0;985.0;627
8911;Waddinxveen;2009;25636;6401;15327;3908;22331;1555;579;976;1750;936;814;227;117;110;113;55;58;299;166;133;522;243;279;589;355;234;263.0;173.0;80.0;102.0;810.0;996.0;627
8912;Waddinxveen;2010;25521;6272;15209;4040;22188;1572;580;992;1761;941;820;228;123;105;115;57;58;297;167;130;528;245;283;593;349;244;262.0;182.0;83.0;94.0;885.0;981.0;627
8913;Waddinxveen;2011;25497;6169;15197;4131;22152;1552;563;989;1793;947;846;224;125;99;119;54;65;302;166;136;545;246;299;603;356;247;263.0;191.0;80.0;95.0;919.0;1002.0;627
8914;Waddinxveen;2012;25474;6073;15023;4378;22125;1563;571;992;1786;944;842;226;127;99;119;59;60;300;160;140;538;239;299;603;359;244;256.0;198.0;93.0;94.0;952.0;989.0;627
8915;Waddinxveen;2013;25495;5982;14957;4556;22087;1584;581;1003;1824;966;858;235;126;109;129;63;66;304;159;145;538;247;291;618;371;247;256.0;200.0;87.0;92.0;968.0;990.0;627
8916;Waddinxveen;2014;25527;5875;14879;4773;22071;1585;581;1004;1871;992;879;239;127;112;134;69;65;320;165;155;540;247;293;638;384;254;261.0;210.0;91.0;88.0;1028.0;1009.0;627
8917;Waddinxveen;2015;25599;5835;14869;4895;22105;1612;596;1016;1882;990;892;235;125;110;139;69;70;327;170;157;539;238;301;642;388;254;260.0;211.0;91.0;95.0;988.0;979.0;627
8918;Waddinxveen;2016;25654;5765;14825;5064;22123;1617;597;1020;1914;1005;909;241;124;117;133;70;63;328;172;156;542;238;304;670;401;269;265.0;218.0;85.0;91.0;932.0;970.0;627
8919;Waddinxveen;2017;25661;5696;14736;5229;22101;1592;583;1009;1968;1015;953;262;133;129;141;72;69;321;167;154;556;239;317;688;404;284;267.0;220.0;77.0;90.0;898.0;991.0;627
8920;Waddinxveen;2018;25603;5605;14630;5368;22031;1573;566;1007;1999;1015;984;266;134;132;157;75;82;333;170;163;550;226;324;693;410;283;279.0;229.0;88.0;95.0;947.0;962.0;627
8921;Waddinxveen;2019;25634;5594;14593;5447;21984;1621;585;1036;2029;1037;992;268;138;130;158;78;80;340;171;169;535;219;316;728;431;297;283.0;232.0;82.0;87.0;961.0;958.0;627
8922;Waddinxveen;2020;25686;5588;14503;5595;22001;1603;575;1028;2082;1049;1033;268;136;132;163;79;84;340;165;175;549;228;321;762;441;321;282.0;232.0;87.0;82.0;938.0;990.0;627
8923;Waddinxveen;2021;25693;5530;14437;5726;21981;1623;581;1042;2089;1053;1036;278;140;138;154;74;80;341;167;174;544;223;321;772;449;323;285.0;240.0;77.0;94.0;974.0;1003.0;627
8924;Waddinxveen;2022;25696;5517;14355;5824;21943;1623;581;1042;2130;1078;1052;282;138;144;159;77;82;356;179;177;544;217;327;789;467;322;286.0;243.0;86.0;84.0;935.0;988.0;627
8925;Waddinxveen;2023;25693;5513;14246;5934;21879;1663;599;1064;2151;1081;1070;279;140;139;161;77;84;368;183;185;536;207;329;807;474;333;290.0;248.0;76.0;93.0;961.0;976.0;627
8926;Waddinxveen;2024;25708;5519;14137;6052;21838;1667;583;1084;2203;1099;1104;293;146;147;164;77;87;383;192;191;539;209;330;824;475;349;295.0;250.0;83.0;82.0;1027.0;979.0;627
8927;Waddinxveen;2025;25804;5570;14093;6141;21914;1663;591;1072;2227;1095;1132;293;144;149;172;79;93;386;196;190;538;200;338;838;476;362;;;;;;;627
8928;Wageningen;2008;36011;7024;24365;4622;26828;4408;2503;1905;4775;3716;1059;353;190;163;102;54;48;210;108;102;285;158;127;3825;3206;619;383.0;324.0;820.0;548.0;1687.0;1779.0;289
8929;Wageningen;2009;36258;7034;24590;4634;26867;4431;2455;1976;4960;3835;1125;365;199;166;108;61;47;238;119;119;300;154;146;3949;3302;647;400.0;319.0;866.0;548.0;1587.0;1734.0;289
8930;Wageningen;2010;36514;7045;24786;4683;26856;4473;2452;2021;5185;3953;1232;362;198;164;133;81;52;274;132;142;311;151;160;4105;3391;714;413.0;314.0;869.0;550.0;1530.0;1720.0;289
8931;Wageningen;2011;36750;7045;24945;4760;26859;4511;2442;2069;5380;4078;1302;370;203;167;157;97;60;292;147;145;309;146;163;4252;3485;767;418.0;314.0;909.0;553.0;1471.0;1691.0;289
8932;Wageningen;2012;36997;7102;24947;4948;26851;4550;2441;2109;5596;4209;1387;379;219;160;170;106;64;307;153;154;332;158;174;4408;3573;835;424.0;313.0;929.0;560.0;1355.0;1658.0;289
8933;Wageningen;2013;37177;7122;24929;5126;26848;4576;2455;2121;5753;4278;1475;379;226;153;174;110;64;336;161;175;349;162;187;4515;3619;896;413.0;314.0;917.0;539.0;1169.0;1630.0;289
8934;Wageningen;2014;37198;7083;24878;5237;26700;4596;2460;2136;5902;4335;1567;400;227;173;181;118;63;349;169;180;358;164;194;4614;3657;957;420.0;318.0;924.0;552.0;1169.0;1586.0;289
8935;Wageningen;2015;37260;7113;24823;5324;26631;4589;2456;2133;6040;4390;1650;393;222;171;193;126;67;377;161;216;357;162;195;4720;3719;1001;416.0;319.0;912.0;548.0;1135.0;1590.0;289
8936;Wageningen;2016;37272;7112;24775;5385;26502;4576;2434;2142;6194;4462;1732;392;227;165;221;144;77;402;166;236;369;165;204;4810;3760;1050;406.0;320.0;933.0;549.0;1150.0;1570.0;289
8937;Wageningen;2017;37327;7129;24708;5490;26425;4610;2449;2161;6292;4516;1776;395;225;170;237;153;84;418;176;242;372;166;206;4870;3796;1074;410.0;328.0;909.0;544.0;1161.0;1534.0;289
8938;Wageningen;2018;37406;7148;24636;5622;26359;4628;2454;2174;6419;4589;1830;391;223;168;240;158;82;425;183;242;380;168;212;4983;3857;1126;387.0;323.0;915.0;522.0;1150.0;1520.0;289
8939;Wageningen;2019;37500;7131;24623;5746;26285;4624;2465;2159;6591;4683;1908;406;223;183;256;169;87;429;185;244;376;162;214;5124;3944;1180;379.0;337.0;933.0;523.0;1149.0;1513.0;289
8940;Wageningen;2020;37594;7082;24665;5847;26193;4657;2490;2167;6744;4747;1997;420;227;193;269;173;96;454;194;260;384;166;218;5217;3987;1230;364.0;338.0;912.0;521.0;1187.0;1502.0;289
8941;Wageningen;2021;37703;7004;24711;5988;26121;4673;2507;2166;6909;4813;2096;436;233;203;283;174;109;482;208;274;403;180;223;5305;4018;1287;351.0;333.0;916.0;524.0;1193.0;1516.0;289
8942;Wageningen;2022;37797;6881;24762;6154;26099;4677;2508;2169;7021;4873;2148;450;245;205;282;180;102;489;208;281;406;186;220;5394;4054;1340;345.0;349.0;916.0;511.0;1175.0;1485.0;289
8943;Wageningen;2023;37894;6765;24810;6319;26084;4637;2483;2154;7173;4941;2232;455;246;209;285;181;104;485;205;280;429;189;240;5519;4120;1399;335.0;352.0;907.0;491.0;1152.0;1474.0;289
8944;Wageningen;2024;37977;6701;24778;6498;26014;4671;2524;2147;7292;5009;2283;473;262;211;298;193;105;494;203;291;437;192;245;5590;4159;1431;321.0;356.0;905.0;496.0;1178.0;1473.0;289
8945;Wageningen;2025;38060;6664;24761;6635;25968;4691;2542;2149;7401;5074;2327;475;262;213;303;198;105;516;213;303;463;204;259;5644;4197;1447;;;;;;;289
8946;Wassenaar;2008;25941;6349;14111;5481;18212;5816;3728;2088;1913;1234;679;232;101;131;162;83;79;123;66;57;148;67;81;1248;917;331;156.0;284.0;868.0;631.0;1237.0;1098.0;629
8947;Wassenaar;2009;26191;6333;14334;5524;18255;5967;3870;2097;1969;1238;731;255;109;146;158;80;78;151;68;83;161;68;93;1244;913;331;171.0;274.0;886.0;640.0;1093.0;1156.0;629
8948;Wassenaar;2010;26270;6262;14432;5576;18149;6099;3988;2111;2022;1251;771;283;120;163;162;86;76;178;83;95;171;75;96;1228;887;341;174.0;275.0;922.0;638.0;902.0;1128.0;629
8949;Wassenaar;2011;26229;6143;14559;5527;17959;6215;4113;2102;2055;1244;811;296;128;168;177;90;87;196;94;102;194;81;113;1192;851;341;180.0;274.0;955.0;644.0;938.0;1136.0;629
8950;Wassenaar;2012;26250;6030;14514;5706;17821;6348;4244;2104;2081;1241;840;304;132;172;182;89;93;211;100;111;209;90;119;1175;830;345;186.0;268.0;961.0;637.0;687.0;1127.0;629
8951;Wassenaar;2013;26054;5893;14359;5802;17520;6468;4367;2101;2066;1206;860;318;138;180;181;95;86;224;102;122;228;99;129;1115;772;343;190.0;269.0;968.0;635.0;818.0;1091.0;629
8952;Wassenaar;2014;26040;5819;14328;5893;17342;6593;4491;2102;2105;1210;895;323;139;184;187;92;95;241;105;136;236;105;131;1118;769;349;198.0;268.0;957.0;642.0;787.0;1091.0;629
8953;Wassenaar;2015;25981;5721;14322;5938;17106;6714;4575;2139;2161;1226;935;336;145;191;181;91;90;256;112;144;259;112;147;1129;766;363;209.0;268.0;959.0;637.0;659.0;1066.0;629
8954;Wassenaar;2016;25837;5538;14329;5970;16827;6814;4653;2161;2196;1248;948;336;151;185;181;96;85;267;117;150;269;109;160;1143;775;368;219.0;266.0;950.0;626.0;648.0;1072.0;629
8955;Wassenaar;2017;25691;5410;14287;5994;16551;6922;4732;2190;2218;1242;976;336;150;186;185;97;88;280;125;155;280;112;168;1137;758;379;232.0;260.0;959.0;639.0;672.0;1069.0;629
8956;Wassenaar;2018;25589;5303;14244;6042;16298;7063;4820;2243;2228;1248;980;334;154;180;186;101;85;289;129;160;289;119;170;1130;745;385;243.0;263.0;945.0;627.0;731.0;1060.0;629
8957;Wassenaar;2019;25559;5144;14310;6105;16139;7172;4880;2292;2248;1238;1010;338;156;182;192;101;91;299;139;160;287;120;167;1132;722;410;251.0;254.0;943.0;638.0;663.0;1042.0;629
8958;Wassenaar;2020;25483;5034;14259;6190;15911;7292;4934;2358;2280;1264;1016;343;161;182;192;109;83;314;145;169;305;129;176;1126;720;406;263.0;263.0;955.0;646.0;679.0;1063.0;629
8959;Wassenaar;2021;25408;4945;14231;6232;15657;7423;4974;2449;2328;1279;1049;352;168;184;180;102;78;346;157;189;326;135;191;1124;717;407;267.0;261.0;940.0;624.0;658.0;1046.0;629
8960;Wassenaar;2022;25343;4823;14184;6336;15457;7541;5022;2519;2345;1269;1076;370;174;196;177;96;81;356;169;187;339;138;201;1103;692;411;276.0;265.0;948.0;610.0;660.0;1094.0;629
8961;Wassenaar;2023;25260;4743;14134;6383;15203;7689;5092;2597;2368;1284;1084;378;179;199;185;105;80;356;165;191;340;144;196;1109;691;418;290.0;274.0;966.0;633.0;779.0;1098.0;629
8962;Wassenaar;2024;25290;4684;14153;6453;15082;7783;5109;2674;2425;1305;1120;385;176;209;188;109;79;366;164;202;347;148;199;1139;708;431;298.0;271.0;958.0;616.0;724.0;1074.0;629
8963;Wassenaar;2025;25312;4601;14145;6566;14900;7954;5175;2779;2458;1314;1144;393;182;211;195;108;87;363;157;206;353;152;201;1154;715;439;;;;;;;629
8964;Waterland;2008;17321;4107;10427;2787;15468;1211;393;818;642;337;305;117;45;72;42;21;21;30;14;16;86;39;47;367;218;149;153.0;140.0;71.0;86.0;684.0;590.0;852
8965;Waterland;2009;17414;4082;10439;2893;15472;1216;400;816;726;373;353;129;53;76;57;33;24;44;18;26;105;43;62;391;226;165;149.0;144.0;73.0;90.0;660.0;595.0;852
8966;Waterland;2010;17468;4032;10454;2982;15442;1252;407;845;774;381;393;134;54;80;56;32;24;54;20;34;112;41;71;418;234;184;154.0;150.0;73.0;96.0;599.0;649.0;852
8967;Waterland;2011;17401;3922;10426;3053;15320;1261;413;848;820;399;421;142;54;88;62;36;26;61;25;36;122;42;80;433;242;191;152.0;153.0;85.0;88.0;621.0;624.0;852
8968;Waterland;2012;17398;3847;10340;3211;15254;1261;419;842;883;432;451;151;58;93;68;35;33;63;31;32;134;45;89;467;263;204;154.0;152.0;89.0;96.0;630.0;620.0;852
8969;Waterland;2013;17404;3755;10314;3335;15195;1278;431;847;931;454;477;158;57;101;65;32;33;89;42;47;137;48;89;482;275;207;156.0;153.0;94.0;82.0;604.0;643.0;852
8970;Waterland;2014;17382;3663;10273;3446;15084;1307;450;857;991;485;506;168;61;107;67;35;32;103;49;54;150;51;99;503;289;214;155.0;161.0;89.0;92.0;569.0;634.0;852
8971;Waterland;2015;17309;3594;10169;3546;14941;1325;462;863;1043;510;533;173;63;110;75;41;34;110;53;57;152;55;97;533;298;235;150.0;162.0;88.0;91.0;607.0;612.0;852
8972;Waterland;2016;17289;3573;10097;3619;14855;1365;474;891;1069;523;546;181;72;109;77;43;34;124;61;63;151;56;95;536;291;245;155.0;164.0;91.0;93.0;614.0;609.0;852
8973;Waterland;2017;17284;3532;10068;3684;14794;1353;474;879;1137;551;586;198;75;123;75;44;31;131;64;67;157;57;100;576;311;265;159.0;164.0;89.0;92.0;607.0;611.0;852
8974;Waterland;2018;17272;3515;10000;3757;14718;1377;489;888;1177;569;608;200;73;127;79;50;29;139;63;76;161;57;104;598;326;272;156.0;169.0;93.0;88.0;649.0;625.0;852
8975;Waterland;2019;17289;3478;9972;3839;14673;1402;489;913;1214;598;616;215;81;134;83;54;29;148;69;79;161;56;105;607;338;269;164.0;169.0;88.0;88.0;612.0;620.0;852
8976;Waterland;2020;17279;3470;9880;3929;14570;1435;501;934;1274;627;647;224;85;139;91;59;32;158;68;90;169;54;115;632;361;271;169.0;174.0;97.0;88.0;669.0;617.0;852
8977;Waterland;2021;17335;3475;9838;4022;14560;1447;510;937;1328;655;673;228;85;143;93;62;31;167;68;99;174;58;116;666;382;284;168.0;176.0;103.0;97.0;680.0;624.0;852
8978;Waterland;2022;17391;3487;9777;4127;14544;1477;533;944;1370;668;702;222;79;143;101;63;38;165;70;95;179;57;122;703;399;304;170.0;181.0;93.0;90.0;576.0;655.0;852
8979;Waterland;2023;17304;3460;9641;4203;14402;1499;540;959;1403;678;725;224;80;144;107;65;42;168;71;97;187;60;127;717;402;315;175.0;180.0;97.0;96.0;654.0;615.0;852
8980;Waterland;2024;17341;3494;9602;4245;14391;1511;548;963;1439;691;748;221;78;143;107;63;44;173;73;100;199;65;134;739;412;327;174.0;185.0;99.0;86.0;723.0;604.0;852
8981;Waterland;2025;17463;3531;9605;4327;14432;1541;562;979;1490;717;773;228;84;144;118;70;48;186;80;106;206;67;139;752;416;336;;;;;;;852
8982;Weert;2008;48285;11138;28918;8229;39415;4814;1640;3174;4056;2310;1746;212;112;100;367;210;157;614;329;285;1950;1031;919;913;628;285;430.0;408.0;256.0;254.0;1019.0;1274.0;988
8983;Weert;2009;48060;11011;28558;8491;39199;4803;1657;3146;4058;2302;1756;216;115;101;363;209;154;629;328;301;1928;1020;908;922;630;292;420.0;423.0;265.0;252.0;1058.0;1265.0;988
8984;Weert;2010;47867;10910;28288;8669;38973;4802;1677;3125;4092;2314;1778;241;126;115;371;212;159;649;324;325;1903;1008;895;928;644;284;409.0;438.0;262.0;240.0;1121.0;1275.0;988
8985;Weert;2011;47712;10769;28083;8860;38814;4778;1681;3097;4120;2335;1785;262;130;132;365;215;150;646;328;318;1870;999;871;977;663;314;399.0;437.0;275.0;232.0;1100.0;1320.0;988
8986;Weert;2012;47499;10577;27769;9153;38559;4790;1700;3090;4150;2349;1801;276;134;142;373;217;156;674;344;330;1834;976;858;993;678;315;397.0;457.0;280.0;241.0;1201.0;1289.0;988
8987;Weert;2013;47392;10447;27561;9384;38388;4811;1772;3039;4193;2371;1822;283;140;143;378;222;156;693;343;350;1807;969;838;1032;697;335;403.0;461.0;290.0;223.0;1289.0;1321.0;988
8988;Weert;2014;47374;10352;27436;9586;38285;4863;1827;3036;4226;2374;1852;303;151;152;381;225;156;708;349;359;1779;948;831;1055;701;354;396.0;469.0;286.0;230.0;1351.0;1323.0;988
8989;Weert;2015;47392;10252;27344;9796;38197;4896;1858;3038;4299;2417;1882;322;162;160;399;236;163;707;354;353;1775;954;821;1096;711;385;409.0;474.0;272.0;219.0;1306.0;1388.0;988
8990;Weert;2016;47303;10129;27205;9969;38055;4912;1892;3020;4336;2444;1892;351;173;178;411;241;170;705;351;354;1746;947;799;1123;732;391;396.0;483.0;304.0;219.0;1446.0;1363.0;988
8991;Weert;2017;47394;10094;27160;10140;38034;4941;1935;3006;4419;2476;1943;375;178;197;421;245;176;714;359;355;1731;935;796;1178;759;419;403.0;491.0;268.0;215.0;1291.0;1383.0;988
8992;Weert;2018;47269;9916;27019;10334;37884;4920;1945;2975;4465;2535;1930;393;189;204;437;259;178;720;374;346;1720;935;785;1195;778;417;418.0;496.0;282.0;219.0;1348.0;1347.0;988
8993;Weert;2019;47259;9835;26909;10515;37815;4922;1970;2952;4522;2590;1932;411;207;204;444;268;176;731;386;345;1699;935;764;1237;794;443;418.0;508.0;277.0;214.0;1352.0;1339.0;988
8994;Weert;2020;47250;9735;26855;10660;37711;4953;2001;2952;4586;2623;1963;428;217;211;467;284;183;744;386;358;1680;925;755;1267;811;456;429.0;505.0;264.0;211.0;1330.0;1349.0;988
8995;Weert;2021;47215;9648;26745;10822;37600;4966;2013;2953;4649;2654;1995;443;220;223;473;283;190;751;394;357;1658;911;747;1324;846;478;427.0;520.0;266.0;218.0;1352.0;1376.0;988
8996;Weert;2022;47151;9598;26562;10991;37499;5013;2058;2955;4639;2641;1998;448;224;224;477;285;192;759;386;373;1617;890;727;1338;856;482;418.0;534.0;257.0;215.0;1482.0;1369.0;988
8997;Weert;2023;47194;9560;26525;11109;37495;5031;2101;2930;4668;2651;2017;453;229;224;485;281;204;772;392;380;1585;877;708;1373;872;501;438.0;530.0;264.0;210.0;1439.0;1397.0;988
8998;Weert;2024;47199;9512;26368;11319;37480;5069;2129;2940;4650;2657;1993;466;241;225;489;282;207;754;399;355;1554;866;688;1387;869;518;443.0;542.0;270.0;205.0;1419.0;1347.0;988
8999;Weert;2025;47241;9500;26252;11489;37398;5122;2173;2949;4721;2700;2021;483;239;244;509;295;214;762;408;354;1544;862;682;1423;896;527;;;;;;;988
9000;Weesp;2008;17512;3811;11000;2701;13469;1824;749;1075;2219;1230;989;265;124;141;128;72;56;373;196;177;817;425;392;636;413;223;171.0;180.0;124.0;132.0;1035.0;1029.0;457
9001;Weesp;2009;17502;3763;11012;2727;13356;1877;788;1089;2269;1244;1025;284;133;151;134;79;55;384;198;186;806;411;395;661;423;238;176.0;175.0;125.0;120.0;1032.0;1038.0;457
9002;Weesp;2010;17501;3744;11001;2756;13310;1879;794;1085;2312;1288;1024;289;133;156;143;84;59;398;204;194;789;412;377;693;455;238;167.0;179.0;126.0;137.0;1316.0;1032.0;457
9003;Weesp;2011;17764;3777;11236;2751;13406;1967;857;1110;2391;1306;1085;303;132;171;153;89;64;409;203;206;802;414;388;724;468;256;169.0;186.0;140.0;132.0;1272.0;1090.0;457
9004;Weesp;2012;17938;3833;11262;2843;13452;2008;875;1133;2478;1344;1134;314;141;173;165;95;70;439;218;221;800;410;390;760;480;280;169.0;182.0;144.0;131.0;1414.0;1092.0;457
9005;Weesp;2013;18261;3867;11424;2970;13632;2090;933;1157;2539;1373;1166;325;147;178;176;103;73;459;232;227;807;412;395;772;479;293;174.0;179.0;148.0;130.0;1344.0;1117.0;457
9006;Weesp;2014;18501;3904;11549;3048;13739;2159;986;1173;2603;1402;1201;335;152;183;174;105;69;461;238;223;825;423;402;808;484;324;177.0;188.0;140.0;141.0;1201.0;1150.0;457
9007;Weesp;2015;18540;3913;11523;3104;13743;2178;1007;1171;2619;1388;1231;345;156;189;176;103;73;463;234;229;825;420;405;810;475;335;178.0;186.0;150.0;132.0;1116.0;1131.0;457
9008;Weesp;2016;18535;3933;11430;3172;13659;2223;1061;1162;2653;1404;1249;353;163;190;189;115;74;485;243;242;821;411;410;805;472;333;177.0;190.0;131.0;128.0;1118.0;1104.0;457
9009;Weesp;2017;18542;3929;11384;3229;13603;2285;1101;1184;2654;1384;1270;359;167;192;183;108;75;488;244;244;806;400;406;818;465;353;175.0;188.0;142.0;128.0;1087.0;1087.0;457
9010;Weesp;2018;18545;3927;11331;3287;13525;2312;1118;1194;2708;1412;1296;370;167;203;198;114;84;495;249;246;816;404;412;829;478;351;176.0;189.0;141.0;132.0;1126.0;1084.0;457
9011;Weesp;2019;18586;3892;11341;3353;13537;2346;1127;1219;2703;1408;1295;369;167;202;201;117;84;480;239;241;805;402;403;848;483;365;182.0;192.0;140.0;124.0;1183.0;1098.0;457
9012;Weesp;2020;18679;3913;11359;3407;13500;2412;1145;1267;2767;1436;1331;386;170;216;208;126;82;493;246;247;801;398;403;879;496;383;180.0;190.0;149.0;123.0;1035.0;1116.0;457
9013;Weesp;2021;18618;3826;11330;3462;13398;2450;1175;1275;2770;1422;1348;380;165;215;206;129;77;490;246;244;804;388;416;890;494;396;181.0;195.0;140.0;129.0;1028.0;1079.0;457
9014;Weesp;2022;18566;3797;11229;3540;13313;2467;1181;1286;2786;1417;1369;380;167;213;199;124;75;488;246;242;802;380;422;917;500;417;172.0;200.0;138.0;131.0;1089.0;1077.0;457
9015;Weesp;2023;18559;3785;11188;3586;13241;2506;1226;1280;2812;1420;1392;378;164;214;210;132;78;495;245;250;800;381;419;929;498;431;178.0;191.0;166.0;131.0;1109.0;1120.0;457
9016;Weesp;2024;18572;3755;11133;3684;13211;2523;1244;1279;2838;1419;1419;391;174;217;218;132;86;486;236;250;782;364;418;961;513;448;173.0;205.0;135.0;129.0;1112.0;1102.0;457
9017;Weesp;2025;18559;3743;11076;3740;13166;2541;1275;1266;2852;1432;1420;401;178;223;222;131;91;486;243;243;765;361;404;978;519;459;;;;;;;457
9018;Werkendam;2008;25912;6760;15472;3680;24533;888;297;591;491;284;207;44;22;22;44;15;29;51;26;25;37;17;20;315;204;111;296.0;176.0;77.0;106.0;555.0;752.0;870
9019;Werkendam;2009;25811;6676;15293;3842;24363;890;295;595;558;320;238;63;33;30;49;17;32;65;32;33;51;24;27;330;214;116;294.0;181.0;80.0;102.0;646.0;755.0;870
9020;Werkendam;2010;25796;6587;15223;3986;24268;918;295;623;610;331;279;72;33;39;51;20;31;84;39;45;71;26;45;332;213;119;283.0;187.0;83.0;102.0;597.0;750.0;870
9021;Werkendam;2011;25724;6497;15123;4104;24124;940;303;637;660;356;304;75;36;39;51;20;31;91;42;49;88;34;54;355;224;131;284.0;196.0;86.0;106.0;719.0;747.0;870
9022;Werkendam;2012;25767;6412;15003;4352;24086;975;313;662;706;372;334;83;37;46;54;21;33;115;49;66;96;39;57;358;226;132;278.0;194.0;91.0;101.0;705.0;769.0;870
9023;Werkendam;2013;25777;6331;14866;4580;24005;1029;333;696;743;386;357;96;41;55;61;24;37;126;52;74;110;43;67;350;226;124;275.0;203.0;91.0;101.0;669.0;762.0;870
9024;Werkendam;2014;25747;6236;14719;4792;23894;1071;341;730;782;410;372;104;48;56;64;27;37;136;60;76;122;45;77;356;230;126;275.0;214.0;93.0;99.0;709.0;745.0;870
9025;Werkendam;2015;25767;6198;14603;4966;23822;1108;352;756;837;438;399;113;55;58;69;30;39;151;65;86;132;47;85;372;241;131;278.0;216.0;91.0;100.0;698.0;740.0;870
9026;Werkendam;2016;25781;6150;14531;5100;23750;1141;363;778;890;457;433;128;64;64;72;33;39;164;71;93;128;45;83;398;244;154;276.0;220.0;88.0;96.0;726.0;728.0;870
9027;Werkendam;2017;25829;6098;14511;5220;23732;1145;368;777;952;485;467;141;71;70;79;39;40;169;71;98;149;54;95;414;250;164;278.0;228.0;80.0;98.0;709.0;753.0;870
9028;Werkendam;2018;25818;6052;14408;5358;23685;1133;360;773;1000;511;489;147;75;72;84;40;44;189;78;111;162;54;108;418;264;154;283.0;231.0;82.0;98.0;681.0;769.0;870
9029;Werkendam;2019;25766;5963;14323;5480;23570;1153;368;785;1043;540;503;145;77;68;94;41;53;191;77;114;164;56;108;449;289;160;279.0;238.0;97.0;102.0;772.0;753.0;870
9030;Werkendam;2020;25823;5928;14287;5608;23546;1181;388;793;1096;568;528;152;82;70;93;43;50;214;84;130;172;57;115;465;302;163;281.0;241.0;107.0;99.0;763.0;766.0;870
9031;Werkendam;2021;25872;5883;14234;5755;23496;1200;397;803;1176;594;582;161;85;76;98;41;57;237;92;145;181;61;120;499;315;184;286.0;249.0;87.0;98.0;803.0;767.0;870
9032;Werkendam;2022;25936;5865;14233;5838;23480;1228;422;806;1228;604;624;177;92;85;98;34;64;249;102;147;198;65;133;506;311;195;292.0;249.0;91.0;98.0;732.0;781.0;870
9033;Werkendam;2023;25926;5824;14175;5927;23406;1241;433;808;1279;632;647;186;93;93;99;35;64;264;108;156;207;68;139;523;328;195;292.0;258.0;84.0;96.0;809.0;771.0;870
9034;Werkendam;2024;25988;5815;14133;6040;23354;1267;441;826;1367;670;697;196;98;98;112;41;71;277;114;163;220;72;148;562;345;217;296.0;260.0;86.0;102.0;771.0;775.0;870
9035;Werkendam;2025;26006;5824;14057;6125;23313;1295;447;848;1398;676;722;200;99;101;123;41;82;275;113;162;228;74;154;572;349;223;;;;;;;870
9036;Wervershoof;2008;8506;2307;5063;1136;8011;288;94;194;207;108;99;40;20;20;10;5;5;12;5;7;17;7;10;128;71;57;85.0;62.0;22.0;33.0;371.0;392.0;459
9037;Wervershoof;2009;8498;2253;5072;1173;7977;291;87;204;230;122;108;44;22;22;16;8;8;22;8;14;16;6;10;132;78;54;86.0;62.0;22.0;35.0;384.0;392.0;459
9038;Wervershoof;2010;8502;2243;5062;1197;7980;286;92;194;236;116;120;43;20;23;18;9;9;28;8;20;19;8;11;128;71;57;85.0;66.0;22.0;31.0;333.0;394.0;459
9039;Wervershoof;2011;8452;2191;5028;1233;7913;292;93;199;247;124;123;43;20;23;18;10;8;34;12;22;21;8;13;131;74;57;81.0;66.0;22.0;31.0;366.0;398.0;459
9040;Wervershoof;2012;8428;2132;5041;1255;7842;309;100;209;277;136;141;50;23;27;20;8;12;34;12;22;30;12;18;143;81;62;80.0;65.0;22.0;32.0;382.0;398.0;459
9041;Wervershoof;2013;8418;2095;5028;1295;7827;309;102;207;282;141;141;49;22;27;23;10;13;34;14;20;34;14;20;142;81;61;80.0;68.0;24.0;31.0;368.0;398.0;459
9042;Wervershoof;2014;8393;2032;4995;1366;7786;307;98;209;300;158;142;53;23;30;24;11;13;36;14;22;33;16;17;154;94;60;76.0;69.0;23.0;29.0;398.0;396.0;459
9043;Wervershoof;2015;8397;1988;4987;1422;7760;321;103;218;316;175;141;47;23;24;23;11;12;38;16;22;35;16;19;173;109;64;77.0;71.0;25.0;32.0;381.0;387.0;459
9044;Wervershoof;2016;8391;1952;4959;1480;7732;329;109;220;330;186;144;51;28;23;25;14;11;37;17;20;36;15;21;181;112;69;81.0;71.0;25.0;33.0;342.0;402.0;459
9045;Wervershoof;2017;8335;1891;4942;1502;7674;334;116;218;327;174;153;54;27;27;26;13;13;37;18;19;41;18;23;169;98;71;76.0;71.0;28.0;31.0;366.0;396.0;459
9046;Wervershoof;2018;8308;1853;4926;1529;7642;343;123;220;323;175;148;58;28;30;24;13;11;43;20;23;37;18;19;161;96;65;79.0;73.0;25.0;31.0;380.0;388.0;459
9047;Wervershoof;2019;8301;1828;4890;1583;7615;347;124;223;339;176;163;58;28;30;28;16;12;56;21;35;38;16;22;159;95;64;81.0;75.0;25.0;30.0;332.0;392.0;459
9048;Wervershoof;2020;8243;1782;4830;1631;7534;356;132;224;353;184;169;57;28;29;30;17;13;54;20;34;42;16;26;170;103;67;77.0;77.0;25.0;29.0;359.0;399.0;459
9049;Wervershoof;2021;8200;1740;4794;1666;7478;353;126;227;369;189;180;55;27;28;31;21;10;55;21;34;44;15;29;184;105;79;77.0;76.0;24.0;32.0;382.0;399.0;459
9050;Wervershoof;2022;8177;1705;4765;1707;7443;354;125;229;380;191;189;66;31;35;34;19;15;55;21;34;45;16;29;180;104;76;79.0;79.0;26.0;29.0;437.0;387.0;459
9051;Wervershoof;2023;8226;1709;4760;1757;7471;360;129;231;395;196;199;66;31;35;42;21;21;60;22;38;49;15;34;178;107;71;81.0;76.0;22.0;27.0;403.0;388.0;459
9052;Wervershoof;2024;8243;1687;4750;1806;7455;373;127;246;415;204;211;68;33;35;42;22;20;68;27;41;49;14;35;188;108;80;86.0;82.0;24.0;32.0;340.0;377.0;459
9053;Wervershoof;2025;8204;1681;4680;1843;7388;388;137;251;428;210;218;68;32;36;42;22;20;68;26;42;50;14;36;200;116;84;;;;;;;459
9054;West Maas en Waal;2008;17981;4316;10929;2736;16903;786;195;591;292;169;123;40;18;22;30;16;14;20;6;14;22;8;14;180;121;59;135.0;169.0;37.0;63.0;401.0;496.0;668
9055;West Maas en Waal;2009;17828;4237;10829;2762;16736;787;195;592;305;165;140;47;22;25;30;14;16;32;9;23;25;7;18;171;113;58;135.0;171.0;38.0;59.0;480.0;513.0;668
9056;West Maas en Waal;2010;17740;4148;10769;2823;16630;781;203;578;329;173;156;52;24;28;29;14;15;42;15;27;34;10;24;172;110;62;127.0;169.0;35.0;62.0;437.0;516.0;668
9057;West Maas en Waal;2011;17593;4045;10676;2872;16454;786;202;584;353;187;166;60;30;30;34;19;15;57;20;37;35;10;25;167;108;59;126.0;174.0;36.0;60.0;517.0;524.0;668
9058;West Maas en Waal;2012;17515;3940;10610;2965;16336;790;211;579;389;214;175;61;34;27;35;21;14;69;27;42;48;17;31;176;115;61;124.0;175.0;39.0;61.0;550.0;535.0;668
9059;West Maas en Waal;2013;17458;3825;10535;3098;16234;810;218;592;414;230;184;71;39;32;40;22;18;64;26;38;54;21;33;185;122;63;128.0;178.0;37.0;57.0;541.0;546.0;668
9060;West Maas en Waal;2014;17384;3757;10435;3192;16134;813;219;594;437;237;200;74;41;33;43;27;16;72;27;45;61;27;34;187;115;72;127.0;179.0;44.0;56.0;527.0;538.0;668
9061;West Maas en Waal;2015;17311;3662;10351;3298;16026;810;213;597;475;267;208;79;45;34;45;30;15;84;32;52;62;29;33;205;131;74;133.0;181.0;40.0;57.0;592.0;553.0;668
9062;West Maas en Waal;2016;17287;3602;10316;3369;15968;812;215;597;507;286;221;77;46;31;46;29;17;96;40;56;71;32;39;217;139;78;138.0;186.0;43.0;56.0;538.0;564.0;668
9063;West Maas en Waal;2017;17201;3499;10248;3454;15841;831;232;599;529;287;242;86;46;40;48;30;18;103;45;58;72;30;42;220;136;84;140.0;187.0;45.0;52.0;546.0;573.0;668
9064;West Maas en Waal;2018;17121;3453;10124;3544;15693;848;243;605;580;311;269;90;47;43;52;34;18;115;50;65;86;34;52;237;146;91;145.0;186.0;45.0;53.0;535.0;553.0;668
9065;West Maas en Waal;2019;17056;3363;10055;3638;15589;862;256;606;605;324;281;92;49;43;53;34;19;124;52;72;92;37;55;244;152;92;149.0;188.0;61.0;55.0;580.0;551.0;668
9066;West Maas en Waal;2020;17052;3310;10030;3712;15488;910;284;626;654;342;312;106;55;51;59;37;22;127;52;75;102;39;63;260;159;101;157.0;194.0;40.0;51.0;623.0;584.0;668
9067;West Maas en Waal;2021;17046;3270;9969;3807;15434;922;298;624;690;355;335;120;61;59;64;41;23;126;56;70;102;35;67;278;162;116;156.0;193.0;38.0;60.0;631.0;579.0;668
9068;West Maas en Waal;2022;17043;3233;9895;3915;15414;932;311;621;697;354;343;111;52;59;70;45;25;139;60;79;99;38;61;278;159;119;165.0;199.0;42.0;54.0;639.0;571.0;668
9069;West Maas en Waal;2023;17068;3234;9852;3982;15406;932;315;617;730;370;360;111;55;56;70;43;27;152;63;89;105;40;65;292;169;123;167.0;206.0;50.0;56.0;620.0;553.0;668
9070;West Maas en Waal;2024;17092;3226;9843;4023;15390;939;325;614;763;386;377;113;56;57;70;41;29;154;63;91;113;45;68;313;181;132;173.0;211.0;39.0;54.0;596.0;562.0;668
9071;West Maas en Waal;2025;17074;3222;9734;4118;15346;940;324;616;788;394;394;115;59;56;73;42;31;163;66;97;125;46;79;312;181;131;;;;;;;668
9072;Westerveld;2008;19087;4308;10731;4048;17750;808;312;496;529;289;240;59;27;32;42;22;20;33;17;16;23;11;12;372;212;160;152.0;203.0;38.0;85.0;914.0;887.0;1701
9073;Westerveld;2009;19016;4288;10597;4131;17583;826;311;515;607;307;300;69;30;39;44;23;21;51;23;28;31;14;17;412;217;195;154.0;208.0;54.0;91.0;937.0;880.0;1701
9074;Westerveld;2010;18983;4293;10481;4209;17421;853;322;531;709;334;375;78;37;41;45;21;24;66;30;36;49;19;30;471;227;244;153.0;210.0;44.0;87.0;913.0;902.0;1701
9075;Westerveld;2011;18896;4242;10371;4283;17229;875;331;544;792;359;433;84;42;42;51;23;28;74;30;44;54;19;35;529;245;284;151.0;211.0;57.0;96.0;895.0;890.0;1701
9076;Westerveld;2012;18805;4213;10152;4440;17030;893;340;553;882;377;505;100;47;53;51;21;30;80;36;44;60;21;39;591;252;339;148.0;213.0;66.0;94.0;948.0;886.0;1701
9077;Westerveld;2013;18777;4172;10067;4538;16899;919;357;562;959;407;552;118;56;62;48;22;26;95;42;53;72;26;46;626;261;365;152.0;211.0;58.0;93.0;889.0;915.0;1701
9078;Westerveld;2014;18660;4119;9929;4612;16734;911;354;557;1015;429;586;121;59;62;50;20;30;104;45;59;76;30;46;664;275;389;154.0;212.0;58.0;97.0;895.0;908.0;1701
9079;Westerveld;2015;18551;4037;9828;4686;16560;919;353;566;1072;450;622;123;63;60;58;23;35;121;52;69;90;34;56;680;278;402;156.0;211.0;54.0;91.0;950.0;903.0;1701
9080;Westerveld;2016;18507;4019;9750;4738;16409;950;368;582;1148;483;665;127;68;59;61;24;37;127;53;74;98;35;63;735;303;432;154.0;219.0;58.0;94.0;877.0;907.0;1701
9081;Westerveld;2017;18376;3940;9635;4801;16215;949;367;582;1212;513;699;136;69;67;64;26;38;133;56;77;112;34;78;767;328;439;152.0;216.0;52.0;91.0;961.0;879.0;1701
9082;Westerveld;2018;18356;3914;9579;4863;16135;937;364;573;1284;534;750;143;72;71;75;35;40;146;61;85;120;34;86;800;332;468;163.0;222.0;55.0;93.0;962.0;897.0;1701
9083;Westerveld;2019;18326;3883;9502;4941;16019;942;357;585;1365;556;809;163;81;82;78;36;42;151;62;89;124;38;86;849;339;510;156.0;219.0;54.0;98.0;963.0;894.0;1701
9084;Westerveld;2020;18288;3828;9462;4998;15897;953;375;578;1438;581;857;168;83;85;89;39;50;165;68;97;137;45;92;879;346;533;158.0;225.0;57.0;95.0;928.0;910.0;1701
9085;Westerveld;2021;18204;3728;9463;5013;15739;955;377;578;1510;609;901;166;81;85;91;42;49;173;72;101;147;49;98;933;365;568;160.0;224.0;56.0;98.0;959.0;904.0;1701
9086;Westerveld;2022;18154;3671;9381;5102;15643;976;404;572;1535;617;918;171;83;88;87;39;48;181;84;97;157;51;106;939;360;579;161.0;231.0;56.0;97.0;916.0;895.0;1701
9087;Westerveld;2023;18066;3602;9291;5173;15483;992;419;573;1591;641;950;170;87;83;90;41;49;190;84;106;160;53;107;981;376;605;162.0;231.0;55.0;94.0;958.0;885.0;1701
9088;Westerveld;2024;18032;3570;9233;5229;15375;1013;431;582;1644;667;977;176;92;84;93;45;48;192;85;107;166;53;113;1017;392;625;161.0;235.0;63.0;97.0;992.0;887.0;1701
9089;Westerveld;2025;18031;3573;9131;5327;15309;1007;425;582;1715;677;1038;188;99;89;99;43;56;200;84;116;169;53;116;1059;398;661;;;;;;;1701
9090;Westervoort;2008;15489;3996;9767;1726;13070;1451;440;1011;968;546;422;166;72;94;72;37;35;207;111;96;108;42;66;415;284;131;138.0;98.0;53.0;78.0;695.0;921.0;293
9091;Westervoort;2009;15280;3827;9669;1784;12853;1419;434;985;1008;568;440;172;74;98;82;47;35;223;116;107;117;47;70;414;284;130;129.0;105.0;67.0;78.0;752.0;911.0;293
9092;Westervoort;2010;15137;3641;9653;1843;12722;1411;445;966;1004;562;442;167;79;88;76;43;33;222;115;107;113;43;70;426;282;144;136.0;100.0;61.0;77.0;760.0;895.0;293
9093;Westervoort;2011;15023;3481;9634;1908;12589;1398;446;952;1036;578;458;168;78;90;83;47;36;224;118;106;118;41;77;443;294;149;131.0;107.0;70.0;79.0;786.0;883.0;293
9094;Westervoort;2012;14941;3358;9564;2019;12526;1367;437;930;1048;583;465;163;79;84;85;56;29;230;119;111;129;42;87;441;287;154;136.0;113.0;62.0;77.0;757.0;859.0;293
9095;Westervoort;2013;14849;3265;9434;2150;12426;1349;428;921;1074;574;500;164;79;85;90;55;35;242;115;127;138;45;93;440;280;160;135.0;117.0;63.0;72.0;760.0;865.0;293
9096;Westervoort;2014;14754;3137;9378;2239;12327;1338;432;906;1089;576;513;156;77;79;92;58;34;235;114;121;151;46;105;455;281;174;133.0;121.0;63.0;75.0;729.0;875.0;293
9097;Westervoort;2015;14608;3022;9222;2364;12204;1316;431;885;1088;578;510;164;84;80;89;57;32;231;109;122;152;45;107;452;283;169;141.0;122.0;62.0;70.0;755.0;864.0;293
9098;Westervoort;2016;14512;2951;9109;2452;12091;1326;447;879;1095;584;511;166;86;80;86;52;34;235;107;128;149;47;102;459;292;167;140.0;118.0;58.0;66.0;780.0;842.0;293
9099;Westervoort;2017;14465;2934;8990;2541;12018;1337;464;873;1110;588;522;164;87;77;85;47;38;246;110;136;158;48;110;457;296;161;146.0;123.0;58.0;68.0;719.0;846.0;293
9100;Westervoort;2018;14354;2864;8859;2631;11921;1302;443;859;1131;601;530;160;86;74;90;49;41;260;117;143;161;45;116;460;304;156;143.0;127.0;53.0;65.0;759.0;838.0;293
9101;Westervoort;2019;14281;2835;8717;2729;11834;1302;456;846;1145;599;546;166;88;78;91;52;39;267;117;150;162;48;114;459;294;165;141.0;127.0;50.0;63.0;727.0;805.0;293
9102;Westervoort;2020;14206;2766;8604;2836;11741;1289;445;844;1176;620;556;166;92;74;96;56;40;279;123;156;166;48;118;469;301;168;146.0;133.0;54.0;59.0;721.0;812.0;293
9103;Westervoort;2021;14125;2751;8439;2935;11664;1251;438;813;1210;634;576;173;96;77;97;54;43;279;124;155;164;50;114;497;310;187;136.0;132.0;52.0;63.0;755.0;801.0;293
9104;Westervoort;2022;14073;2757;8339;2977;11610;1256;428;828;1207;621;586;168;91;77;100;56;44;279;125;154;171;50;121;489;299;190;143.0;136.0;53.0;60.0;690.0;817.0;293
9105;Westervoort;2023;13946;2718;8145;3083;11498;1228;417;811;1220;615;605;169;90;79;106;61;45;279;120;159;176;51;125;490;293;197;139.0;140.0;53.0;64.0;728.0;792.0;293
9106;Westervoort;2024;13871;2699;7972;3200;11412;1220;419;801;1239;626;613;173;90;83;99;57;42;278;120;158;176;53;123;513;306;207;136.0;145.0;59.0;61.0;710.0;801.0;293
9107;Westervoort;2025;13770;2673;7812;3285;11334;1188;412;776;1248;636;612;169;93;76;102;61;41;281;120;161;178;54;124;518;308;210;;;;;;;293
9108;Westland;2008;98444;25995;58312;14137;88717;4857;1846;3011;4870;2655;2215;698;347;351;219;90;129;693;349;344;1436;738;698;1824;1131;693;1078.0;730.0;306.0;393.0;2173.0;2501.0;1783
9109;Westland;2009;98387;25768;58007;14612;88236;4937;1874;3063;5214;2788;2426;743;360;383;247;97;150;803;380;423;1458;736;722;1963;1215;748;1064.0;755.0;345.0;395.0;2232.0;2476.0;1783
9110;Westland;2010;98413;25572;57737;15104;87758;5024;1921;3103;5631;2975;2656;796;372;424;282;113;169;942;445;497;1504;748;756;2107;1297;810;1036.0;761.0;348.0;389.0;2780.0;2533.0;1783
9111;Westland;2011;98911;25385;58013;15513;87601;5249;2038;3211;6061;3139;2922;869;392;477;325;129;196;1057;491;566;1562;770;792;2248;1357;891;1013.0;780.0;378.0;402.0;2932.0;2538.0;1783
9112;Westland;2012;99523;25293;57838;16392;87508;5465;2166;3299;6550;3328;3222;940;407;533;368;149;219;1166;536;630;1654;814;840;2422;1422;1000;1035.0;798.0;402.0;394.0;3007.0;2529.0;1783
9113;Westland;2013;100257;25192;57984;17081;87470;5750;2303;3447;7037;3527;3510;1007;428;579;425;174;251;1287;587;700;1714;836;878;2604;1502;1102;1026.0;822.0;398.0;406.0;2915.0;2488.0;1783
9114;Westland;2014;100890;25039;58102;17749;87434;6017;2472;3545;7439;3691;3748;1081;456;625;461;193;268;1405;643;762;1750;851;899;2742;1548;1194;1027.0;842.0;429.0;415.0;3084.0;2452.0;1783
9115;Westland;2015;101726;24957;58449;18320;87535;6306;2636;3670;7885;3854;4031;1117;455;662;494;200;294;1527;674;853;1811;882;929;2936;1643;1293;1039.0;865.0;410.0;427.0;3068.0;2469.0;1783
9116;Westland;2016;102492;24956;58668;18868;87600;6571;2776;3795;8321;3998;4323;1170;465;705;532;213;319;1681;730;951;1849;894;955;3089;1696;1393;1063.0;884.0;427.0;432.0;3214.0;2473.0;1783
9117;Westland;2017;103417;24983;59054;19380;87796;6861;2946;3915;8760;4148;4612;1241;497;744;571;224;347;1784;763;1021;1916;906;1010;3248;1758;1490;1075.0;902.0;444.0;439.0;2685.0;2482.0;1783
9118;Westland;2018;103813;24921;58919;19973;87648;7095;3045;4050;9070;4264;4806;1263;501;762;592;226;366;1846;788;1058;1951;917;1034;3418;1832;1586;1079.0;915.0;440.0;437.0;2656.0;2469.0;1783
9119;Westland;2019;104186;24941;58778;20467;87408;7307;3156;4151;9471;4388;5083;1324;523;801;610;233;377;1941;809;1132;2013;918;1095;3583;1905;1678;1063.0;942.0;449.0;453.0;2620.0;2436.0;1783
9120;Westland;2020;104498;24812;58747;20939;87231;7567;3306;4261;9700;4485;5215;1359;527;832;627;232;395;2021;846;1175;2023;929;1094;3670;1951;1719;1070.0;958.0;454.0;448.0;2749.0;2436.0;1783
9121;Westland;2021;104935;24706;58821;21408;87127;7757;3402;4355;10051;4639;5412;1409;551;858;651;239;412;2112;884;1228;2099;957;1142;3780;2008;1772;1063.0;976.0;461.0;460.0;2825.0;2465.0;1783
9122;Westland;2022;105396;24650;58804;21942;87007;7994;3529;4465;10395;4802;5593;1454;579;875;682;249;433;2174;913;1261;2144;969;1175;3941;2092;1849;1084.0;1003.0;460.0;460.0;2879.0;2466.0;1783
9123;Westland;2023;105898;24614;58821;22463;86980;8241;3648;4593;10677;4919;5758;1480;586;894;716;266;450;2231;934;1297;2170;976;1194;4080;2157;1923;1073.0;1014.0;478.0;470.0;2723.0;2475.0;1783
9124;Westland;2024;106219;24499;58697;23023;86793;8498;3809;4689;10928;5056;5872;1520;601;919;734;276;458;2308;976;1332;2200;996;1204;4166;2207;1959;1081.0;1037.0;484.0;456.0;2844.0;2460.0;1783
9125;Westland;2025;106683;24576;58570;23537;86745;8742;3934;4808;11196;5179;6017;1547;612;935;766;286;480;2407;1016;1391;2215;1007;1208;4261;2258;2003;;;;;;;1783
9126;Weststellingwerf;2008;25279;5806;14898;4575;23468;1052;327;725;759;450;309;75;36;39;131;80;51;34;16;18;186;104;82;333;214;119;253.0;284.0;62.0;110.0;1064.0;1066.0;98
9127;Weststellingwerf;2009;25199;5734;14854;4611;23354;1049;308;741;796;458;338;70;34;36;125;70;55;51;24;27;207;112;95;343;218;125;246.0;281.0;64.0;113.0;1108.0;1052.0;98
9128;Weststellingwerf;2010;25176;5636;14871;4669;23291;1056;306;750;829;483;346;80;43;37;138;83;55;54;28;26;211;115;96;346;214;132;247.0;286.0;85.0;101.0;1127.0;1082.0;98
9129;Weststellingwerf;2011;25168;5569;14848;4751;23223;1077;317;760;868;501;367;85;43;42;147;87;60;61;31;30;217;119;98;358;221;137;240.0;287.0;71.0;107.0;1170.0;1077.0;98
9130;Weststellingwerf;2012;25183;5498;14805;4880;23187;1079;313;766;917;524;393;87;46;41;142;85;57;77;39;38;236;132;104;375;222;153;243.0;282.0;73.0;114.0;1072.0;1075.0;98
9131;Weststellingwerf;2013;25102;5453;14616;5033;23051;1082;305;777;969;554;415;99;54;45;146;89;57;88;41;47;251;140;111;385;230;155;246.0;284.0;72.0;102.0;1086.0;1075.0;98
9132;Weststellingwerf;2014;25045;5376;14579;5090;22971;1078;301;777;996;572;424;100;53;47;146;94;52;101;47;54;274;156;118;375;222;153;240.0;288.0;93.0;97.0;1146.0;1059.0;98
9133;Weststellingwerf;2015;25083;5300;14615;5168;22947;1111;311;800;1025;588;437;103;57;46;157;100;57;110;50;60;268;150;118;387;231;156;238.0;288.0;75.0;106.0;1105.0;1059.0;98
9134;Weststellingwerf;2016;25052;5258;14559;5235;22898;1121;309;812;1033;587;446;103;57;46;154;94;60;116;55;61;273;155;118;387;226;161;241.0;284.0;64.0;113.0;1160.0;1063.0;98
9135;Weststellingwerf;2017;25058;5201;14518;5339;22877;1127;305;822;1054;601;453;108;61;47;144;89;55;127;61;66;284;160;124;391;230;161;241.0;284.0;68.0;105.0;1101.0;1056.0;98
9136;Weststellingwerf;2018;25024;5128;14421;5475;22838;1128;314;814;1058;592;466;109;62;47;138;85;53;131;61;70;286;155;131;394;229;165;242.0;287.0;74.0;104.0;1048.0;1074.0;98
9137;Weststellingwerf;2019;24925;5022;14342;5561;22690;1144;325;819;1091;611;480;126;67;59;144;89;55;137;67;70;294;163;131;390;225;165;244.0;290.0;66.0;99.0;1183.0;1055.0;98
9138;Weststellingwerf;2020;24976;5006;14261;5709;22689;1142;316;826;1145;640;505;137;74;63;149;87;62;148;68;80;306;169;137;405;242;163;249.0;295.0;69.0;98.0;1022.0;1057.0;98
9139;Weststellingwerf;2021;24867;4928;14124;5815;22537;1147;325;822;1183;663;520;139;72;67;160;97;63;154;69;85;316;175;141;414;250;164;250.0;293.0;63.0;102.0;1161.0;1055.0;98
9140;Weststellingwerf;2022;24892;4874;14104;5914;22489;1173;329;844;1230;693;537;148;78;70;171;102;69;150;67;83;320;175;145;441;271;170;249.0;299.0;81.0;102.0;1168.0;1043.0;98
9141;Weststellingwerf;2023;24947;4883;14042;6022;22496;1194;346;848;1257;709;548;158;83;75;170;99;71;162;70;92;321;178;143;446;279;167;248.0;305.0;73.0;96.0;1091.0;1052.0;98
9142;Weststellingwerf;2024;24906;4834;13933;6139;22444;1188;340;848;1274;716;558;175;87;88;167;98;69;156;69;87;327;186;141;449;276;173;247.0;307.0;67.0;94.0;1168.0;1027.0;98
9143;Weststellingwerf;2025;24962;4850;13815;6297;22457;1197;348;849;1308;728;580;183;90;93;176;104;72;168;74;94;335;187;148;446;273;173;;;;;;;98
9144;Westvoorne;2008;13869;3011;8179;2679;12528;948;358;590;393;185;208;53;18;35;63;23;40;46;22;24;20;12;8;211;110;101;93.0;128.0;32.0;49.0;424.0;564.0;614
9145;Westvoorne;2009;13678;2896;8071;2711;12301;958;370;588;419;203;216;62;22;40;61;24;37;54;29;25;28;15;13;214;113;101;92.0;127.0;33.0;51.0;506.0;568.0;614
9146;Westvoorne;2010;13565;2814;7985;2766;12153;949;360;589;463;212;251;72;28;44;66;26;40;59;31;28;37;15;22;229;112;117;93.0;125.0;37.0;52.0;565.0;558.0;614
9147;Westvoorne;2011;13527;2752;7977;2798;12073;941;363;578;513;226;287;74;30;44;72;25;47;77;37;40;45;16;29;245;118;127;93.0;128.0;34.0;50.0;540.0;561.0;614
9148;Westvoorne;2012;13456;2653;7887;2916;11978;929;361;568;549;255;294;80;34;46;74;30;44;84;41;43;45;16;29;266;134;132;95.0;126.0;34.0;45.0;436.0;561.0;614
9149;Westvoorne;2013;13291;2539;7709;3043;11793;933;363;570;565;270;295;87;37;50;74;31;43;87;47;40;58;21;37;259;134;125;94.0;128.0;33.0;49.0;580.0;533.0;614
9150;Westvoorne;2014;13288;2494;7676;3118;11754;924;360;564;610;292;318;99;44;55;77;30;47;97;50;47;67;24;43;270;144;126;95.0;128.0;34.0;47.0;546.0;561.0;614
9151;Westvoorne;2015;13228;2432;7649;3147;11672;920;362;558;636;297;339;104;46;58;74;28;46;110;54;56;74;27;47;274;142;132;97.0;128.0;41.0;43.0;484.0;557.0;614
9152;Westvoorne;2016;13123;2353;7566;3204;11535;932;359;573;656;303;353;102;41;61;78;30;48;114;55;59;75;29;46;287;148;139;100.0;125.0;39.0;44.0;549.0;571.0;614
9153;Westvoorne;2017;13074;2337;7476;3261;11438;936;361;575;700;325;375;109;45;64;86;33;53;127;60;67;78;28;50;300;159;141;98.0;133.0;37.0;42.0;530.0;544.0;614
9154;Westvoorne;2018;13020;2314;7399;3307;11351;942;358;584;727;348;379;117;51;66;93;34;59;139;70;69;80;34;46;298;159;139;103.0;135.0;36.0;46.0;558.0;547.0;614
9155;Westvoorne;2019;12989;2281;7372;3336;11266;947;350;597;776;365;411;131;54;77;97;34;63;145;69;76;84;37;47;319;171;148;104.0;132.0;36.0;44.0;513.0;539.0;614
9156;Westvoorne;2020;12928;2233;7323;3372;11167;965;362;603;796;379;417;129;53;76;101;37;64;155;75;80;89;38;51;322;176;146;104.0;129.0;31.0;43.0;550.0;536.0;614
9157;Westvoorne;2021;12906;2216;7250;3440;11100;970;364;606;836;394;442;131;57;74;110;42;68;166;78;88;96;39;57;333;178;155;105.0;132.0;35.0;42.0;536.0;530.0;614
9158;Westvoorne;2022;12879;2190;7204;3485;11053;970;354;616;856;395;461;137;60;77;115;45;70;172;79;93;99;40;59;333;171;162;108.0;134.0;30.0;43.0;557.0;536.0;614
9159;Westvoorne;2023;12863;2171;7164;3528;11018;965;359;606;880;410;470;138;63;75;119;45;74;175;85;90;104;44;60;344;173;171;107.0;134.0;45.0;43.0;554.0;556.0;614
9160;Westvoorne;2024;12837;2165;7078;3594;10967;958;356;602;912;425;487;144;64;80;121;50;71;174;85;89;111;45;66;362;181;181;105.0;136.0;41.0;40.0;639.0;563.0;614
9161;Westvoorne;2025;12884;2197;7011;3676;10962;991;364;627;931;431;500;142;66;76;127;53;74;174;89;85;116;46;70;372;177;195;;;;;;;614
9162;Wierden;2008;22970;5899;13577;3494;21345;1160;423;737;465;274;191;41;18;23;16;4;12;172;95;77;42;18;24;194;139;55;240.0;175.0;45.0;74.0;525.0;727.0;189
9163;Wierden;2009;22807;5799;13420;3588;21137;1147;407;740;523;300;223;55;19;36;24;12;12;178;92;86;50;24;26;216;153;63;232.0;176.0;53.0;68.0;608.0;742.0;189
9164;Wierden;2010;22716;5653;13331;3732;20989;1151;407;744;576;325;251;70;26;44;32;17;15;183;91;92;56;32;24;235;159;76;233.0;185.0;58.0;77.0;717.0;747.0;189
9165;Wierden;2011;22717;5562;13341;3814;20923;1158;406;752;636;357;279;84;33;51;35;18;17;186;94;92;61;31;30;270;181;89;229.0;188.0;68.0;67.0;715.0;750.0;189
9166;Wierden;2012;22729;5500;13257;3972;20867;1168;413;755;694;391;303;98;38;60;35;20;15;192;94;98;74;36;38;295;203;92;233.0;198.0;61.0;67.0;575.0;774.0;189
9167;Wierden;2013;22561;5344;13093;4124;20658;1157;405;752;746;422;324;104;43;61;41;26;15;198;96;102;81;37;44;322;220;102;231.0;199.0;60.0;62.0;710.0;749.0;189
9168;Wierden;2014;22554;5237;13063;4254;20594;1166;403;763;794;436;358;120;48;72;44;27;17;198;93;105;87;39;48;345;229;116;231.0;205.0;61.0;67.0;609.0;762.0;189
9169;Wierden;2015;22426;5083;13013;4330;20444;1173;411;762;809;443;366;122;44;78;49;31;18;206;94;112;85;35;50;347;239;108;232.0;205.0;55.0;64.0;647.0;739.0;189
9170;Wierden;2016;22354;5012;12908;4434;20324;1171;407;764;859;464;395;132;49;83;57;36;21;220;100;120;92;37;55;358;242;116;230.0;211.0;62.0;58.0;695.0;737.0;189
9171;Wierden;2017;22334;4925;12888;4521;20251;1165;404;761;918;495;423;147;55;92;67;41;26;222;101;121;95;37;58;387;261;126;229.0;215.0;55.0;58.0;753.0;754.0;189
9172;Wierden;2018;22348;4890;12831;4627;20218;1173;414;759;957;516;441;147;62;85;77;48;29;234;104;130;104;40;64;395;262;133;240.0;217.0;58.0;63.0;816.0;764.0;189
9173;Wierden;2019;22420;4831;12859;4730;20246;1176;426;750;998;531;467;154;65;89;74;44;30;248;112;136;115;45;70;407;265;142;243.0;222.0;61.0;65.0;749.0;766.0;189
9174;Wierden;2020;22420;4797;12805;4818;20219;1179;432;747;1022;540;482;159;69;90;77;44;33;245;111;134;130;49;81;411;267;144;244.0;233.0;57.0;68.0;853.0;791.0;189
9175;Wierden;2021;22483;4740;12845;4898;20217;1197;423;774;1069;564;505;170;67;103;79;49;30;245;112;133;142;59;83;433;277;156;248.0;233.0;56.0;67.0;730.0;797.0;189
9176;Wierden;2022;22426;4693;12741;4992;20118;1203;419;784;1105;578;527;183;69;114;87;49;38;243;110;133;148;67;81;444;283;161;252.0;237.0;60.0;65.0;771.0;770.0;189
9177;Wierden;2023;22438;4652;12724;5062;20096;1218;431;787;1124;590;534;191;73;118;90;52;38;247;113;134;156;69;87;440;283;157;248.0;237.0;63.0;65.0;744.0;768.0;189
9178;Wierden;2024;22425;4619;12632;5174;20045;1211;433;778;1169;597;572;197;75;122;92;56;36;272;118;154;157;66;91;451;282;169;253.0;242.0;59.0;64.0;750.0;753.0;189
9179;Wierden;2025;22431;4616;12548;5267;20003;1219;431;788;1209;622;587;208;79;129;106;65;41;279;123;156;156;64;92;460;291;169;;;;;;;189
9180;Wieringen;2008;8749;1984;5261;1504;8089;439;135;304;221;129;92;24;11;13;20;9;11;16;5;11;14;8;6;147;96;51;98.0;85.0;25.0;40.0;347.0;299.0;462
9181;Wieringen;2009;8797;1978;5286;1533;8108;451;133;318;238;139;99;27;15;12;22;8;14;19;9;10;17;9;8;153;98;55;97.0;89.0;21.0;36.0;348.0;309.0;462
9182;Wieringen;2010;8831;1983;5279;1569;8127;447;137;310;257;142;115;31;17;14;26;10;16;23;11;12;21;9;12;156;95;61;97.0;84.0;26.0;37.0;343.0;320.0;462
9183;Wieringen;2011;8858;1972;5306;1580;8117;477;154;323;264;143;121;33;17;16;24;9;15;27;12;15;22;6;16;158;99;59;93.0;80.0;24.0;40.0;247.0;311.0;462
9184;Wieringen;2012;8792;1941;5207;1644;8053;459;146;313;280;145;135;39;19;20;23;10;13;31;12;19;24;7;17;163;97;66;91.0;85.0;29.0;36.0;290.0;301.0;462
9185;Wieringen;2013;8781;1932;5168;1681;8041;449;144;305;291;154;137;42;22;20;21;10;11;37;17;20;25;6;19;166;99;67;91.0;85.0;27.0;36.0;280.0;302.0;462
9186;Wieringen;2014;8757;1908;5127;1722;7993;462;140;322;302;162;140;47;23;24;17;8;9;42;19;23;28;9;19;168;103;65;89.0;86.0;29.0;33.0;328.0;292.0;462
9187;Wieringen;2015;8793;1911;5112;1770;8003;460;142;318;330;169;161;54;28;26;21;10;11;46;18;28;32;10;22;177;103;74;89.0;89.0;34.0;35.0;337.0;296.0;462
9188;Wieringen;2016;8834;1910;5130;1794;8038;457;139;318;339;170;169;59;29;30;24;10;14;53;20;33;28;10;18;175;101;74;88.0;86.0;28.0;36.0;349.0;312.0;462
9189;Wieringen;2017;8866;1901;5132;1833;8045;460;147;313;361;182;179;62;29;33;26;10;16;54;20;34;33;13;20;186;110;76;90.0;90.0;26.0;36.0;300.0;303.0;462
9190;Wieringen;2018;8854;1888;5094;1872;8017;468;149;319;369;186;183;62;31;31;27;11;16;58;20;38;40;16;24;182;108;74;91.0;91.0;28.0;32.0;310.0;293.0;462
9191;Wieringen;2019;8868;1877;5070;1921;7993;491;158;333;384;193;191;64;31;33;28;13;15;59;22;37;45;22;23;188;105;83;91.0;89.0;29.0;33.0;338.0;307.0;462
9192;Wieringen;2020;8897;1879;5074;1944;8006;503;168;335;388;191;197;63;31;32;34;14;20;63;23;40;47;23;24;181;100;81;92.0;90.0;29.0;32.0;238.0;313.0;462
9193;Wieringen;2021;8822;1856;5018;1948;7935;496;168;328;391;190;201;61;30;31;34;12;22;59;22;37;48;24;24;189;102;87;91.0;92.0;24.0;34.0;404.0;296.0;462
9194;Wieringen;2022;8920;1856;5065;1999;7994;521;181;340;405;187;218;64;30;34;37;13;24;64;23;41;52;22;30;188;99;89;91.0;98.0;28.0;34.0;310.0;303.0;462
9195;Wieringen;2023;8915;1853;5049;2013;7960;542;195;347;413;185;228;63;28;35;32;11;21;76;25;51;57;25;32;185;96;89;92.0;93.0;26.0;30.0;321.0;313.0;462
9196;Wieringen;2024;8918;1832;5017;2069;7950;541;199;342;427;194;233;63;28;35;30;12;18;74;23;51;62;27;35;198;104;94;90.0;96.0;22.0;34.0;372.0;307.0;462
9197;Wieringen;2025;8966;1828;5034;2104;7966;548;203;345;452;203;249;69;32;37;33;13;20;81;27;54;66;24;42;203;107;96;;;;;;;462
9198;Wieringermeer;2008;12532;3148;7497;1887;11461;675;249;426;396;225;171;50;23;27;47;22;25;28;10;18;27;12;15;244;158;86;141.0;102.0;46.0;56.0;479.0;530.0;463
9199;Wieringermeer;2009;12513;3089;7479;1945;11414;668;245;423;431;244;187;60;31;29;48;22;26;34;12;22;32;14;18;257;165;92;146.0;100.0;38.0;57.0;493.0;534.0;463
9200;Wieringermeer;2010;12502;3028;7472;2002;11388;664;234;430;450;250;200;60;32;28;45;19;26;44;18;26;35;13;22;266;168;98;146.0;106.0;40.0;58.0;756.0;543.0;463
9201;Wieringermeer;2011;12735;3030;7633;2072;11578;676;241;435;481;272;209;67;37;30;45;20;25;55;26;29;38;16;22;276;173;103;149.0;105.0;42.0;60.0;794.0;565.0;463
9202;Wieringermeer;2012;12992;3084;7730;2178;11781;702;249;453;509;284;225;73;40;33;47;20;27;62;27;35;39;15;24;288;182;106;158.0;111.0;38.0;58.0;742.0;584.0;463
9203;Wieringermeer;2013;13179;3077;7789;2313;11904;712;243;469;563;304;259;83;44;39;50;22;28;70;28;42;49;19;30;311;191;120;164.0;115.0;48.0;56.0;750.0;603.0;463
9204;Wieringermeer;2014;13368;3085;7860;2423;12028;724;242;482;616;327;289;92;48;44;53;27;26;80;32;48;55;20;35;336;200;136;164.0;120.0;47.0;57.0;808.0;620.0;463
9205;Wieringermeer;2015;13591;3121;7936;2534;12207;735;236;499;649;339;310;85;47;38;52;23;29;87;36;51;62;25;37;363;208;155;166.0;125.0;45.0;57.0;704.0;636.0;463
9206;Wieringermeer;2016;13692;3123;7973;2596;12253;747;241;506;692;342;350;92;49;43;58;23;35;92;37;55;70;26;44;380;207;173;162.0;122.0;44.0;59.0;696.0;627.0;463
9207;Wieringermeer;2017;13787;3109;7974;2704;12332;748;241;507;707;355;352;91;49;42;57;23;34;100;42;58;65;25;40;394;216;178;165.0;128.0;47.0;59.0;707.0;614.0;463
9208;Wieringermeer;2018;13905;3115;8007;2783;12429;761;245;516;715;371;344;94;53;41;56;23;33;110;47;63;66;27;39;389;221;168;172.0;128.0;52.0;58.0;699.0;623.0;463
9209;Wieringermeer;2019;14022;3127;8044;2851;12510;777;248;529;735;376;359;96;52;44;55;22;33;124;52;72;67;28;39;393;222;171;173.0;136.0;47.0;57.0;713.0;647.0;463
9210;Wieringermeer;2020;14117;3134;8086;2897;12581;786;255;531;750;388;362;99;57;42;61;23;38;122;52;70;72;30;42;396;226;170;179.0;139.0;47.0;57.0;711.0;645.0;463
9211;Wieringermeer;2021;14215;3101;8153;2961;12629;804;269;535;782;414;368;106;62;44;60;25;35;128;56;72;84;36;48;404;235;169;179.0;141.0;46.0;57.0;799.0;645.0;463
9212;Wieringermeer;2022;14397;3119;8235;3043;12732;847;292;555;818;438;380;106;60;46;68;31;37;132;57;75;83;38;45;429;252;177;182.0;144.0;49.0;58.0;646.0;655.0;463
9213;Wieringermeer;2023;14417;3094;8199;3124;12729;850;292;558;838;432;406;104;57;47;70;30;40;132;54;78;89;36;53;443;255;188;182.0;146.0;50.0;52.0;663.0;642.0;463
9214;Wieringermeer;2024;14473;3101;8194;3178;12747;863;304;559;863;444;419;104;57;47;70;31;39;140;62;78;91;33;58;458;261;197;179.0;152.0;48.0;60.0;708.0;640.0;463
9215;Wieringermeer;2025;14558;3138;8150;3270;12785;875;319;556;898;451;447;110;60;50;75;32;43;149;64;85;98;33;65;466;262;204;;;;;;;463
9216;Wijchen;2008;39269;10075;24090;5104;34888;2810;871;1939;1571;851;720;256;127;129;186;88;98;291;135;156;195;92;103;643;409;234;391.0;286.0;121.0;175.0;1554.0;1633.0;296
9217;Wijchen;2009;39246;9904;24068;5274;34753;2833;860;1973;1660;912;748;267;135;132;188;98;90;298;142;156;215;99;116;692;438;254;380.0;291.0;131.0;178.0;1625.0;1662.0;296
9218;Wijchen;2010;39258;9795;24019;5444;34668;2848;857;1991;1742;973;769;278;142;136;199;101;98;317;163;154;234;111;123;714;456;258;377.0;303.0;136.0;175.0;1581.0;1693.0;296
9219;Wijchen;2011;39185;9564;23945;5676;34567;2830;859;1971;1788;1003;785;289;154;135;186;90;96;334;176;158;256;122;134;723;461;262;369.0;304.0;133.0;178.0;1773.0;1669.0;296
9220;Wijchen;2012;39314;9377;24003;5934;34567;2839;867;1972;1908;1061;847;301;163;138;196;93;103;357;188;169;267;122;145;787;495;292;370.0;312.0;134.0;177.0;1622.0;1709.0;296
9221;Wijchen;2013;39245;9209;23808;6228;34407;2859;878;1981;1979;1089;890;312;164;148;202;96;106;380;191;189;276;129;147;809;509;300;370.0;321.0;142.0;168.0;1558.0;1709.0;296
9222;Wijchen;2014;39124;8984;23684;6456;34249;2848;894;1954;2027;1133;894;314;168;146;206;105;101;411;207;204;277;131;146;819;522;297;368.0;324.0;139.0;161.0;1521.0;1682.0;296
9223;Wijchen;2015;38986;8782;23516;6688;34090;2814;887;1927;2082;1150;932;322;173;149;220;108;112;428;217;211;287;131;156;825;521;304;366.0;325.0;139.0;163.0;1659.0;1714.0;296
9224;Wijchen;2016;38951;8677;23354;6920;33996;2840;905;1935;2115;1149;966;325;178;147;224;113;111;432;226;206;303;129;174;831;503;328;377.0;343.0;132.0;152.0;1645.0;1710.0;296
9225;Wijchen;2017;38904;8522;23282;7100;33878;2856;924;1932;2170;1158;1012;334;182;152;233;119;114;458;237;221;308;127;181;837;493;344;367.0;342.0;130.0;161.0;1687.0;1695.0;296
9226;Wijchen;2018;38896;8364;23209;7323;33759;2886;955;1931;2251;1199;1052;328;178;150;242;125;117;476;238;238;333;136;197;872;522;350;376.0;353.0;136.0;159.0;1539.0;1721.0;296
9227;Wijchen;2019;38717;8192;23036;7489;33540;2871;965;1906;2306;1223;1083;336;181;155;248;129;119;489;237;252;350;145;205;883;531;352;375.0;358.0;129.0;155.0;1544.0;1696.0;296
9228;Wijchen;2020;38562;8044;22834;7684;33367;2848;957;1891;2347;1228;1119;350;192;158;258;128;130;499;246;253;343;135;208;897;527;370;380.0;365.0;125.0;157.0;1620.0;1694.0;296
9229;Wijchen;2021;38474;7918;22708;7848;33205;2867;975;1892;2402;1245;1157;361;190;171;251;128;123;515;253;262;353;134;219;922;540;382;381.0;378.0;125.0;149.0;1543.0;1691.0;296
9230;Wijchen;2022;38310;7802;22431;8077;32996;2850;978;1872;2464;1276;1188;372;202;170;250;134;116;524;255;269;374;138;236;944;547;397;382.0;377.0;136.0;149.0;1566.0;1699.0;296
9231;Wijchen;2023;38171;7707;22263;8201;32788;2854;995;1859;2529;1301;1228;383;214;169;257;142;115;550;259;291;394;145;249;945;541;404;386.0;386.0;127.0;154.0;1587.0;1671.0;296
9232;Wijchen;2024;38063;7551;22111;8401;32597;2864;1015;1849;2602;1317;1285;387;221;166;269;145;124;563;264;299;413;153;260;970;534;436;375.0;390.0;128.0;146.0;1609.0;1658.0;296
9233;Wijchen;2025;37984;7477;21903;8604;32433;2889;1035;1854;2662;1341;1321;391;220;171;262;139;123;581;274;307;428;159;269;1000;549;451;;;;;;;296
9234;Wijdemeren;2008;23530;5654;13690;4186;20799;1844;613;1231;887;459;428;125;51;74;95;39;56;81;37;44;100;45;55;486;287;199;186.0;209.0;126.0;145.0;1064.0;1104.0;1696
9235;Wijdemeren;2009;23451;5627;13551;4273;20650;1817;604;1213;984;499;485;144;54;90;102;44;58;99;47;52;119;51;68;520;303;217;174.0;207.0;125.0;140.0;1097.0;1103.0;1696
9236;Wijdemeren;2010;23398;5555;13443;4400;20519;1819;609;1210;1060;504;556;159;53;106;108;52;56;110;44;66;146;54;92;537;301;236;168.0;208.0;129.0;137.0;1028.0;1068.0;1696
9237;Wijdemeren;2011;23312;5436;13378;4498;20358;1840;617;1223;1114;517;597;168;57;111;110;45;65;128;52;76;155;56;99;553;307;246;165.0;213.0;147.0;137.0;1024.0;1091.0;1696
9238;Wijdemeren;2012;23209;5332;13129;4748;20168;1859;637;1222;1182;541;641;187;65;122;110;47;63;130;56;74;165;59;106;590;314;276;156.0;214.0;140.0;138.0;1189.0;1122.0;1696
9239;Wijdemeren;2013;23223;5271;13054;4898;20134;1855;649;1206;1234;562;672;200;70;130;109;50;59;148;60;88;177;65;112;600;317;283;161.0;210.0;148.0;138.0;1143.0;1140.0;1696
9240;Wijdemeren;2014;23188;5181;12980;5027;20005;1868;656;1212;1315;588;727;225;85;140;118;54;64;175;71;104;194;71;123;603;307;296;167.0;213.0;150.0;133.0;1080.0;1138.0;1696
9241;Wijdemeren;2015;23104;5093;12912;5099;19834;1903;678;1225;1367;620;747;226;91;135;124;59;65;192;76;116;198;73;125;627;321;306;170.0;218.0;140.0;136.0;1067.0;1140.0;1696
9242;Wijdemeren;2016;22990;5031;12764;5195;19648;1906;673;1233;1436;643;793;237;99;138;133;64;69;205;77;128;214;77;137;647;326;321;172.0;224.0;138.0;125.0;1177.0;1135.0;1696
9243;Wijdemeren;2017;22995;4974;12739;5282;19554;1915;675;1240;1526;696;830;253;104;149;137;77;60;228;89;139;223;79;144;685;347;338;177.0;218.0;139.0;130.0;1120.0;1103.0;1696
9244;Wijdemeren;2018;22982;4903;12712;5367;19477;1936;689;1247;1569;721;848;258;114;144;138;76;62;241;97;144;237;86;151;695;348;347;182.0;220.0;139.0;130.0;1026.0;1130.0;1696
9245;Wijdemeren;2019;22849;4790;12645;5414;19330;1954;709;1245;1565;694;871;262;114;148;140;73;67;255;100;155;231;89;142;677;318;359;184.0;221.0;149.0;129.0;1009.0;1082.0;1696
9246;Wijdemeren;2020;22760;4720;12531;5509;19185;1942;702;1240;1633;730;903;258;116;142;157;83;74;270;111;159;243;93;150;705;327;378;182.0;234.0;140.0;126.0;1142.0;1103.0;1696
9247;Wijdemeren;2021;22762;4714;12468;5580;19083;1973;731;1242;1706;760;946;287;130;157;162;83;79;287;121;166;254;96;158;716;330;386;181.0;230.0;138.0;125.0;1202.0;1130.0;1696
9248;Wijdemeren;2022;22802;4697;12455;5650;19046;2021;750;1271;1735;752;983;298;130;168;172;87;85;291;123;168;263;93;170;711;319;392;191.0;232.0;127.0;123.0;1100.0;1117.0;1696
9249;Wijdemeren;2023;22750;4633;12416;5701;18914;2034;757;1277;1802;788;1014;309;138;171;167;79;88;312;133;179;264;92;172;750;346;404;190.0;235.0;128.0;125.0;1033.0;1129.0;1696
9250;Wijdemeren;2024;22613;4551;12303;5759;18750;2047;782;1265;1816;799;1017;327;145;182;169;78;91;314;138;176;262;102;160;744;336;408;198.0;241.0;128.0;120.0;1174.0;1128.0;1696
9251;Wijdemeren;2025;22625;4517;12270;5838;18679;2047;785;1262;1899;851;1048;342;154;188;189;90;99;330;144;186;268;106;162;770;357;413;;;;;;;1696
9252;Wijk bij Duurstede;2008;23269;6227;14570;2472;20821;1483;461;1022;965;507;458;143;68;75;98;36;62;52;20;32;229;96;133;443;287;156;214.0;131.0;73.0;100.0;690.0;867.0;352
9253;Wijk bij Duurstede;2009;23152;6029;14516;2607;20714;1475;472;1003;963;501;462;141;70;71;102;36;66;61;21;40;232;99;133;427;275;152;202.0;137.0;75.0;97.0;741.0;857.0;352
9254;Wijk bij Duurstede;2010;23082;5847;14471;2764;20615;1474;488;986;993;523;470;150;73;77;102;37;65;67;25;42;233;99;134;441;289;152;198.0;145.0;70.0;95.0;680.0;895.0;352
9255;Wijk bij Duurstede;2011;22898;5657;14348;2893;20442;1469;483;986;987;524;463;155;76;79;100;40;60;66;30;36;239;99;140;427;279;148;195.0;147.0;73.0;93.0;747.0;885.0;352
9256;Wijk bij Duurstede;2012;22792;5439;14210;3143;20298;1455;476;979;1039;557;482;162;84;78;103;45;58;84;35;49;249;104;145;441;289;152;191.0;153.0;79.0;92.0;679.0;878.0;352
9257;Wijk bij Duurstede;2013;22621;5225;14027;3369;20091;1458;475;983;1072;560;512;164;85;79;109;42;67;99;39;60;254;100;154;446;294;152;193.0;154.0;75.0;94.0;770.0;894.0;352
9258;Wijk bij Duurstede;2014;22519;5094;13857;3568;19973;1446;473;973;1100;577;523;160;84;76;117;47;70;111;46;65;263;105;158;449;295;154;192.0;163.0;73.0;88.0;771.0;875.0;352
9259;Wijk bij Duurstede;2015;22431;4951;13727;3753;19842;1460;491;969;1129;600;529;162;90;72;109;48;61;126;52;74;269;105;164;463;305;158;193.0;166.0;74.0;88.0;737.0;891.0;352
9260;Wijk bij Duurstede;2016;22294;4820;13583;3891;19668;1455;493;962;1171;617;554;171;96;75;123;58;65;127;53;74;277;109;168;473;301;172;193.0;170.0;76.0;88.0;745.0;920.0;352
9261;Wijk bij Duurstede;2017;22133;4696;13402;4035;19469;1460;500;960;1204;649;555;174;98;76;137;70;67;132;61;71;284;111;173;477;309;168;190.0;175.0;75.0;78.0;764.0;892.0;352
9262;Wijk bij Duurstede;2018;22019;4563;13254;4202;19322;1458;512;946;1239;670;569;179;101;78;139;72;67;132;58;74;298;119;179;491;320;171;200.0;181.0;66.0;84.0;794.0;877.0;352
9263;Wijk bij Duurstede;2019;21941;4479;13089;4373;19237;1442;509;933;1262;666;596;188;102;86;133;66;67;138;61;77;311;121;190;492;316;176;194.0;183.0;80.0;82.0;743.0;883.0;352
9264;Wijk bij Duurstede;2020;21813;4346;12966;4501;19072;1457;520;937;1284;685;599;198;107;91;130;69;61;155;69;86;303;117;186;498;323;175;202.0;188.0;75.0;81.0;819.0;880.0;352
9265;Wijk bij Duurstede;2021;21762;4237;12847;4678;18995;1457;530;927;1310;692;618;196;106;90;134;75;59;154;71;83;316;121;195;510;319;191;203.0;190.0;69.0;76.0;810.0;885.0;352
9266;Wijk bij Duurstede;2022;21696;4142;12744;4810;18932;1447;521;926;1317;695;622;195;104;91;137;74;63;162;74;88;305;123;182;518;320;198;209.0;194.0;74.0;80.0;806.0;896.0;352
9267;Wijk bij Duurstede;2023;21618;4060;12584;4974;18843;1457;529;928;1318;699;619;197;108;89;135;73;62;156;77;79;309;123;186;521;318;203;213.0;200.0;73.0;75.0;777.0;882.0;352
9268;Wijk bij Duurstede;2024;21527;4010;12376;5141;18721;1437;507;930;1369;736;633;208;114;94;144;74;70;153;75;78;311;128;183;553;345;208;211.0;211.0;69.0;76.0;862.0;866.0;352
9269;Wijk bij Duurstede;2025;21519;4007;12258;5254;18666;1450;528;922;1403;737;666;217;118;99;151;76;75;160;75;85;321;130;191;554;338;216;;;;;;;352
9270;Winschoten;2008;18170;3793;10701;3676;15971;1383;613;770;816;506;310;163;88;75;42;24;18;99;49;50;48;23;25;464;322;142;185.0;239.0;68.0;119.0;929.0;930.0;52
9271;Winschoten;2009;18068;3799;10632;3637;15875;1357;597;760;836;515;321;163;92;71;47;26;21;115;60;55;55;28;27;456;309;147;178.0;238.0;74.0;124.0;943.0;912.0;52
9272;Winschoten;2010;17991;3776;10586;3629;15775;1346;598;748;870;531;339;166;93;73;59;35;24;118;65;53;64;29;35;463;309;154;176.0;239.0;71.0;116.0;984.0;937.0;52
9273;Winschoten;2011;17930;3754;10544;3632;15708;1334;586;748;888;537;351;179;97;82;64;38;26;121;70;51;68;27;41;456;305;151;174.0;230.0;89.0;112.0;964.0;936.0;52
9274;Winschoten;2012;17882;3744;10434;3704;15648;1318;583;735;916;557;359;185;100;85;73;43;30;135;76;59;64;30;34;459;308;151;172.0;222.0;83.0;109.0;917.0;918.0;52
9275;Winschoten;2013;17807;3717;10321;3769;15558;1303;578;725;946;573;373;198;106;92;76;47;29;147;82;65;70;33;37;455;305;150;171.0;229.0;74.0;112.0;941.0;903.0;52
9276;Winschoten;2014;17751;3711;10259;3781;15478;1306;589;717;967;580;387;199;111;88;81;48;33;162;90;72;75;33;42;450;298;152;168.0;224.0;73.0;110.0;935.0;898.0;52
9277;Winschoten;2015;17698;3656;10254;3788;15406;1302;597;705;990;587;403;210;117;93;78;47;31;175;95;80;81;35;46;446;293;153;169.0;217.0;70.0;101.0;905.0;899.0;52
9278;Winschoten;2016;17628;3638;10219;3771;15285;1309;607;702;1034;611;423;214;122;92;93;54;39;187;101;86;96;40;56;444;294;150;169.0;217.0;73.0;106.0;911.0;921.0;52
9279;Winschoten;2017;17539;3588;10130;3821;15213;1284;597;687;1042;608;434;210;120;90;89;52;37;201;107;94;102;44;58;440;285;155;167.0;218.0;68.0;100.0;893.0;889.0;52
9280;Winschoten;2018;17465;3571;10051;3843;15156;1254;582;672;1055;596;459;217;125;92;97;56;41;224;114;110;100;41;59;417;260;157;167.0;214.0;68.0;98.0;897.0;892.0;52
9281;Winschoten;2019;17395;3551;9995;3849;15071;1243;581;662;1081;606;475;213;125;88;103;56;47;232;114;118;109;47;62;424;264;160;165.0;218.0;67.0;93.0;958.0;874.0;52
9282;Winschoten;2020;17402;3549;9964;3889;15030;1249;582;667;1123;631;492;223;131;92;110;60;50;246;114;132;114;54;60;430;272;158;162.0;218.0;67.0;102.0;895.0;864.0;52
9283;Winschoten;2021;17345;3504;9919;3922;14950;1265;582;683;1130;644;486;222;131;91;108;63;45;258;123;135;121;58;63;421;269;152;161.0;215.0;66.0;97.0;924.0;879.0;52
9284;Winschoten;2022;17306;3513;9840;3953;14880;1243;558;685;1183;680;503;232;134;98;114;67;47;282;137;145;125;60;65;430;282;148;161.0;215.0;70.0;93.0;847.0;869.0;52
9285;Winschoten;2023;17209;3471;9760;3978;14765;1241;555;686;1203;694;509;238;139;99;117;67;50;287;141;146;134;64;70;427;283;144;159.0;218.0;83.0;87.0;831.0;867.0;52
9286;Winschoten;2024;17113;3482;9621;4010;14657;1234;560;674;1222;715;507;231;138;93;119;67;52;297;149;148;147;72;75;428;289;139;156.0;221.0;65.0;91.0;895.0;849.0;52
9287;Winschoten;2025;17070;3493;9541;4036;14591;1215;558;657;1264;728;536;228;135;93;127;71;56;315;152;163;152;72;80;442;298;144;;;;;;;52
9288;Winsum;2008;14142;3659;8558;1925;13171;607;197;410;364;209;155;50;19;31;58;35;23;25;6;19;22;12;10;209;137;72;159.0;104.0;40.0;59.0;713.0;759.0;53
9289;Winsum;2009;14134;3564;8576;1994;13137;606;199;407;391;225;166;58;24;34;62;36;26;27;6;21;24;14;10;220;145;75;159.0;108.0;43.0;64.0;685.0;770.0;53
9290;Winsum;2010;14079;3464;8553;2062;13076;605;187;418;398;228;170;57;26;31;60;34;26;38;10;28;29;15;14;214;143;71;160.0;106.0;42.0;62.0;724.0;789.0;53
9291;Winsum;2011;14047;3395;8523;2129;13040;592;188;404;415;236;179;64;28;36;62;37;25;34;9;25;29;15;14;226;147;79;167.0;105.0;57.0;62.0;698.0;776.0;53
9292;Winsum;2012;14028;3321;8433;2274;12990;598;191;407;440;246;194;54;27;27;69;37;32;45;13;32;40;20;20;232;149;83;163.0;108.0;46.0;57.0;674.0;793.0;53
9293;Winsum;2013;13954;3251;8305;2398;12900;597;189;408;457;245;212;61;29;32;76;39;37;46;15;31;52;22;30;222;140;82;165.0;112.0;49.0;59.0;735.0;761.0;53
9294;Winsum;2014;13971;3216;8245;2510;12897;593;189;404;481;252;229;57;29;28;76;42;34;54;19;35;58;22;36;236;140;96;164.0;114.0;66.0;56.0;740.0;771.0;53
9295;Winsum;2015;14007;3187;8218;2602;12872;608;197;411;527;274;253;67;32;35;85;47;38;64;25;39;70;30;40;241;140;101;164.0;113.0;46.0;56.0;773.0;762.0;53
9296;Winsum;2016;14061;3146;8248;2667;12911;610;200;410;540;272;268;70;33;37;89;50;39;62;25;37;70;29;41;249;135;114;171.0;114.0;38.0;59.0;728.0;769.0;53
9297;Winsum;2017;14059;3117;8202;2740;12915;601;190;411;543;270;273;72;34;38;88;48;40;68;28;40;75;29;46;240;131;109;174.0;118.0;44.0;52.0;730.0;772.0;53
9298;Winsum;2018;14067;3093;8175;2799;12882;601;191;410;584;288;296;79;39;40;99;56;43;73;32;41;84;29;55;249;132;117;176.0;118.0;42.0;57.0;752.0;774.0;53
9299;Winsum;2019;14093;3088;8129;2876;12876;602;185;417;615;307;308;77;39;38;107;60;47;78;36;42;85;30;55;268;142;126;174.0;124.0;52.0;57.0;739.0;790.0;53
9300;Winsum;2020;14088;3062;8093;2933;12842;625;190;435;621;305;316;79;40;39;107;55;52;87;37;50;86;31;55;262;142;120;173.0;120.0;45.0;55.0;716.0;773.0;53
9301;Winsum;2021;14074;3045;8023;3006;12809;633;195;438;632;297;335;79;37;42;105;52;53;89;39;50;90;32;58;269;137;132;177.0;127.0;42.0;53.0;748.0;767.0;53
9302;Winsum;2022;14096;3038;7970;3088;12795;650;200;450;651;307;344;89;43;46;110;57;53;94;40;54;94;33;61;264;134;130;176.0;132.0;45.0;54.0;742.0;761.0;53
9303;Winsum;2023;14113;3029;7941;3143;12789;656;199;457;668;314;354;90;39;51;105;58;47;113;46;67;99;35;64;261;136;125;173.0;132.0;41.0;49.0;737.0;768.0;53
9304;Winsum;2024;14116;3021;7868;3227;12764;660;197;463;692;330;362;90;41;49;118;68;50;111;48;63;103;40;63;270;133;137;173.0;133.0;37.0;58.0;772.0;745.0;53
9305;Winsum;2025;14164;3054;7827;3283;12804;654;196;458;706;344;362;96;44;52;112;65;47;117;51;66;103;41;62;278;143;135;;;;;;;53
9306;Winterswijk;2008;29197;7163;16973;5061;25118;2616;1009;1607;1463;871;592;75;41;34;37;20;17;440;231;209;198;90;108;713;489;224;331.0;320.0;91.0;143.0;887.0;819.0;294
9307;Winterswijk;2009;29226;7167;16948;5111;25121;2592;1008;1584;1513;897;616;86;49;37;41;22;19;437;227;210;207;92;115;742;507;235;322.0;322.0;86.0;140.0;908.0;810.0;294
9308;Winterswijk;2010;29274;7160;16927;5187;25161;2578;1003;1575;1535;894;641;98;57;41;52;31;21;441;233;208;214;93;121;730;480;250;323.0;320.0;103.0;135.0;926.0;843.0;294
9309;Winterswijk;2011;29332;7110;16993;5229;25169;2553;985;1568;1610;925;685;109;62;47;57;36;21;449;234;215;231;97;134;764;496;268;327.0;324.0;94.0;137.0;927.0;868.0;294
9310;Winterswijk;2012;29355;7047;16936;5372;25154;2553;989;1564;1648;925;723;122;68;54;58;36;22;468;237;231;218;94;124;782;490;292;320.0;328.0;97.0;133.0;875.0;845.0;294
9311;Winterswijk;2013;29344;6998;16860;5486;25090;2546;998;1548;1708;967;741;134;72;62;68;44;24;463;235;228;218;96;122;825;520;305;321.0;326.0;96.0;137.0;902.0;847.0;294
9312;Winterswijk;2014;29355;6970;16784;5601;25047;2550;1003;1547;1758;969;789;148;79;69;81;52;29;469;236;233;223;96;127;837;506;331;316.0;332.0;95.0;130.0;908.0;857.0;294
9313;Winterswijk;2015;29356;6917;16711;5728;25014;2529;981;1548;1813;994;819;159;87;72;87;55;32;469;237;232;234;98;136;864;517;347;308.0;331.0;92.0;132.0;925.0;843.0;294
9314;Winterswijk;2016;29378;6876;16696;5806;24980;2551;997;1554;1847;1001;846;171;89;82;93;58;35;466;235;231;250;101;149;867;518;349;310.0;342.0;95.0;132.0;888.0;858.0;294
9315;Winterswijk;2017;29340;6822;16675;5843;24876;2545;1003;1542;1919;1042;877;185;97;88;109;66;43;457;231;226;261;106;155;907;542;365;312.0;338.0;100.0;121.0;899.0;886.0;294
9316;Winterswijk;2018;29308;6776;16595;5937;24773;2557;1026;1531;1978;1047;931;192;99;93;123;69;54;454;228;226;261;104;157;948;547;401;311.0;332.0;94.0;124.0;845.0;855.0;294
9317;Winterswijk;2019;29250;6737;16480;6033;24713;2526;1016;1510;2011;1059;952;202;101;101;119;67;52;469;232;237;262;108;154;959;551;408;311.0;338.0;88.0;121.0;888.0;870.0;294
9318;Winterswijk;2020;29209;6633;16444;6132;24645;2510;999;1511;2054;1080;974;214;110;104;124;68;56;477;233;244;273;112;161;966;557;409;306.0;343.0;98.0;123.0;827.0;860.0;294
9319;Winterswijk;2021;29120;6590;16331;6199;24547;2480;1008;1472;2093;1103;990;224;117;107;126;72;54;473;229;244;282;115;167;988;570;418;304.0;341.0;92.0;116.0;926.0;868.0;294
9320;Winterswijk;2022;29121;6523;16267;6331;24539;2446;1007;1439;2136;1127;1009;243;126;117;130;75;55;461;222;239;281;115;166;1021;589;432;306.0;344.0;99.0;118.0;885.0;869.0;294
9321;Winterswijk;2023;29083;6455;16175;6453;24484;2436;1019;1417;2163;1144;1019;252;130;122;137;81;56;451;219;232;285;112;173;1038;602;436;305.0;349.0;97.0;128.0;869.0;860.0;294
9322;Winterswijk;2024;29020;6345;16094;6581;24419;2427;1036;1391;2174;1148;1026;258;128;130;148;89;59;450;223;227;282;108;174;1036;600;436;303.0;352.0;94.0;110.0;846.0;847.0;294
9323;Winterswijk;2025;28957;6316;15932;6709;24319;2430;1041;1389;2208;1169;1039;265;129;136;158;90;68;437;218;219;294;116;178;1054;616;438;;;;;;;294
9324;Woensdrecht;2008;21077;4589;12823;3665;17194;3244;1489;1755;639;357;282;87;44;43;52;30;22;106;57;49;81;36;45;313;190;123;163.0;168.0;119.0;159.0;609.0;687.0;873
9325;Woensdrecht;2009;20956;4499;12651;3806;17106;3168;1439;1729;682;385;297;93;49;44;60;36;24;120;66;54;89;43;46;320;191;129;160.0;175.0;124.0;150.0;601.0;664.0;873
9326;Woensdrecht;2010;20853;4437;12432;3984;17009;3102;1403;1699;742;402;340;106;51;55;67;37;30;132;67;65;101;54;47;336;193;143;161.0;176.0;142.0;149.0;513.0;674.0;873
9327;Woensdrecht;2011;20673;4324;12177;4172;16866;3034;1383;1651;773;412;361;115;56;59;63;34;29;142;68;74;111;61;50;342;193;149;149.0;183.0;130.0;142.0;539.0;676.0;873
9328;Woensdrecht;2012;20491;4201;11928;4362;16695;3004;1373;1631;792;426;366;112;55;57;59;32;27;143;67;76;121;63;58;357;209;148;147.0;183.0;136.0;139.0;583.0;668.0;873
9329;Woensdrecht;2013;20369;4122;11666;4581;16585;2944;1334;1610;840;451;389;118;55;63;64;35;29;153;77;76;136;65;71;369;219;150;146.0;194.0;150.0;138.0;524.0;672.0;873
9330;Woensdrecht;2014;20187;4007;11439;4741;16412;2889;1311;1578;886;470;416;126;56;70;70;37;33;162;82;80;145;69;76;383;226;157;140.0;194.0;124.0;137.0;573.0;651.0;873
9331;Woensdrecht;2015;20042;3920;11248;4874;16252;2862;1316;1546;928;498;430;132;62;70;76;43;33;167;85;82;166;77;89;387;231;156;141.0;200.0;124.0;129.0;494.0;658.0;873
9332;Woensdrecht;2016;19816;3832;11008;4976;16037;2808;1270;1538;971;518;453;140;66;74;76;41;35;170;84;86;181;90;91;404;237;167;141.0;202.0;136.0;129.0;519.0;640.0;873
9333;Woensdrecht;2017;19646;3739;10849;5058;15878;2754;1246;1508;1014;533;481;153;68;85;77;40;37;180;89;91;200;98;102;404;238;166;143.0;206.0;126.0;124.0;691.0;627.0;873
9334;Woensdrecht;2018;19648;3703;10807;5138;15857;2734;1248;1486;1057;549;508;162;72;90;76;40;36;192;93;99;217;106;111;410;238;172;141.0;209.0;116.0;128.0;636.0;656.0;873
9335;Woensdrecht;2019;19549;3598;10737;5214;15751;2702;1233;1469;1096;562;534;169;75;94;81;42;39;212;101;111;229;108;121;405;236;169;147.0;213.0;125.0;119.0;532.0;669.0;873
9336;Woensdrecht;2020;19352;3516;10579;5257;15570;2649;1209;1440;1133;587;546;174;81;93;86;47;39;232;104;128;237;116;121;404;239;165;142.0;213.0;115.0;119.0;727.0;632.0;873
9337;Woensdrecht;2021;19373;3464;10554;5355;15509;2666;1217;1449;1198;612;586;175;82;93;95;52;43;255;115;140;252;123;129;421;240;181;153.0;220.0;107.0;121.0;687.0;643.0;873
9338;Woensdrecht;2022;19336;3418;10521;5397;15460;2643;1207;1436;1233;630;603;188;92;96;106;60;46;257;117;140;263;125;138;419;236;183;151.0;225.0;113.0;115.0;713.0;640.0;873
9339;Woensdrecht;2023;19334;3378;10485;5471;15420;2609;1190;1419;1305;674;631;198;96;102;105;59;46;275;128;147;280;134;146;447;257;190;158.0;236.0;124.0;110.0;591.0;650.0;873
9340;Woensdrecht;2024;19211;3351;10343;5517;15309;2559;1152;1407;1343;687;656;210;97;113;104;60;44;277;134;143;295;140;155;457;256;201;163.0;231.0;112.0;107.0;661.0;636.0;873
9341;Woensdrecht;2025;19176;3355;10271;5550;15238;2523;1138;1385;1415;723;692;216;99;117;103;58;45;305;146;159;317;153;164;474;267;207;;;;;;;873
9342;Woerden;2008;48038;12859;29049;6130;41986;3062;1037;2025;2990;1642;1348;439;247;192;167;76;91;207;100;107;1181;617;564;996;602;394;558.0;356.0;147.0;156.0;1575.0;1758.0;632
9343;Woerden;2009;48057;12716;28971;6370;41919;3094;1067;2027;3044;1656;1388;436;246;190;167;78;89;240;108;132;1178;608;570;1023;616;407;560.0;363.0;157.0;146.0;1583.0;1777.0;632
9344;Woerden;2010;48077;12621;28848;6608;41838;3126;1103;2023;3113;1693;1420;439;253;186;173;86;87;261;115;146;1192;618;574;1048;621;427;550.0;375.0;169.0;148.0;1550.0;1760.0;632
9345;Woerden;2011;48066;12459;28822;6785;41696;3170;1134;2036;3200;1743;1457;463;265;198;185;89;96;280;122;158;1190;625;565;1082;642;440;534.0;378.0;172.0;135.0;1567.0;1738.0;632
9346;Woerden;2012;48093;12308;28644;7141;41605;3189;1160;2029;3299;1778;1521;482;270;212;209;103;106;299;127;172;1203;631;572;1106;647;459;516.0;391.0;168.0;145.0;1507.0;1724.0;632
9347;Woerden;2013;48029;12117;28428;7484;41453;3226;1180;2046;3350;1794;1556;492;271;221;217;100;117;318;132;186;1213;642;571;1110;649;461;520.0;394.0;175.0;136.0;1539.0;1663.0;632
9348;Woerden;2014;48076;12001;28285;7790;41339;3285;1217;2068;3452;1844;1608;501;271;230;223;110;113;338;139;199;1224;649;575;1166;675;491;519.0;406.0;177.0;136.0;1592.0;1661.0;632
9349;Woerden;2015;48165;11912;28185;8068;41306;3331;1242;2089;3528;1872;1656;509;270;239;235;113;122;363;144;219;1218;645;573;1203;700;503;503.0;410.0;186.0;155.0;1570.0;1702.0;632
9350;Woerden;2016;48167;11805;28045;8317;41180;3374;1266;2108;3613;1922;1691;527;276;251;255;119;136;378;158;220;1206;639;567;1247;730;517;498.0;423.0;172.0;136.0;1583.0;1705.0;632
9351;Woerden;2017;48160;11705;27905;8550;41104;3406;1277;2129;3650;1950;1700;532;287;245;257;120;137;388;162;226;1210;637;573;1263;744;519;500.0;430.0;168.0;125.0;1545.0;1706.0;632
9352;Woerden;2018;48116;11556;27809;8751;40947;3448;1317;2131;3721;1977;1744;535;293;242;277;133;144;403;167;236;1206;635;571;1300;749;551;503.0;430.0;182.0;137.0;1517.0;1689.0;632
9353;Woerden;2019;48065;11346;27744;8975;40805;3514;1348;2166;3746;1971;1775;551;295;256;288;135;153;427;181;246;1202;631;571;1278;729;549;506.0;442.0;173.0;129.0;1591.0;1660.0;632
9354;Woerden;2020;48104;11209;27711;9184;40701;3570;1381;2189;3833;2005;1828;569;302;267;290;141;149;454;192;262;1218;629;589;1302;741;561;501.0;455.0;196.0;127.0;1516.0;1714.0;632
9355;Woerden;2021;48022;11005;27674;9343;40537;3611;1424;2187;3874;2052;1822;576;307;269;297;148;149;475;196;279;1198;634;564;1328;767;561;500.0;461.0;181.0;127.0;1651.0;1714.0;632
9356;Woerden;2022;48054;10825;27702;9527;40434;3664;1460;2204;3956;2105;1851;584;315;269;310;152;158;495;202;293;1208;637;571;1359;799;560;508.0;461.0;191.0;137.0;1608.0;1731.0;632
9357;Woerden;2023;48038;10705;27576;9757;40331;3715;1498;2217;3992;2111;1881;603;316;287;315;160;155;507;215;292;1188;623;565;1379;797;582;507.0;469.0;176.0;125.0;1515.0;1709.0;632
9358;Woerden;2024;47938;10544;27417;9977;40183;3739;1507;2232;4016;2143;1873;606;320;286;333;171;162;526;227;299;1172;615;557;1379;810;569;513.0;488.0;168.0;129.0;1758.0;1708.0;632
9359;Woerden;2025;48058;10522;27333;10203;40185;3770;1538;2232;4103;2188;1915;624;322;302;342;180;162;526;227;299;1183;617;566;1428;842;586;;;;;;;632
9360;De Wolden;2008;23416;5935;13281;4200;22330;719;254;465;367;199;168;48;23;25;27;11;16;42;19;23;44;20;24;206;126;80;186.0;214.0;45.0;83.0;935.0;1125.0;1690
9361;De Wolden;2009;23166;5760;13141;4265;22026;721;257;464;419;221;198;56;26;30;27;11;16;55;25;30;57;25;32;224;134;90;181.0;212.0;45.0;78.0;1007.0;1117.0;1690
9362;De Wolden;2010;22995;5633;12968;4394;21810;729;254;475;456;241;215;67;34;33;33;16;17;69;30;39;61;26;35;226;135;91;173.0;210.0;56.0;78.0;1146.0;1154.0;1690
9363;De Wolden;2011;22930;5493;12977;4460;21684;731;258;473;515;279;236;78;44;34;36;18;18;82;33;49;72;33;39;247;151;96;175.0;208.0;54.0;80.0;1044.0;1156.0;1690
9364;De Wolden;2012;22759;5352;12804;4603;21465;739;263;476;555;306;249;93;53;40;45;22;23;84;35;49;81;37;44;252;159;93;169.0;221.0;50.0;83.0;1085.0;1172.0;1690
9365;De Wolden;2013;22592;5204;12680;4708;21254;748;267;481;590;324;266;102;56;46;45;24;21;93;41;52;84;39;45;266;164;102;173.0;219.0;67.0;79.0;1128.0;1149.0;1690
9366;De Wolden;2014;22516;5085;12590;4841;21116;758;273;485;642;343;299;113;63;50;53;29;24;105;41;64;93;40;53;278;170;108;178.0;223.0;56.0;76.0;1123.0;1176.0;1690
9367;De Wolden;2015;22403;4970;12467;4966;20946;767;274;493;690;359;331;119;67;52;54;28;26;123;46;77;100;43;57;294;175;119;170.0;225.0;54.0;74.0;1086.0;1157.0;1690
9368;De Wolden;2016;22260;4838;12362;5060;20777;761;269;492;722;356;366;133;74;59;56;26;30;134;47;87;109;49;60;290;160;130;181.0;226.0;42.0;78.0;1022.0;1154.0;1690
9369;De Wolden;2017;22051;4743;12149;5159;20547;743;261;482;761;379;382;147;81;66;59;26;33;139;52;87;116;50;66;300;170;130;176.0;225.0;59.0;79.0;1058.0;1125.0;1690
9370;De Wolden;2018;21916;4636;11998;5282;20378;757;273;484;781;403;378;147;83;64;59;27;32;143;53;90;121;56;65;311;184;127;180.0;231.0;48.0;71.0;1071.0;1134.0;1690
9371;De Wolden;2019;21781;4543;11862;5376;20192;747;262;485;842;415;427;154;84;70;66;28;38;160;58;102;138;61;77;324;184;140;182.0;231.0;51.0;73.0;1024.0;1126.0;1690
9372;De Wolden;2020;21609;4409;11741;5459;19968;744;260;484;897;440;457;167;93;74;77;35;42;174;66;108;153;60;93;326;186;140;183.0;233.0;49.0;75.0;1089.0;1127.0;1690
9373;De Wolden;2021;21497;4310;11638;5549;19848;736;262;474;913;454;459;167;97;70;84;37;47;181;72;109;149;56;93;332;192;140;184.0;236.0;50.0;71.0;1041.0;1146.0;1690
9374;De Wolden;2022;21319;4193;11484;5642;19658;734;258;476;927;463;464;163;94;69;91;41;50;187;72;115;149;59;90;337;197;140;186.0;241.0;52.0;73.0;1009.0;1156.0;1690
9375;De Wolden;2023;21099;4103;11272;5724;19422;735;268;467;942;472;470;164;93;71;99;40;59;194;78;116;157;64;93;328;197;131;189.0;242.0;43.0;68.0;1166.0;1099.0;1690
9376;De Wolden;2024;21090;4092;11144;5854;19368;742;269;473;980;484;496;171;99;72;104;39;65;205;79;126;156;66;90;344;201;143;185.0;247.0;53.0;73.0;1181.0;1094.0;1690
9377;De Wolden;2025;21096;4094;11075;5927;19327;744;261;483;1025;498;527;178;101;77;107;43;64;218;81;137;168;74;94;354;199;155;;;;;;;1690
9378;Wormerland;2008;15847;3925;9297;2625;14061;945;313;632;841;442;399;170;77;93;41;15;26;204;99;105;46;16;30;380;235;145;132.0;96.0;50.0;75.0;563.0;633.0;880
9379;Wormerland;2009;15790;3868;9190;2732;13966;934;303;631;890;456;434;186;79;107;49;17;32;212;102;110;56;22;34;387;236;151;129.0;98.0;57.0;67.0;610.0;653.0;880
9380;Wormerland;2010;15771;3832;9103;2836;13877;939;293;646;955;474;481;195;81;114;53;17;36;225;103;122;66;24;42;416;249;167;119.0;103.0;56.0;68.0;613.0;657.0;880
9381;Wormerland;2011;15733;3745;9088;2900;13771;941;288;653;1021;511;510;200;87;113;60;22;38;238;108;130;68;29;39;455;265;190;124.0;107.0;60.0;71.0;575.0;661.0;880
9382;Wormerland;2012;15653;3644;8953;3056;13677;936;297;639;1040;529;511;196;85;111;63;25;38;239;114;125;76;31;45;466;274;192;115.0;107.0;59.0;65.0;551.0;664.0;880
9383;Wormerland;2013;15543;3537;8830;3176;13506;957;321;636;1080;546;534;207;86;121;71;32;39;251;116;135;85;36;49;466;276;190;120.0;111.0;56.0;64.0;526.0;661.0;880
9384;Wormerland;2014;15409;3443;8686;3280;13339;949;317;632;1121;561;560;227;91;136;70;30;40;248;117;131;79;33;46;497;290;207;114.0;113.0;58.0;58.0;657.0;641.0;880
9385;Wormerland;2015;15427;3402;8668;3357;13273;976;325;651;1178;585;593;237;95;142;80;33;47;254;120;134;85;36;49;522;301;221;115.0;114.0;57.0;60.0;572.0;626.0;880
9386;Wormerland;2016;15372;3300;8645;3427;13200;963;322;641;1209;596;613;240;91;149;88;38;50;247;116;131;99;42;57;535;309;226;118.0;123.0;56.0;57.0;591.0;653.0;880
9387;Wormerland;2017;15304;3226;8619;3459;13085;976;330;646;1243;605;638;248;94;154;85;35;50;247;113;134;95;42;53;568;321;247;122.0;121.0;50.0;64.0;628.0;645.0;880
9388;Wormerland;2018;15275;3172;8590;3513;12991;1007;339;668;1277;624;653;251;99;152;88;39;49;250;116;134;102;41;61;586;329;257;120.0;124.0;63.0;61.0;581.0;660.0;880
9389;Wormerland;2019;15195;3088;8527;3580;12878;1007;346;661;1310;646;664;248;96;152;91;37;54;255;116;139;113;43;70;603;354;249;126.0;123.0;61.0;66.0;590.0;669.0;880
9390;Wormerland;2020;15115;3023;8475;3617;12758;1014;348;666;1343;657;686;245;94;151;95;38;57;258;116;142;118;47;71;627;362;265;131.0;126.0;65.0;63.0;559.0;662.0;880
9391;Wormerland;2021;15020;2897;8458;3665;12628;1011;340;671;1381;670;711;259;97;162;99;42;57;270;123;147;126;52;74;627;356;271;128.0;130.0;57.0;62.0;616.0;648.0;880
9392;Wormerland;2022;14981;2837;8428;3716;12544;1011;349;662;1426;686;740;270;98;172;97;45;52;275;121;154;125;49;76;659;373;286;130.0;133.0;58.0;57.0;509.0;636.0;880
9393;Wormerland;2023;14853;2770;8318;3765;12413;995;351;644;1445;688;757;271;98;173;107;52;55;263;111;152;138;49;89;666;378;288;127.0;137.0;63.0;59.0;700.0;645.0;880
9394;Wormerland;2024;14903;2753;8325;3825;12421;1000;349;651;1482;703;779;268;96;172;110;51;59;280;121;159;149;51;98;675;384;291;135.0;141.0;60.0;63.0;564.0;649.0;880
9395;Wormerland;2025;14810;2700;8233;3877;12275;987;340;647;1548;746;802;272;103;169;114;50;64;297;132;165;167;59;108;698;402;296;;;;;;;880
9396;Woudenberg;2008;11405;3158;6615;1632;10499;507;157;350;399;224;175;40;17;23;39;21;18;41;17;24;49;21;28;230;148;82;130.0;85.0;30.0;44.0;570.0;448.0;351
9397;Woudenberg;2009;11559;3159;6706;1694;10617;515;158;357;427;235;192;48;20;28;45;22;23;49;22;27;55;25;30;230;146;84;134.0;87.0;33.0;43.0;507.0;478.0;351
9398;Woudenberg;2010;11627;3093;6759;1775;10634;535;164;371;458;245;213;54;21;33;47;22;25;60;26;34;62;29;33;235;147;88;136.0;90.0;35.0;46.0;486.0;474.0;351
9399;Woudenberg;2011;11674;3058;6821;1795;10655;543;158;385;476;255;221;58;24;34;52;28;24;69;29;40;67;31;36;230;143;87;128.0;89.0;38.0;42.0;407.0;461.0;351
9400;Woudenberg;2012;11656;3021;6755;1880;10600;541;163;378;515;281;234;63;26;37;51;27;24;84;38;46;79;36;43;238;154;84;131.0;97.0;37.0;45.0;477.0;455.0;351
9401;Woudenberg;2013;11705;2973;6757;1975;10595;568;172;396;542;285;257;68;25;43;55;26;29;83;36;47;84;36;48;252;162;90;132.0;95.0;38.0;44.0;465.0;466.0;351
9402;Woudenberg;2014;11736;2924;6756;2056;10615;572;177;395;549;285;264;72;27;45;57;28;29;82;36;46;83;33;50;255;161;94;131.0;97.0;47.0;47.0;528.0;466.0;351
9403;Woudenberg;2015;11833;2906;6794;2133;10655;599;192;407;579;296;283;83;35;48;63;29;34;88;39;49;90;35;55;255;158;97;132.0;101.0;34.0;39.0;469.0;479.0;351
9404;Woudenberg;2016;11850;2862;6789;2199;10648;611;197;414;591;305;286;80;36;44;65;31;34;89;39;50;94;39;55;263;160;103;131.0;102.0;38.0;47.0;426.0;466.0;351
9405;Woudenberg;2017;11831;2827;6789;2215;10600;614;204;410;617;312;305;82;36;46;64;31;33;91;37;54;99;41;58;281;167;114;129.0;100.0;39.0;42.0;485.0;457.0;351
9406;Woudenberg;2018;11886;2779;6848;2259;10616;629;207;422;641;317;324;87;37;50;67;34;33;100;39;61;99;39;60;288;168;120;135.0;106.0;34.0;44.0;309.0;466.0;351
9407;Woudenberg;2019;11749;2713;6729;2307;10460;631;209;422;658;329;329;92;40;52;70;37;33;101;43;58;102;41;61;293;168;125;126.0;106.0;39.0;41.0;487.0;443.0;351
9408;Woudenberg;2020;11813;2679;6748;2386;10487;639;220;419;687;336;351;97;45;52;74;38;36;114;44;70;105;39;66;297;170;127;131.0;107.0;34.0;43.0;568.0;475.0;351
9409;Woudenberg;2021;11922;2663;6832;2427;10557;648;225;423;717;342;375;97;42;55;85;46;39;120;43;77;106;38;68;309;173;136;134.0;106.0;38.0;43.0;522.0;485.0;351
9410;Woudenberg;2022;11983;2638;6859;2486;10584;655;226;429;744;351;393;95;42;53;84;48;36;131;49;82;112;36;76;322;176;146;134.0;115.0;36.0;42.0;504.0;474.0;351
9411;Woudenberg;2023;12027;2623;6863;2541;10621;666;226;440;740;356;384;98;49;49;82;47;35;129;50;79;115;36;79;316;174;142;135.0;117.0;39.0;43.0;537.0;495.0;351
9412;Woudenberg;2024;12084;2625;6871;2588;10640;688;231;457;756;364;392;105;51;54;78;44;34;137;53;84;109;34;75;327;182;145;138.0;114.0;37.0;44.0;495.0;486.0;351
9413;Woudenberg;2025;12111;2620;6852;2639;10627;701;240;461;783;365;418;102;47;55;77;38;39;143;54;89;117;35;82;344;191;153;;;;;;;351
9414;Woudrichem;2008;14173;3619;8593;1961;13334;588;227;361;251;151;100;39;16;23;13;10;3;24;14;10;22;10;12;153;101;52;152.0;122.0;39.0;60.0;475.0;462.0;874
9415;Woudrichem;2009;14197;3630;8549;2018;13314;611;241;370;272;154;118;48;20;28;14;10;4;35;20;15;23;12;11;152;92;60;151.0;122.0;43.0;57.0;529.0;500.0;874
9416;Woudrichem;2010;14247;3629;8547;2071;13300;631;246;385;316;170;146;56;21;35;18;10;8;43;21;22;31;16;15;168;102;66;147.0;122.0;44.0;61.0;482.0;486.0;874
9417;Woudrichem;2011;14254;3574;8528;2152;13262;637;234;403;355;192;163;68;25;43;22;12;10;50;22;28;38;17;21;177;116;61;147.0;125.0;46.0;60.0;446.0;523.0;874
9418;Woudrichem;2012;14188;3513;8438;2237;13157;658;245;413;373;204;169;73;31;42;23;13;10;51;27;24;46;19;27;180;114;66;139.0;123.0;47.0;56.0;513.0;501.0;874
9419;Woudrichem;2013;14208;3433;8430;2345;13108;678;260;418;422;225;197;74;30;44;29;15;14;67;33;34;54;23;31;198;124;74;140.0;123.0;47.0;57.0;519.0;497.0;874
9420;Woudrichem;2014;14237;3431;8344;2462;13080;688;264;424;469;244;225;86;33;53;32;16;16;73;34;39;65;27;38;213;134;79;138.0;124.0;50.0;58.0;507.0;518.0;874
9421;Woudrichem;2015;14233;3360;8325;2548;13017;716;270;446;500;262;238;100;43;57;34;14;20;80;39;41;69;29;40;217;137;80;136.0;127.0;48.0;59.0;478.0;520.0;874
9422;Woudrichem;2016;14189;3321;8239;2629;12937;735;278;457;517;279;238;92;38;54;39;17;22;84;44;40;76;34;42;226;146;80;141.0;128.0;54.0;59.0;482.0;523.0;874
9423;Woudrichem;2017;14157;3292;8147;2718;12853;751;275;476;553;290;263;91;37;54;43;17;26;92;48;44;88;37;51;239;151;88;135.0;130.0;52.0;54.0;463.0;493.0;874
9424;Woudrichem;2018;14130;3253;8078;2799;12782;766;284;482;582;306;276;97;40;57;46;17;29;99;51;48;95;40;55;245;158;87;136.0;135.0;51.0;59.0;524.0;502.0;874
9425;Woudrichem;2019;14147;3207;8049;2891;12757;762;283;479;628;328;300;109;44;65;45;16;29;103;57;46;103;44;59;268;167;101;137.0;139.0;54.0;62.0;503.0;491.0;874
9426;Woudrichem;2020;14150;3154;8028;2968;12698;806;303;503;646;331;315;114;46;68;49;19;30;105;57;48;108;46;62;270;163;107;138.0;141.0;53.0;60.0;559.0;500.0;874
9427;Woudrichem;2021;14199;3133;8028;3038;12688;846;323;523;665;340;325;117;45;72;47;18;29;114;57;57;111;50;61;276;170;106;140.0;146.0;49.0;58.0;542.0;504.0;874
9428;Woudrichem;2022;14226;3110;8013;3103;12675;864;333;531;687;346;341;118;47;71;48;19;29;118;58;60;119;56;63;284;166;118;140.0;150.0;53.0;61.0;493.0;516.0;874
9429;Woudrichem;2023;14185;3064;7951;3170;12610;875;341;534;700;345;355;125;50;75;50;21;29;117;58;59;133;58;75;275;158;117;138.0;154.0;50.0;56.0;529.0;512.0;874
9430;Woudrichem;2024;14181;3023;7966;3192;12556;881;348;533;744;370;374;130;55;75;51;21;30;127;59;68;144;61;83;292;174;118;140.0;157.0;52.0;62.0;551.0;509.0;874
9431;Woudrichem;2025;14198;3004;7938;3256;12505;923;368;555;770;386;384;132;60;72;54;26;28;136;65;71;145;63;82;303;172;131;;;;;;;874
9432;Wûnseradiel;2008;11905;3111;7131;1663;11081;573;196;377;251;142;109;21;7;14;18;10;8;29;12;17;12;5;7;171;108;63;133.0;94.0;28.0;44.0;517.0;563.0;710
9433;Wûnseradiel;2009;11884;3059;7090;1735;11022;577;201;376;285;146;139;33;12;21;23;13;10;33;10;23;14;5;9;182;106;76;128.0;93.0;26.0;39.0;486.0;545.0;710
9434;Wûnseradiel;2010;11850;2988;7037;1825;10953;585;200;385;312;162;150;35;13;22;25;14;11;44;18;26;18;9;9;190;108;82;124.0;93.0;27.0;43.0;496.0;568.0;710
9435;Wûnseradiel;2011;11795;2912;7007;1876;10852;599;206;393;344;182;162;36;14;22;29;14;15;51;20;31;25;11;14;203;123;80;119.0;97.0;28.0;45.0;504.0;556.0;710
9436;Wûnseradiel;2012;11748;2856;6912;1980;10756;626;218;408;366;200;166;41;18;23;26;13;13;61;23;38;28;12;16;210;134;76;115.0;98.0;33.0;38.0;471.0;553.0;710
9437;Wûnseradiel;2013;11681;2814;6796;2071;10662;635;221;414;384;201;183;47;21;26;29;14;15;66;27;39;33;13;20;209;126;83;114.0;102.0;31.0;45.0;485.0;563.0;710
9438;Wûnseradiel;2014;11600;2731;6718;2151;10547;633;220;413;420;219;201;55;25;30;34;16;18;72;32;40;39;17;22;220;129;91;108.0;102.0;35.0;39.0;478.0;537.0;710
9439;Wûnseradiel;2015;11543;2677;6655;2211;10437;647;230;417;459;233;226;55;24;31;43;19;24;84;36;48;43;21;22;234;133;101;108.0;103.0;31.0;41.0;466.0;558.0;710
9440;Wûnseradiel;2016;11448;2593;6585;2270;10312;662;222;440;474;247;227;57;26;31;49;24;25;85;37;48;43;23;20;240;137;103;108.0;103.0;32.0;39.0;515.0;552.0;710
9441;Wûnseradiel;2017;11411;2555;6535;2321;10240;669;221;448;502;248;254;57;27;30;53;21;32;96;41;55;47;23;24;249;136;113;108.0;105.0;32.0;38.0;492.0;538.0;710
9442;Wûnseradiel;2018;11363;2500;6456;2407;10172;685;228;457;506;252;254;63;29;34;58;23;35;99;41;58;51;24;27;235;135;100;106.0;110.0;29.0;42.0;456.0;536.0;710
9443;Wûnseradiel;2019;11266;2434;6357;2475;10050;701;240;461;515;259;256;63;29;34;60;24;36;107;44;63;56;24;32;229;138;91;107.0;111.0;31.0;38.0;472.0;539.0;710
9444;Wûnseradiel;2020;11190;2379;6292;2519;9918;741;258;483;531;262;269;68;32;36;61;24;37;109;42;67;59;26;33;234;138;96;104.0;113.0;27.0;40.0;544.0;519.0;710
9445;Wûnseradiel;2021;11194;2337;6291;2566;9902;744;264;480;548;260;288;68;32;36;65;22;43;115;42;73;56;24;32;244;140;104;106.0;114.0;29.0;42.0;491.0;534.0;710
9446;Wûnseradiel;2022;11131;2261;6262;2608;9809;755;265;490;567;263;304;70;32;38;60;20;40;120;41;79;62;26;36;255;144;111;103.0;122.0;31.0;38.0;459.0;526.0;710
9447;Wûnseradiel;2023;11038;2222;6201;2615;9697;753;268;485;588;264;324;70;31;39;61;22;39;122;47;75;70;28;42;265;136;129;107.0;119.0;28.0;37.0;482.0;524.0;710
9448;Wûnseradiel;2024;10977;2199;6132;2646;9622;756;278;478;599;263;336;73;33;40;61;21;40;125;51;74;70;28;42;270;130;140;110.0;116.0;34.0;39.0;486.0;517.0;710
9449;Wûnseradiel;2025;10934;2165;6057;2712;9566;767;273;494;601;279;322;78;34;44;65;22;43;128;57;71;70;31;39;260;135;125;;;;;;;710
9450;Wymbritseradiel;2008;16181;4389;9547;2245;15400;529;137;392;252;131;121;23;9;14;19;8;11;25;17;8;14;4;10;171;93;78;162.0;117.0;39.0;50.0;745.0;761.0;683
9451;Wymbritseradiel;2009;16201;4293;9534;2374;15368;544;144;400;289;147;142;29;12;17;26;14;12;36;21;15;26;9;17;172;91;81;162.0;119.0;33.0;55.0;754.0;761.0;683
9452;Wymbritseradiel;2010;16216;4183;9524;2509;15364;549;148;401;303;154;149;34;14;20;26;14;12;41;25;16;26;9;17;176;92;84;160.0;129.0;34.0;48.0;699.0;787.0;683
9453;Wymbritseradiel;2011;16148;4055;9477;2616;15271;551;145;406;326;165;161;39;17;22;32;18;14;39;25;14;32;9;23;184;96;88;156.0;130.0;37.0;47.0;676.0;763.0;683
9454;Wymbritseradiel;2012;16081;3964;9334;2783;15180;553;142;411;348;170;178;44;17;27;29;15;14;43;23;20;43;11;32;189;104;85;157.0;132.0;45.0;50.0;657.0;768.0;683
9455;Wymbritseradiel;2013;15992;3822;9258;2912;15056;560;147;413;376;191;185;53;21;32;29;15;14;49;23;26;43;14;29;202;118;84;156.0;138.0;35.0;49.0;740.0;783.0;683
9456;Wymbritseradiel;2014;15958;3727;9213;3018;14987;579;149;430;392;194;198;57;20;37;30;17;13;54;23;31;45;16;29;206;118;88;158.0;136.0;44.0;50.0;675.0;785.0;683
9457;Wymbritseradiel;2015;15866;3645;9105;3116;14847;600;156;444;419;204;215;64;25;39;31;16;15;55;24;31;52;17;35;217;122;95;157.0;142.0;36.0;48.0;666.0;761.0;683
9458;Wymbritseradiel;2016;15777;3534;9036;3207;14732;605;158;447;440;210;230;65;24;41;37;22;15;66;27;39;53;17;36;219;120;99;158.0;146.0;35.0;51.0;670.0;766.0;683
9459;Wymbritseradiel;2017;15680;3435;8965;3280;14600;611;156;455;469;228;241;66;24;42;45;28;17;76;33;43;56;18;38;226;125;101;156.0;145.0;39.0;46.0;660.0;765.0;683
9460;Wymbritseradiel;2018;15580;3358;8890;3332;14469;611;157;454;500;232;268;69;26;43;45;28;17;80;31;49;65;18;47;241;129;112;162.0;151.0;35.0;47.0;815.0;765.0;683
9461;Wymbritseradiel;2019;15632;3323;8913;3396;14484;613;155;458;535;246;289;77;28;49;49;30;19;86;31;55;63;20;43;260;137;123;161.0;154.0;36.0;49.0;817.0;782.0;683
9462;Wymbritseradiel;2020;15661;3271;8923;3467;14456;645;174;471;560;257;303;79;31;48;54;32;22;93;34;59;68;22;46;266;138;128;159.0;153.0;39.0;47.0;762.0;782.0;683
9463;Wymbritseradiel;2021;15640;3193;8893;3554;14422;647;162;485;571;271;300;75;32;43;59;37;22;92;35;57;77;24;53;268;143;125;163.0;160.0;43.0;52.0;766.0;778.0;683
9464;Wymbritseradiel;2022;15623;3120;8878;3625;14384;667;176;491;572;274;298;80;33;47;61;39;22;88;32;56;73;27;46;270;143;127;154.0;163.0;48.0;49.0;683.0;776.0;683
9465;Wymbritseradiel;2023;15521;3048;8768;3705;14283;656;173;483;582;280;302;83;36;47;66;38;28;92;35;57;78;26;52;263;145;118;159.0;170.0;38.0;44.0;748.0;766.0;683
9466;Wymbritseradiel;2024;15489;2988;8713;3788;14214;672;171;501;603;281;322;88;38;50;65;38;27;99;35;64;79;26;53;272;144;128;161.0;172.0;45.0;49.0;728.0;763.0;683
9467;Wymbritseradiel;2025;15440;2968;8613;3859;14135;675;175;500;630;309;321;93;43;50;70;42;28;104;43;61;84;32;52;279;149;130;;;;;;;683
9468;Zaanstad;2008;142233;34308;86915;21010;107158;12409;4948;7461;22666;12467;10199;4218;2162;2056;841;458;383;10051;5448;4603;2291;1142;1149;5265;3257;2008;1560.0;1167.0;603.0;811.0;4414.0;3920.0;479
9469;Zaanstad;2009;142929;34431;86849;21649;107140;12673;5102;7571;23116;12595;10521;4284;2152;2132;876;480;396;9975;5392;4583;2526;1251;1275;5455;3320;2135;1557.0;1201.0;657.0;805.0;4880.0;3939.0;479
9470;Zaanstad;2010;144099;34788;86988;22323;107423;12969;5293;7676;23707;12773;10934;4335;2133;2202;935;508;427;9950;5348;4602;2828;1409;1419;5659;3375;2284;1542.0;1213.0;682.0;814.0;5040.0;3929.0;479
9471;Zaanstad;2011;145418;34928;87722;22768;107802;13263;5476;7787;24353;12987;11366;4415;2112;2303;990;526;464;9892;5296;4596;3109;1536;1573;5947;3517;2430;1525.0;1231.0;754.0;813.0;4973.0;4021.0;479
9472;Zaanstad;2012;146617;35044;87589;23984;108098;13557;5639;7918;24962;13224;11738;4517;2143;2374;1071;563;508;9855;5235;4620;3355;1667;1688;6164;3616;2548;1542.0;1256.0;720.0;800.0;4938.0;4076.0;479
9473;Zaanstad;2013;147700;35126;87668;24906;108290;13837;5786;8051;25573;13477;12096;4597;2139;2458;1119;578;541;9795;5217;4578;3619;1782;1837;6443;3761;2682;1529.0;1259.0;756.0;811.0;4799.0;4120.0;479
9474;Zaanstad;2014;148612;35205;87695;25712;108415;14104;5951;8153;26093;13589;12504;4680;2141;2539;1159;589;570;9754;5164;4590;3849;1882;1967;6651;3813;2838;1510.0;1275.0;762.0;788.0;4932.0;4133.0;479
9475;Zaanstad;2015;149630;35287;87865;26478;108642;14405;6113;8292;26583;13741;12842;4755;2151;2604;1218;608;610;9691;5132;4559;4089;1974;2115;6830;3876;2954;1521.0;1313.0;813.0;807.0;4931.0;4106.0;479
9476;Zaanstad;2016;150688;35467;88085;27136;108885;14672;6246;8426;27131;13933;13198;4838;2154;2684;1296;638;658;9622;5088;4534;4349;2095;2254;7026;3958;3068;1533.0;1337.0;767.0;803.0;5038.0;4135.0;479
9477;Zaanstad;2017;151760;35571;88452;27737;109182;14934;6392;8542;27644;14105;13539;4910;2152;2758;1365;656;709;9557;5064;4493;4576;2203;2373;7236;4030;3206;1543.0;1360.0;768.0;781.0;5065.0;4179.0;479
9478;Zaanstad;2018;152834;35573;88877;28384;109409;15292;6595;8697;28133;14259;13874;4965;2148;2817;1425;690;735;9492;5043;4449;4806;2296;2510;7445;4082;3363;1579.0;1396.0;801.0;798.0;5202.0;4256.0;479
9479;Zaanstad;2019;153973;35525;89495;28953;109756;15591;6757;8834;28626;14419;14207;5009;2126;2883;1485;722;763;9427;5000;4427;5069;2393;2676;7636;4178;3458;1582.0;1395.0;777.0;799.0;4881.0;4297.0;479
9480;Zaanstad;2020;154740;35461;89806;29473;109910;15823;6914;8909;29007;14529;14478;5038;2115;2923;1541;736;805;9308;4944;4364;5262;2497;2765;7858;4237;3621;1591.0;1412.0;785.0;786.0;4942.0;4232.0;479
9481;Zaanstad;2021;155639;35365;90241;30033;110108;16176;7111;9065;29355;14628;14727;5072;2105;2967;1568;750;818;9271;4917;4354;5418;2559;2859;8026;4297;3729;1598.0;1445.0;784.0;806.0;4915.0;4291.0;479
9482;Zaanstad;2022;156410;35273;90528;30609;110148;16491;7260;9231;29771;14774;14997;5121;2094;3027;1593;766;827;9204;4875;4329;5588;2632;2956;8265;4407;3858;1649.0;1474.0;783.0;815.0;4754.0;4243.0;479
9483;Zaanstad;2023;157073;35206;90750;31117;110206;16792;7424;9368;30075;14829;15246;5155;2084;3071;1645;792;853;9127;4821;4306;5760;2694;3066;8388;4438;3950;1661.0;1504.0;772.0;776.0;4846.0;4335.0;479
9484;Zaanstad;2024;157744;35020;91117;31607;110260;17022;7555;9467;30462;14999;15463;5203;2081;3122;1680;819;861;9056;4797;4259;5910;2776;3134;8613;4526;4087;1698.0;1536.0;773.0;795.0;4957.0;4326.0;479
9485;Zaanstad;2025;158528;35070;91400;32058;110400;17303;7701;9602;30825;15123;15702;5267;2083;3184;1713;837;876;9007;4740;4267;6075;2860;3215;8763;4603;4160;;;;;;;479
9486;Zaltbommel;2008;25908;7340;15117;3451;23530;1110;385;725;1268;663;605;74;33;41;56;26;30;47;22;25;722;362;360;369;220;149;356.0;185.0;58.0;109.0;674.0;822.0;297
9487;Zaltbommel;2009;25884;7295;15053;3536;23460;1144;417;727;1280;673;607;70;38;32;54;26;28;52;28;24;721;350;371;383;231;152;337.0;186.0;68.0;102.0;735.0;871.0;297
9488;Zaltbommel;2010;25868;7245;14997;3626;23357;1178;438;740;1333;694;639;70;38;32;63;33;30;68;32;36;726;352;374;406;239;167;332.0;190.0;68.0;103.0;787.0;871.0;297
9489;Zaltbommel;2011;25895;7185;15022;3688;23305;1228;466;762;1362;692;670;79;41;38;68;34;34;76;31;45;731;352;379;408;234;174;331.0;192.0;74.0;104.0;768.0;902.0;297
9490;Zaltbommel;2012;25874;7090;14893;3891;23214;1238;479;759;1422;720;702;99;46;53;72;37;35;93;36;57;738;358;380;420;243;177;330.0;198.0;68.0;99.0;731.0;900.0;297
9491;Zaltbommel;2013;25807;6985;14779;4043;23078;1266;491;775;1463;733;730;111;51;60;76;36;40;109;44;65;754;360;394;413;242;171;314.0;197.0;69.0;100.0;750.0;874.0;297
9492;Zaltbommel;2014;25771;6926;14611;4234;22970;1266;469;797;1535;774;761;112;57;55;85;40;45;129;51;78;765;361;404;444;265;179;304.0;202.0;72.0;94.0;753.0;892.0;297
9493;Zaltbommel;2015;25715;6810;14540;4365;22857;1286;473;813;1572;790;782;120;61;59;91;47;44;135;53;82;777;372;405;449;257;192;303.0;207.0;62.0;91.0;766.0;877.0;297
9494;Zaltbommel;2016;25674;6714;14460;4500;22768;1302;479;823;1604;823;781;132;68;64;91;45;46;136;56;80;768;374;394;477;280;197;299.0;212.0;75.0;96.0;826.0;880.0;297
9495;Zaltbommel;2017;25691;6666;14434;4591;22729;1325;485;840;1637;853;784;139;74;65;95;47;48;151;64;87;761;372;389;491;296;195;307.0;214.0;67.0;97.0;714.0;918.0;297
9496;Zaltbommel;2018;25554;6537;14299;4718;22571;1343;484;859;1640;854;786;143;77;66;96;51;45;154;66;88;761;371;390;486;289;197;299.0;219.0;67.0;94.0;802.0;899.0;297
9497;Zaltbommel;2019;25514;6435;14265;4814;22464;1387;523;864;1663;868;795;147;77;70;96;52;44;166;67;99;754;376;378;500;296;204;306.0;221.0;69.0;93.0;750.0;914.0;297
9498;Zaltbommel;2020;25415;6358;14133;4924;22336;1400;529;871;1679;882;797;141;77;64;93;49;44;173;70;103;756;374;382;516;312;204;297.0;224.0;76.0;88.0;813.0;900.0;297
9499;Zaltbommel;2021;25391;6233;14120;5038;22244;1437;552;885;1710;898;812;152;82;70;100;49;51;188;77;111;751;372;379;519;318;201;298.0;229.0;65.0;91.0;828.0;882.0;297
9500;Zaltbommel;2022;25384;6159;14051;5174;22176;1454;557;897;1754;923;831;159;81;78;103;53;50;208;88;120;761;379;382;523;322;201;295.0;237.0;67.0;88.0;712.0;876.0;297
9501;Zaltbommel;2023;25256;6028;13989;5239;22008;1463;578;885;1785;949;836;176;87;89;101;52;49;219;92;127;754;382;372;535;336;199;283.0;230.0;63.0;84.0;821.0;878.0;297
9502;Zaltbommel;2024;25233;5915;13940;5378;21962;1460;589;871;1811;971;840;182;89;93;108;57;51;229;101;128;743;380;363;549;344;205;298.0;248.0;69.0;84.0;750.0;882.0;297
9503;Zaltbommel;2025;25143;5859;13778;5506;21833;1495;619;876;1815;985;830;184;90;94;104;55;49;230;105;125;727;371;356;570;364;206;;;;;;;297
9504;Zandvoort;2008;16668;3221;10216;3231;13578;2051;935;1116;1039;569;470;121;57;64;83;40;43;109;54;55;134;62;72;592;356;236;133.0;196.0;118.0;137.0;645.0;531.0;473
9505;Zandvoort;2009;16702;3235;10188;3279;13588;2049;941;1108;1065;575;490;128;61;67;85;42;43;120;51;69;146;67;79;586;354;232;132.0;193.0;131.0;133.0;647.0;533.0;473
9506;Zandvoort;2010;16755;3260;10138;3357;13611;2060;946;1114;1084;586;498;131;62;69;91;48;43;129;55;74;149;72;77;584;349;235;131.0;194.0;147.0;133.0;688.0;558.0;473
9507;Zandvoort;2011;16838;3242;10192;3404;13639;2065;954;1111;1134;604;530;139;67;72;94;48;46;141;59;82;156;70;86;604;360;244;129.0;191.0;143.0;129.0;666.0;567.0;473
9508;Zandvoort;2012;16892;3220;10111;3561;13649;2081;971;1110;1162;620;542;140;73;67;101;51;50;144;60;84;155;71;84;622;365;257;119.0;197.0;150.0;132.0;674.0;578.0;473
9509;Zandvoort;2013;16932;3163;10093;3676;13628;2080;977;1103;1224;660;564;157;79;78;109;62;47;153;68;85;154;69;85;651;382;269;127.0;187.0;143.0;129.0;606.0;568.0;473
9510;Zandvoort;2014;16926;3140;10025;3761;13568;2089;989;1100;1269;681;588;162;77;85;107;62;45;169;74;95;162;74;88;669;394;275;127.0;191.0;148.0;123.0;673.0;554.0;473
9511;Zandvoort;2015;17010;3163;9980;3867;13588;2109;996;1113;1313;685;628;166;77;89;110;61;49;181;84;97;170;74;96;686;389;297;131.0;187.0;155.0;123.0;626.0;581.0;473
9512;Zandvoort;2016;17033;3114;9979;3940;13554;2132;1027;1105;1347;698;649;169;82;87;117;68;49;199;84;115;181;83;98;681;381;300;137.0;189.0;148.0;117.0;750.0;560.0;473
9513;Zandvoort;2017;17203;3119;10074;4010;13656;2154;1056;1098;1393;719;674;174;84;90;123;73;50;217;95;122;188;84;104;691;383;308;141.0;198.0;147.0;133.0;655.0;562.0;473
9514;Zandvoort;2018;17255;3122;10054;4079;13659;2169;1081;1088;1427;730;697;184;88;96;121;70;51;235;101;134;177;82;95;710;389;321;147.0;194.0;132.0;123.0;674.0;563.0;473
9515;Zandvoort;2019;17330;3153;10063;4114;13674;2189;1098;1091;1467;751;716;188;90;98;124;72;52;238;106;132;188;84;104;729;399;330;145.0;199.0;150.0;120.0;643.0;556.0;473
9516;Zandvoort;2020;17395;3129;10102;4164;13661;2226;1124;1102;1508;778;730;192;87;105;126;73;53;250;109;141;190;86;104;750;423;327;152.0;202.0;143.0;116.0;623.0;573.0;473
9517;Zandvoort;2021;17424;3125;10094;4205;13634;2235;1136;1099;1555;793;762;198;89;109;132;76;56;263;112;151;190;86;104;772;430;342;153.0;205.0;153.0;129.0;553.0;578.0;473
9518;Zandvoort;2022;17372;3084;10078;4210;13585;2215;1117;1098;1572;795;777;203;96;107;131;77;54;270;112;158;187;80;107;781;430;351;155.0;203.0;145.0;118.0;626.0;571.0;473
9519;Zandvoort;2023;17408;3088;10053;4267;13579;2215;1107;1108;1614;820;794;202;96;106;142;83;59;277;115;162;187;81;106;806;445;361;159.0;209.0;142.0;117.0;737.0;581.0;473
9520;Zandvoort;2024;17541;3115;10121;4305;13603;2249;1115;1134;1689;846;843;205;97;108;147;85;62;298;122;176;203;84;119;836;458;378;166.0;207.0;149.0;120.0;645.0;571.0;473
9521;Zandvoort;2025;17605;3136;10120;4349;13604;2276;1131;1145;1725;851;874;207;96;111;146;83;63;307;126;181;217;89;128;848;457;391;;;;;;;473
9522;Zederik;2008;13140;3608;7712;1820;12575;343;105;238;222;142;80;24;10;14;16;10;6;18;9;9;23;15;8;141;98;43;140.0;109.0;19.0;36.0;344.0;427.0;707
9523;Zederik;2009;13073;3525;7676;1872;12453;372;120;252;248;153;95;27;10;17;18;11;7;28;14;14;31;20;11;144;98;46;142.0;108.0;21.0;35.0;221.0;409.0;707
9524;Zederik;2010;12906;3448;7531;1927;12248;386;126;260;272;157;115;33;12;21;19;10;9;40;18;22;35;21;14;145;96;49;135.0;107.0;25.0;31.0;423.0;395.0;707
9525;Zederik;2011;12956;3400;7563;1993;12243;405;137;268;308;174;134;34;10;24;21;10;11;54;26;28;43;25;18;156;103;53;138.0;109.0;22.0;33.0;360.0;416.0;707
9526;Zederik;2012;12918;3318;7516;2084;12152;430;152;278;336;182;154;39;10;29;24;11;13;53;26;27;53;27;26;167;108;59;135.0;109.0;25.0;32.0;336.0;427.0;707
9527;Zederik;2013;12848;3231;7454;2163;12034;440;155;285;374;185;189;38;11;27;29;10;19;61;25;36;67;27;40;179;112;67;138.0;113.0;33.0;32.0;392.0;416.0;707
9528;Zederik;2014;12851;3167;7430;2254;11962;456;167;289;433;209;224;44;14;30;36;11;25;74;27;47;79;32;47;200;125;75;138.0;111.0;26.0;35.0;360.0;428.0;707
9529;Zederik;2015;12802;3101;7385;2316;11906;451;165;286;445;219;226;47;18;29;37;15;22;79;27;52;73;30;43;209;129;80;140.0;115.0;29.0;38.0;371.0;417.0;707
9530;Zederik;2016;12773;3058;7356;2359;11852;453;167;286;468;229;239;42;18;24;36;13;23;81;30;51;87;36;51;222;132;90;138.0;114.0;29.0;33.0;383.0;428.0;707
9531;Zederik;2017;12748;3001;7304;2443;11777;468;175;293;503;243;260;49;24;25;41;13;28;90;33;57;91;37;54;232;136;96;137.0;116.0;29.0;36.0;487.0;436.0;707
9532;Zederik;2018;12814;2974;7331;2509;11793;478;175;303;543;261;282;58;27;31;50;17;33;100;38;62;99;38;61;236;141;95;140.0;119.0;30.0;32.0;451.0;414.0;707
9533;Zederik;2019;12869;2931;7375;2563;11807;483;171;312;579;275;304;66;31;35;52;18;34;107;42;65;108;42;66;246;142;104;139.0;124.0;28.0;35.0;455.0;419.0;707
9534;Zederik;2020;12913;2905;7382;2626;11802;501;181;320;610;294;316;69;35;34;53;18;35;110;46;64;107;41;66;271;154;117;145.0;128.0;33.0;35.0;473.0;428.0;707
9535;Zederik;2021;12975;2866;7414;2695;11815;501;191;310;659;320;339;78;40;38;58;22;36;122;52;70;106;40;66;295;166;129;148.0;133.0;29.0;35.0;432.0;443.0;707
9536;Zederik;2022;12973;2844;7381;2748;11769;506;191;315;698;333;365;87;47;40;67;30;37;129;54;75;115;41;74;300;161;139;147.0;133.0;26.0;38.0;430.0;435.0;707
9537;Zederik;2023;12972;2820;7340;2812;11721;518;192;326;733;342;391;86;48;38;72;30;42;137;58;79;126;42;84;312;164;148;148.0;135.0;25.0;36.0;459.0;409.0;707
9538;Zederik;2024;13025;2825;7306;2894;11728;543;210;333;754;347;407;93;49;44;71;30;41;145;61;84;130;40;90;315;167;148;150.0;140.0;31.0;35.0;420.0;430.0;707
9539;Zederik;2025;13021;2791;7273;2957;11660;569;225;344;792;365;427;99;53;46;73;33;40;156;66;90;134;43;91;330;170;160;;;;;;;707
9540;Zeevang;2008;6201;1580;3800;821;5625;403;136;267;173;85;88;37;12;25;18;5;13;24;10;14;8;3;5;86;55;31;46.0;43.0;23.0;32.0;258.0;285.0;478
9541;Zeevang;2009;6168;1538;3754;876;5573;405;139;266;190;95;95;41;15;26;18;5;13;20;10;10;9;3;6;102;62;40;45.0;46.0;27.0;31.0;268.0;282.0;478
9542;Zeevang;2010;6150;1494;3723;933;5525;405;137;268;220;106;114;51;21;30;18;5;13;23;10;13;11;3;8;117;67;50;48.0;46.0;27.0;31.0;248.0;295.0;478
9543;Zeevang;2011;6102;1461;3666;975;5457;403;142;261;242;113;129;57;22;35;20;6;14;28;13;15;13;3;10;124;69;55;41.0;48.0;28.0;33.0;275.0;299.0;478
9544;Zeevang;2012;6067;1396;3606;1065;5421;391;134;257;255;111;144;63;22;41;23;7;16;25;12;13;21;5;16;123;65;58;46.0;47.0;30.0;32.0;300.0;312.0;478
9545;Zeevang;2013;6052;1343;3572;1137;5373;402;139;263;277;119;158;66;19;47;21;8;13;32;15;17;25;6;19;133;71;62;40.0;49.0;30.0;29.0;309.0;315.0;478
9546;Zeevang;2014;6039;1316;3514;1209;5342;397;139;258;300;125;175;66;20;46;21;9;12;36;14;22;26;5;21;151;77;74;44.0;52.0;26.0;32.0;258.0;332.0;478
9547;Zeevang;2015;5952;1267;3455;1230;5264;396;141;255;292;124;168;64;21;43;20;8;12;38;15;23;24;5;19;146;75;71;44.0;52.0;28.0;30.0;302.0;312.0;478
9548;Zeevang;2016;5933;1236;3449;1248;5225;393;138;255;315;141;174;69;24;45;25;9;16;40;17;23;25;5;20;156;86;70;48.0;54.0;26.0;30.0;274.0;319.0;478
9549;Zeevang;2017;5879;1189;3397;1293;5165;390;140;250;324;140;184;72;23;49;28;11;17;41;18;23;24;5;19;159;83;76;46.0;56.0;29.0;26.0;310.0;316.0;478
9550;Zeevang;2018;5867;1172;3377;1318;5136;398;144;254;333;149;184;74;29;45;25;11;14;46;20;26;32;8;24;156;81;75;48.0;58.0;28.0;28.0;307.0;320.0;478
9551;Zeevang;2019;5845;1138;3353;1354;5091;410;153;257;344;155;189;68;28;40;33;17;16;43;18;25;35;8;27;165;84;81;48.0;60.0;29.0;28.0;320.0;315.0;478
9552;Zeevang;2020;5841;1110;3355;1376;5059;418;147;271;364;161;203;71;29;42;36;17;19;44;19;25;41;7;34;172;89;83;50.0;58.0;23.0;29.0;277.0;303.0;478
9553;Zeevang;2021;5803;1067;3345;1391;5008;424;156;268;371;162;209;70;27;43;38;16;22;48;21;27;40;9;31;175;89;86;49.0;61.0;29.0;27.0;288.0;299.0;478
9554;Zeevang;2022;5783;1067;3321;1395;4973;425;158;267;385;162;223;70;27;43;40;16;24;53;20;33;42;10;32;180;89;91;51.0;62.0;22.0;27.0;303.0;305.0;478
9555;Zeevang;2023;5766;1049;3308;1409;4940;425;151;274;401;175;226;71;27;44;44;18;26;59;23;36;41;11;30;186;96;90;49.0;61.0;25.0;30.0;285.0;301.0;478
9556;Zeevang;2024;5734;1039;3271;1424;4903;436;158;278;395;180;215;70;30;40;44;19;25;58;24;34;43;10;33;180;97;83;48.0;66.0;26.0;29.0;342.0;292.0;478
9557;Zeevang;2025;5764;1046;3256;1462;4902;454;171;283;408;189;219;71;33;38;46;18;28;58;27;31;45;13;32;188;98;90;;;;;;;478
9558;Zeewolde;2008;20187;6563;11893;1731;17911;1399;453;946;877;462;415;124;53;71;83;41;42;75;36;39;100;42;58;495;290;205;286.0;92.0;129.0;112.0;1131.0;882.0;50
9559;Zeewolde;2009;20649;6604;12189;1856;18299;1402;450;952;948;501;447;136;60;76;88;42;46;85;42;43;104;40;64;535;317;218;288.0;101.0;139.0;118.0;987.0;913.0;50
9560;Zeewolde;2010;20933;6571;12389;1973;18489;1409;458;951;1035;549;486;139;59;80;93;46;47;97;52;45;121;48;73;585;344;241;284.0;113.0;153.0;118.0;936.0;933.0;50
9561;Zeewolde;2011;21143;6478;12609;2056;18621;1418;478;940;1104;585;519;144;61;83;98;49;49;103;55;48;131;48;83;628;372;256;278.0;117.0;157.0;119.0;959.0;927.0;50
9562;Zeewolde;2012;21377;6398;12743;2236;18750;1446;490;956;1181;624;557;155;67;88;105;55;50;121;57;64;143;51;92;657;394;263;273.0;123.0;161.0;116.0;910.0;927.0;50
9563;Zeewolde;2013;21557;6304;12882;2371;18851;1430;484;946;1276;700;576;159;70;89;114;67;47;140;68;72;154;58;96;709;437;272;274.0;129.0;173.0;118.0;975.0;918.0;50
9564;Zeewolde;2014;21816;6280;13022;2514;19037;1437;480;957;1342;725;617;162;73;89;116;63;53;151;73;78;162;55;107;751;461;290;271.0;138.0;160.0;119.0;945.0;920.0;50
9565;Zeewolde;2015;22018;6224;13182;2612;19152;1452;503;949;1414;763;651;167;74;93;117;66;51;168;83;85;174;57;117;788;483;305;270.0;142.0;175.0;119.0;1047.0;952.0;50
9566;Zeewolde;2016;22301;6225;13314;2762;19333;1453;479;974;1515;809;706;178;79;99;120;68;52;194;93;101;182;61;121;841;508;333;273.0;151.0;162.0;117.0;1056.0;955.0;50
9567;Zeewolde;2017;22570;6177;13502;2891;19504;1449;476;973;1617;865;752;188;84;104;120;71;49;220;101;119;197;66;131;892;543;349;270.0;154.0;178.0;123.0;970.0;980.0;50
9568;Zeewolde;2018;22733;6134;13564;3035;19601;1458;480;978;1674;904;770;203;93;110;130;76;54;232;109;123;205;67;138;904;559;345;272.0;160.0;166.0;111.0;1028.0;976.0;50
9569;Zeewolde;2019;22954;6058;13702;3194;19711;1469;494;975;1774;952;822;210;97;113;143;80;63;256;120;136;228;76;152;937;579;358;269.0;166.0;176.0;118.0;970.0;971.0;50
9570;Zeewolde;2020;23117;6021;13741;3355;19790;1493;517;976;1834;991;843;215;100;115;140;83;57;254;122;132;243;78;165;982;608;374;272.0;168.0;168.0;111.0;944.0;986.0;50
9571;Zeewolde;2021;23238;5959;13762;3517;19856;1491;528;963;1891;1025;866;220;102;118;150;86;64;264;122;142;246;79;167;1011;636;375;280.0;174.0;171.0;116.0;992.0;993.0;50
9572;Zeewolde;2022;23400;5913;13786;3701;19960;1510;542;968;1930;1055;875;220;102;118;155;87;68;268;117;151;245;79;166;1042;670;372;275.0;184.0;174.0;115.0;962.0;968.0;50
9573;Zeewolde;2023;23545;5885;13779;3881;20033;1506;545;961;2006;1094;912;227;107;120;153;84;69;272;119;153;267;85;182;1087;699;388;277.0;190.0;169.0;118.0;990.0;973.0;50
9574;Zeewolde;2024;23701;5886;13710;4105;20141;1530;553;977;2030;1095;935;230;111;119;163;84;79;271;121;150;273;85;188;1093;694;399;274.0;192.0;170.0;120.0;942.0;973.0;50
9575;Zeewolde;2025;23801;5842;13613;4346;20175;1550;569;981;2076;1117;959;239;113;126;163;89;74;278;121;157;282;91;191;1114;703;411;;;;;;;50
9576;Zeist;2008;60224;14191;35719;10314;47566;5795;2171;3624;6863;3801;3062;881;472;409;410;218;192;610;307;303;2896;1509;1387;2066;1295;771;636.0;640.0;367.0;389.0;3463.0;3322.0;355
9577;Zeist;2009;60345;14097;35948;10300;47537;5781;2175;3606;7027;3926;3101;921;496;425;436;244;192;655;325;330;2839;1490;1349;2176;1371;805;641.0;626.0;389.0;374.0;3413.0;3352.0;355
9578;Zeist;2010;60439;13948;36143;10348;47535;5782;2186;3596;7122;3925;3197;952;497;455;436;239;197;703;344;359;2801;1458;1343;2230;1387;843;645.0;626.0;419.0;370.0;3470.0;3402.0;355
9579;Zeist;2011;60581;13939;36296;10346;47600;5780;2189;3591;7201;3919;3282;939;473;466;435;241;194;745;354;391;2770;1432;1338;2312;1419;893;656.0;610.0;414.0;369.0;3551.0;3373.0;355
9580;Zeist;2012;60856;13903;36254;10699;47743;5842;2242;3600;7271;3965;3306;943;482;461;456;255;201;779;366;413;2753;1427;1326;2340;1435;905;651.0;611.0;425.0;372.0;3504.0;3402.0;355
9581;Zeist;2013;61057;13879;36170;11008;47870;5837;2247;3590;7350;4027;3323;973;497;476;448;255;193;803;382;421;2754;1436;1318;2372;1457;915;653.0;600.0;415.0;351.0;3499.0;3404.0;355
9582;Zeist;2014;61277;13822;36193;11262;47949;5906;2315;3591;7422;4066;3356;975;487;488;464;261;203;850;404;446;2712;1416;1296;2421;1498;923;663.0;600.0;410.0;355.0;3541.0;3408.0;355
9583;Zeist;2015;61534;13840;36234;11460;48087;5907;2328;3579;7540;4076;3464;963;484;479;476;269;207;890;409;481;2720;1411;1309;2491;1503;988;648.0;597.0;402.0;346.0;3521.0;3379.0;355
9584;Zeist;2016;61789;13848;36282;11659;48216;5942;2358;3584;7631;4115;3516;982;499;483;474;268;206;910;423;487;2733;1405;1328;2532;1520;1012;661.0;593.0;397.0;341.0;3549.0;3457.0;355
9585;Zeist;2017;62012;13874;36333;11805;48361;5972;2364;3608;7679;4108;3571;974;498;476;486;273;213;949;423;526;2726;1402;1324;2544;1512;1032;659.0;596.0;420.0;347.0;3509.0;3444.0;355
9586;Zeist;2018;62219;13871;36343;12005;48426;5953;2371;3582;7840;4205;3635;987;509;478;505;294;211;966;433;533;2739;1395;1344;2643;1574;1069;673.0;606.0;404.0;333.0;3619.0;3432.0;355
9587;Zeist;2019;62552;13895;36433;12224;48576;6058;2434;3624;7918;4225;3693;1006;518;488;510;297;213;1012;448;564;2703;1374;1329;2687;1588;1099;667.0;613.0;393.0;346.0;3678.0;3469.0;355
9588;Zeist;2020;62871;13869;36631;12371;48768;6065;2448;3617;8038;4306;3732;1007;516;491;547;323;224;1032;473;559;2673;1355;1318;2779;1639;1140;669.0;607.0;403.0;344.0;3648.0;3502.0;355
9589;Zeist;2021;63144;13823;36753;12568;48941;6066;2463;3603;8137;4360;3777;1011;510;501;567;338;229;1055;484;571;2667;1357;1310;2837;1671;1166;675.0;617.0;401.0;343.0;3587.0;3515.0;355
9590;Zeist;2022;63337;13785;36870;12682;49021;6100;2491;3609;8216;4380;3836;1033;512;521;584;336;248;1065;488;577;2643;1356;1287;2891;1688;1203;673.0;620.0;398.0;334.0;3708.0;3504.0;355
9591;Zeist;2023;63666;13751;37042;12873;49166;6112;2514;3598;8388;4454;3934;1039;512;527;597;352;245;1111;499;612;2630;1347;1283;3011;1744;1267;680.0;632.0;401.0;329.0;3670.0;3605.0;355
9592;Zeist;2024;63856;13700;37139;13017;49260;6154;2552;3602;8442;4479;3963;1044;517;527;602;362;240;1156;514;642;2610;1329;1281;3030;1757;1273;674.0;617.0;389.0;323.0;3638.0;3580.0;355
9593;Zeist;2025;64045;13662;37120;13263;49344;6199;2569;3630;8502;4517;3985;1034;519;515;633;372;261;1153;514;639;2570;1306;1264;3112;1806;1306;;;;;;;355
9594;Zevenaar;2008;31727;7132;19372;5223;27167;3200;1018;2182;1360;759;601;264;131;133;92;46;46;475;258;217;78;37;41;451;287;164;283.0;266.0;107.0;156.0;1118.0;1202.0;299
9595;Zevenaar;2009;31617;7040;19195;5382;27099;3105;982;2123;1413;791;622;271;131;140;97;49;48;481;261;220;90;44;46;474;306;168;274.0;277.0;112.0;149.0;1199.0;1208.0;299
9596;Zevenaar;2010;31573;6940;19057;5576;27084;3043;953;2090;1446;798;648;271;132;139;100;50;50;488;260;228;99;50;49;488;306;182;271.0;279.0;127.0;145.0;1304.0;1225.0;299
9597;Zevenaar;2011;31628;6855;19036;5737;27094;3011;956;2055;1523;848;675;269;137;132;107;57;50;516;280;236;128;62;66;503;312;191;266.0;284.0;121.0;146.0;1283.0;1216.0;299
9598;Zevenaar;2012;31654;6734;18829;6091;27094;2981;942;2039;1579;886;693;276;147;129;115;58;57;529;289;240;135;64;71;524;328;196;271.0;293.0;121.0;145.0;1347.0;1240.0;299
9599;Zevenaar;2013;31718;6613;18791;6314;27096;2964;942;2022;1658;926;732;291;153;138;120;65;55;539;290;249;143;66;77;565;352;213;264.0;301.0;131.0;147.0;1415.0;1238.0;299
9600;Zevenaar;2014;31845;6536;18719;6590;27195;2903;932;1971;1747;971;776;297;161;136;128;70;58;551;286;265;161;71;90;610;383;227;271.0;305.0;119.0;142.0;1204.0;1258.0;299
9601;Zevenaar;2015;31739;6379;18613;6747;27108;2854;918;1936;1777;994;783;305;167;138;136;78;58;565;293;272;161;69;92;610;387;223;271.0;314.0;113.0;141.0;1406.0;1283.0;299
9602;Zevenaar;2016;31793;6335;18552;6906;27150;2790;892;1898;1853;1012;841;316;172;144;140;79;61;577;294;283;175;70;105;645;397;248;274.0;319.0;121.0;135.0;1374.0;1277.0;299
9603;Zevenaar;2017;31835;6267;18530;7038;27200;2754;895;1859;1881;1040;841;309;175;134;146;89;57;572;293;279;183;75;108;671;408;263;276.0;315.0;116.0;132.0;1293.0;1286.0;299
9604;Zevenaar;2018;31792;6181;18403;7208;27133;2716;876;1840;1943;1067;876;326;180;146;157;97;60;580;290;290;201;84;117;679;416;263;277.0;336.0;115.0;129.0;1331.0;1275.0;299
9605;Zevenaar;2019;31777;6089;18342;7346;27102;2705;878;1827;1970;1092;878;325;182;143;171;104;67;593;299;294;199;84;115;682;423;259;282.0;332.0;114.0;133.0;1363.0;1296.0;299
9606;Zevenaar;2020;31779;6012;18292;7475;27060;2684;868;1816;2035;1118;917;334;192;142;173;106;67;631;309;322;209;85;124;688;426;262;295.0;343.0;109.0;121.0;1326.0;1309.0;299
9607;Zevenaar;2021;31738;5941;18220;7577;27037;2647;878;1769;2054;1118;936;341;192;149;172;105;67;631;318;313;222;86;136;688;417;271;301.0;352.0;113.0;122.0;1330.0;1283.0;299
9608;Zevenaar;2022;31726;5851;18212;7663;26971;2627;880;1747;2128;1159;969;342;188;154;184;111;73;662;332;330;215;86;129;725;442;283;299.0;353.0;102.0;131.0;1333.0;1273.0;299
9609;Zevenaar;2023;31707;5801;18190;7716;26975;2586;865;1721;2146;1170;976;354;192;162;192;114;78;648;332;316;222;91;131;730;441;289;308.0;357.0;111.0;124.0;1337.0;1271.0;299
9610;Zevenaar;2024;31714;5765;18150;7799;26978;2550;843;1707;2186;1187;999;339;181;158;194;113;81;661;344;317;236;99;137;756;450;306;310.0;358.0;107.0;120.0;1318.0;1275.0;299
9611;Zevenaar;2025;31698;5799;18023;7876;26933;2533;842;1691;2232;1189;1043;342;174;168;194;111;83;685;344;341;238;102;136;773;458;315;;;;;;;299
9612;Zevenhuizen-Moerkapelle;2008;10250;2804;5897;1549;9428;517;190;327;305;168;137;60;30;30;22;9;13;27;13;14;65;36;29;131;80;51;96.0;82.0;24.0;34.0;403.0;396.0;1666
9613;Zevenhuizen-Moerkapelle;2009;10263;2755;5899;1609;9393;522;189;333;348;183;165;70;35;35;25;12;13;37;17;20;71;35;36;145;84;61;98.0;83.0;26.0;36.0;506.0;404.0;1666
9614;Zevenhuizen-Moerkapelle;2010;10371;2723;5979;1669;9426;545;196;349;400;206;194;84;39;45;31;15;16;41;18;23;79;40;39;165;94;71;101.0;86.0;27.0;36.0;506.0;403.0;1666
9615;Zevenhuizen-Moerkapelle;2011;10481;2704;6063;1714;9466;573;206;367;442;218;224;91;43;48;35;16;19;54;26;28;81;36;45;181;97;84;101.0;88.0;28.0;36.0;569.0;419.0;1666
9616;Zevenhuizen-Moerkapelle;2012;10637;2678;6116;1843;9555;601;222;379;481;236;245;99;46;53;44;20;24;57;24;33;90;40;50;191;106;85;105.0;88.0;33.0;36.0;613.0;404.0;1666
9617;Zevenhuizen-Moerkapelle;2013;10860;2684;6235;1941;9700;641;237;404;519;243;276;104;40;64;48;22;26;63;26;37;100;40;60;204;115;89;113.0;94.0;32.0;38.0;631.0;427.0;1666
9618;Zevenhuizen-Moerkapelle;2014;11077;2687;6348;2042;9842;673;250;423;562;249;313;110;46;64;53;22;31;75;31;44;106;38;68;218;112;106;116.0;96.0;33.0;38.0;613.0;436.0;1666
9619;Zevenhuizen-Moerkapelle;2015;11270;2661;6492;2117;9997;683;248;435;590;256;334;117;47;70;55;22;33;79;28;51;114;39;75;225;120;105;124.0;95.0;33.0;38.0;610.0;437.0;1666
9620;Zevenhuizen-Moerkapelle;2016;11468;2666;6606;2196;10133;708;264;444;627;267;360;127;50;77;63;26;37;84;28;56;117;42;75;236;121;115;136.0;102.0;37.0;40.0;666.0;454.0;1666
9621;Zevenhuizen-Moerkapelle;2017;11711;2714;6750;2247;10282;761;286;475;668;291;377;128;52;76;68;29;39;97;32;65;128;49;79;247;129;118;142.0;109.0;39.0;41.0;632.0;448.0;1666
9622;Zevenhuizen-Moerkapelle;2018;11926;2747;6848;2331;10425;789;296;493;712;306;406;135;55;80;80;35;45;104;36;68;127;46;81;266;134;132;142.0;106.0;35.0;40.0;674.0;460.0;1666
9623;Zevenhuizen-Moerkapelle;2019;12172;2782;7015;2375;10600;816;300;516;756;321;435;139;55;84;81;33;48;108;37;71;136;47;89;292;149;143;152.0;112.0;34.0;44.0;645.0;460.0;1666
9624;Zevenhuizen-Moerkapelle;2020;12387;2818;7098;2471;10744;839;314;525;804;338;466;145;57;88;89;36;53;117;42;75;133;43;90;320;160;160;157.0;110.0;39.0;45.0;710.0;462.0;1666
9625;Zevenhuizen-Moerkapelle;2021;12678;2880;7242;2556;10938;883;331;552;857;359;498;157;59;98;92;40;52;128;46;82;138;44;94;342;170;172;166.0;117.0;53.0;48.0;694.0;487.0;1666
9626;Zevenhuizen-Moerkapelle;2022;12942;2957;7339;2646;11143;914;348;566;885;366;519;161;60;101;92;37;55;133;46;87;148;47;101;351;176;175;161.0;123.0;42.0;49.0;682.0;511.0;1666
9627;Zevenhuizen-Moerkapelle;2023;13145;2980;7459;2706;11304;933;352;581;908;378;530;163;60;103;97;39;58;136;46;90;155;48;107;357;185;172;172.0;127.0;48.0;44.0;705.0;516.0;1666
9628;Zevenhuizen-Moerkapelle;2024;13384;3050;7532;2802;11462;964;371;593;958;385;573;170;62;108;101;39;62;146;49;97;176;57;119;365;178;187;168.0;131.0;40.0;45.0;677.0;525.0;1666
9629;Zevenhuizen-Moerkapelle;2025;13570;3113;7566;2891;11597;999;384;615;974;384;590;160;60;100;111;42;69;155;53;102;178;55;123;370;174;196;;;;;;;1666
9630;Zijpe;2008;11531;2780;7050;1701;10559;718;291;427;254;160;94;29;12;17;25;9;16;23;17;6;16;8;8;161;114;47;117.0;91.0;31.0;49.0;542.0;605.0;476
9631;Zijpe;2009;11478;2713;6979;1786;10482;708;278;430;288;171;117;32;13;19;33;13;20;34;21;13;19;6;13;170;118;52;110.0;94.0;28.0;51.0;567.0;627.0;476
9632;Zijpe;2010;11413;2638;6899;1876;10408;694;264;430;311;180;131;34;14;20;33;13;20;48;27;21;20;6;14;176;120;56;109.0;93.0;34.0;49.0;714.0;629.0;476
9633;Zijpe;2011;11500;2613;6908;1979;10464;683;251;432;353;194;159;42;18;24;35;14;21;53;26;27;30;12;18;193;124;69;110.0;95.0;38.0;56.0;714.0;650.0;476
9634;Zijpe;2012;11562;2561;6881;2120;10516;677;246;431;369;191;178;41;17;24;43;17;26;57;30;27;37;14;23;191;113;78;110.0;99.0;34.0;49.0;644.0;648.0;476
9635;Zijpe;2013;11554;2497;6808;2249;10493;678;246;432;383;196;187;49;20;29;43;18;25;60;33;27;42;15;27;189;110;79;108.0;107.0;35.0;45.0;677.0;631.0;476
9636;Zijpe;2014;11593;2466;6790;2337;10499;666;236;430;428;215;213;60;26;34;43;19;24;63;35;28;50;16;34;212;119;93;110.0;109.0;35.0;48.0;729.0;652.0;476
9637;Zijpe;2015;11659;2409;6821;2429;10555;649;230;419;455;235;220;62;29;33;51;23;28;76;40;36;48;16;32;218;127;91;110.0;110.0;36.0;51.0;680.0;659.0;476
9638;Zijpe;2016;11666;2366;6787;2513;10535;651;231;420;480;243;237;63;33;30;58;25;33;84;43;41;61;19;42;214;123;91;117.0;118.0;53.0;48.0;716.0;658.0;476
9639;Zijpe;2017;11729;2364;6800;2565;10547;665;237;428;517;259;258;74;37;37;59;25;34;94;48;46;63;22;41;227;127;100;114.0;114.0;39.0;50.0;661.0;669.0;476
9640;Zijpe;2018;11711;2335;6738;2638;10536;667;241;426;508;243;265;75;37;38;53;19;34;92;43;49;66;22;44;222;122;100;113.0;119.0;41.0;46.0;744.0;627.0;476
9641;Zijpe;2019;11818;2344;6748;2726;10615;669;235;434;534;265;269;79;42;37;54;22;32;97;44;53;74;24;50;230;133;97;115.0;125.0;37.0;43.0;659.0;665.0;476
9642;Zijpe;2020;11797;2307;6714;2776;10576;679;256;423;542;257;285;83;43;40;54;23;31;101;47;54;81;24;57;223;120;103;120.0;123.0;35.0;42.0;722.0;682.0;476
9643;Zijpe;2021;11828;2286;6722;2820;10610;664;249;415;554;260;294;84;42;42;56;23;33;105;46;59;87;29;58;222;120;102;119.0;124.0;37.0;45.0;697.0;657.0;476
9644;Zijpe;2022;11857;2275;6722;2860;10627;664;255;409;566;267;299;83;39;44;54;23;31;108;49;59;91;32;59;230;124;106;119.0;133.0;35.0;45.0;710.0;672.0;476
9645;Zijpe;2023;11872;2244;6721;2907;10611;659;245;414;602;284;318;80;38;42;60;25;35;112;53;59;103;38;65;247;130;117;120.0;132.0;35.0;44.0;704.0;660.0;476
9646;Zijpe;2024;11896;2221;6709;2966;10613;671;247;424;612;285;327;82;40;42;60;26;34;112;51;61;110;38;72;248;130;118;122.0;139.0;32.0;46.0;749.0;666.0;476
9647;Zijpe;2025;11949;2231;6678;3040;10663;676;254;422;610;293;317;84;40;44;63;28;35;114;55;59;108;38;70;241;132;109;;;;;;;476
9648;Zoetermeer;2008;119107;30013;74940;14154;87286;13097;5101;7996;18724;10559;8165;7426;3914;3512;2114;1246;868;1155;601;554;1740;816;924;6289;3982;2307;1307.0;877.0;513.0;790.0;4943.0;4052.0;637
9649;Zoetermeer;2009;120167;29814;75575;14778;87911;13173;5143;8030;19083;10637;8446;7310;3839;3471;2097;1228;869;1303;669;634;1935;913;1022;6438;3988;2450;1326.0;904.0;586.0;761.0;4692.0;4010.0;637
9650;Zoetermeer;2010;121107;29757;75853;15497;88339;13297;5212;8085;19471;10747;8724;7231;3781;3450;2087;1213;874;1467;732;735;2082;977;1105;6604;4044;2560;1348.0;937.0;567.0;758.0;4907.0;3981.0;637
9651;Zoetermeer;2011;122262;29617;76583;16062;88907;13385;5302;8083;19970;10846;9124;7164;3728;3436;2127;1233;894;1601;780;821;2264;1034;1230;6814;4071;2743;1351.0;965.0;595.0;737.0;4797.0;3969.0;637
9652;Zoetermeer;2012;123344;29556;76426;17362;89425;13540;5387;8153;20379;10942;9437;7052;3662;3390;2151;1240;911;1743;837;906;2424;1078;1346;7009;4125;2884;1369.0;1000.0;609.0;765.0;3352.0;3934.0;637
9653;Zoetermeer;2013;122985;29203;75273;18509;89038;13492;5351;8141;20455;10897;9558;6921;3595;3326;2159;1232;927;1808;861;947;2507;1115;1392;7060;4094;2966;1338.0;1017.0;614.0;723.0;3206.0;3762.0;637
9654;Zoetermeer;2014;122646;28960;74277;19409;88551;13478;5378;8100;20617;10852;9765;6855;3547;3308;2143;1210;933;1872;882;990;2610;1151;1459;7137;4062;3075;1296.0;1036.0;611.0;704.0;3307.0;3611.0;637
9655;Zoetermeer;2015;122520;28726;73514;20280;88230;13525;5406;8119;20765;10888;9877;6723;3490;3233;2145;1221;924;1947;916;1031;2713;1184;1529;7237;4077;3160;1271.0;1058.0;623.0;700.0;3389.0;3565.0;637
9656;Zoetermeer;2016;122490;28640;72780;21070;87961;13581;5407;8174;20948;10873;10075;6632;3441;3191;2160;1211;949;2030;954;1076;2805;1205;1600;7321;4062;3259;1271.0;1073.0;606.0;711.0;3246.0;3457.0;637
9657;Zoetermeer;2017;122389;28525;72010;21854;87624;13637;5460;8177;21128;10831;10297;6519;3350;3169;2168;1210;958;2115;976;1139;2896;1232;1664;7430;4063;3367;1246.0;1112.0;614.0;698.0;3391.0;3466.0;637
9658;Zoetermeer;2018;122376;28456;71217;22703;87410;13644;5483;8161;21322;10854;10468;6443;3305;3138;2190;1209;981;2192;1009;1183;2944;1248;1696;7553;4083;3470;1250.0;1107.0;582.0;677.0;3473.0;3405.0;637
9659;Zoetermeer;2019;122503;28370;70587;23546;87321;13700;5527;8173;21482;10868;10614;6334;3237;3097;2201;1206;995;2231;1033;1198;3041;1282;1759;7675;4110;3565;1242.0;1135.0;590.0;662.0;3528.0;3374.0;637
9660;Zoetermeer;2020;122710;28358;70094;24258;87189;13814;5589;8225;21707;10942;10765;6293;3208;3085;2201;1195;1006;2282;1067;1215;3119;1307;1812;7812;4165;3647;1233.0;1170.0;609.0;675.0;3249.0;3390.0;637
9661;Zoetermeer;2021;122580;28082;69410;25088;86938;13860;5634;8226;21782;10971;10811;6212;3152;3060;2179;1189;990;2363;1116;1247;3161;1334;1827;7867;4180;3687;1229.0;1201.0;551.0;659.0;3476.0;3408.0;637
9662;Zoetermeer;2022;122578;27922;68825;25831;86835;13870;5657;8213;21873;10985;10888;6143;3112;3031;2175;1197;978;2401;1124;1277;3250;1371;1879;7904;4181;3723;1232.0;1214.0;555.0;641.0;3556.0;3416.0;637
9663;Zoetermeer;2023;122656;27840;68154;26662;86689;13924;5645;8279;22043;11026;11017;6060;3060;3000;2197;1192;1005;2450;1140;1310;3313;1395;1918;8023;4239;3784;1225.0;1227.0;554.0;636.0;3804.0;3423.0;637
9664;Zoetermeer;2024;122965;27762;67924;27279;86699;14049;5700;8349;22217;11118;11099;5999;3012;2987;2219;1202;1017;2501;1169;1332;3337;1405;1932;8161;4330;3831;1220.0;1258.0;536.0;639.0;3641.0;3439.0;637
9665;Zoetermeer;2025;123038;27708;67304;28026;86576;14132;5754;8378;22330;11126;11204;5917;2963;2954;2222;1199;1023;2544;1182;1362;3410;1439;1971;8237;4343;3894;;;;;;;637
9666;Zoeterwoude;2008;8115;2043;4899;1173;7327;481;187;294;307;195;112;64;36;28;19;10;9;55;29;26;23;17;6;146;103;43;58.0;58.0;32.0;44.0;212.0;323.0;638
9667;Zoeterwoude;2009;7993;1946;4822;1225;7187;482;191;291;324;196;128;62;33;29;18;10;8;57;27;30;28;16;12;159;110;49;56.0;60.0;41.0;39.0;248.0;330.0;638
9668;Zoeterwoude;2010;7910;1876;4750;1284;7066;513;220;293;331;195;136;64;34;30;20;11;9;55;24;31;31;18;13;161;108;53;53.0;66.0;48.0;40.0;315.0;341.0;638
9669;Zoeterwoude;2011;7881;1796;4773;1312;7015;524;231;293;342;193;149;62;32;30;23;14;9;59;25;34;35;21;14;163;101;62;57.0;64.0;45.0;40.0;283.0;369.0;638
9670;Zoeterwoude;2012;7793;1710;4671;1412;6904;543;249;294;346;193;153;65;33;32;28;18;10;54;23;31;39;21;18;160;98;62;53.0;66.0;48.0;39.0;288.0;341.0;638
9671;Zoeterwoude;2013;7737;1665;4608;1464;6796;562;271;291;379;210;169;68;33;35;25;15;10;55;24;31;42;22;20;189;116;73;58.0;69.0;44.0;42.0;325.0;351.0;638
9672;Zoeterwoude;2014;7703;1608;4582;1513;6757;571;285;286;375;205;170;70;32;38;24;14;10;46;21;25;49;25;24;186;113;73;61.0;67.0;52.0;40.0;257.0;330.0;638
9673;Zoeterwoude;2015;7637;1556;4517;1564;6664;587;288;299;386;211;175;72;30;42;30;18;12;48;24;24;49;25;24;187;114;73;60.0;69.0;51.0;39.0;227.0;318.0;638
9674;Zoeterwoude;2016;7551;1517;4442;1592;6557;599;288;311;395;217;178;70;29;41;30;20;10;49;27;22;52;26;26;194;115;79;66.0;70.0;52.0;42.0;291.0;321.0;638
9675;Zoeterwoude;2017;7528;1498;4409;1621;6510;612;293;319;406;223;183;65;26;39;34;20;14;49;26;23;55;26;29;203;125;78;67.0;71.0;50.0;38.0;312.0;315.0;638
9676;Zoeterwoude;2018;7534;1472;4420;1642;6469;644;309;335;421;233;188;71;31;40;33;19;14;49;27;22;55;25;30;213;131;82;70.0;71.0;51.0;40.0;286.0;314.0;638
9677;Zoeterwoude;2019;7517;1473;4369;1675;6422;666;314;352;429;236;193;75;33;42;32;18;14;51;25;26;56;26;30;215;134;81;71.0;75.0;47.0;38.0;333.0;338.0;638
9678;Zoeterwoude;2020;7518;1470;4335;1713;6387;689;333;356;442;245;197;78;36;42;32;18;14;58;30;28;63;29;34;211;132;79;73.0;75.0;52.0;40.0;356.0;320.0;638
9679;Zoeterwoude;2021;7565;1461;4356;1748;6394;708;359;349;463;258;205;77;39;38;39;21;18;63;31;32;67;30;37;217;137;80;75.0;77.0;52.0;40.0;332.0;324.0;638
9680;Zoeterwoude;2022;7584;1465;4327;1792;6388;719;374;345;477;265;212;77;36;41;44;25;19;69;35;34;66;28;38;221;141;80;79.0;81.0;48.0;40.0;291.0;338.0;638
9681;Zoeterwoude;2023;7543;1429;4302;1812;6330;730;383;347;483;265;218;77;36;41;47;24;23;75;37;38;65;30;35;219;138;81;77.0;83.0;47.0;37.0;342.0;324.0;638
9682;Zoeterwoude;2024;7567;1447;4266;1854;6319;750;394;356;498;278;220;75;38;37;48;23;25;78;42;36;71;32;39;226;143;83;80.0;81.0;48.0;40.0;290.0;333.0;638
9683;Zoeterwoude;2025;7533;1457;4172;1904;6265;767;401;366;501;273;228;70;38;32;47;24;23;81;44;37;82;34;48;221;133;88;;;;;;;638
9684;Zuidhorn;2008;18548;5125;10948;2475;17444;750;256;494;354;204;150;53;21;32;23;9;14;34;16;18;18;10;8;226;148;78;205.0;152.0;40.0;72.0;717.0;704.0;56
9685;Zuidhorn;2009;18582;5009;11000;2573;17415;755;254;501;412;228;184;55;27;28;29;14;15;53;21;32;32;16;16;243;150;93;201.0;155.0;45.0;71.0;672.0;728.0;56
9686;Zuidhorn;2010;18550;4906;10935;2709;17380;742;245;497;428;228;200;62;27;35;32;17;15;51;21;30;33;16;17;250;147;103;205.0;151.0;50.0;74.0;677.0;750.0;56
9687;Zuidhorn;2011;18508;4791;10931;2786;17295;755;255;500;458;240;218;71;31;40;36;19;17;61;26;35;37;19;18;253;145;108;202.0;153.0;56.0;67.0;784.0;734.0;56
9688;Zuidhorn;2012;18598;4683;10988;2927;17344;751;251;500;503;261;242;82;35;47;41;25;16;66;27;39;52;26;26;262;148;114;204.0;154.0;50.0;72.0;702.0;763.0;56
9689;Zuidhorn;2013;18566;4552;10938;3076;17309;751;247;504;506;263;243;83;38;45;43;26;17;72;32;40;57;27;30;251;140;111;204.0;159.0;54.0;72.0;644.0;735.0;56
9690;Zuidhorn;2014;18505;4462;10858;3185;17214;752;249;503;539;277;262;95;44;51;48;31;17;82;35;47;65;31;34;249;136;113;206.0;161.0;53.0;59.0;735.0;736.0;56
9691;Zuidhorn;2015;18546;4399;10860;3287;17208;764;265;499;574;302;272;100;48;52;51;34;17;95;40;55;66;31;35;262;149;113;208.0;162.0;51.0;66.0;719.0;757.0;56
9692;Zuidhorn;2016;18543;4311;10850;3382;17177;766;271;495;600;306;294;97;43;54;56;37;19;103;42;61;70;29;41;274;155;119;210.0;167.0;46.0;65.0;692.0;733.0;56
9693;Zuidhorn;2017;18528;4252;10834;3442;17140;766;271;495;622;320;302;99;45;54;61;41;20;101;39;62;74;33;41;287;162;125;209.0;164.0;54.0;66.0;700.0;730.0;56
9694;Zuidhorn;2018;18534;4162;10839;3533;17110;773;271;502;651;331;320;108;46;62;61;40;21;116;46;70;80;38;42;286;161;125;212.0;166.0;47.0;58.0;739.0;748.0;56
9695;Zuidhorn;2019;18562;4135;10798;3629;17115;789;276;513;658;346;312;105;47;58;60;37;23;118;51;67;80;39;41;295;172;123;212.0;173.0;48.0;61.0;711.0;735.0;56
9696;Zuidhorn;2020;18565;4092;10758;3715;17076;797;284;513;692;354;338;111;48;63;63;38;25;129;56;73;87;40;47;302;172;130;212.0;180.0;54.0;63.0;729.0;724.0;56
9697;Zuidhorn;2021;18594;4101;10696;3797;17075;787;275;512;732;380;352;112;52;60;72;46;26;140;62;78;95;39;56;313;181;132;216.0;177.0;52.0;65.0;640.0;760.0;56
9698;Zuidhorn;2022;18502;4030;10577;3895;16953;793;270;523;756;392;364;116;52;64;77;49;28;138;63;75;102;41;61;323;187;136;202.0;179.0;50.0;65.0;761.0;727.0;56
9699;Zuidhorn;2023;18548;3995;10551;4002;16985;782;275;507;781;404;377;120;59;61;77;44;33;147;63;84;102;40;62;335;198;137;207.0;183.0;46.0;65.0;781.0;749.0;56
9700;Zuidhorn;2024;18586;3999;10483;4104;17018;790;276;514;778;412;366;135;68;67;74;44;30;134;62;72;105;39;66;330;199;131;204.0;195.0;50.0;60.0;786.0;726.0;56
9701;Zuidhorn;2025;18649;4039;10436;4174;17015;805;283;522;829;422;407;133;66;67;81;46;35;159;68;91;118;43;75;338;199;139;;;;;;;56
9702;Zundert;2008;20605;4729;12475;3401;17927;2162;956;1206;516;286;230;45;25;20;31;16;15;38;22;16;217;102;115;185;121;64;143.0;163.0;217.0;121.0;297.0;456.0;879
9703;Zundert;2009;20525;4649;12393;3483;17827;2109;920;1189;589;337;252;52;33;19;39;20;19;48;27;21;227;108;119;223;149;74;139.0;169.0;227.0;119.0;245.0;487.0;879
9704;Zundert;2010;20363;4536;12244;3583;17652;2083;907;1176;628;363;265;57;38;19;49;27;22;49;28;21;232;112;120;241;158;83;136.0;175.0;244.0;114.0;336.0;492.0;879
9705;Zundert;2011;20300;4403;12186;3711;17559;2055;901;1154;686;401;285;69;46;23;57;32;25;59;31;28;229;115;114;272;177;95;138.0;182.0;249.0;120.0;302.0;518.0;879
9706;Zundert;2012;20171;4273;12076;3822;17408;2019;884;1135;744;433;311;74;50;24;64;37;27;67;30;37;239;123;116;300;193;107;142.0;184.0;262.0;118.0;251.0;513.0;879
9707;Zundert;2013;20011;4156;11921;3934;17232;1990;871;1119;789;467;322;82;53;29;75;45;30;68;34;34;244;127;117;320;208;112;138.0;190.0;256.0;114.0;357.0;519.0;879
9708;Zundert;2014;19941;4017;11888;4036;17083;1985;863;1122;873;527;346;96;60;36;85;50;35;77;37;40;246;131;115;369;249;120;135.0;184.0;272.0;113.0;273.0;525.0;879
9709;Zundert;2015;19801;3855;11817;4129;16902;1970;856;1114;929;554;375;106;62;44;89;54;35;87;42;45;256;134;122;391;262;129;136.0;194.0;267.0;102.0;377.0;510.0;879
9710;Zundert;2016;19777;3771;11783;4223;16826;1962;866;1096;989;582;407;112;66;46;85;51;34;96;44;52;263;132;131;433;289;144;142.0;192.0;262.0;112.0;296.0;522.0;879
9711;Zundert;2017;19653;3625;11720;4308;16646;1955;878;1077;1052;610;442;124;72;52;95;57;38;107;46;61;259;131;128;467;304;163;144.0;194.0;258.0;108.0;318.0;511.0;879
9712;Zundert;2018;19562;3500;11660;4402;16532;1931;903;1028;1099;652;447;135;82;53;98;62;36;111;49;62;265;137;128;490;322;168;142.0;199.0;277.0;109.0;377.0;523.0;879
9713;Zundert;2019;19537;3429;11594;4514;16448;1932;907;1025;1157;688;469;146;91;55;110;71;39;121;49;72;274;135;139;506;342;164;149.0;199.0;260.0;110.0;423.0;500.0;879
9714;Zundert;2020;19561;3408;11544;4609;16436;1914;909;1005;1211;715;496;152;94;58;115;73;42;128;53;75;279;132;147;537;363;174;156.0;207.0;259.0;112.0;431.0;517.0;879
9715;Zundert;2021;19573;3390;11467;4716;16384;1904;914;990;1285;754;531;165;102;63;122;78;44;132;55;77;290;133;157;576;386;190;159.0;212.0;260.0;110.0;452.0;513.0;879
9716;Zundert;2022;19610;3353;11440;4817;16339;1915;930;985;1356;802;554;170;111;59;132;86;46;142;64;78;303;140;163;609;401;208;165.0;208.0;257.0;106.0;449.0;519.0;879
9717;Zundert;2023;19649;3322;11377;4950;16301;1902;934;968;1446;876;570;184;122;62;145;94;51;161;74;87;304;147;157;652;439;213;175.0;217.0;264.0;108.0;442.0;511.0;879
9718;Zundert;2024;19698;3360;11271;5067;16252;1917;934;983;1529;925;604;196;131;65;156;107;49;172;80;92;321;155;166;684;452;232;176.0;219.0;256.0;108.0;443.0;531.0;879
9719;Zundert;2025;19718;3413;11102;5203;16203;1914;931;983;1601;980;621;215;143;72;157;107;50;178;85;93;330;162;168;721;483;238;;;;;;;879
9720;Zutphen;2008;47038;11663;28701;6674;39904;3925;1334;2591;3209;1767;1442;298;149;149;181;99;82;1378;681;697;300;141;159;1052;697;355;544.0;419.0;138.0;167.0;2270.0;1945.0;301
9721;Zutphen;2009;47466;11678;28896;6892;40261;3904;1339;2565;3301;1816;1485;320;160;160;201;106;95;1375;682;693;319;148;171;1086;720;366;536.0;426.0;154.0;157.0;2209.0;1997.0;301
9722;Zutphen;2010;47790;11673;29026;7091;40600;3884;1337;2547;3306;1807;1499;328;161;167;209;115;94;1343;672;671;331;154;177;1095;705;390;533.0;426.0;184.0;164.0;2217.0;2049.0;301
9723;Zutphen;2011;48088;11607;29197;7284;40845;3872;1321;2551;3371;1836;1535;346;176;170;225;125;100;1342;668;674;351;165;186;1107;702;405;522.0;435.0;162.0;155.0;1995.0;2031.0;301
9724;Zutphen;2012;48151;11487;29028;7636;40942;3814;1279;2535;3395;1854;1541;358;184;174;232;126;106;1324;659;665;361;170;191;1120;715;405;526.0;437.0;175.0;158.0;2069.0;2019.0;301
9725;Zutphen;2013;48309;11428;28899;7982;41069;3824;1294;2530;3416;1845;1571;358;184;174;231;128;103;1311;639;672;382;184;198;1134;710;424;512.0;444.0;163.0;158.0;2103.0;2059.0;301
9726;Zutphen;2014;48432;11332;28800;8300;41166;3817;1307;2510;3449;1864;1585;376;192;184;237;138;99;1298;640;658;398;189;209;1140;705;435;513.0;451.0;165.0;155.0;2091.0;2079.0;301
9727;Zutphen;2015;48523;11286;28668;8569;41246;3771;1293;2478;3506;1907;1599;393;204;189;255;148;107;1277;644;633;423;194;229;1158;717;441;506.0;455.0;168.0;151.0;2212.0;2063.0;301
9728;Zutphen;2016;48742;11236;28673;8833;41409;3756;1299;2457;3577;1925;1652;409;212;197;273;149;124;1289;647;642;434;199;235;1172;718;454;509.0;456.0;167.0;147.0;2162.0;2092.0;301
9729;Zutphen;2017;48889;11164;28636;9089;41446;3791;1308;2483;3652;1945;1707;432;220;212;282;150;132;1297;652;645;448;198;250;1193;725;468;514.0;460.0;157.0;150.0;2119.0;2106.0;301
9730;Zutphen;2018;48968;11050;28582;9336;41509;3758;1292;2466;3701;1988;1713;447;226;221;291;160;131;1284;645;639;464;215;249;1215;742;473;522.0;469.0;173.0;144.0;2085.0;2078.0;301
9731;Zutphen;2019;49065;10958;28516;9591;41574;3727;1283;2444;3764;2020;1744;452;232;220;317;174;143;1259;635;624;472;223;249;1264;756;508;520.0;483.0;154.0;145.0;2038.0;2069.0;301
9732;Zutphen;2020;49087;10811;28430;9846;41611;3681;1277;2404;3795;2042;1753;451;229;222;313;170;143;1253;638;615;483;219;264;1295;786;509;517.0;488.0;153.0;144.0;2054.0;2099.0;301
9733;Zutphen;2021;49085;10702;28288;10095;41602;3629;1247;2382;3854;2066;1788;469;239;230;344;185;159;1231;633;598;499;223;276;1311;786;525;520.0;492.0;160.0;136.0;2080.0;2075.0;301
9734;Zutphen;2022;49150;10631;28178;10341;41606;3627;1258;2369;3917;2110;1807;484;243;241;355;197;158;1232;631;601;505;224;281;1341;815;526;525.0;497.0;168.0;144.0;2092.0;2060.0;301
9735;Zutphen;2023;49240;10558;28057;10625;41666;3612;1274;2338;3962;2124;1838;501;256;245;364;203;161;1211;613;598;515;222;293;1371;830;541;523.0;509.0;158.0;129.0;2069.0;2066.0;301
9736;Zutphen;2024;49289;10517;27959;10813;41702;3631;1296;2335;3956;2146;1810;501;259;242;365;212;153;1188;604;584;527;228;299;1375;843;532;517.0;519.0;144.0;138.0;2067.0;2057.0;301
9737;Zutphen;2025;49309;10466;27798;11045;41669;3626;1300;2326;4014;2173;1841;511;270;241;374;218;156;1186;597;589;539;236;303;1404;852;552;;;;;;;301
9738;Zwartewaterland;2008;21638;6837;12281;2520;20693;571;185;386;374;208;166;46;17;29;36;14;22;27;15;12;31;11;20;234;151;83;351.0;143.0;46.0;66.0;569.0;669.0;1896
9739;Zwartewaterland;2009;21730;6843;12256;2631;20701;599;199;400;430;244;186;53;20;33;39;17;22;38;16;22;41;16;25;259;175;84;351.0;142.0;49.0;68.0;520.0;690.0;1896
9740;Zwartewaterland;2010;21753;6797;12213;2743;20661;610;205;405;482;268;214;59;24;35;46;22;24;49;20;29;45;17;28;283;185;98;344.0;144.0;49.0;68.0;526.0;713.0;1896
9741;Zwartewaterland;2011;21750;6714;12163;2873;20613;629;210;419;508;281;227;66;25;41;50;25;25;54;24;30;46;16;30;292;191;101;345.0;150.0;57.0;63.0;577.0;709.0;1896
9742;Zwartewaterland;2012;21809;6739;12055;3015;20625;643;211;432;541;298;243;76;31;45;47;24;23;64;27;37;49;18;31;305;198;107;333.0;157.0;60.0;65.0;608.0;710.0;1896
9743;Zwartewaterland;2013;21882;6701;12021;3160;20625;655;225;430;602;328;274;84;33;51;47;24;23;73;32;41;61;21;40;337;218;119;338.0;161.0;53.0;68.0;623.0;740.0;1896
9744;Zwartewaterland;2014;21930;6638;11969;3323;20610;681;225;456;639;338;301;100;41;59;50;25;25;78;33;45;73;26;47;338;213;125;330.0;161.0;53.0;63.0;625.0;737.0;1896
9745;Zwartewaterland;2015;21975;6601;11967;3407;20607;684;224;460;684;366;318;109;46;63;57;31;26;89;39;50;73;27;46;356;223;133;330.0;165.0;54.0;68.0;622.0;711.0;1896
9746;Zwartewaterland;2016;22037;6553;11957;3527;20622;671;213;458;744;375;369;119;50;69;65;31;34;99;38;61;84;29;55;377;227;150;331.0;170.0;51.0;65.0;583.0;730.0;1896
9747;Zwartewaterland;2017;22037;6479;11933;3625;20585;670;215;455;782;389;393;127;55;72;71;35;36;108;42;66;91;29;62;385;228;157;336.0;171.0;55.0;64.0;621.0;734.0;1896
9748;Zwartewaterland;2018;22083;6410;11934;3739;20593;682;217;465;808;403;405;135;60;75;74;37;37;115;44;71;90;29;61;394;233;161;333.0;175.0;47.0;60.0;635.0;746.0;1896
9749;Zwartewaterland;2019;22118;6338;11907;3873;20593;674;212;462;851;425;426;145;70;75;79;40;39;121;45;76;98;32;66;408;238;170;325.0;183.0;51.0;63.0;652.0;744.0;1896
9750;Zwartewaterland;2020;22161;6311;11869;3981;20594;685;217;468;882;436;446;160;75;85;77;37;40;122;43;79;105;37;68;418;244;174;330.0;184.0;56.0;63.0;605.0;780.0;1896
9751;Zwartewaterland;2021;22128;6240;11772;4116;20522;681;220;461;925;453;472;168;76;92;85;42;43;131;43;88;114;39;75;427;253;174;319.0;187.0;54.0;63.0;621.0;738.0;1896
9752;Zwartewaterland;2022;22138;6169;11745;4224;20481;686;222;464;971;482;489;174;83;91;92;49;43;137;45;92;117;37;80;451;268;183;314.0;193.0;61.0;66.0;656.0;737.0;1896
9753;Zwartewaterland;2023;22177;6115;11750;4312;20428;719;236;483;1030;507;523;180;90;90;90;48;42;158;54;104;139;43;96;463;272;191;324.0;196.0;57.0;66.0;571.0;756.0;1896
9754;Zwartewaterland;2024;22114;6030;11681;4403;20326;734;250;484;1054;522;532;184;93;91;91;47;44;156;53;103;143;48;95;480;281;199;309.0;198.0;54.0;67.0;619.0;755.0;1896
9755;Zwartewaterland;2025;22079;5992;11600;4487;20244;759;261;498;1076;522;554;186;94;92;86;44;42;172;58;114;143;46;97;489;280;209;;;;;;;1896
9756;Zwijndrecht;2008;44427;10179;26374;7874;36626;3276;1200;2076;4525;2537;1988;633;351;282;528;305;223;1204;596;608;793;403;390;1367;882;485;437.0;405.0;154.0;214.0;1912.0;1994.0;642
9757;Zwijndrecht;2009;44326;10088;26256;7982;36480;3278;1195;2083;4568;2545;2023;646;344;302;519;296;223;1198;590;608;801;414;387;1404;901;503;434.0;404.0;177.0;198.0;1943.0;2007.0;642
9758;Zwijndrecht;2010;44272;9981;26152;8139;36373;3273;1197;2076;4626;2583;2043;670;355;315;518;287;231;1172;589;583;829;434;395;1437;918;519;429.0;416.0;172.0;200.0;1954.0;1898.0;642
9759;Zwijndrecht;2011;44316;9965;26128;8223;36310;3300;1218;2082;4706;2611;2095;689;360;329;524;285;239;1170;596;574;857;450;407;1466;920;546;422.0;416.0;163.0;200.0;1890.0;1931.0;642
9760;Zwijndrecht;2012;44249;9841;25866;8542;36228;3255;1202;2053;4766;2616;2150;710;368;342;522;272;250;1168;600;568;869;450;419;1497;926;571;440.0;425.0;175.0;195.0;1832.0;1920.0;642
9761;Zwijndrecht;2013;44159;9718;25633;8808;36069;3277;1223;2054;4813;2632;2181;721;375;346;513;268;245;1149;591;558;896;461;435;1534;937;597;423.0;424.0;173.0;189.0;1862.0;1864.0;642
9762;Zwijndrecht;2014;44144;9665;25423;9056;35994;3284;1214;2070;4866;2645;2221;723;378;345;533;275;258;1146;587;559;913;483;430;1551;922;629;426.0;429.0;164.0;187.0;1906.0;1874.0;642
9763;Zwijndrecht;2015;44153;9581;25362;9210;36003;3250;1204;2046;4900;2657;2243;721;380;341;549;281;268;1151;590;561;926;488;438;1553;918;635;430.0;435.0;157.0;189.0;1906.0;1849.0;642
9764;Zwijndrecht;2016;44175;9546;25303;9326;35951;3272;1222;2050;4952;2671;2281;731;380;351;545;283;262;1137;584;553;941;494;447;1598;930;668;437.0;433.0;168.0;183.0;1947.0;1836.0;642
9765;Zwijndrecht;2017;44276;9558;25219;9499;35978;3306;1238;2068;4992;2671;2321;727;383;344;555;287;268;1146;592;554;940;495;445;1624;914;710;444.0;442.0;181.0;179.0;1862.0;1822.0;642
9766;Zwijndrecht;2018;44329;9559;25142;9628;35913;3296;1218;2078;5120;2710;2410;752;393;359;559;284;275;1162;600;562;954;499;455;1693;934;759;427.0;454.0;169.0;178.0;1928.0;1852.0;642
9767;Zwijndrecht;2019;44373;9513;25126;9734;35875;3329;1239;2090;5169;2729;2440;761;387;374;554;286;268;1178;597;581;962;494;468;1714;965;749;444.0;455.0;161.0;174.0;1883.0;1804.0;642
9768;Zwijndrecht;2020;44433;9521;25072;9840;35854;3357;1258;2099;5222;2751;2471;769;386;383;562;289;273;1178;590;588;977;503;474;1736;983;753;440.0;466.0;163.0;180.0;1895.0;1844.0;642
9769;Zwijndrecht;2021;44444;9481;25004;9959;35837;3392;1278;2114;5215;2733;2482;748;383;365;559;287;272;1160;575;585;992;515;477;1756;973;783;452.0;462.0;150.0;162.0;1949.0;1884.0;642
9770;Zwijndrecht;2022;44490;9515;24871;10104;35803;3425;1304;2121;5262;2755;2507;763;393;370;548;283;265;1139;566;573;1008;522;486;1804;991;813;452.0;468.0;166.0;167.0;1971.0;1818.0;642
9771;Zwijndrecht;2023;44633;9521;24875;10237;35894;3433;1310;2123;5306;2763;2543;773;401;372;555;289;266;1164;565;599;997;512;485;1817;996;821;463.0;469.0;145.0;165.0;1906.0;1830.0;642
9772;Zwijndrecht;2024;44688;9503;24778;10407;35867;3465;1317;2148;5356;2784;2572;789;407;382;551;282;269;1181;576;605;991;508;483;1844;1011;833;464.0;475.0;180.0;167.0;1879.0;1890.0;642
9773;Zwijndrecht;2025;44689;9480;24646;10563;35797;3481;1316;2165;5411;2801;2610;784;402;382;554;280;274;1198;576;622;984;508;476;1891;1035;856;;;;;;;642
9774;Zwolle;2008;115006;28505;71807;14694;97547;7584;2666;4918;9875;5765;4110;1219;618;601;1294;810;484;2472;1289;1183;769;347;422;4121;2701;1420;1687.0;975.0;503.0;625.0;4882.0;4478.0;193
9775;Zwolle;2009;116026;28931;72210;14885;98400;7604;2704;4900;10022;5816;4206;1262;650;612;1282;787;495;2473;1278;1195;827;375;452;4178;2726;1452;1650.0;962.0;524.0;618.0;4742.0;4416.0;193
9776;Zwolle;2010;116963;29322;72488;15153;99152;7677;2734;4943;10134;5847;4287;1280;655;625;1279;784;495;2483;1286;1197;857;379;478;4235;2743;1492;1649.0;975.0;552.0;627.0;4728.0;4466.0;193
9777;Zwolle;2011;117847;29644;72769;15434;99825;7752;2779;4973;10270;5879;4391;1310;670;640;1266;780;486;2505;1284;1221;898;390;508;4291;2755;1536;1616.0;998.0;575.0;617.0;4731.0;4437.0;193
9778;Zwolle;2012;118735;29871;72923;15941;100462;7843;2824;5019;10430;5951;4479;1330;671;659;1268;780;488;2522;1304;1218;927;400;527;4383;2796;1587;1589.0;1007.0;566.0;601.0;4863.0;4447.0;193
9779;Zwolle;2013;119710;30189;73005;16516;101184;7916;2851;5065;10610;6041;4569;1373;682;691;1265;778;487;2527;1305;1222;958;409;549;4487;2867;1620;1552.0;1017.0;597.0;593.0;4852.0;4442.0;193
9780;Zwolle;2014;120676;30428;73310;16938;101911;7994;2928;5066;10771;6079;4692;1369;683;686;1278;792;486;2553;1298;1255;1007;419;588;4564;2887;1677;1523.0;1026.0;596.0;577.0;4884.0;4444.0;193
9781;Zwolle;2015;121651;30683;73608;17360;102606;8077;2974;5103;10968;6182;4786;1412;705;707;1255;767;488;2540;1301;1239;1062;441;621;4699;2968;1731;1504.0;1041.0;565.0;576.0;4918.0;4439.0;193
9782;Zwolle;2016;122603;30889;73916;17798;103280;8173;3018;5155;11150;6253;4897;1420;708;712;1275;766;509;2556;1317;1239;1127;459;668;4772;3003;1769;1504.0;1058.0;600.0;574.0;4860.0;4491.0;193
9783;Zwolle;2017;123458;31061;74176;18221;103832;8238;3060;5178;11388;6346;5042;1459;720;739;1294;772;522;2561;1314;1247;1209;486;723;4865;3054;1811;1457.0;1066.0;602.0;573.0;5019.0;4524.0;193
9784;Zwolle;2018;124387;31316;74379;18692;104525;8308;3101;5207;11554;6436;5118;1462;727;735;1308;778;530;2547;1307;1240;1234;492;742;5003;3132;1871;1477.0;1087.0;572.0;560.0;4951.0;4574.0;193
9785;Zwolle;2019;125182;31405;74627;19150;105072;8375;3171;5204;11735;6533;5202;1487;741;746;1312;777;535;2581;1322;1259;1273;514;759;5082;3179;1903;1456.0;1083.0;579.0;551.0;4948.0;4592.0;193
9786;Zwolle;2020;125956;31438;74901;19617;105507;8503;3236;5267;11946;6656;5290;1506;746;760;1340;795;545;2580;1329;1251;1329;530;799;5191;3256;1935;1454.0;1091.0;589.0;566.0;4795.0;4590.0;193
9787;Zwolle;2021;126561;31378;75097;20086;105896;8558;3308;5250;12107;6734;5373;1522;752;770;1360;807;553;2588;1330;1258;1357;538;819;5280;3307;1973;1441.0;1114.0;597.0;546.0;4888.0;4621.0;193
9788;Zwolle;2022;127218;31256;75389;20573;106277;8645;3369;5276;12296;6820;5476;1564;774;790;1377;814;563;2579;1314;1265;1405;545;860;5371;3373;1998;1442.0;1132.0;551.0;549.0;4932.0;4606.0;193
9789;Zwolle;2023;127868;31133;75645;21090;106672;8703;3364;5339;12493;6948;5545;1563;777;786;1378;804;574;2615;1336;1279;1431;563;868;5506;3468;2038;1444.0;1159.0;544.0;541.0;4831.0;4698.0;193
9790;Zwolle;2024;128308;30963;75759;21586;106930;8719;3379;5340;12659;7028;5631;1580;783;797;1408;820;588;2622;1344;1278;1479;567;912;5570;3514;2056;1448.0;1184.0;551.0;562.0;4811.0;4664.0;193
9791;Zwolle;2025;128729;30895;75746;22088;107153;8737;3409;5328;12839;7108;5731;1597;799;798;1429;825;604;2630;1333;1297;1518;577;941;5665;3574;2091;;;;;;;193
